Invoice Date,New Category,Product Name,Encoded Cat,MRP,Selling Price,Discount,Sold Qty
11-05-2025,Spices & Seasonings,Menthulu 250 gms,15,50,45,5,1
11-05-2025,Spices & Seasonings,Vamu 100GM,15,60,50,10,1
11-05-2025,Misc,ROLL D C,8,70,45,25,1
11-05-2025,Spices & Seasonings,dalchin chekka,15,50,40,10,1
11-05-2025,Spices & Seasonings,sonthi choornam,15,200,200,0,2
11-05-2025,"Grains, Flours & Dals",RICE FLOUR 500 GM,4,35,28,7,1
11-05-2025,Oils & Ghee,rice bran oil f,9,388,338,50,2
11-05-2025,"Grains, Flours & Dals",THICK POHA 500GM,4,40,35,5,1
11-05-2025,Snacks & Ready-to-Eat,Corn Chips 250GM,14,80,70,10,2
11-05-2025,"Grains, Flours & Dals",chana flour 500 gms,4,120,108,12,2
11-05-2025,"Dry Fruits, Nuts & Seeds",SUNFLOWER SEEDS 250GRM,2,150,130,20,1
11-05-2025,"Dry Fruits, Nuts & Seeds",PLAIN PISTA 250GM,2,660,550,110,1
11-05-2025,"Dry Fruits, Nuts & Seeds",PUMPKIN SEEDS 250GM,2,200,160,40,1
11-05-2025,"Grains, Flours & Dals",KORRALU (FOXTAIL M) 1KG,4,300,220,80,2
11-05-2025,"Dry Fruits, Nuts & Seeds",ALMONDS 250GM,2,280,260,20,1
11-05-2025,"Dry Fruits, Nuts & Seeds",WATERMELON SEEDS 250GRM,2,320,280,40,1
11-05-2025,"Dry Fruits, Nuts & Seeds",wallnuts,2,380,320,60,1
11-05-2025,"Dry Fruits, Nuts & Seeds",BLACK KISMIS 250GM,2,175,140,35,1
11-05-2025,"Grains, Flours & Dals",SABDANA,4,40,35,5,1
11-05-2025,"Grains, Flours & Dals",SA Sprouted Ragi Flour 500GM,4,69,69,0,1
11-05-2025,Spices & Seasonings,YB Rock Salt 1KG,15,120,120,0,1
11-05-2025,Oils & Ghee,Coconut oil 1 L,9,440,400,40,1
11-05-2025,"Grains, Flours & Dals",BOMBAY RAVA,4,70,55,15,1
11-05-2025,"Dry Fruits, Nuts & Seeds",PLAIN PISTA 250GM,2,660,550,110,1
11-05-2025,"Dry Fruits, Nuts & Seeds",YELLOW KISHMISH 250GM,2,130,110,20,1
11-05-2025,"Dry Fruits, Nuts & Seeds",WATERMELON SEEDS 250GRM,2,320,280,40,1
11-05-2025,"Dry Fruits, Nuts & Seeds",PUMPKIN SEEDS 250GM,2,200,160,40,1
11-05-2025,"Dry Fruits, Nuts & Seeds",wallnuts,2,380,320,60,1
11-05-2025,"Grains, Flours & Dals",RICE FLOUR 500 GM,4,35,28,7,1
11-05-2025,Oils & Ghee,Groundnut oil 500ml,9,180,165,15,1
11-05-2025,Misc,ROLL D C,8,350,225,125,5
11-05-2025,Beverages,BISLERI 100ml,1,10,10,0,1
11-05-2025,"Grains, Flours & Dals",Green gram 1 kg,4,150,130,20,1
11-05-2025,"Grains, Flours & Dals",Urad dall 1 Kg,4,185,170,15,1
11-05-2025,"Dry Fruits, Nuts & Seeds",SABJA SEEDS,2,70,70,0,1
11-05-2025,Snacks & Ready-to-Eat,SIRI ICE CREAM 100ML,14,100,80,20,1
11-05-2025,"Grains, Flours & Dals",EM Ragi idli R 500G,4,75,75,0,1
11-05-2025,"Grains, Flours & Dals",SA Sprouted Ragi Flour 500GM,4,69,69,0,1
11-05-2025,Personal Care & Cosmetics,HERBAL BATH POWDER 200GM,10,80,80,0,1
11-05-2025,Oils & Ghee,Groundnut oil 1 L,9,330,330,0,1
11-05-2025,Spices & Seasonings,Jeera 100GM,15,50,45,5,1
11-05-2025,"Grains, Flours & Dals",Wheat Flour 1 kg,4,70,60,10,1
11-05-2025,"Grains, Flours & Dals",Urad dall 1 Kg,4,185,170,15,1
11-05-2025,"Grains, Flours & Dals",SPLIT BLACK GRAM 500 GM,4,90,85,5,1
11-05-2025,"Dry Fruits, Nuts & Seeds",Groundnuts 1 kg,2,190,165,25,1
11-05-2025,"Grains, Flours & Dals",BOMBAY RAVA,4,70,55,15,1
11-05-2025,"Grains, Flours & Dals",SRILATHA RICE RAVVA 500GM,4,70,70,0,2
11-05-2025,"Grains, Flours & Dals",SABDANA 500GM,4,90,70,20,1
11-05-2025,Pooja & Spiritual Items,GD Aiswarya Deepam 700ML,12,195,195,0,1
11-05-2025,Pickles & Cooking Pastes,DURGA BRAND TM PICKLES SPECIAL,11,28,28,0,1
11-05-2025,Spices & Seasonings,MUSTARD POWDR 500G,15,130,110,20,1
11-05-2025,Spices & Seasonings,3M.MIRCHI POWDER,15,720,640,80,2
11-05-2025,General Household & Kitchenware,chalk piece 1b,3,15,10,5,1
11-05-2025,"Dry Fruits, Nuts & Seeds",MAHA BEERA SEEDS 100GM,2,60,60,0,1
11-05-2025,"Dry Fruits, Nuts & Seeds",SABJA SEEDS,2,70,70,0,1
11-05-2025,"Grains, Flours & Dals",BARLEY SEEDS 250GMS,4,40,35,5,1
11-05-2025,"Grains, Flours & Dals",SRILATHA RICE RAVVA 500GM,4,35,35,0,1
11-05-2025,"Grains, Flours & Dals",RAGULU 1 KG,4,70,60,10,1
11-05-2025,"Grains, Flours & Dals",FLOUR CHARGE,4,18,18,0,1.5
11-05-2025,"Grains, Flours & Dals",BAJRA 1 KG,4,15,12.5,2.5,0.25
11-05-2025,"Grains, Flours & Dals",YELLOW JOWER 1KG,4,22.5,20,2.5,0.25
11-05-2025,"Grains, Flours & Dals",Wheat Rava S 500GM,4,33,30,3,1
11-05-2025,Oils & Ghee,Groundnut oil 1 L,9,330,330,0,1
11-05-2025,"Grains, Flours & Dals",THICK POHA 500GM,4,40,35,5,1
11-05-2025,Personal Care & Cosmetics,MYSORE SANDAL SOAP 75G,10,42,42,0,1
11-05-2025,Snacks & Ready-to-Eat,A biscuits,14,0,0,0,1
11-05-2025,"Dry Fruits, Nuts & Seeds",Groundnuts 500 gms,2,95,85,10,1
11-05-2025,Spices & Seasonings,ROYAL SAFFRON 400GRMS,15,65,65,0,1
11-05-2025,Spices & Seasonings,Turmeric powder 250 gms,15,100,80,20,1
11-05-2025,"Grains, Flours & Dals",JOWAR WHITE 1 KG,4,160,140,20,2
11-05-2025,General Household & Kitchenware,chalk piece 1b,3,15,10,5,1
11-05-2025,Snacks & Ready-to-Eat,SD Methi laddu with honey 175gm,14,135,135,0,1
11-05-2025,"Grains, Flours & Dals",RAGI FLOUR 1KG,4,160,140,20,2
11-05-2025,"Grains, Flours & Dals",EM Ragi idli R 500G,4,150,150,0,2
11-05-2025,"Grains, Flours & Dals",RAGULU 1 KG,4,21,18,3,0.3
11-05-2025,"Grains, Flours & Dals",FLOUR CHARGE,4,64.8,64.8,0,5.4
11-05-2025,"Dry Fruits, Nuts & Seeds",FLAX SEEDS 1KG,2,72,60,12,0.3
11-05-2025,"Grains, Flours & Dals",BAJRA 1 KG,4,18,15,3,0.3
11-05-2025,"Grains, Flours & Dals",JOWAR WHITE 1 KG,4,48,42,6,0.6
11-05-2025,"Grains, Flours & Dals",PLAIN OATS 1KG,4,63,63,0,0.3
11-05-2025,"Grains, Flours & Dals",BARLEY SEEDS 1KG,4,48,42,6,0.3
11-05-2025,"Grains, Flours & Dals",WHEAT 1 KG,4,180,150,30,3
11-05-2025,"Grains, Flours & Dals",SOYA BEANS 1KG,4,60,54,6,0.3
11-05-2025,"Grains, Flours & Dals",chana flour 500 gms,4,60,54,6,1
11-05-2025,Snacks & Ready-to-Eat,VD TOMATO MURUKULU,14,60,60,0,1
11-05-2025,"Dry Fruits, Nuts & Seeds",SUNFLOWER SEEDS 250GRM,2,150,130,20,1
11-05-2025,Sweeteners,YB JAGGERY POWDER 500GMS,16,75,75,0,1
11-05-2025,"Dry Fruits, Nuts & Seeds",WATERMELON SEEDS 250GRM,2,320,280,40,1
11-05-2025,"Dry Fruits, Nuts & Seeds",PUMPKIN SEEDS 250GM,2,200,160,40,1
11-05-2025,"Dry Fruits, Nuts & Seeds",ALMONDS 250GM,2,280,260,20,1
11-05-2025,"Dry Fruits, Nuts & Seeds",KAJU HALF 250GM,2,310,290,20,1
11-05-2025,Oils & Ghee,sesame oil 1L,9,1770,"1,680.00",90,3
11-05-2025,Spices & Seasonings,DURGA SALT CRYSTAL 1KG,15,50,50,0,2
11-05-2025,"Grains, Flours & Dals",FLOUR CHARGE,4,48,48,0,4
11-05-2025,Snacks & Ready-to-Eat,RSC ORANGE 100GMS,14,20,20,0,1
11-05-2025,Spices & Seasonings,Turmeric powder 250 gms,15,100,80,20,1
11-05-2025,"Grains, Flours & Dals",IDLY RAVA 1KG,4,60,50,10,1
11-05-2025,"Grains, Flours & Dals",maida 500grms,4,70,60,10,2
11-05-2025,"Grains, Flours & Dals",BOMBAY RAVA,4,70,55,15,1
11-05-2025,"Grains, Flours & Dals",Wheat Flour 1 kg,4,280,240,40,4
11-05-2025,Oils & Ghee,Groundnut oil 500ml,9,180,165,15,1
11-05-2025,"Grains, Flours & Dals",Wheat Rava M 1KG,4,130,110,20,2
11-05-2025,General Household & Kitchenware,MATCH BOX,3,10,10,0,1
11-05-2025,"Dry Fruits, Nuts & Seeds",WATERMELON SEEDS 250GRM,2,320,280,40,1
11-05-2025,"Dry Fruits, Nuts & Seeds",PUMPKIN SEEDS 250GM,2,200,160,40,1
11-05-2025,Oils & Ghee,Groundnut oil 500ml,9,180,165,15,1
11-05-2025,Spices & Seasonings,sf jeera,15,240,240,0,2
11-05-2025,Personal Care & Cosmetics,ROUND LOOFAH,10,65,65,0,1
11-05-2025,Oils & Ghee,cow ghee 500 ml,9,430,390,40,1
11-05-2025,Household & Cleaning,ROOPERI PITAMBARI SILVER 50ML,6,110,110,0,1
11-05-2025,Oils & Ghee,sesame oil 1L,9,590,560,30,1
11-05-2025,"Grains, Flours & Dals",DESI CHANA,4,50,50,0,2
11-05-2025,Snacks & Ready-to-Eat,SD Aswagandha with palm Jaggery250Gm,14,135,135,0,1
11-05-2025,"Health, Wellness & Ayurvedic Products",MD Manjistha Choornam 50GM,5,150,150,0,1
11-05-2025,Personal Care & Cosmetics,DWIBHASHI GULABA ARKA ROSA WATER,10,60,60,0,1
11-05-2025,Oils & Ghee,sesame oil 1L,9,590,560,30,1
11-05-2025,Snacks & Ready-to-Eat,CHOCO H SMALL PH,14,220,220,0,1
11-05-2025,Spices & Seasonings,idli karam powdwer,15,65,65,0,1
11-05-2025,General Household & Kitchenware,CLASSMATE,3,22,22,0,1
11-05-2025,Oils & Ghee,Safflower oil 1 L,9,400,400,0,1
11-05-2025,Snacks & Ready-to-Eat,PEANUT CHILLI,14,10,10,0,2
11-05-2025,Oils & Ghee,Safflower oil 500 ml,9,220,200,20,1
11-05-2025,Oils & Ghee,Sesame oil 500ml,9,295,280,15,1
11-05-2025,Spices & Seasonings,TATA SALT 1KG,15,30,30,0,1
11-05-2025,Spices & Seasonings,Tamarind 500GM,15,160,130,30,1
11-05-2025,"Grains, Flours & Dals",Urad dall 1 Kg,4,185,170,15,1
11-05-2025,Spices & Seasonings,Jeera 100GM,15,50,45,5,1
11-05-2025,"Grains, Flours & Dals",Wheat Rava S 1KG,4,33,30,3,1
11-05-2025,"Grains, Flours & Dals",Wheat Flour 1 kg,4,70,60,10,1
11-05-2025,"Grains, Flours & Dals",turdal 1kg,4,660,510,150,3
11-05-2025,"Grains, Flours & Dals",Bombay Rava 500GM,4,35,30,5,1
11-05-2025,Oils & Ghee,cow ghee 500 ml,9,430,390,40,1
11-05-2025,Oils & Ghee,Groundnut oil 1 L,9,990,990,0,3
11-05-2025,Spices & Seasonings,ROYAL SAFFRON,15,125,125,0,1
11-05-2025,Sweeteners,SUGAR 1KG,16,120,112,8,2
11-05-2025,"Grains, Flours & Dals",KORRALU (FOXTAIL M) 500GM,4,65,55,10,1
11-05-2025,"Grains, Flours & Dals",Green gram 1 kg,4,150,130,20,1
11-05-2025,"Grains, Flours & Dals",Green Batani 250GM,4,55,45,10,1
11-05-2025,Spices & Seasonings,Turmeric powder 250 gms,15,100,80,20,1
11-05-2025,"Grains, Flours & Dals",white Bobarlu 500 gms,4,80,75,5,1
11-05-2025,Spices & Seasonings,Chilli powder 500 gms,15,290,210,80,1
11-05-2025,"Grains, Flours & Dals",RAGI FLOUR 500GRMS,4,40,35,5,1
11-05-2025,"Grains, Flours & Dals",RICE FLOUR 1KG,4,70,55,15,1
11-05-2025,"Grains, Flours & Dals",MAIDA 1KG,4,70,60,10,1
11-05-2025,"Grains, Flours & Dals",RAGI FLOUR 1KG,4,80,70,10,1
11-05-2025,"Health, Wellness & Ayurvedic Products",MD Hibiscus Flower Choornam 30GM,5,100,100,0,1
11-05-2025,Spices & Seasonings,lavangam,15,50,50,0,1
11-05-2025,"Dry Fruits, Nuts & Seeds",FLAX SEEDS 250GM,2,60,50,10,1
11-05-2025,Pooja & Spiritual Items,GD Dhoop Cones 40GM,12,30,30,0,1
11-05-2025,Pooja & Spiritual Items,GD SANDAL 150GM,12,220,220,0,2
11-05-2025,"Dry Fruits, Nuts & Seeds",PUMPKIN SEEDS 250GM,2,200,160,40,1
11-05-2025,"Grains, Flours & Dals",Multigrain 1 kg,4,200,170,30,2
11-05-2025,Misc,ROLL D C,8,70,45,25,1
11-05-2025,Spices & Seasonings,SATHVI ANASAPUVUU 25GM,15,90,65,25,1
11-05-2025,Personal Care & Cosmetics,DWIBASSHI HENNA POWDER,10,60,60,0,1
11-05-2025,Beverages,BISLERI 100ml,1,10,10,0,1
11-05-2025,Personal Care & Cosmetics,MADDI BATH POWDER 400GM,10,150,150,0,1
11-05-2025,"Grains, Flours & Dals",RAGI FLOUR 1KG,4,160,140,20,2
11-05-2025,Personal Care & Cosmetics,stay free 1,10,100,100,0,1
11-05-2025,"Grains, Flours & Dals",EM Foxtail idli r 500 g,4,109,109,0,1
11-05-2025,"Grains, Flours & Dals",AISHWARYA SP 1KG,4,80,70,10,1
11-05-2025,"Dry Fruits, Nuts & Seeds",PULMAKHANA 100 GM,2,180,170,10,1
11-05-2025,Snacks & Ready-to-Eat,PEANUT CHILLI,14,5,5,0,1
11-05-2025,"Health, Wellness & Ayurvedic Products",RB Max Protein Spanish Tomato,5,45,45,0,1
11-05-2025,"Grains, Flours & Dals",SPLIT URAD DAL,4,45,45,0,1
11-05-2025,Oils & Ghee,Coconut oil 500 ml,9,220,200,20,1
11-05-2025,Snacks & Ready-to-Eat,Corn Chips 250GM,14,40,35,5,1
11-05-2025,"Grains, Flours & Dals",UDALU (Barnyard millet) 500 gms,4,70,60,10,1
11-05-2025,"Grains, Flours & Dals",BARLEY SEEDS 250GMS,4,40,35,5,1
11-05-2025,Snacks & Ready-to-Eat,PN ORGANIC PUFFED RICE 200GM,14,55,55,0,1
11-05-2025,Snacks & Ready-to-Eat,RINGS 200GM,14,30,30,0,1
11-05-2025,Snacks & Ready-to-Eat,KURNOOL MARMURA,14,70,55,15,1
11-05-2025,"Grains, Flours & Dals",Urad dall 1 Kg,4,555,510,45,3
11-05-2025,"Grains, Flours & Dals",white Bobarlu 500 gms,4,80,75,5,1
11-05-2025,Sweeteners,organic jaggery powder,16,99,99,0,1
11-05-2025,Spices & Seasonings,JEERA 250 gms,15,125,105,20,1
11-05-2025,"Grains, Flours & Dals",split black gram 1 kg,4,180,170,10,1
11-05-2025,Spices & Seasonings,Gasagasalu 50GM,15,130,110,20,1
11-05-2025,"Dry Fruits, Nuts & Seeds",KAJU HALF 250GM,2,310,290,20,1
11-05-2025,"Dry Fruits, Nuts & Seeds",SATHVI CHIA SEEDS 100GM,2,100,80,20,1
11-05-2025,"Grains, Flours & Dals",Wheat Flour 1 kg,4,140,120,20,2
11-05-2025,"Dry Fruits, Nuts & Seeds",SUNFLOWER SEEDS 250GRM,2,150,130,20,1
11-05-2025,Spices & Seasonings,NUVVULU 250GM,15,80,65,15,1
11-05-2025,"Grains, Flours & Dals",chana flour 500 gms,4,60,54,6,1
11-05-2025,Beverages,REFRESH SHARBATH NORMAL,1,199,190,9,1
11-05-2025,Spices & Seasonings,ROYAL SAFFRON,15,125,125,0,1
11-05-2025,"Dry Fruits, Nuts & Seeds",PUMPKIN SEEDS 250GM,2,200,160,40,1
11-05-2025,Spices & Seasonings,KARAKAYA,15,50,30,20,1
11-05-2025,Spices & Seasonings,Jeera 100GM,15,50,45,5,1
11-05-2025,"Grains, Flours & Dals",SAMALU (Little millet) 500 gms,4,85,65,20,1
11-05-2025,"Grains, Flours & Dals",UDALU (Barnyard millet) 500 gms,4,70,60,10,1
11-05-2025,"Grains, Flours & Dals",RAGI FLOUR 500GRMS,4,40,35,5,1
11-05-2025,"Grains, Flours & Dals",turdal 1kg,4,220,170,50,1
11-05-2025,"Grains, Flours & Dals",Wheat Flour 1 kg,4,70,60,10,1
11-05-2025,"Grains, Flours & Dals",IDLY RAVA 1KG,4,60,50,10,1
11-05-2025,"Grains, Flours & Dals",AISHWARYA SP 1KG,4,160,140,20,2
11-05-2025,"Grains, Flours & Dals",IDLY RAVA 1KG,4,120,100,20,2
11-05-2025,Spices & Seasonings,RED COPRA 500GM,15,170,148,22,1
11-05-2025,"Grains, Flours & Dals",Multigrain 1 kg,4,100,85,15,1
11-05-2025,Personal Care & Cosmetics,NISHA BLACK HENNA,10,70,70,0,1
11-05-2025,Oils & Ghee,Coconut oil 500 ml,9,440,400,40,2
11-05-2025,"Grains, Flours & Dals",turdal 500 gms,4,110,85,25,1
11-05-2025,"Grains, Flours & Dals",MAATEJA rice 1 kg,4,216,207,9,3
11-05-2025,"Grains, Flours & Dals",Wheat Rava S 500GM,4,33,30,3,1
11-05-2025,"Grains, Flours & Dals",Bombay Rava 500GM,4,35,30,5,1
11-05-2025,"Grains, Flours & Dals",SRILATHA RICE RAVVA 500GM,4,35,35,0,1
11-05-2025,"Grains, Flours & Dals",RAGI FLOUR 500GRMS,4,40,35,5,1
11-05-2025,Spices & Seasonings,Jeera 100GM,15,50,45,5,1
11-05-2025,"Dry Fruits, Nuts & Seeds",Putnalu 250GM,2,45,38,7,1
11-05-2025,"Grains, Flours & Dals",BASMATHI RICE 1KG,4,150,135,15,1
11-05-2025,"Grains, Flours & Dals",CHANA DAL 500GM,4,56,48,8,1
11-05-2025,"Grains, Flours & Dals",Urad dall 1 Kg,4,185,170,15,1
11-05-2025,"Grains, Flours & Dals",IDLY RAVA 1KG,4,60,50,10,1
11-05-2025,Spices & Seasonings,Coriander seeds 200 gms,15,48,40,8,1
11-05-2025,"Dry Fruits, Nuts & Seeds",Groundnuts 500 gms,2,95,85,10,1
11-05-2025,"Grains, Flours & Dals",turdal 500 gms,4,110,85,25,1
11-05-2025,"Grains, Flours & Dals",turdal 500 gms,4,110,85,25,1
11-05-2025,Snacks & Ready-to-Eat,VD PALLI LADDU,14,80,80,0,1
11-05-2025,Snacks & Ready-to-Eat,VD MULTI CHAKKA,14,110,110,0,1
11-05-2025,"Grains, Flours & Dals",RAGI FLOUR 500GRMS,4,40,35,5,1
11-05-2025,Snacks & Ready-to-Eat,VD MURUKU 175GM,14,60,60,0,1
11-05-2025,"Dry Fruits, Nuts & Seeds",PLAIN PISTA 250GM,2,660,550,110,1
11-05-2025,Household & Cleaning,SURFEXCEL BAR 80G,6,40,40,0,4
11-05-2025,Spices & Seasonings,YB Rock Salt 1KG,15,120,120,0,1
11-05-2025,"Grains, Flours & Dals",SRILATHA RICE RAVVA 500GM,4,70,70,0,2
11-05-2025,"Grains, Flours & Dals",turdal 1kg,4,220,170,50,1
11-05-2025,"Dry Fruits, Nuts & Seeds",Groundnuts 1 kg,2,380,330,50,2
11-05-2025,Oils & Ghee,rice bran oil f,9,388,338,50,2
11-05-2025,"Grains, Flours & Dals",VGR rice 1 kg,4,140,130,10,2
11-05-2025,"Grains, Flours & Dals",CHANA DAL 500GM,4,56,48,8,1
11-05-2025,"Grains, Flours & Dals",AISHWARYA SP 1KG,4,240,210,30,3
11-05-2025,"Grains, Flours & Dals",Bombay Rava 500GM,4,35,30,5,1
11-05-2025,"Dry Fruits, Nuts & Seeds",wallnuts,2,380,320,60,1
11-05-2025,"Dry Fruits, Nuts & Seeds",cashew,2,1020,930,90,3
11-05-2025,"Dry Fruits, Nuts & Seeds",DRYDATES YELLOW 250GM,2,270,240,30,2
11-05-2025,Personal Care & Cosmetics,OLD SPICE FRESH LIME 70GM,10,75,75,0,1
11-05-2025,Snacks & Ready-to-Eat,SF NOODLES CLKASSIC MASALA,14,129,129,0,1
11-05-2025,Household & Cleaning,mostick,6,120,120,0,6
11-05-2025,Snacks & Ready-to-Eat,SF MILLET NOODLES MILD MASALA 192GM,14,129,129,0,1
11-05-2025,"Grains, Flours & Dals",Chittimuthaylu rice 1 kg,4,160,140,20,1
11-05-2025,"Health, Wellness & Ayurvedic Products",RB Nuts& Seeds cashews 35g,5,90,90,0,2
11-05-2025,"Dry Fruits, Nuts & Seeds",YELLOW KISHMISH 250GM,2,130,110,20,1
11-05-2025,"Dry Fruits, Nuts & Seeds",PLAIN PISTA 250GM,2,660,550,110,1
11-05-2025,"Grains, Flours & Dals",SL Idly Rava 1KG,4,65,55,10,1
11-05-2025,"Dry Fruits, Nuts & Seeds",wallnuts,2,380,320,60,1
11-05-2025,"Dry Fruits, Nuts & Seeds",ALMONDS 250GM,2,280,260,20,1
11-05-2025,Sweeteners,Natural Honey 500 gms,16,280,240,40,1
11-05-2025,Oils & Ghee,Safflower oil 500 ml,9,220,200,20,1
11-05-2025,"Dry Fruits, Nuts & Seeds",PN ORGANIC MAKHANA 50GM,2,125,125,0,1
11-05-2025,Personal Care & Cosmetics,VETIVER SOAP 100GM,10,100,100,0,1
11-05-2025,Oils & Ghee,Sesame oil 500ml,9,295,280,15,1
11-05-2025,"Dry Fruits, Nuts & Seeds",GF KIMIA DATES 500GM,2,310,190,120,1
11-05-2025,Beverages,BISLERI WATER 1L,1,20,20,0,1
11-05-2025,Snacks & Ready-to-Eat,Sprouted Ragi Biscuits 450GM,14,300,300,0,2
11-05-2025,Snacks & Ready-to-Eat,3D PAPAD,14,40,40,0,1
11-05-2025,Snacks & Ready-to-Eat,SUNNUNDALU,14,120,120,0,1
11-05-2025,Beverages,BISLERI 100ml,1,10,10,0,1
11-05-2025,"Grains, Flours & Dals",White jowar.F 1 kg,4,400,320,80,4
11-05-2025,Oils & Ghee,Safflower oil 5 L,9,2200,"1,950.00",250,1
11-05-2025,"Grains, Flours & Dals",RAGI FLOUR 1KG,4,160,140,20,2
11-05-2025,Pickles & Cooking Pastes,SD MANGO PICKLE,11,120,120,0,1
11-05-2025,"Grains, Flours & Dals",chana flour 500 gms,4,60,54,6,1
11-05-2025,Misc,ROLL D C,8,70,45,25,1
11-05-2025,Personal Care & Cosmetics,GAYATHRI KUMKUDUKAYA,10,600,600,0,4
11-05-2025,Personal Care & Cosmetics,Soapnut 250GM,10,60,45,15,1
11-05-2025,"Grains, Flours & Dals",IDLY RAVA 1KG,4,60,50,10,1
11-05-2025,Misc,C123,8,95,80,15,1
11-05-2025,Pooja & Spiritual Items,GD WOODS 150GM,12,110,110,0,1
11-05-2025,Pooja & Spiritual Items,GD SANDAL 150GM,12,110,110,0,1
11-05-2025,Pooja & Spiritual Items,GD Aiswarya Deepam 700ML,12,390,390,0,2
11-05-2025,Oils & Ghee,Groundnut oil 1 L,9,990,990,0,3
11-05-2025,Pickles & Cooking Pastes,DURGA BRAND TM PICKLES SPECIAL,11,56,56,0,2
11-05-2025,Spices & Seasonings,AVALU 100GM,15,25,20,5,1
11-05-2025,Spices & Seasonings,MUSTARD POWDR 500G,15,130,110,20,1
11-05-2025,Oils & Ghee,sesame oil 1L,9,1180,"1,120.00",60,2
11-05-2025,Spices & Seasonings,Menthulu 250 gms,15,50,45,5,1
11-05-2025,Oils & Ghee,sesame oil 1L,9,590,560,30,1
11-05-2025,Oils & Ghee,Safflower oil 1 L,9,400,400,0,1
11-05-2025,Pickles & Cooking Pastes,DURGA BRAND TM PICKLES SPECIAL,11,56,56,0,2
11-05-2025,Oils & Ghee,Groundnut oil 1 L,9,660,660,0,2
11-05-2025,Oils & Ghee,Sesame oil 500ml,9,295,280,15,1
11-05-2025,Oils & Ghee,Coconut oil 500 ml,9,220,200,20,1
11-05-2025,Spices & Seasonings,NUVVULU 250GM,15,160,130,30,2
11-05-2025,Milk & Dairy,SANGAM CURD 450GM,7,38,38,0,1
11-05-2025,"Grains, Flours & Dals",BOMBAY RAVA,4,70,55,15,1
11-05-2025,Milk & Dairy,HERITAGE BUTTERMILK,7,10,10,0,1
11-05-2025,Milk & Dairy,HERITAGE TOTAL CURD 500GM,7,50,50,0,1
11-05-2025,"Dry Fruits, Nuts & Seeds",Groundnuts 500 gms,2,95,85,10,1
11-05-2025,Oils & Ghee,sesame oil 1L,9,590,560,30,1
11-05-2025,Personal Care & Cosmetics,OVAL BODY LOOFAH,10,55,55,0,1
11-05-2025,Snacks & Ready-to-Eat,RINGS 200GM,14,30,30,0,1
11-05-2025,Oils & Ghee,sesame oil 1L,9,590,560,30,1
11-05-2025,Spices & Seasonings,Coriander seeds 200 gms,15,48,40,8,1
11-05-2025,"Grains, Flours & Dals",SABDANA,4,40,35,5,1
11-05-2025,"Grains, Flours & Dals",Green Batani 250GM,4,55,45,10,1
11-05-2025,Snacks & Ready-to-Eat,NGT CHATPATTA CHANA 90GM,14,50,50,0,2
11-05-2025,Spices & Seasonings,Tamarind 250GMS,15,80,65,15,1
11-05-2025,"Grains, Flours & Dals",RAGULU 1 KG,4,140,120,20,2
11-05-2025,Personal Care & Cosmetics,MD Bath Powder 100GM,10,40,40,0,1
11-05-2025,Misc,C123,8,190,160,30,2
11-05-2025,Spices & Seasonings,RED COPRA 500GM,15,170,148,22,1
11-05-2025,Oils & Ghee,Groundnut oil 1 L,9,330,330,0,1
11-05-2025,Snacks & Ready-to-Eat,SIRI ICE CREAM 100ML,14,400,320,80,4
11-05-2025,"Grains, Flours & Dals",RED RICE 1KG,4,750,600,150,5
11-05-2025,"Health, Wellness & Ayurvedic Products",GS Wheat Grass Powder 100GMS,5,349,349,0,1
11-05-2025,"Dry Fruits, Nuts & Seeds",cashew,2,680,620,60,2
11-05-2025,"Grains, Flours & Dals",Wheat Rava S 500GM,4,33,30,3,1
11-05-2025,"Grains, Flours & Dals",SB Javva Wheat Ravva 500GM,4,95,95,0,1
11-05-2025,"Grains, Flours & Dals",Red Bobarlu 500 gms,4,95,85,10,1
11-05-2025,"Grains, Flours & Dals",THICK POHA 500GM,4,40,35,5,1
11-05-2025,"Grains, Flours & Dals",turdal 1kg,4,220,170,50,1
11-05-2025,"Grains, Flours & Dals",Wheat Flour 1 kg,4,70,60,10,1
11-05-2025,"Grains, Flours & Dals",chana flour 500 gms,4,60,54,6,1
11-05-2025,"Grains, Flours & Dals",Em kodo idli R 500G,4,129,129,0,1
11-05-2025,Personal Care & Cosmetics,MD Soapnut Choornam 100GM,10,80,80,0,1
11-05-2025,Spices & Seasonings,DRY MIECHI 200GM,15,80,60,20,1
11-05-2025,"Grains, Flours & Dals",EM Foxtail idli r 500 g,4,109,109,0,1
11-05-2025,"Grains, Flours & Dals",Urad dall 500 gms,4,190,170,20,2
11-05-2025,"Grains, Flours & Dals",CHANA DAL 500GM,4,56,48,8,1
11-05-2025,"Dry Fruits, Nuts & Seeds",Groundnuts 1 kg,2,380,330,50,2
11-05-2025,Snacks & Ready-to-Eat,SF MILLET VERMICELLII FOXTAIL,14,139,139,0,1
11-05-2025,Pooja & Spiritual Items,GD Dhoop Sticks 26GM,12,20,20,0,1
11-05-2025,Snacks & Ready-to-Eat,SF NOODLES CLKASSIC MASALA,14,129,129,0,1
11-05-2025,"Grains, Flours & Dals",RAGI FLOUR 1KG,4,80,70,10,1
11-05-2025,"Grains, Flours & Dals",SRILATHA RICE RAVVA 500GM,4,35,35,0,1
11-05-2025,Snacks & Ready-to-Eat,SF VERMICELLI,14,139,139,0,1
11-05-2025,Oils & Ghee,Coconut oil 1 L,9,440,400,40,1
11-05-2025,Sweeteners,MISHRI 250 GM,16,35,30,5,1
11-05-2025,"Health, Wellness & Ayurvedic Products",MXP CREAM ONION,5,45,45,0,1
11-05-2025,Oils & Ghee,Groundnut oil 500ml,9,180,165,15,1
11-05-2025,Spices & Seasonings,BIRYANI LEAF 10GM,15,30,20,10,1
11-05-2025,Oils & Ghee,Groundnut oil 1 L,9,330,330,0,1
11-05-2025,"Grains, Flours & Dals",RAGI FLOUR 500GRMS,4,40,35,5,1
11-05-2025,Oils & Ghee,Coconut oil 1 L,9,440,400,40,1
11-05-2025,"Grains, Flours & Dals",Wheat Flour 1 kg,4,70,60,10,1
11-05-2025,"Grains, Flours & Dals",SABDANA,4,40,35,5,1
11-05-2025,"Grains, Flours & Dals",KORRALU (FOXTAIL M) 500GM,4,65,55,10,1
11-05-2025,Oils & Ghee,Sesame oil 500ml,9,295,280,15,1
11-05-2025,Oils & Ghee,Groundnut oil 500ml,9,180,165,15,1
11-05-2025,"Grains, Flours & Dals",Wheat Flour 1 kg,4,70,60,10,1
11-05-2025,Oils & Ghee,Coconut oil 500 ml,9,220,200,20,1
11-05-2025,"Grains, Flours & Dals",RAGI FLOUR 500GRMS,4,40,35,5,1
11-05-2025,"Dry Fruits, Nuts & Seeds",DRYDATES 250GM,2,150,120,30,1
11-05-2025,"Health, Wellness & Ayurvedic Products",HARITHAKI CHOORNAM,5,80,80,0,1
11-05-2025,Oils & Ghee,Groundnut oil 1 L,9,660,660,0,2
11-05-2025,Pooja & Spiritual Items,SWASTIK CAMPHORE,12,90,90,0,1
11-05-2025,Sweeteners,YB Brown Sugar 500GM,16,75,75,0,1
11-05-2025,"Grains, Flours & Dals",unpolished turdall500grms,4,360,330,30,3
11-05-2025,Misc,VD00014,8,100,90,10,1
11-05-2025,Sweeteners,YB Palm Jaggery 250GM,16,200,200,0,1
11-05-2025,"Grains, Flours & Dals",Wheat Flour 1 kg,4,70,60,10,1
11-05-2025,Snacks & Ready-to-Eat,NGT CHATPATTA CHANA 90GM,14,50,50,0,2
11-05-2025,Oils & Ghee,rice bran oil f,9,194,169,25,1
11-05-2025,Spices & Seasonings,DURGA SALT CRYSTAL 1KG,15,50,50,0,2
11-05-2025,Spices & Seasonings,Avalu small 500 gms,15,240,240,0,2
11-05-2025,"Grains, Flours & Dals",PESARA PAPPU 1 KG,4,170,145,25,1
11-05-2025,Oils & Ghee,Groundnut oil 1 L,9,660,660,0,2
11-05-2025,Spices & Seasonings,Menthulu 500 gms,15,100,90,10,1
11-05-2025,"Dry Fruits, Nuts & Seeds",SATHVI CHIA SEEDS 100GM,2,100,80,20,1
11-05-2025,Sweeteners,HANS JAGGERY PRODUCTS,16,125,125,0,1
11-05-2025,Snacks & Ready-to-Eat,Sprouted Ragi Biscuits 450GM,14,300,300,0,2
11-05-2025,Snacks & Ready-to-Eat,VD MURUKU 175GM,14,60,60,0,1
11-05-2025,Snacks & Ready-to-Eat,VD Pappu Chekkalu 190gm,14,60,60,0,1
11-05-2025,Snacks & Ready-to-Eat,FOXTAIL BIS,14,135,135,0,1
11-05-2025,Misc,VD00220,8,60,60,0,1
11-05-2025,"Grains, Flours & Dals",KORRALU (FOXTAIL M) 1KG,4,300,220,80,2
11-05-2025,"Dry Fruits, Nuts & Seeds",FLAX SEEDS 250GM,2,60,50,10,1
11-05-2025,Snacks & Ready-to-Eat,VD PAPPU CHEGODI 200GM,14,120,120,0,2
11-05-2025,Personal Care & Cosmetics,HEART SHAPE LOOFAH,10,79,79,0,1
11-05-2025,Spices & Seasonings,KALONJI SEEDS,15,90,80,10,1
11-05-2025,Spices & Seasonings,Jeera 100GM,15,50,45,5,1
11-05-2025,"Dry Fruits, Nuts & Seeds",KAJU HALF 250GM,2,620,580,40,2
11-05-2025,Spices & Seasonings,AVALU 100GM,15,25,20,5,1
11-05-2025,Spices & Seasonings,Menthulu 250 gms,15,50,45,5,1
11-05-2025,"Dry Fruits, Nuts & Seeds",SABJA SEEDS,2,70,70,0,1
11-05-2025,"Grains, Flours & Dals",samalu,4,130,130,0,1
11-05-2025,Snacks & Ready-to-Eat,SF MILLET PANCAKE CLASSIC 150GM,14,149,149,0,1
11-05-2025,"Grains, Flours & Dals",UDALU (Barnyard millet) 1 kg,4,140,115,25,1
11-05-2025,"Health, Wellness & Ayurvedic Products",MXP CHOCO CLASSIC BAR,5,70,70,0,1
11-05-2025,"Health, Wellness & Ayurvedic Products",RB Max Protein Salt & Caramel Bar 50g,5,75,75,0,1
11-05-2025,Snacks & Ready-to-Eat,RSC ORANGE 100GMS,14,20,20,0,1
11-05-2025,Snacks & Ready-to-Eat,VD MURUKU 175GM,14,60,60,0,1
11-05-2025,Snacks & Ready-to-Eat,VD PAPPU CHEGODI 200GM,14,60,60,0,1
11-05-2025,Pickles & Cooking Pastes,DURGA BRAND TM PICKLES SPECIAL,11,28,28,0,1
11-05-2025,Spices & Seasonings,3M.MIRCHI POWDER,15,360,320,40,1
11-05-2025,Snacks & Ready-to-Eat,TILLI CHIKKI,14,25,25,0,5
11-05-2025,Spices & Seasonings,Jeera 100GM,15,50,45,5,1
11-05-2025,Oils & Ghee,Groundnut oil 1 L,9,660,660,0,2
11-05-2025,Spices & Seasonings,AVALU 250grms,15,80,80,0,2
11-05-2025,Spices & Seasonings,GS Pink Rock Salt 1KG,15,120,120,0,1
11-05-2025,Spices & Seasonings,Tamarind 250GMS,15,80,65,15,1
11-05-2025,Milk & Dairy,SANGAM CURD 450GM,7,40,40,0,1
11-05-2025,Snacks & Ready-to-Eat,VD SAGOPAPAD 150GM,14,55,55,0,1
11-05-2025,"Grains, Flours & Dals",Urad dall 500 gms,4,95,85,10,1
11-05-2025,Spices & Seasonings,DRY MIECHI 200GM,15,80,60,20,1
11-05-2025,Spices & Seasonings,DALCHIN POWDER M,15,100,90,10,1
11-05-2025,Spices & Seasonings,MAMTA BLACK PEPPER POWDER,15,90,90,0,1
11-05-2025,Misc,VD0009,8,100,100,0,1
11-05-2025,Milk & Dairy,SANGAM TONED MILK 500ML,7,62,62,0,2
11-05-2025,Spices & Seasonings,lavangam,15,50,50,0,1
11-05-2025,Spices & Seasonings,dalchin chekka,15,50,40,10,1
11-05-2025,Spices & Seasonings,Elaichi 25GM,15,145,120,25,1
11-05-2025,Spices & Seasonings,SH BAY LEAF / TEJ PATTA 30GM,15,35,35,0,1
11-05-2025,"Health, Wellness & Ayurvedic Products",ORGANIC MORINGA POWER 100GM,5,498,498,0,2
11-05-2025,Spices & Seasonings,SATHVI ANASAPUVUU 25GM,15,90,65,25,1
11-05-2025,Sweeteners,mishri 500g,16,70,60,10,1
11-05-2025,Spices & Seasonings,Japatri 25GM,15,100,80,20,1
11-05-2025,Pooja & Spiritual Items,JAGI KAYA 25GM,12,80,60,20,1
11-05-2025,Spices & Seasonings,Turmeric powder 250 gms,15,300,240,60,3
11-05-2025,Oils & Ghee,sesame oil 1L,9,590,560,30,1
11-05-2025,Snacks & Ready-to-Eat,TILLI CHIKKI,14,125,125,0,1
11-05-2025,Snacks & Ready-to-Eat,SD Pumpkin Seeds With Dates 175gm,14,170,170,0,1
11-05-2025,Spices & Seasonings,avalu,15,80,80,0,1
11-05-2025,Spices & Seasonings,Menthulu 250 gms,15,50,45,5,1
11-05-2025,Snacks & Ready-to-Eat,RAGI LADDU,14,120,120,0,1
11-05-2025,Oils & Ghee,Groundnut oil 1 L,9,990,990,0,3
11-05-2025,Misc,VD00220,8,60,60,0,1
11-05-2025,Oils & Ghee,mustard oil 1l,9,880,780,100,2
11-05-2025,Spices & Seasonings,LG 50GM,15,92,92,0,1
11-05-2025,Snacks & Ready-to-Eat,VD PAPPU CHEGODI 200GM,14,60,60,0,1
11-05-2025,Snacks & Ready-to-Eat,cocnut laddu,14,135,135,0,1
11-05-2025,Spices & Seasonings,ROYAL SAFFRON,15,125,125,0,1
11-05-2025,Oils & Ghee,Groundnut oil 500ml,9,180,165,15,1
11-05-2025,Oils & Ghee,sesame oil 1L,9,2360,"2,240.00",120,4
11-05-2025,Spices & Seasonings,avalu,15,80,80,0,1
11-05-2025,Spices & Seasonings,avalu,15,160,160,0,2
11-05-2025,Spices & Seasonings,Turmeric powder 250 gms,15,100,80,20,1
11-05-2025,Oils & Ghee,Groundnut oil 1 L,9,330,330,0,1
11-05-2025,"Health, Wellness & Ayurvedic Products",RB Max Protein Fruit &amp;Nut 50g,5,75,75,0,1
11-05-2025,"Grains, Flours & Dals",HS JOWAR IDLY RAWA,4,65,65,0,1
11-05-2025,"Grains, Flours & Dals",MULTIMILLET IDLY RAVVA,4,65,65,0,1
11-05-2025,"Grains, Flours & Dals",RICE FLOUR 500 GM,4,70,56,14,2
11-05-2025,Snacks & Ready-to-Eat,VD MULTI CHAKKA,14,110,110,0,1
11-05-2025,Oils & Ghee,Groundnut oil 1 L,9,330,330,0,1
11-05-2025,Snacks & Ready-to-Eat,SF COOKIES BANANA OATS,14,99,99,0,1
11-05-2025,Oils & Ghee,Groundnut oil 5 L,9,1800,"1,600.00",200,1
11-05-2025,Snacks & Ready-to-Eat,SD Groundnut with palm jaggery 250gm,14,135,135,0,1
11-05-2025,"Grains, Flours & Dals",BASMATHI RICE 1KG,4,150,135,15,1
11-05-2025,"Dry Fruits, Nuts & Seeds",Groundnuts 1 kg,2,190,165,25,1
11-05-2025,Spices & Seasonings,Elaichi 25GM,15,145,120,25,1
11-05-2025,Spices & Seasonings,Turmeric powder 250 gms,15,100,80,20,1
11-05-2025,Oils & Ghee,Groundnut oil 1 L,9,330,330,0,1
11-05-2025,Oils & Ghee,Groundnut oil 500ml,9,180,165,15,1
11-05-2025,Snacks & Ready-to-Eat,SIRI ICE CREAM 100ML,14,100,80,20,1
11-05-2025,"Grains, Flours & Dals",UNPOLISHED TURDALL 1KG,4,240,210,30,1
11-05-2025,"Grains, Flours & Dals",BLACKGRAM,4,70,70,0,1
11-05-2025,"Grains, Flours & Dals",CHANA DAL 500GM,4,56,48,8,1
11-05-2025,Spices & Seasonings,AV Iodized Salt 1KG,15,56,50,6,2
11-05-2025,Spices & Seasonings,ROYAL SAFFRON,15,250,250,0,2
11-05-2025,Beverages,TAJ MAHAL 250GM,1,235,235,0,1
11-05-2025,Oils & Ghee,Coconut oil 500 ml,9,220,200,20,1
11-05-2025,"Grains, Flours & Dals",Wheat Flour 1 kg,4,350,300,50,5
11-05-2025,"Grains, Flours & Dals",turdal 1kg,4,220,170,50,1
11-05-2025,Pooja & Spiritual Items,deep jyothi deepam oil 1000ml,12,198,198,0,1
11-05-2025,Oils & Ghee,mustard oil,9,195,195,0,1
11-05-2025,Snacks & Ready-to-Eat,VD NUVULU CHEGODI 175GM,14,60,60,0,1
11-05-2025,Snacks & Ready-to-Eat,BATANA NGT 70GMS,14,20,20,0,1
11-05-2025,"Grains, Flours & Dals",FLOUR CHARGE,4,27.6,27.6,0,2.3
11-05-2025,Snacks & Ready-to-Eat,NGT CHATPATTA CHANA 90GM,14,25,25,0,1
11-05-2025,Spices & Seasonings,Chilli powder 250 gms,15,145,110,35,1
11-05-2025,"Grains, Flours & Dals",chana flour 500 gms,4,60,54,6,1
11-05-2025,Oils & Ghee,Coconut oil 500 ml,9,220,200,20,1
11-05-2025,"Grains, Flours & Dals",Wheat Flour 1 kg,4,70,60,10,1
11-05-2025,Oils & Ghee,Groundnut oil 1 L,9,330,330,0,1
11-05-2025,"Grains, Flours & Dals",SL Idly Rava 1KG,4,65,55,10,1
11-05-2025,Oils & Ghee,Groundnut oil 1 L,9,660,660,0,2
11-05-2025,Spices & Seasonings,PICKLES CHILLIP 500 GMS,15,355,325,30,1
11-05-2025,"Dry Fruits, Nuts & Seeds",SUNFLOWER SEEDS 250GRM,2,150,130,20,1
11-05-2025,Sweeteners,YB Brown Sugar 500GM,16,150,150,0,2
11-05-2025,Spices & Seasonings,JEERA 250 gms,15,125,105,20,1
11-05-2025,"Grains, Flours & Dals",ulavalu red,4,40,40,0,1
11-05-2025,Spices & Seasonings,AVALU 100GM,15,25,20,5,1
11-05-2025,Snacks & Ready-to-Eat,SUNNUNDALU,14,120,120,0,1
11-05-2025,Oils & Ghee,Groundnut oil 1 L,9,660,660,0,2
11-05-2025,Pooja & Spiritual Items,GD Aiswarya Deepam 700ML,12,195,195,0,1
11-05-2025,Pooja & Spiritual Items,GD TULASI 75GM,12,60,60,0,1
11-05-2025,Spices & Seasonings,MUSTARD POWDR 500G,15,130,110,20,1
11-05-2025,Sweeteners,YB JAGGERY POWDER 1KG,16,140,140,0,1
11-05-2025,Oils & Ghee,sesame oil 1L,9,590,560,30,1
11-05-2025,Oils & Ghee,Groundnut oil 1 L,9,330,330,0,1
11-05-2025,Oils & Ghee,Groundnut oil 1 L,9,330,330,0,1
11-05-2025,Spices & Seasonings,GROUNDNUT KARAM POWDER,15,65,65,0,1
11-05-2025,"Grains, Flours & Dals",PESARA PAPPU 1 KG,4,170,145,25,1
11-05-2025,Snacks & Ready-to-Eat,SF COOKIES CHOCO RAGI,14,99,99,0,1
11-05-2025,"Grains, Flours & Dals",DH URAD GOTA 1KG,4,215,190,25,1
11-05-2025,"Grains, Flours & Dals",turdal 1kg,4,220,170,50,1
11-05-2025,Oils & Ghee,Safflower oil 1 L,9,400,400,0,1
11-05-2025,Snacks & Ready-to-Eat,Sprouted Ragi Biscuits 450GM,14,150,150,0,1
11-05-2025,"Grains, Flours & Dals",UDALU (Barnyard millet) 1 kg,4,140,115,25,1
11-05-2025,Oils & Ghee,Groundnut oil 1 L,9,330,330,0,1
11-05-2025,Sweeteners,NATURAL HONEY 1KG,16,560,480,80,1
11-05-2025,"Grains, Flours & Dals",SRILATHA RICE RAVVA 500GM,4,35,35,0,1
11-05-2025,Sweeteners,YB JAGGERY POWDER 500GMS,16,75,75,0,1
11-05-2025,Snacks & Ready-to-Eat,VD PAPPU CHEGODI 200GM,14,60,60,0,1
11-05-2025,"Grains, Flours & Dals",unpolished turdall500grms,4,120,110,10,1
11-05-2025,Oils & Ghee,sesame oil 1L,9,590,560,30,1
11-05-2025,"Grains, Flours & Dals",YELLOW JOWER 1KG,4,90,80,10,1
11-05-2025,"Grains, Flours & Dals",Multigrain 1 kg,4,200,170,30,2
11-05-2025,"Grains, Flours & Dals",RAGULU 1 KG,4,70,60,10,1
11-05-2025,Spices & Seasonings,sonthi choornam,15,100,100,0,1
11-05-2025,"Health, Wellness & Ayurvedic Products",HARITHAKI CHOORNAM,5,80,80,0,1
11-05-2025,"Grains, Flours & Dals",RICE FLOUR 500 GM,4,35,28,7,1
11-05-2025,"Grains, Flours & Dals",PESARA PAPPU 500GMS,4,85,75,10,1
11-05-2025,"Grains, Flours & Dals",split greengram,4,140,140,0,1
11-05-2025,Snacks & Ready-to-Eat,PEANUT CHILLI,14,5,5,0,1
11-05-2025,Oils & Ghee,Groundnut oil 1 L,9,330,330,0,1
11-05-2025,Oils & Ghee,Groundnut oil 5 L,9,1800,"1,600.00",200,1
11-05-2025,Sweeteners,MADHUR SUGAR 1KG,16,65,55,10,1
11-05-2025,Personal Care & Cosmetics,KHADI Charcoal Face Wash 200ML,10,235,235,0,1
11-05-2025,"Grains, Flours & Dals",SL Idly Rava 1KG,4,260,220,40,4
11-05-2025,Oils & Ghee,Groundnut oil 1 L,9,990,990,0,3
11-05-2025,"Grains, Flours & Dals",turdal 1kg,4,220,170,50,1
11-05-2025,"Grains, Flours & Dals",SL Suji Rava 500GM,4,64,64,0,2
11-05-2025,Spices & Seasonings,telaga pindi,15,70,70,0,1
11-05-2025,Oils & Ghee,sesame oil 1L,9,590,560,30,1
11-05-2025,Oils & Ghee,sesame oil 1L,9,1180,"1,120.00",60,2
11-05-2025,Snacks & Ready-to-Eat,VD Pappu Chekkalu 190gm,14,60,60,0,1
11-05-2025,Spices & Seasonings,GROUNDNUT KARAM POWDER,15,65,65,0,1
11-05-2025,Snacks & Ready-to-Eat,BATANA NGT 70GMS,14,40,40,0,2
11-05-2025,Sweeteners,YB Brown Sugar 500GM,16,75,75,0,1
11-05-2025,"Grains, Flours & Dals",Urad dall 1 Kg,4,185,170,15,1
11-05-2025,"Dry Fruits, Nuts & Seeds",GF KIMIA DATES 500GM,2,310,190,120,1
11-05-2025,"Grains, Flours & Dals",Wheat Flour 1 kg,4,70,60,10,1
11-05-2025,"Grains, Flours & Dals",Multigrain 1 kg,4,100,85,15,1
11-05-2025,Snacks & Ready-to-Eat,NGT CHATPATTA CHANA 90GM,14,25,25,0,1
11-05-2025,"Grains, Flours & Dals",RICE FLOUR 1KG,4,210,165,45,3
10-05-2025,"Grains, Flours & Dals",KORRALU (FOXTAIL M) 1KG,4,150,110,40,1
10-05-2025,"Grains, Flours & Dals",PRO SABUDHANA 500GM,4,89,89,0,1
10-05-2025,"Grains, Flours & Dals",Arikadu ( kodo),4,140,130,10,1
10-05-2025,Beverages,REFRESH SHARBATH SUGAR FREE,1,299,285,14,1
10-05-2025,"Grains, Flours & Dals",samalu,4,130,130,0,1
10-05-2025,"Grains, Flours & Dals",MAATEJA rice 5 kg,4,360,345,15,1
10-05-2025,"Grains, Flours & Dals",RICE FLOUR 500 GM,4,35,28,7,1
10-05-2025,Oils & Ghee,rice bran oil f,9,194,169,25,1
10-05-2025,"Grains, Flours & Dals",chana flour 500 gms,4,60,54,6,1
10-05-2025,"Grains, Flours & Dals",RAGI FLOUR 500GRMS,4,40,35,5,1
10-05-2025,Milk & Dairy,SANGAM TONED MILK 500ML,7,31,31,0,1
10-05-2025,Snacks & Ready-to-Eat,BELLAM MINAPA SUNADULLU,14,180,180,0,1
10-05-2025,Snacks & Ready-to-Eat,VD Minapa papad 200gm,14,60,60,0,1
10-05-2025,Snacks & Ready-to-Eat,ANNAPURNA APPALAM,14,35,35,0,1
10-05-2025,Personal Care & Cosmetics,UVIS RED SANDAL SOAP 100GM,10,170,170,0,2
10-05-2025,"Dry Fruits, Nuts & Seeds",SABJA SEEDS,2,70,70,0,1
10-05-2025,"Grains, Flours & Dals",IDLY RAVA 1KG,4,180,150,30,3
10-05-2025,Snacks & Ready-to-Eat,SD Aswagandha with palm Jaggery250Gm,14,135,135,0,1
10-05-2025,Spices & Seasonings,SONTI 50GM,15,30,20,10,1
10-05-2025,"Grains, Flours & Dals",split black gram 1 kg,4,180,170,10,1
10-05-2025,"Grains, Flours & Dals",SL Suji Rava 500GM,4,32,32,0,1
10-05-2025,"Grains, Flours & Dals",RAGULU 1 KG,4,70,60,10,1
10-05-2025,"Grains, Flours & Dals",Multigrain 1 kg,4,100,85,15,1
10-05-2025,"Grains, Flours & Dals",SL Idly Rava 1KG,4,65,55,10,1
10-05-2025,Snacks & Ready-to-Eat,HS JOWAR BISCUITS,14,50,50,0,1
10-05-2025,"Grains, Flours & Dals",WHEAT 1 KG,4,30,25,5,0.5
10-05-2025,"Grains, Flours & Dals",Wheat Flour 1 kg,4,140,120,20,2
10-05-2025,Snacks & Ready-to-Eat,SIRI ICE CREAM 100ML,14,100,80,20,1
10-05-2025,"Grains, Flours & Dals",Multigrain 1 kg,4,100,85,15,1
10-05-2025,Spices & Seasonings,PICKLES CHILLIP 500 GMS,15,710,650,60,2
10-05-2025,Snacks & Ready-to-Eat,VD Minapa papad 200gm,14,180,180,0,3
10-05-2025,Spices & Seasonings,AVALU 100GM,15,25,20,5,1
10-05-2025,"Grains, Flours & Dals",White jowar.F 1 kg,4,100,80,20,1
10-05-2025,Spices & Seasonings,Menthulu 250 gms,15,50,45,5,1
10-05-2025,Snacks & Ready-to-Eat,GB SALT COOKIES,14,60,55,5,1
10-05-2025,Snacks & Ready-to-Eat,SD Aswagandha with palm Jaggery250Gm,14,270,270,0,2
10-05-2025,Spices & Seasonings,gd asafoetida,15,0,0,0,1
10-05-2025,Oils & Ghee,Groundnut oil 1 L,9,660,660,0,2
10-05-2025,Snacks & Ready-to-Eat,BATANA NGT 70GMS,14,20,20,0,1
10-05-2025,Spices & Seasonings,AVALU 250grms,15,60,60,0,1
10-05-2025,Oils & Ghee,Groundnut oil 1 L,9,330,330,0,1
10-05-2025,Household & Cleaning,LIZOL FORAL CLEANER,6,48,48,0,1
10-05-2025,"Grains, Flours & Dals",RAGI FLOUR 500GRMS,4,40,35,5,1
10-05-2025,"Grains, Flours & Dals",MULTIMILLET IDLY RAVVA,4,65,65,0,1
10-05-2025,"Grains, Flours & Dals",AISHWARYA SP 25KG,4,1999,"1,690.00",309,1
10-05-2025,Snacks & Ready-to-Eat,FOXTAIL BIS,14,135,135,0,1
10-05-2025,Snacks & Ready-to-Eat,RSC ORANGE 100GMS,14,20,20,0,1
10-05-2025,Pooja & Spiritual Items,SWASTIK CAMPHOR 10GM,12,60,60,0,3
10-05-2025,Pooja & Spiritual Items,SOSR SWATHHI 365,12,60,60,0,2
10-05-2025,Oils & Ghee,cow ghee 500 ml,9,430,390,40,1
10-05-2025,Pooja & Spiritual Items,SST 365 PURE COTTON POOJA,12,30,30,0,1
10-05-2025,"Dry Fruits, Nuts & Seeds",SD Mango cubes 200gm,2,90,90,0,1
10-05-2025,"Grains, Flours & Dals",RAGI FLOUR 500GRMS,4,40,35,5,1
10-05-2025,"Grains, Flours & Dals",SRILATHA RICE RAVVA 500GM,4,70,70,0,2
10-05-2025,"Grains, Flours & Dals",DH URAD GOTA 1KG,4,215,190,25,1
10-05-2025,Milk & Dairy,SANGAM CURD 450GM,7,38,38,0,1
10-05-2025,Beverages,BISLERI WATER 1L,1,20,20,0,1
10-05-2025,Pooja & Spiritual Items,GD Bhagavatha Mallika 75GM,12,60,60,0,1
10-05-2025,"Grains, Flours & Dals",yellow jowar flour 1kg,4,100,92,8,1
10-05-2025,"Grains, Flours & Dals",WHEAT 1 KG,4,480,400,80,8
10-05-2025,General Household & Kitchenware,MATCH BOX,3,10,10,0,1
10-05-2025,"Grains, Flours & Dals",FLOUR CHARGE,4,96,96,0,8
10-05-2025,Spices & Seasonings,LG 50GM,15,92,92,0,1
10-05-2025,"Grains, Flours & Dals",Green gram 500 gms,4,75,70,5,1
10-05-2025,"Grains, Flours & Dals",HS BAJRA FLAKES 250GM 1+1,4,119,59.5,59.5,1
10-05-2025,"Dry Fruits, Nuts & Seeds",cashew,2,340,310,30,1
10-05-2025,Oils & Ghee,rice bran oil f,9,194,169,25,1
10-05-2025,"Grains, Flours & Dals",JOWAR UPMA RAVA,4,65,65,0,1
10-05-2025,Personal Care & Cosmetics,boroline,10,45,45,0,1
10-05-2025,Snacks & Ready-to-Eat,SIRI ICE CREAM 100ML,14,400,320,80,4
10-05-2025,Household & Cleaning,VIM MAHA BAR,6,20,20,0,2
10-05-2025,Snacks & Ready-to-Eat,HS Ragi biscuits,14,150,150,0,1
10-05-2025,Snacks & Ready-to-Eat,ONION MURK,14,60,60,0,1
10-05-2025,Spices & Seasonings,RED COPRA 250GMS,15,85,74,11,1
10-05-2025,"Grains, Flours & Dals",turdal 500 gms,4,110,85,25,1
10-05-2025,"Grains, Flours & Dals",unpolished turdall500grms,4,120,110,10,1
10-05-2025,Misc,VD00014,8,100,90,10,1
10-05-2025,Snacks & Ready-to-Eat,VD ARISELU,14,0,0,0,1
10-05-2025,"Grains, Flours & Dals",SRILATHA RICE RAVVA 500GM,4,35,35,0,1
10-05-2025,"Grains, Flours & Dals",RAGI FLOUR 500GRMS,4,40,35,5,1
10-05-2025,"Grains, Flours & Dals",VGR RICE bag 1,4,1899,"1,650.00",249,1
10-05-2025,Pickles & Cooking Pastes,DURGA BRAND TM PICKLES SPECIAL,11,28,28,0,1
10-05-2025,Spices & Seasonings,PICKLES CHILLIP 500 GMS,15,355,325,30,1
10-05-2025,"Grains, Flours & Dals",DESI CHANA,4,25,25,0,1
10-05-2025,Oils & Ghee,sesame oil 1L,9,590,560,30,1
10-05-2025,Spices & Seasonings,MUSTARD POWDR 500G,15,130,110,20,1
10-05-2025,"Dry Fruits, Nuts & Seeds",Groundnuts 500 gms,2,95,85,10,1
10-05-2025,Snacks & Ready-to-Eat,NAVARATNA MIX,14,60,60,0,1
10-05-2025,Snacks & Ready-to-Eat,VD MURUKU 175GM,14,60,60,0,1
10-05-2025,Snacks & Ready-to-Eat,sannakarampusa,14,60,60,0,1
10-05-2025,"Grains, Flours & Dals",FLOUR CHARGE,4,51.6,51.6,0,4.3
10-05-2025,"Grains, Flours & Dals",KORRALU (FOXTAIL M) 500GM,4,65,55,10,1
10-05-2025,"Grains, Flours & Dals",ANDU KORRALU (Brown top .mlt) 500,4,130,110,20,1
10-05-2025,"Grains, Flours & Dals",PESARA PAPPU 500GMS,4,85,75,10,1
10-05-2025,"Dry Fruits, Nuts & Seeds",ANJEER 250GM,2,400,360,40,1
10-05-2025,"Grains, Flours & Dals",RAGI FLOUR 500GRMS,4,40,35,5,1
10-05-2025,"Grains, Flours & Dals",Wheat Rava M 500GM,4,33,30,3,1
10-05-2025,"Dry Fruits, Nuts & Seeds",Groundnuts 1 kg,2,190,165,25,1
10-05-2025,"Grains, Flours & Dals",Urad dall 1 Kg,4,185,170,15,1
10-05-2025,"Grains, Flours & Dals",Em jowar idly R 500G,4,75,75,0,1
10-05-2025,"Grains, Flours & Dals",SRILATHA RICE RAVVA 500GM,4,70,70,0,2
10-05-2025,"Grains, Flours & Dals",EM Ragi upma R 500g,4,75,75,0,1
10-05-2025,Snacks & Ready-to-Eat,VD MIXTURE 175 GM,14,60,60,0,1
10-05-2025,"Health, Wellness & Ayurvedic Products",MD Triphala Chorrnam 100GM,5,80,80,0,1
10-05-2025,Snacks & Ready-to-Eat,VD BOONDI 175GM,14,60,60,0,1
10-05-2025,Snacks & Ready-to-Eat,sannakarampusa,14,60,60,0,1
10-05-2025,"Grains, Flours & Dals",RAGI FLOUR 1KG,4,80,70,10,1
10-05-2025,General Household & Kitchenware,WOODEN SPATULA 11,3,22,22,0,1
10-05-2025,"Dry Fruits, Nuts & Seeds",MAHA BEERA SEEDS 100GM,2,60,60,0,1
10-05-2025,Spices & Seasonings,BLACK JEERA 50 GM,15,45,30,15,1
10-05-2025,"Grains, Flours & Dals",CORN FLOUR,4,80,70,10,1
10-05-2025,Snacks & Ready-to-Eat,VD GUMMADI VADIYAM,14,150,150,0,2
10-05-2025,Snacks & Ready-to-Eat,SD Aswagandha with palm Jaggery250Gm,14,135,135,0,1
10-05-2025,Snacks & Ready-to-Eat,VD SAGOPAPAD 150GM,14,55,55,0,1
10-05-2025,"Grains, Flours & Dals",RAGI FLOUR 500GRMS,4,40,35,5,1
10-05-2025,Snacks & Ready-to-Eat,VD RICE MURUKU 150GM,14,100,100,0,2
10-05-2025,"Grains, Flours & Dals",SRILATHA RICE RAVVA 500GM,4,70,70,0,2
10-05-2025,Sweeteners,SD PALM JAGGERY 500GM,16,400,400,0,2
10-05-2025,Snacks & Ready-to-Eat,JONNA RIBAN,14,60,60,0,1
10-05-2025,Snacks & Ready-to-Eat,VD SAGOPAPAD 150GM,14,55,55,0,1
10-05-2025,Snacks & Ready-to-Eat,VD CORNFLAKES MIXTURE 175GM,14,60,60,0,1
10-05-2025,Snacks & Ready-to-Eat,SAGOPAPAD RED CHILLI VD,14,55,55,0,1
10-05-2025,Snacks & Ready-to-Eat,SAGOPAPAD GREEN CHILLI VD,14,55,55,0,1
10-05-2025,"Grains, Flours & Dals",Wheat Rava M 500GM,4,33,30,3,1
10-05-2025,Snacks & Ready-to-Eat,VD DAHI MIRCHI(SALTED) 100GM,14,45,45,0,1
10-05-2025,Snacks & Ready-to-Eat,VD GUMMADI VADIYAM,14,150,150,0,2
10-05-2025,Snacks & Ready-to-Eat,BEETROOT MURK,14,60,60,0,1
10-05-2025,Spices & Seasonings,3M.MIRCHI POWDER,15,360,320,40,1
10-05-2025,Spices & Seasonings,DURGA SALT CRYSTAL 1KG,15,25,25,0,1
10-05-2025,Oils & Ghee,Groundnut oil 1 L,9,990,990,0,3
10-05-2025,Oils & Ghee,Groundnut oil 1 L,9,990,990,0,3
10-05-2025,Spices & Seasonings,3M.MIRCHI POWDER,15,360,320,40,1
10-05-2025,Spices & Seasonings,Turmeric powder 250 gms,15,100,80,20,1
10-05-2025,"Grains, Flours & Dals",split green gram 500 gms,4,75,70,5,1
10-05-2025,"Grains, Flours & Dals",turdal 1kg,4,220,170,50,1
10-05-2025,Oils & Ghee,Groundnut oil 1 L,9,330,330,0,1
10-05-2025,"Grains, Flours & Dals",CHANA DALL 250GM,4,28,24,4,1
10-05-2025,"Grains, Flours & Dals",FLOUR CHARGE,4,90,90,0,7.5
10-05-2025,"Grains, Flours & Dals",HS JOWAR IDLY RAWA,4,65,65,0,1
10-05-2025,"Grains, Flours & Dals",RAGI FLOUR 500GRMS,4,80,70,10,2
10-05-2025,"Grains, Flours & Dals",Green gram 500 gms,4,75,70,5,1
10-05-2025,"Grains, Flours & Dals",PESARA PAPPU 500GMS,4,85,75,10,1
10-05-2025,"Grains, Flours & Dals",turdal 1kg,4,220,170,50,1
10-05-2025,"Grains, Flours & Dals",Bombay Rava 500GM,4,35,30,5,1
10-05-2025,Sweeteners,SUGAR 1KG,16,60,56,4,1
10-05-2025,"Grains, Flours & Dals",Urad dall 500 gms,4,285,255,30,3
10-05-2025,"Dry Fruits, Nuts & Seeds",Groundnuts 500 gms,2,190,170,20,2
10-05-2025,"Grains, Flours & Dals",IDLY RAVA 1KG,4,120,100,20,2
10-05-2025,"Dry Fruits, Nuts & Seeds",PUTNALU 500GMS,2,90,76,14,1
10-05-2025,"Health, Wellness & Ayurvedic Products",RB Nuts& Seeds cashews 35g,5,45,45,0,1
10-05-2025,Oils & Ghee,Safflower oil 1 L,9,400,400,0,1
10-05-2025,"Grains, Flours & Dals",Wheat Flour 1 kg,4,140,120,20,2
10-05-2025,Snacks & Ready-to-Eat,VD RIBBON PAKODI 175GM,14,60,60,0,1
10-05-2025,Snacks & Ready-to-Eat,VD MURUKU 175GM,14,60,60,0,1
10-05-2025,Misc,C123,8,95,80,15,1
10-05-2025,"Grains, Flours & Dals",RAGI FLOUR 1KG,4,80,70,10,1
10-05-2025,"Grains, Flours & Dals",Chana Flour 500 gms,4,140,110,30,1
10-05-2025,Oils & Ghee,Groundnut oil 1 L,9,330,330,0,1
10-05-2025,Oils & Ghee,Groundnut oil 1 L,9,330,330,0,1
10-05-2025,Pooja & Spiritual Items,GD Aiswarya Deepam 700ML,12,195,195,0,1
10-05-2025,Snacks & Ready-to-Eat,SAGOPAPAD RED CHILLI VD,14,55,55,0,1
10-05-2025,Spices & Seasonings,AVALU 100GM,15,25,20,5,1
10-05-2025,Pooja & Spiritual Items,GD Dhoop Sticks 26GM,12,60,60,0,3
10-05-2025,Sweeteners,MISHRI 250 GM,16,35,30,5,1
10-05-2025,Snacks & Ready-to-Eat,DINNER PAPAD,14,80,80,0,1
10-05-2025,"Grains, Flours & Dals",WHEAT 1 KG,4,120,100,20,2
10-05-2025,"Grains, Flours & Dals",CHANA DALL 250GM,4,28,24,4,1
10-05-2025,"Grains, Flours & Dals",SOYA BEANS 1KG,4,40,36,4,0.2
10-05-2025,Pooja & Spiritual Items,GD Aiswarya Deepam 700ML,12,390,390,0,2
10-05-2025,Sweeteners,SUGAR 1KG,16,60,56,4,1
10-05-2025,"Grains, Flours & Dals",COW B rice 1 kg,4,720,690,30,10
10-05-2025,"Grains, Flours & Dals",SL Idly Rava 1KG,4,65,55,10,1
10-05-2025,"Grains, Flours & Dals",White Chana 500GM,4,120,100,20,1
10-05-2025,"Grains, Flours & Dals",RICE FLOUR 1KG,4,210,165,45,3
10-05-2025,"Grains, Flours & Dals",SB Javva Wheat Ravva 500GM,4,190,190,0,2
10-05-2025,Snacks & Ready-to-Eat,VD RICE SAGO PAPAD 150GM,14,55,55,0,1
10-05-2025,Spices & Seasonings,AVALU 100GM,15,25,20,5,1
10-05-2025,"Grains, Flours & Dals",AISHWARYA SP 1KG,4,160,140,20,2
10-05-2025,Snacks & Ready-to-Eat,KURNOOL MARMURA,14,70,55,15,1
10-05-2025,"Grains, Flours & Dals",Red Chana 500 GM,4,75,60,15,1
10-05-2025,"Dry Fruits, Nuts & Seeds",PUTNALU 500GMS,2,180,152,28,2
10-05-2025,"Grains, Flours & Dals",BARLEY SEEDS 250GMS,4,40,35,5,1
10-05-2025,Snacks & Ready-to-Eat,BB VERMICELLI 1KG,14,95,90,5,1
10-05-2025,Spices & Seasonings,DRY MIECHI 200GM,15,80,60,20,1
10-05-2025,"Grains, Flours & Dals",SRILATHA RICE RAVVA 500GM,4,280,280,0,8
10-05-2025,"Grains, Flours & Dals",turdal 1kg,4,440,340,100,2
10-05-2025,"Grains, Flours & Dals",THICK POHA 1KG,4,160,140,20,2
10-05-2025,"Grains, Flours & Dals",Wheat Flour 1 kg,4,140,120,20,2
10-05-2025,"Grains, Flours & Dals",UNPOLISHED TURDALL 1KG,4,240,210,30,1
10-05-2025,Snacks & Ready-to-Eat,VD RICE MURUKU 150GM,14,50,50,0,1
10-05-2025,Spices & Seasonings,Avalu small 250 gms,15,60,60,0,1
10-05-2025,Oils & Ghee,Groundnut oil 1 L,9,330,330,0,1
10-05-2025,"Grains, Flours & Dals",SPLIT BLACK GRAM 500 GM,4,90,85,5,1
10-05-2025,"Grains, Flours & Dals",CHANA DAL 500GM,4,56,48,8,1
10-05-2025,"Grains, Flours & Dals",white Bobarlu 500 gms,4,40,37.5,2.5,0.5
10-05-2025,"Grains, Flours & Dals",Urad dall 1 Kg,4,185,170,15,1
10-05-2025,"Grains, Flours & Dals",IDLY RAVA 1KG,4,120,100,20,2
10-05-2025,"Grains, Flours & Dals",BOMBAY RAVA,4,70,55,15,1
10-05-2025,"Dry Fruits, Nuts & Seeds",Putnalu 250GM,2,45,38,7,1
10-05-2025,"Grains, Flours & Dals",Green gram 500 gms,4,75,70,5,1
10-05-2025,"Grains, Flours & Dals",turdal 1kg,4,220,170,50,1
10-05-2025,"Grains, Flours & Dals",Wheat Rava S 500GM,4,33,30,3,1
10-05-2025,"Grains, Flours & Dals",CHANA DAL 1KG,4,112,96,16,1
10-05-2025,Spices & Seasonings,AVALU 250grms,15,60,60,0,1
10-05-2025,"Grains, Flours & Dals",Bombay Rava 500GM,4,105,90,15,3
10-05-2025,Snacks & Ready-to-Eat,FOXTAIL NOODLES,14,75,75,0,1
10-05-2025,"Grains, Flours & Dals",Wheat Rava M 1KG,4,65,55,10,1
10-05-2025,Spices & Seasonings,ROYAL SAFFRON,15,125,125,0,1
10-05-2025,Spices & Seasonings,PUTNALA KARAM POWDER 100GM,15,65,65,0,1
10-05-2025,"Grains, Flours & Dals",Chana Flour 500 gms,4,140,110,30,1
10-05-2025,Spices & Seasonings,Coriander seeds 200 gms,15,96,80,16,2
10-05-2025,Spices & Seasonings,ROYAL SAFFRON 400GRMS,15,65,65,0,1
10-05-2025,Snacks & Ready-to-Eat,PN ORGANIC PUFFED RICE 200GM,14,55,55,0,1
10-05-2025,"Grains, Flours & Dals",maida 500grms,4,35,30,5,1
10-05-2025,Spices & Seasonings,DRY MIECHI 200GM,15,80,60,20,1
10-05-2025,Snacks & Ready-to-Eat,BD LITTLE MILLET NOODLES 200G,14,75,75,0,1
10-05-2025,Personal Care & Cosmetics,MYSORE SANDAL SOAP 75G,10,42,42,0,1
10-05-2025,Snacks & Ready-to-Eat,RAJGIRA PEANUT CHIKKI 450GM,14,125,125,0,1
10-05-2025,Snacks & Ready-to-Eat,ONION MURK,14,60,60,0,1
10-05-2025,Spices & Seasonings,Turmeric powder 250 gms,15,100,80,20,1
10-05-2025,"Grains, Flours & Dals",MELMEKER 250GMS,4,60,45,15,1
10-05-2025,"Grains, Flours & Dals",IDLY RAVA 1KG,4,60,50,10,1
10-05-2025,"Dry Fruits, Nuts & Seeds",PUTNALU 500GMS,2,90,76,14,1
10-05-2025,"Grains, Flours & Dals",turdal 500 gms,4,220,170,50,2
10-05-2025,"Dry Fruits, Nuts & Seeds",Groundnuts 1 kg,2,190,165,25,1
10-05-2025,"Grains, Flours & Dals",CHANA DAL 500GM,4,56,48,8,1
10-05-2025,"Grains, Flours & Dals",Green gram 500 gms,4,150,140,10,2
10-05-2025,"Grains, Flours & Dals",PESARA PAPPU 500GMS,4,170,150,20,2
10-05-2025,Spices & Seasonings,NUVVULU 250GM,15,80,65,15,1
10-05-2025,Spices & Seasonings,SD Redgram Karam Powder 100GM,15,65,65,0,1
10-05-2025,"Health, Wellness & Ayurvedic Products",MD Guduchi Choornam 100GM,5,110,110,0,1
10-05-2025,"Grains, Flours & Dals",Wheat Rava S 1KG,4,65,55,10,1
10-05-2025,"Health, Wellness & Ayurvedic Products",RB Max Protein Fruit &amp;Nut 50g,5,75,75,0,1
10-05-2025,Spices & Seasonings,Tamarind 250GMS,15,80,65,15,1
10-05-2025,"Grains, Flours & Dals",THICK POHA 500GM,4,40,35,5,1
10-05-2025,"Grains, Flours & Dals",BLACKGRAM,4,140,140,0,2
10-05-2025,Snacks & Ready-to-Eat,VD MANGO JELLY 250GRMS,14,80,80,0,1
10-05-2025,"Grains, Flours & Dals",Multigrain 1 kg,4,100,85,15,1
10-05-2025,"Grains, Flours & Dals",Wheat Rava S 1KG,4,65,55,10,1
10-05-2025,"Grains, Flours & Dals",Multigrain 1 kg,4,100,85,15,1
10-05-2025,"Grains, Flours & Dals",PESARA PAPPU 500GMS,4,85,75,10,1
10-05-2025,"Grains, Flours & Dals",Green gram 500 gms,4,150,140,10,2
10-05-2025,"Grains, Flours & Dals",chana flour 500 gms,4,120,108,12,2
10-05-2025,"Grains, Flours & Dals",THICK POHA 500GM,4,40,35,5,1
10-05-2025,Misc,ROLL D C,8,70,45,25,1
10-05-2025,"Grains, Flours & Dals",Wheat Rava M 1KG,4,65,55,10,1
10-05-2025,Spices & Seasonings,lavangam,15,50,50,0,1
10-05-2025,"Grains, Flours & Dals",Bombay Rava 500GM,4,140,120,20,4
10-05-2025,"Dry Fruits, Nuts & Seeds",Groundnuts 500 gms,2,95,85,10,1
10-05-2025,"Grains, Flours & Dals",CHANA DAL 500GM,4,112,96,16,2
10-05-2025,Spices & Seasonings,ROYAL SAFFRON 400GRMS,15,65,65,0,1
10-05-2025,Spices & Seasonings,SAJEERA,15,60,40,20,1
10-05-2025,"Grains, Flours & Dals",turdal 500 gms,4,220,170,50,2
10-05-2025,"Grains, Flours & Dals",split black gram 1 kg,4,180,170,10,1
10-05-2025,"Health, Wellness & Ayurvedic Products",RB Max Protein NUTS &SEEDS 55gm,5,50,50,0,1
10-05-2025,"Health, Wellness & Ayurvedic Products",MXP CHOCO CLASSIC BAR,5,70,70,0,1
10-05-2025,Milk & Dairy,SANGAM TONED MILK 500ML,7,31,31,0,1
10-05-2025,Household & Cleaning,vim small,6,30,30,0,2
10-05-2025,Milk & Dairy,SANGAM CURD 450GM,7,40,40,0,1
10-05-2025,Oils & Ghee,BUFFALLO GHEE 500ML,9,410,370,40,1
10-05-2025,Snacks & Ready-to-Eat,MIGHTY PUFF,14,25,25,0,1
10-05-2025,General Household & Kitchenware,chalk piece 1b,3,15,10,5,1
10-05-2025,Snacks & Ready-to-Eat,PEANUT CHILLI,14,30,30,0,6
10-05-2025,Snacks & Ready-to-Eat,TILLI CHIKKI,14,50,50,0,10
10-05-2025,Spices & Seasonings,Vamu 100GM,15,60,50,10,1
10-05-2025,Snacks & Ready-to-Eat,Corn Chips 250GM,14,80,70,10,2
10-05-2025,"Health, Wellness & Ayurvedic Products",SHIKAKAI CHOORNAM,5,80,80,0,1
10-05-2025,"Grains, Flours & Dals",Red Bobarlu 500 gms,4,95,85,10,1
10-05-2025,"Grains, Flours & Dals",SRILATHA RICE RAVVA 500GM,4,70,70,0,2
10-05-2025,Snacks & Ready-to-Eat,VD MURUKU 175GM,14,60,60,0,1
10-05-2025,Milk & Dairy,SANGAM TONED MILK 500ML,7,31,31,0,1
10-05-2025,Snacks & Ready-to-Eat,VD NUVULU CHEGODI 175GM,14,120,120,0,2
10-05-2025,Snacks & Ready-to-Eat,VD BOONDI 175GM,14,120,120,0,2
10-05-2025,Snacks & Ready-to-Eat,ragi chegodi,14,60,60,0,1
10-05-2025,Snacks & Ready-to-Eat,SD SESAME PAPAD,14,80,80,0,1
10-05-2025,Snacks & Ready-to-Eat,SD Pumpkin Seeds With Dates 175gm,14,170,170,0,1
10-05-2025,Snacks & Ready-to-Eat,ragi chegodi,14,60,60,0,1
10-05-2025,"Grains, Flours & Dals",Em Multimillet idli r 500g,4,129,129,0,1
10-05-2025,Misc,VD0009,8,100,100,0,1
10-05-2025,"Grains, Flours & Dals",RAGI FLOUR 1KG,4,320,280,40,4
10-05-2025,"Grains, Flours & Dals",Wheat Flour 1 kg,4,630,540,90,9
10-05-2025,Snacks & Ready-to-Eat,SD Atreyapuram DRY Fruit ghee,14,150,150,0,1
10-05-2025,"Grains, Flours & Dals",aishwarya rice,4,450,450,0,1
10-05-2025,"Grains, Flours & Dals",Wheat Flour 1 kg,4,140,120,20,2
10-05-2025,"Grains, Flours & Dals",split greengram,4,140,140,0,1
10-05-2025,"Grains, Flours & Dals",Wheat Flour 1 kg,4,490,420,70,7
10-05-2025,"Grains, Flours & Dals",Wheat Flour 1 kg,4,70,60,10,1
10-05-2025,Spices & Seasonings,DURGA SALT CRYSTAL 1KG,15,25,25,0,1
10-05-2025,Spices & Seasonings,TATA SALT 1KG,15,30,30,0,1
10-05-2025,"Grains, Flours & Dals",RICE FLOUR 1KG,4,140,110,30,2
10-05-2025,Misc,C123,8,95,80,15,1
10-05-2025,Misc,C123,8,95,80,15,1
10-05-2025,"Grains, Flours & Dals",Bombay Rava 500GM,4,35,30,5,1
10-05-2025,"Grains, Flours & Dals",SL Idly Rava 1KG,4,65,55,10,1
10-05-2025,"Grains, Flours & Dals",chana flour 500 gms,4,60,54,6,1
10-05-2025,"Grains, Flours & Dals",SRILATHA RICE RAVVA 500GM,4,70,70,0,2
10-05-2025,"Grains, Flours & Dals",chana flour 500 gms,4,60,54,6,1
10-05-2025,"Grains, Flours & Dals",White Chana 250 GM,4,60,50,10,1
10-05-2025,"Grains, Flours & Dals",Red Bobarlu 500 gms,4,95,85,10,1
10-05-2025,"Grains, Flours & Dals",HS JOWAR IDLY RAWA,4,65,65,0,1
10-05-2025,Personal Care & Cosmetics,SVE KHADI ALOEVERA GEL 100GM,10,140,140,0,1
10-05-2025,"Grains, Flours & Dals",RAGI FLOUR 1KG,4,80,70,10,1
10-05-2025,Personal Care & Cosmetics,UVIS CHARCOAL SOAP 100GM,10,99,99,0,1
10-05-2025,Snacks & Ready-to-Eat,Pani Poori Chips 250GM,14,50,40,10,1
10-05-2025,"Grains, Flours & Dals",Red Chana 500 GM,4,75,60,15,1
10-05-2025,"Dry Fruits, Nuts & Seeds",SABJA SEEDS,2,70,70,0,1
10-05-2025,Snacks & Ready-to-Eat,PN ORGANIC PUFFED RICE 200GM,14,55,55,0,1
10-05-2025,Snacks & Ready-to-Eat,ANNAPURNA APPALAM,14,35,35,0,1
10-05-2025,Snacks & Ready-to-Eat,VD GUMMADI VADIYAM,14,75,75,0,1
10-05-2025,"Dry Fruits, Nuts & Seeds",wallnuts,2,380,320,60,1
10-05-2025,Spices & Seasonings,pickle chili powder,15,180,165,15,1
10-05-2025,Oils & Ghee,Groundnut oil 1 L,9,330,330,0,1
10-05-2025,"Grains, Flours & Dals",yellow jowar flour 1kg,4,100,92,8,1
10-05-2025,Baking & Cooking Aids,GONDKATIRA Ag,0,85,75,10,1
10-05-2025,"Grains, Flours & Dals",White jowar.F 1 kg,4,100,80,20,1
10-05-2025,"Grains, Flours & Dals",BAJRA 1 KG,4,60,50,10,1
10-05-2025,Spices & Seasonings,Turmeric powder 250 gms,15,100,80,20,1
10-05-2025,"Health, Wellness & Ayurvedic Products",MORINGA LEAF POWDER M,5,400,400,0,5
10-05-2025,Spices & Seasonings,AVALU 100GM,15,50,40,10,2
10-05-2025,Beverages,BISLERI 100ml,1,10,10,0,1
10-05-2025,Spices & Seasonings,pickle chili powder,15,360,330,30,2
10-05-2025,Oils & Ghee,Groundnut oil 1 L,9,330,330,0,1
10-05-2025,"Grains, Flours & Dals",DOCTOR RICE DIABETIC SFR 5KG,4,600,600,0,1
10-05-2025,Beverages,REFRESH SHARBATH SUGAR FREE,1,299,285,14,1
10-05-2025,Spices & Seasonings,TATA SALT 1KG,15,60,60,0,2
10-05-2025,"Dry Fruits, Nuts & Seeds",Groundnuts 1 kg,2,190,165,25,1
10-05-2025,Oils & Ghee,Groundnut oil 1 L,9,990,990,0,3
10-05-2025,Milk & Dairy,HERITAGE TOTAL CURD 500GM,7,50,50,0,1
10-05-2025,Milk & Dairy,HERITAGE TONED MILK 500ML,7,62,62,0,2
10-05-2025,Beverages,BRU GREEN LABEL 1.2G,1,14,14,0,7
10-05-2025,Spices & Seasonings,Japatri 25GM,15,100,80,20,1
10-05-2025,"Dry Fruits, Nuts & Seeds",YELLOW KISHMISH 250GM,2,130,110,20,1
10-05-2025,Pooja & Spiritual Items,JAGI KAYA 25GM,12,80,60,20,1
10-05-2025,Spices & Seasonings,SATHVI ANASAPUVUU 25GM,15,90,65,25,1
10-05-2025,Misc,ROLL D C,8,70,45,25,1
10-05-2025,Oils & Ghee,GANTASALA A2 COW GHEE 250ML,9,299,299,0,1
10-05-2025,"Dry Fruits, Nuts & Seeds",cashew,2,340,310,30,1
10-05-2025,Oils & Ghee,Groundnut oil 1 L,9,330,330,0,1
10-05-2025,Snacks & Ready-to-Eat,DOSA BATTER 1KG,14,60,60,0,1
10-05-2025,Spices & Seasonings,AVALU 100GM,15,25,20,5,1
10-05-2025,Oils & Ghee,rice bran oil f,9,194,169,25,1
10-05-2025,Spices & Seasonings,Jeera 100GM,15,50,45,5,1
09-05-2025,"Grains, Flours & Dals",Wheat Flour 1 kg,4,140,120,20,2
09-05-2025,Spices & Seasonings,Elaichi 25GM,15,145,120,25,1
09-05-2025,Household & Cleaning,vim dish liquid,6,165,165,0,3
09-05-2025,"Grains, Flours & Dals",BOMBAY RAVA,4,70,55,15,1
09-05-2025,"Grains, Flours & Dals",SL Idly Rava 1KG,4,65,55,10,1
09-05-2025,Oils & Ghee,Groundnut oil 1 L,9,660,660,0,2
09-05-2025,"Dry Fruits, Nuts & Seeds",Groundnuts 1 kg,2,190,165,25,1
09-05-2025,"Dry Fruits, Nuts & Seeds",YELLOW KISHMISH 250GM,2,130,110,20,1
09-05-2025,"Grains, Flours & Dals",Urad dall 1 Kg,4,370,340,30,2
09-05-2025,"Grains, Flours & Dals",AISHWARAYA IDLY RAVA 1KG,4,99,66,33,1
09-05-2025,"Grains, Flours & Dals",THICK POHA 1KG,4,80,70,10,1
09-05-2025,"Grains, Flours & Dals",BARLEY SEEDS 500 GM,4,90,70,20,1
09-05-2025,Oils & Ghee,Groundnut oil 1 L,9,330,330,0,1
09-05-2025,Oils & Ghee,Safflower oil 1 L,9,400,400,0,1
09-05-2025,"Grains, Flours & Dals",RAGI FLOUR 500GRMS,4,40,35,5,1
09-05-2025,Oils & Ghee,Safflower oil 1 L,9,400,400,0,1
09-05-2025,"Grains, Flours & Dals",RAGULU 1 KG,4,70,60,10,1
09-05-2025,"Grains, Flours & Dals",Multigrain 1 kg,4,300,255,45,3
09-05-2025,Snacks & Ready-to-Eat,KURNOOL MARMURA,14,70,55,15,1
09-05-2025,General Household & Kitchenware,chalk piece 1b,3,15,10,5,1
09-05-2025,Snacks & Ready-to-Eat,BATANA NGT 70GMS,14,40,40,0,2
09-05-2025,"Grains, Flours & Dals",Multigrain 1 kg,4,100,85,15,1
09-05-2025,Snacks & Ready-to-Eat,SATHVI REGIVADA 200GM,14,80,60,20,1
09-05-2025,Spices & Seasonings,NUVVULU 250GM,15,80,65,15,1
09-05-2025,Oils & Ghee,Black Sesame oil 500 ml,9,440,380,60,2
09-05-2025,Snacks & Ready-to-Eat,VD DAHI MIRCHI(SALTED) 100GM,14,45,45,0,1
09-05-2025,"Dry Fruits, Nuts & Seeds",MAHA BEERA SEEDS 100GM,2,60,60,0,1
09-05-2025,Beverages,BRU GREEN LABEL 1.2G,1,28,28,0,14
09-05-2025,Spices & Seasonings,Gasagasalu 50GM,15,130,110,20,1
09-05-2025,"Grains, Flours & Dals",DESI CHANA,4,25,25,0,1
09-05-2025,Spices & Seasonings,NUVVULU 250GM,15,100,85,15,1
09-05-2025,Oils & Ghee,Groundnut oil 1 L,9,330,330,0,1
09-05-2025,Pooja & Spiritual Items,SOSR SWATHHI 365,12,60,60,0,2
09-05-2025,"Grains, Flours & Dals",chana flour 500 gms,4,60,54,6,1
09-05-2025,"Grains, Flours & Dals",Wheat Flour 1 kg,4,490,420,70,7
09-05-2025,"Grains, Flours & Dals",Multigrain 1 kg,4,200,170,30,2
09-05-2025,"Grains, Flours & Dals",Wheat Rava M 500GM,4,33,30,3,1
09-05-2025,"Dry Fruits, Nuts & Seeds",Groundnuts 500 gms,2,190,170,20,2
09-05-2025,"Grains, Flours & Dals",turdal 500 gms,4,110,85,25,1
09-05-2025,"Grains, Flours & Dals",Wheat Flour 1 kg,4,70,60,10,1
09-05-2025,Sweeteners,YB JAGGERY POWDER 1KG,16,140,140,0,1
09-05-2025,Snacks & Ready-to-Eat,BATANA NGT 70GMS,14,40,40,0,2
09-05-2025,Snacks & Ready-to-Eat,VD PAPPU CHEGODI 200GM,14,60,60,0,1
09-05-2025,Milk & Dairy,HERTG FULL CREAM M,7,41,41,0,1
09-05-2025,"Grains, Flours & Dals",Multigrain 1 kg,4,100,85,15,1
09-05-2025,"Grains, Flours & Dals",KORRALU (FOXTAIL M) 500GM,4,65,55,10,1
09-05-2025,Snacks & Ready-to-Eat,ANNAPURNA APPALAM,14,35,35,0,1
09-05-2025,"Grains, Flours & Dals",AISHWARYA SP 1KG,4,120,105,15,1.5
09-05-2025,"Grains, Flours & Dals",AISHWARYA SP 25KG,4,1999,"1,690.00",309,1
09-05-2025,"Grains, Flours & Dals",DESI CHANA,4,25,25,0,1
09-05-2025,Oils & Ghee,Groundnut oil 1 L,9,660,660,0,2
09-05-2025,"Grains, Flours & Dals",Wheat Flour 1 kg,4,280,240,40,4
09-05-2025,Snacks & Ready-to-Eat,VD VAMUPUSA 175GM,14,60,60,0,1
09-05-2025,"Grains, Flours & Dals",chana flour 500 gms,4,60,54,6,1
09-05-2025,Personal Care & Cosmetics,UVIS HENNA 100GM,10,70,70,0,2
09-05-2025,Snacks & Ready-to-Eat,SS IDLY BATTER 1KG,14,60,60,0,1
09-05-2025,Snacks & Ready-to-Eat,RAJGIRA PEANUT CHIKKI 450GM,14,125,125,0,1
09-05-2025,"Grains, Flours & Dals",AISHWARYA SP 25KG,4,1999,"1,690.00",309,1
09-05-2025,"Health, Wellness & Ayurvedic Products",RB Max Protein DESI MASALA 60gm,5,90,90,0,2
09-05-2025,"Grains, Flours & Dals",Wheat Flour 1 kg,4,140,120,20,2
09-05-2025,"Grains, Flours & Dals",HS JOWAR IDLY RAWA,4,65,65,0,1
09-05-2025,Oils & Ghee,Coconut oil 500 ml,9,220,200,20,1
09-05-2025,"Grains, Flours & Dals",RAGI FLOUR 500GRMS,4,40,35,5,1
09-05-2025,Snacks & Ready-to-Eat,VD MURUKU 175GM,14,60,60,0,1
09-05-2025,"Grains, Flours & Dals",chana flour 500 gms,4,60,54,6,1
09-05-2025,"Grains, Flours & Dals",White jowar.F 1 kg,4,100,80,20,1
09-05-2025,Spices & Seasonings,JEERA 250 gms,15,125,105,20,1
09-05-2025,Spices & Seasonings,AVALU 250grms,15,60,60,0,1
09-05-2025,Milk & Dairy,BUTTER MILK,7,10,10,0,1
09-05-2025,Personal Care & Cosmetics,MYSORE SANDAL BABY SOAP,10,45,45,0,1
09-05-2025,"Grains, Flours & Dals",chana flour 500 gms,4,60,54,6,1
09-05-2025,"Grains, Flours & Dals",POORI ATTA 1KG,4,70,60,10,1
09-05-2025,"Grains, Flours & Dals",Bombay Rava 500GM,4,35,30,5,1
09-05-2025,Household & Cleaning,VIM MAHA BAR,6,10,10,0,1
09-05-2025,Snacks & Ready-to-Eat,SS IDLY BATTER 1KG,14,60,60,0,1
09-05-2025,Sweeteners,YB JAGGERY POWDER 1KG,16,140,140,0,1
09-05-2025,Snacks & Ready-to-Eat,MIGHTY PUFF,14,75,75,0,3
09-05-2025,"Grains, Flours & Dals",Wheat Flour 1 kg,4,70,60,10,1
09-05-2025,"Grains, Flours & Dals",SL Idly Rava 1KG,4,65,55,10,1
09-05-2025,"Dry Fruits, Nuts & Seeds",FLAX SEEDS 250GM,2,60,50,10,1
09-05-2025,Pooja & Spiritual Items,PACHAKARPURAM,12,120,100,20,2
09-05-2025,"Dry Fruits, Nuts & Seeds",wallnuts,2,380,320,60,1
09-05-2025,General Household & Kitchenware,MATCH BOX,3,10,10,0,1
09-05-2025,"Health, Wellness & Ayurvedic Products",MH Millets Malt 500GM,5,800,760,40,4
09-05-2025,"Grains, Flours & Dals",DESI CHANA,4,25,25,0,1
09-05-2025,Baking & Cooking Aids,GONDKATIRA Ag,0,85,75,10,1
09-05-2025,"Dry Fruits, Nuts & Seeds",SATHVI CHIA SEEDS 100GM,2,100,80,20,1
09-05-2025,Personal Care & Cosmetics,APPLE BC POWDER,10,200,200,0,1
09-05-2025,"Dry Fruits, Nuts & Seeds",SUNFLOWER SEEDS 250GRM,2,150,130,20,1
09-05-2025,"Grains, Flours & Dals",SRILATHA RICE RAVVA 500GM,4,35,35,0,1
09-05-2025,Misc,VD0009,8,100,100,0,1
09-05-2025,Snacks & Ready-to-Eat,DOSA BATTER 1KG,14,60,60,0,1
09-05-2025,General Household & Kitchenware,WOODEN SPATULA 11,3,22,22,0,1
09-05-2025,"Dry Fruits, Nuts & Seeds",Groundnuts 500 gms,2,95,85,10,1
09-05-2025,"Dry Fruits, Nuts & Seeds",YELLOW KISHMISH 250GM,2,130,110,20,1
09-05-2025,"Dry Fruits, Nuts & Seeds",SABJA SEEDS,2,70,70,0,1
09-05-2025,"Grains, Flours & Dals",DESI CHANA,4,25,25,0,1
09-05-2025,Personal Care & Cosmetics,UVIS ALOEVERA GEL,10,140,140,0,1
09-05-2025,"Grains, Flours & Dals",SL Idly Rava 1KG,4,65,55,10,1
09-05-2025,"Grains, Flours & Dals",MAATEJA rice 5 kg,4,360,345,15,1
09-05-2025,Snacks & Ready-to-Eat,VD GUMMADI VADIYAM,14,75,75,0,1
09-05-2025,Misc,VD00014,8,100,90,10,1
09-05-2025,Oils & Ghee,Coconut oil 500 ml,9,220,200,20,1
09-05-2025,Spices & Seasonings,Chilli powder 250 gms,15,145,110,35,1
09-05-2025,Oils & Ghee,Safflower oil 1 L,9,400,400,0,1
09-05-2025,Spices & Seasonings,PICKLES CHILLIP 500 GMS,15,2130,"1,950.00",180,6
09-05-2025,"Grains, Flours & Dals",Multigrain 1 kg,4,100,85,15,1
09-05-2025,Milk & Dairy,BUTTER MILK,7,30,30,0,3
09-05-2025,Pickles & Cooking Pastes,DURGA BRAND TM PICKLES SPECIAL,11,84,84,0,3
09-05-2025,Oils & Ghee,sesame oil 1L,9,2360,"2,240.00",120,4
09-05-2025,Spices & Seasonings,MUSTARD POWDER 250G,15,130,110,20,2
09-05-2025,Spices & Seasonings,MUSTARD POWDR 500G,15,260,220,40,2
09-05-2025,Personal Care & Cosmetics,JOHNOSONS BABY OIL 50ML,10,70,70,0,1
09-05-2025,Milk & Dairy,BUTTER MILK,7,30,30,0,3
09-05-2025,Personal Care & Cosmetics,UVIS MULTANI MITTI PW 100GM,10,49,49,0,1
09-05-2025,"Health, Wellness & Ayurvedic Products",MD Aamlaki Choornam 100GM,5,80,80,0,1
09-05-2025,Personal Care & Cosmetics,GOHNSONS BABY OIL 100ML,10,140,140,0,1
09-05-2025,Pooja & Spiritual Items,GD Aiswarya Deepam 700ML,12,195,195,0,1
09-05-2025,Personal Care & Cosmetics,ES POCKET COMB,10,50,50,0,1
09-05-2025,Oils & Ghee,Groundnut oil 1 L,9,660,660,0,2
09-05-2025,Spices & Seasonings,Chilli powder 500 gms,15,290,210,80,1
09-05-2025,"Grains, Flours & Dals",Green gram 1 kg,4,150,130,20,1
09-05-2025,Spices & Seasonings,Coriander seeds 200 gms,15,48,40,8,1
09-05-2025,Spices & Seasonings,DRY MIECHI 200GM,15,80,60,20,1
09-05-2025,"Grains, Flours & Dals",SL Idly Rava 1KG,4,65,55,10,1
09-05-2025,Oils & Ghee,Groundnut oil 1 L,9,660,660,0,2
09-05-2025,Oils & Ghee,Safflower oil 1 L,9,800,800,0,2
09-05-2025,Pickles & Cooking Pastes,DURGA BRAND TM PICKLES SPECIAL,11,28,28,0,1
09-05-2025,Oils & Ghee,Groundnut oil 1 L,9,660,660,0,2
09-05-2025,"Grains, Flours & Dals",KORRALU (FOXTAIL M) 1KG,4,150,110,40,1
09-05-2025,"Grains, Flours & Dals",yellow jowar flour 1kg,4,100,92,8,1
09-05-2025,"Grains, Flours & Dals",RAGI FLOUR 500GRMS,4,80,70,10,2
09-05-2025,Snacks & Ready-to-Eat,ANNAPURNA APPALAM,14,35,35,0,1
09-05-2025,"Grains, Flours & Dals",SPLIT BLACK GRAM 500 GM,4,90,85,5,1
09-05-2025,Snacks & Ready-to-Eat,RINGS 200GM,14,30,30,0,1
09-05-2025,General Household & Kitchenware,chalk piece 1b,3,15,10,5,1
09-05-2025,Milk & Dairy,HERITAGE TOTAL CURD 500GM,7,50,50,0,1
09-05-2025,Spices & Seasonings,dalchin chekka,15,50,40,10,1
09-05-2025,"Grains, Flours & Dals",RAGI FLOUR 1KG,4,80,70,10,1
09-05-2025,Oils & Ghee,Groundnut oil 1 L,9,990,990,0,3
09-05-2025,Snacks & Ready-to-Eat,BATANA NGT 70GMS,14,20,20,0,1
09-05-2025,Snacks & Ready-to-Eat,RSC ORANGE 100GMS,14,20,20,0,1
09-05-2025,Oils & Ghee,sesame oil 1L,9,590,560,30,1
09-05-2025,"Grains, Flours & Dals",Wheat Flour 1 kg,4,140,120,20,2
09-05-2025,"Grains, Flours & Dals",Multigrain 1 kg,4,100,85,15,1
09-05-2025,Snacks & Ready-to-Eat,SD Vamu with palm jaggery 250gm,14,135,135,0,1
09-05-2025,Snacks & Ready-to-Eat,SD Groundnut with palm jaggery 250gm,14,135,135,0,1
09-05-2025,Snacks & Ready-to-Eat,GB SALT COOKIES,14,60,55,5,1
09-05-2025,Snacks & Ready-to-Eat,SD Bajra with palm Jaggery 250gm,14,135,135,0,1
09-05-2025,Snacks & Ready-to-Eat,SD JOWAR WITH PALM JAGGERY 250GM,14,135,135,0,1
09-05-2025,Snacks & Ready-to-Eat,RAGI LADDU,14,120,120,0,1
09-05-2025,Snacks & Ready-to-Eat,SF MIGHTY PUFFS,14,25,25,0,1
09-05-2025,Snacks & Ready-to-Eat,SUNNUNDALU,14,120,120,0,1
09-05-2025,Snacks & Ready-to-Eat,SD Sesame laddu with dates250gm,14,135,135,0,1
09-05-2025,Spices & Seasonings,DURGA SALT CRYSTAL 1KG,15,75,75,0,3
09-05-2025,Oils & Ghee,sesame oil 1L,9,2360,"2,240.00",120,4
09-05-2025,Oils & Ghee,Groundnut oil 1 L,9,1320,"1,320.00",0,4
09-05-2025,"Grains, Flours & Dals",THICK POHA 1KG,4,80,70,10,1
09-05-2025,"Grains, Flours & Dals",Wheat Flour 1 kg,4,140,120,20,2
09-05-2025,Oils & Ghee,Coconut oil 500 ml,9,440,400,40,2
09-05-2025,"Grains, Flours & Dals",DISANO OATS 1KG,4,143,143,0,1
09-05-2025,Oils & Ghee,Groundnut oil 1 L,9,660,660,0,2
09-05-2025,Personal Care & Cosmetics,HERBAL BATH POWDER 200GM,10,80,80,0,1
09-05-2025,"Grains, Flours & Dals",PESARA PAPPU 500GMS,4,85,75,10,1
09-05-2025,"Grains, Flours & Dals",SAMALU (Little millet) 500 gms,4,85,65,20,1
09-05-2025,"Grains, Flours & Dals",MAATEJA rice 26 kg,4,1690,"1,690.00",0,1
09-05-2025,Snacks & Ready-to-Eat,SIRI ICE CREAM 100ML,14,200,160,40,2
09-05-2025,Snacks & Ready-to-Eat,ELITE ELAICHI RUSK 200GM,14,35,35,0,1
09-05-2025,"Grains, Flours & Dals",Wheat Flour 1 kg,4,70,60,10,1
09-05-2025,"Grains, Flours & Dals",VGR rice 1 kg,4,70,65,5,1
09-05-2025,"Grains, Flours & Dals",AISHWARYA SP 1KG,4,160,140,20,2
09-05-2025,Spices & Seasonings,DRY MIECHI 200GM,15,80,60,20,1
09-05-2025,Spices & Seasonings,Turmeric powder 250 gms,15,100,80,20,1
09-05-2025,Personal Care & Cosmetics,OVAL BODY LOOFAH,10,55,55,0,1
09-05-2025,"Grains, Flours & Dals",BAJRA 1 KG,4,60,50,10,1
09-05-2025,"Grains, Flours & Dals",JOWAR WHITE 1 KG,4,80,70,10,1
09-05-2025,Oils & Ghee,Sesame oil 500ml,9,295,280,15,1
09-05-2025,Sweeteners,HANS JAGGERY PRODUCTS,16,125,125,0,1
09-05-2025,Snacks & Ready-to-Eat,VD RIBBON PAKODI 175GM,14,60,60,0,1
09-05-2025,Spices & Seasonings,LG 50GM,15,92,92,0,1
09-05-2025,Oils & Ghee,Groundnut oil 1 L,9,330,330,0,1
09-05-2025,Pooja & Spiritual Items,NALLAS VAISHNAVI MAISHAKSHI 50GM,12,50,50,0,1
09-05-2025,Sweeteners,sugar 500 gms,16,30,28,2,1
09-05-2025,Sweeteners,MISHRI 250 GM,16,35,30,5,1
09-05-2025,Pooja & Spiritual Items,sambrani powder,12,40,40,0,1
09-05-2025,Spices & Seasonings,DURGA SALT CRYSTAL 1KG,15,50,50,0,2
09-05-2025,Oils & Ghee,Groundnut oil 1 L,9,330,330,0,1
09-05-2025,Milk & Dairy,SANGAM TONED MILK 500ML,7,31,31,0,1
09-05-2025,Spices & Seasonings,DURGA SALT CRYSTAL 1KG,15,25,25,0,1
09-05-2025,"Grains, Flours & Dals",IDLY RAVA 1KG,4,120,100,20,2
09-05-2025,Spices & Seasonings,RED COPRA 250GMS,15,85,74,11,1
09-05-2025,Snacks & Ready-to-Eat,KURNOOL MARMURA,14,70,55,15,1
09-05-2025,"Grains, Flours & Dals",split black gram 1 kg,4,360,340,20,2
09-05-2025,"Grains, Flours & Dals",THICK POHA 1KG,4,160,140,20,2
09-05-2025,"Grains, Flours & Dals",BOMBAY RAVA,4,140,110,30,2
09-05-2025,"Grains, Flours & Dals",DH URAD GOTA 1KG,4,215,190,25,1
09-05-2025,"Grains, Flours & Dals",Wheat Flour 1 kg,4,70,60,10,1
09-05-2025,Snacks & Ready-to-Eat,GB SALT COOKIES,14,60,55,5,1
09-05-2025,Snacks & Ready-to-Eat,MIGHTY PUFFS CHEDDAR CHEESE,14,25,25,0,1
09-05-2025,"Grains, Flours & Dals",Wheat Flour 1 kg,4,70,60,10,1
09-05-2025,"Grains, Flours & Dals",Multigrain 1 kg,4,100,85,15,1
09-05-2025,Beverages,REFRESH SHARBATH NORMAL,1,199,190,9,1
09-05-2025,"Health, Wellness & Ayurvedic Products",gyan thyapobhumi,5,60,60,0,1
09-05-2025,Spices & Seasonings,SWEET SOUNF,15,20,20,0,1
09-05-2025,Snacks & Ready-to-Eat,VD GUMMADI VADIYAM,14,75,75,0,1
09-05-2025,"Grains, Flours & Dals",Multigrain 1 kg,4,100,85,15,1
09-05-2025,Milk & Dairy,HERTG FULL CREAM M,7,41,41,0,1
09-05-2025,Snacks & Ready-to-Eat,SATHVI REGIVADA 200GM,14,80,60,20,1
09-05-2025,Milk & Dairy,HERITAGE TOTAL CURD 500GM,7,50,50,0,1
09-05-2025,Spices & Seasonings,GROUNDNUT KARAM POWDER,15,65,65,0,1
09-05-2025,Spices & Seasonings,Tamalapaku Karam Powder 100GM,15,80,80,0,1
09-05-2025,"Health, Wellness & Ayurvedic Products",MXP CHOCO CLASSIC BAR,5,70,70,0,1
09-05-2025,Oils & Ghee,sesame oil 1L,9,1180,"1,120.00",60,2
09-05-2025,Oils & Ghee,sesame oil 1L,9,590,560,30,1
09-05-2025,"Dry Fruits, Nuts & Seeds",Groundnuts 500 gms,2,95,85,10,1
09-05-2025,"Grains, Flours & Dals",IDLY RAVA 1KG,4,60,50,10,1
09-05-2025,Spices & Seasonings,Turmeric powder 250 gms,15,100,80,20,1
09-05-2025,"Grains, Flours & Dals",KORRALU (FOXTAIL M) 1KG,4,150,110,40,1
09-05-2025,"Grains, Flours & Dals",SB Javva Wheat Ravva 500GM,4,95,95,0,1
09-05-2025,Oils & Ghee,Groundnut oil 1 L,9,330,330,0,1
09-05-2025,Spices & Seasonings,Chilli powder 500 gms,15,290,210,80,1
09-05-2025,"Grains, Flours & Dals",Multigrain 1 kg,4,100,85,15,1
09-05-2025,"Grains, Flours & Dals",RAGI FLOUR 500GRMS,4,40,35,5,1
09-05-2025,"Health, Wellness & Ayurvedic Products",KONDAPINDI CHOORNAM,5,100,100,0,1
09-05-2025,Pickles & Cooking Pastes,DURGA BRAND TM PICKLES SPECIAL,11,56,56,0,2
09-05-2025,Spices & Seasonings,pickle chili powder,15,360,330,30,2
09-05-2025,Oils & Ghee,sesame oil 1L,9,1180,"1,120.00",60,2
09-05-2025,Spices & Seasonings,Menthulu 250 gms,15,50,45,5,1
09-05-2025,Spices & Seasonings,DURGA SALT CRYSTAL 1KG,15,25,25,0,1
09-05-2025,Spices & Seasonings,MUSTARD POWDR 500G,15,130,110,20,1
09-05-2025,Spices & Seasonings,Jeera 100GM,15,50,45,5,1
09-05-2025,Sweeteners,organic jaggery powder,16,99,99,0,1
09-05-2025,"Grains, Flours & Dals",Arikalu (kodo),4,70,65,5,1
09-05-2025,"Dry Fruits, Nuts & Seeds",PUTNALU 500GMS,2,90,76,14,1
09-05-2025,Spices & Seasonings,DURGA SALT CRYSTAL 1KG,15,25,25,0,1
09-05-2025,Spices & Seasonings,3M.MIRCHI POWDER,15,360,320,40,1
09-05-2025,"Dry Fruits, Nuts & Seeds",Groundnuts 500 gms,2,95,85,10,1
09-05-2025,Spices & Seasonings,AVALU 100GM,15,25,20,5,1
09-05-2025,Snacks & Ready-to-Eat,BB VERMICELLI 1KG,14,95,90,5,1
09-05-2025,Spices & Seasonings,AV Iodized Salt 1KG,15,28,25,3,1
09-05-2025,Spices & Seasonings,AVALU 250grms,15,60,60,0,1
09-05-2025,"Grains, Flours & Dals",RAGI FLOUR 1KG,4,80,70,10,1
09-05-2025,Oils & Ghee,Groundnut oil 1 L,9,330,330,0,1
09-05-2025,Sweeteners,YB Brown Sugar 500GM,16,75,75,0,1
09-05-2025,Snacks & Ready-to-Eat,DINNER PAPAD,14,80,80,0,1
09-05-2025,"Grains, Flours & Dals",Green gram 1 kg,4,150,130,20,1
09-05-2025,Spices & Seasonings,DRY MIECHI 200GM,15,80,60,20,1
09-05-2025,Oils & Ghee,sesame oil 1L,9,590,560,30,1
09-05-2025,"Grains, Flours & Dals",split black gram 1 kg,4,180,170,10,1
09-05-2025,Snacks & Ready-to-Eat,VD PALLI LADDU,14,80,80,0,1
09-05-2025,Oils & Ghee,Coconut oil 500 ml,9,440,400,40,2
09-05-2025,Spices & Seasonings,Tamarind 250GMS,15,80,65,15,1
09-05-2025,"Grains, Flours & Dals",Wheat Flour 1 kg,4,70,60,10,1
09-05-2025,Snacks & Ready-to-Eat,NGT CHATPATTA CHANA 90GM,14,50,50,0,2
09-05-2025,Spices & Seasonings,Jeera 100GM,15,50,45,5,1
09-05-2025,Sweeteners,sugar 500 gms,16,30,28,2,1
09-05-2025,Sweeteners,MISHRI 250 GM,16,35,30,5,1
09-05-2025,Spices & Seasonings,Coriander seeds 200 gms,15,48,40,8,1
09-05-2025,Spices & Seasonings,Menthulu 250 gms,15,50,45,5,1
09-05-2025,"Dry Fruits, Nuts & Seeds",Groundnuts 500 gms,2,95,85,10,1
09-05-2025,Oils & Ghee,sesame oil 1L,9,1180,"1,120.00",60,2
09-05-2025,Spices & Seasonings,Jeera 100GM,15,50,45,5,1
09-05-2025,Snacks & Ready-to-Eat,NGT CHATPATTA CHANA 90GM,14,75,75,0,3
09-05-2025,Snacks & Ready-to-Eat,BB ROASTED VERMICELLY 500GM,14,70,70,0,1
09-05-2025,"Grains, Flours & Dals",Wheat Rava M 500GM,4,33,30,3,1
09-05-2025,Oils & Ghee,Groundnut oil 1 L,9,660,660,0,2
09-05-2025,Sweeteners,YB JAGGERY POWDER 500GMS,16,75,75,0,1
09-05-2025,"Grains, Flours & Dals",doctor rice 1kg,4,600,600,0,5
09-05-2025,"Grains, Flours & Dals",YELLOW JOWER 1KG,4,450,400,50,5
09-05-2025,"Grains, Flours & Dals",MELMEKER 250GMS,4,60,45,15,1
09-05-2025,"Grains, Flours & Dals",samalu,4,130,130,0,1
09-05-2025,"Grains, Flours & Dals",SL Suji Rava 500GM,4,64,64,0,2
09-05-2025,"Grains, Flours & Dals",Arikadu ( kodo),4,140,130,10,1
09-05-2025,"Grains, Flours & Dals",Quinova 1 kg,4,880,780,100,4
09-05-2025,Snacks & Ready-to-Eat,NGT CHATPATTA CHANA 90GM,14,125,125,0,5
09-05-2025,"Dry Fruits, Nuts & Seeds",PUMPKIN SEEDS 250GM,2,400,320,80,2
09-05-2025,Spices & Seasonings,NUVVULU 500GM,15,200,170,30,1
09-05-2025,"Dry Fruits, Nuts & Seeds",PULMAKHANA 100 GM,2,360,340,20,2
09-05-2025,"Dry Fruits, Nuts & Seeds",Groundnuts 1 kg,2,190,165,25,1
09-05-2025,"Grains, Flours & Dals",AISHWARYA SP 1KG,4,80,70,10,1
09-05-2025,"Grains, Flours & Dals",Urad dall 1 Kg,4,185,170,15,1
09-05-2025,Spices & Seasonings,Jeera 100GM,15,50,45,5,1
09-05-2025,"Grains, Flours & Dals",turdal 1kg,4,220,170,50,1
09-05-2025,Spices & Seasonings,Tamarind 250GMS,15,80,65,15,1
09-05-2025,"Grains, Flours & Dals",Wheat Flour 1 kg,4,70,60,10,1
09-05-2025,"Grains, Flours & Dals",RAGI FLOUR 500GRMS,4,40,35,5,1
09-05-2025,Snacks & Ready-to-Eat,NGT CHATPATTA CHANA 90GM,14,125,125,0,5
09-05-2025,"Grains, Flours & Dals",Quinova 1 kg,4,880,780,100,4
09-05-2025,"Dry Fruits, Nuts & Seeds",Groundnuts 1 kg,2,190,165,25,1
09-05-2025,"Dry Fruits, Nuts & Seeds",PUMPKIN SEEDS 250GM,2,400,320,80,2
09-05-2025,Oils & Ghee,Groundnut oil 1 L,9,330,330,0,1
09-05-2025,Spices & Seasonings,DURGA SALT CRYSTAL 1KG,15,25,25,0,1
09-05-2025,Spices & Seasonings,Turmeric powder 250 gms,15,100,80,20,1
09-05-2025,"Grains, Flours & Dals",Chittimuthaylu rice 1 kg,4,160,140,20,1
09-05-2025,"Grains, Flours & Dals",SPLIT BLACK GRAM 500 GM,4,90,85,5,1
09-05-2025,"Grains, Flours & Dals",Arikalu (kodo),4,70,65,5,1
09-05-2025,"Grains, Flours & Dals",MAATEJA rice 26 kg,4,1700,"1,700.00",0,1
09-05-2025,"Grains, Flours & Dals",SAMALU (Little millet) 500 gms,4,85,65,20,1
09-05-2025,Spices & Seasonings,PICKLES CHILLIP 500 GMS,15,355,325,30,1
09-05-2025,Spices & Seasonings,MUSTARD POWDER 250G,15,65,55,10,1
09-05-2025,Oils & Ghee,sesame oil 1L,9,590,560,30,1
09-05-2025,Pickles & Cooking Pastes,DURGA BRAND TM PICKLES SPECIAL,11,28,28,0,1
09-05-2025,"Grains, Flours & Dals",YELLOW JOWER 1KG,4,180,160,20,2
09-05-2025,"Grains, Flours & Dals",UNPOLISHED TURDALL 1KG,4,240,210,30,1
09-05-2025,"Grains, Flours & Dals",SABDANA 500GM,4,90,70,20,1
09-05-2025,"Grains, Flours & Dals",Green gram 500 gms,4,75,70,5,1
09-05-2025,"Grains, Flours & Dals",RAGULU 1 KG,4,140,120,20,2
09-05-2025,"Grains, Flours & Dals",Green gram 1 kg,4,150,130,20,1
09-05-2025,"Grains, Flours & Dals",BAJRA 1 KG,4,75,75,0,1
09-05-2025,"Grains, Flours & Dals",IDLY RAVA 1KG,4,120,100,20,2
09-05-2025,"Grains, Flours & Dals",Wheat Rava M 1KG,4,65,55,10,1
09-05-2025,"Health, Wellness & Ayurvedic Products",RB FRUITS &amp;seeds Cranberries,5,45,45,0,1
09-05-2025,"Grains, Flours & Dals",Wheat Flour 1 kg,4,140,120,20,2
09-05-2025,Snacks & Ready-to-Eat,SIRI ICE CREAM 100ML,14,700,560,140,7
09-05-2025,Beverages,REFRESH SHARBATH SUGAR FREE,1,299,285,14,1
09-05-2025,Spices & Seasonings,PICKLES CHILLIP 500 GMS,15,1420,"1,300.00",120,4
09-05-2025,Spices & Seasonings,MUSTARD POWDR 500G,15,130,110,20,1
09-05-2025,Snacks & Ready-to-Eat,VD PALLI CHIKKI,14,80,80,0,1
09-05-2025,Oils & Ghee,sesame oil 1L,9,1180,"1,120.00",60,2
09-05-2025,Spices & Seasonings,MUSTARD POWDER 250G,15,65,55,10,1
09-05-2025,"Grains, Flours & Dals",Arikalu (kodo),4,135,130,5,1
09-05-2025,"Grains, Flours & Dals",samalu,4,130,130,0,1
09-05-2025,Spices & Seasonings,Menthulu 250 gms,15,50,45,5,1
09-05-2025,Pickles & Cooking Pastes,DURGA BRAND TM PICKLES SPECIAL,11,56,56,0,2
09-05-2025,"Grains, Flours & Dals",RAGI FLOUR 1KG,4,80,70,10,1
09-05-2025,"Grains, Flours & Dals",KORRALU (FOXTAIL M) 1KG,4,150,110,40,1
09-05-2025,Oils & Ghee,Black Sesame oil 1 L,9,440,380,60,1
09-05-2025,Oils & Ghee,Groundnut oil 1 L,9,660,660,0,2
09-05-2025,Oils & Ghee,Coconut oil 500 ml,9,220,200,20,1
09-05-2025,"Health, Wellness & Ayurvedic Products",VAMU WATER,5,99,99,0,1
09-05-2025,"Grains, Flours & Dals",AISHWARYA SP 1KG,4,160,140,20,2
09-05-2025,"Grains, Flours & Dals",VGR rice 1 kg,4,70,65,5,1
09-05-2025,Household & Cleaning,VIM SOAP,6,10,10,0,2
09-05-2025,General Household & Kitchenware,chalk piece 1b,3,15,10,5,1
09-05-2025,Beverages,BRU GREEN LABEL 1.2G,1,20,20,0,10
09-05-2025,Pooja & Spiritual Items,GOW DURBAR GEETHA CAMPHOR,12,60,60,0,1
09-05-2025,Pooja & Spiritual Items,999 SINGAPORE DHOOP POW 50GM,12,35,35,0,1
09-05-2025,"Grains, Flours & Dals",RICE FLOUR 500 GM,4,35,28,7,1
09-05-2025,"Grains, Flours & Dals",BARLEY SEEDS 500 GM,4,90,70,20,1
09-05-2025,"Grains, Flours & Dals",yellow jowar flour 1kg,4,100,92,8,1
09-05-2025,"Grains, Flours & Dals",Wheat Rava M 500GM,4,33,30,3,1
09-05-2025,"Grains, Flours & Dals",Multigrain 1 kg,4,100,85,15,1
09-05-2025,Snacks & Ready-to-Eat,VD CORNFLAKES MIXTURE 175GM,14,60,60,0,1
09-05-2025,"Dry Fruits, Nuts & Seeds",Putnalu 250GM,2,45,38,7,1
09-05-2025,"Grains, Flours & Dals",Wheat Flour 1 kg,4,70,60,10,1
09-05-2025,"Grains, Flours & Dals",White jowar.F 1 kg,4,100,80,20,1
09-05-2025,Snacks & Ready-to-Eat,ANNAPURNA APPALAM,14,34,34,0,1
09-05-2025,"Grains, Flours & Dals",maida 500grms,4,35,30,5,1
09-05-2025,"Dry Fruits, Nuts & Seeds",Groundnuts 500 gms,2,95,85,10,1
09-05-2025,"Grains, Flours & Dals",RICE FLOUR 500 GM,4,35,28,7,1
09-05-2025,"Grains, Flours & Dals",RAGI FLOUR 500GRMS,4,80,70,10,2
09-05-2025,Snacks & Ready-to-Eat,VD Pappu Chekkalu 190gm,14,60,60,0,1
09-05-2025,"Grains, Flours & Dals",AISHWARYA SP 1KG,4,160,140,20,2
09-05-2025,"Grains, Flours & Dals",MAATEJA rice 1 kg,4,216,207,9,3
09-05-2025,"Dry Fruits, Nuts & Seeds",PUMPKIN SEEDS 250GM,2,200,160,40,1
09-05-2025,Sweeteners,ACHUBELLAM 500GM,16,50,40,10,1
09-05-2025,"Dry Fruits, Nuts & Seeds",DRYDATES 250GM,2,150,120,30,1
09-05-2025,Oils & Ghee,A2 BUFFALO GHEE 250ML,9,299,299,0,1
09-05-2025,Snacks & Ready-to-Eat,ELITE ELAICHI RUSK 200GM,14,35,35,0,1
09-05-2025,"Grains, Flours & Dals",White jowar.F 1 kg,4,100,80,20,1
09-05-2025,Snacks & Ready-to-Eat,BB VERMICELLY 500GM,14,53,53,0,1
09-05-2025,"Dry Fruits, Nuts & Seeds",PUTNALU 500GMS,2,90,76,14,1
09-05-2025,"Grains, Flours & Dals",Urad dall 1 Kg,4,185,170,15,1
09-05-2025,Household & Cleaning,vim 500ml,6,125,125,0,1
09-05-2025,Spices & Seasonings,JEERA 250 gms,15,125,105,20,1
09-05-2025,"Grains, Flours & Dals",PESARA PAPPU 1 KG,4,170,145,25,1
09-05-2025,"Grains, Flours & Dals",split black gram 1 kg,4,180,170,10,1
09-05-2025,"Grains, Flours & Dals",CHANA DAL 1KG,4,112,96,16,1
09-05-2025,Spices & Seasonings,lavangam,15,50,50,0,1
09-05-2025,Snacks & Ready-to-Eat,BB ROASTED VERMICELLY 500GM,14,70,70,0,1
09-05-2025,Spices & Seasonings,pasupu 500gms,15,180,150,30,1
09-05-2025,Oils & Ghee,Black Sesame oil 1 L,9,440,380,60,1
09-05-2025,"Grains, Flours & Dals",split greengram,4,140,140,0,1
09-05-2025,Spices & Seasonings,Elaichi 25GM,15,145,120,25,1
09-05-2025,"Grains, Flours & Dals",turdal 1kg,4,220,170,50,1
09-05-2025,Spices & Seasonings,Avalu small 250 gms,15,60,60,0,1
09-05-2025,"Grains, Flours & Dals",THICK POHA 1KG,4,80,70,10,1
09-05-2025,"Grains, Flours & Dals",Wheat Flour 1 kg,4,210,180,30,3
09-05-2025,"Grains, Flours & Dals",BOMBAY RAVA,4,70,55,15,1
09-05-2025,"Grains, Flours & Dals",Green gram 500 gms,4,75,70,5,1
09-05-2025,Oils & Ghee,Sesame oil 500ml,9,295,280,15,1
09-05-2025,"Grains, Flours & Dals",MAATEJA rice 1 kg,4,216,207,9,3
09-05-2025,"Dry Fruits, Nuts & Seeds",Groundnuts 500 gms,2,95,85,10,1
09-05-2025,"Grains, Flours & Dals",IDLY RAVA 1KG,4,60,50,10,1
09-05-2025,Sweeteners,MISHRI 250 GM,16,35,30,5,1
09-05-2025,Pooja & Spiritual Items,SWASTIK CAMPHORE,12,90,90,0,1
09-05-2025,"Dry Fruits, Nuts & Seeds",Groundnuts 1 kg,2,190,165,25,1
09-05-2025,"Grains, Flours & Dals",chana flour 500 gms,4,60,54,6,1
08-05-2025,Sweeteners,MADHUR SUGAR 1KG,16,130,110,20,2
08-05-2025,"Grains, Flours & Dals",ULAVALU RED,4,180,150,30,2
08-05-2025,Oils & Ghee,Groundnut oil 1 L,9,660,660,0,2
08-05-2025,Oils & Ghee,Black Sesame oil 1 L,9,440,380,60,1
08-05-2025,Sweeteners,mishri 500g,16,70,60,10,1
08-05-2025,Snacks & Ready-to-Eat,JONNA RIBAN,14,60,60,0,1
08-05-2025,Snacks & Ready-to-Eat,VD MINAPA SUNNUNDALU 12P,14,120,120,0,1
08-05-2025,Snacks & Ready-to-Eat,DOSA BATTER 1KG,14,60,60,0,1
08-05-2025,General Household & Kitchenware,IRN 4MM DOSA TAWA 12,3,460,460,0,1
08-05-2025,Oils & Ghee,Groundnut oil 1 L,9,330,330,0,1
08-05-2025,Oils & Ghee,sesame oil 1L,9,590,560,30,1
08-05-2025,"Grains, Flours & Dals",AISHWARYA SP 25KG,4,1999,"1,690.00",309,1
08-05-2025,"Grains, Flours & Dals",MAATEJA rice 1 kg,4,720,690,30,10
08-05-2025,"Grains, Flours & Dals",VGR RICE bag 1,4,1899,"1,650.00",249,1
08-05-2025,"Grains, Flours & Dals",Wheat Rava M 1KG,4,65,55,10,1
08-05-2025,Sweeteners,SUGAR 1KG,16,60,56,4,1
08-05-2025,Spices & Seasonings,Turmeric powder 250 gms,15,100,80,20,1
08-05-2025,"Grains, Flours & Dals",Urad dall 1 Kg,4,370,340,30,2
08-05-2025,"Grains, Flours & Dals",IDLY RAVA 1KG,4,120,100,20,2
08-05-2025,Spices & Seasonings,ROYAL SAFFRON 400GRMS,15,130,130,0,2
08-05-2025,"Grains, Flours & Dals",Brown RICE 1KG,4,140,130,10,2
08-05-2025,Spices & Seasonings,Tamarind 500GM,15,160,130,30,1
08-05-2025,Spices & Seasonings,DRY MIECHI 200GM,15,80,60,20,1
08-05-2025,Spices & Seasonings,Menthulu 250 gms,15,50,45,5,1
08-05-2025,Household & Cleaning,mostick,6,80,80,0,4
08-05-2025,Spices & Seasonings,Coriander seeds 200 gms,15,48,40,8,1
08-05-2025,Personal Care & Cosmetics,APPLE BC POWDER,10,200,200,0,1
08-05-2025,"Grains, Flours & Dals",Green gram 500 gms,4,75,70,5,1
08-05-2025,"Grains, Flours & Dals",SPLIT URAD DAL,4,45,45,0,1
08-05-2025,Spices & Seasonings,Jeera 100GM,15,50,45,5,1
08-05-2025,"Grains, Flours & Dals",PESARA PAPPU 500GMS,4,85,75,10,1
08-05-2025,"Grains, Flours & Dals",chana flour 500 gms,4,120,108,12,2
08-05-2025,"Grains, Flours & Dals",turdal 1kg,4,660,510,150,3
08-05-2025,Spices & Seasonings,MIRYALU 50 GRMS,15,100,80,20,1
08-05-2025,"Grains, Flours & Dals",White Chana 250 GM,4,60,50,10,1
08-05-2025,Oils & Ghee,Coconut oil 500 ml,9,220,200,20,1
08-05-2025,"Health, Wellness & Ayurvedic Products",RB Max Protein DESI MASALA 60gm,5,45,45,0,1
08-05-2025,Oils & Ghee,sesame oil 1L,9,1180,"1,120.00",60,2
08-05-2025,"Dry Fruits, Nuts & Seeds",PUMPKIN SEEDS 250GM,2,200,160,40,1
08-05-2025,Milk & Dairy,HRITAGE TOTAL CURD 130GM,7,20,20,0,2
08-05-2025,Spices & Seasonings,KURA KARAM G,15,75,75,0,1
08-05-2025,"Dry Fruits, Nuts & Seeds",SUNFLOWER SEEDS 250GRM,2,150,130,20,1
08-05-2025,Oils & Ghee,Coconut oil 500 ml,9,220,200,20,1
08-05-2025,Snacks & Ready-to-Eat,RINGS 200GM,14,30,30,0,1
08-05-2025,"Grains, Flours & Dals",SL Suji Rava 500GM,4,32,32,0,1
08-05-2025,Snacks & Ready-to-Eat,ANNAPURNA APPALAM,14,70,70,0,2
08-05-2025,"Grains, Flours & Dals",BOMBAY RAVA,4,70,55,15,1
08-05-2025,"Grains, Flours & Dals",Wheat Flour 1 kg,4,140,120,20,2
08-05-2025,Snacks & Ready-to-Eat,MB PEARL MILLET NOODLES 180GM,14,190,190,0,2
08-05-2025,"Dry Fruits, Nuts & Seeds",cashew,2,340,310,30,1
08-05-2025,Oils & Ghee,Groundnut oil 1 L,9,330,330,0,1
08-05-2025,Sweeteners,MADHUR SUGAR 1KG,16,65,55,10,1
08-05-2025,"Dry Fruits, Nuts & Seeds",Putnalu 250GM,2,45,38,7,1
08-05-2025,Pooja & Spiritual Items,deep jyothi deepam oil 1000ml,12,198,198,0,1
08-05-2025,"Grains, Flours & Dals",Wheat Flour 1 kg,4,70,60,10,1
08-05-2025,"Grains, Flours & Dals",Multigrain 1 kg,4,100,85,15,1
08-05-2025,Snacks & Ready-to-Eat,BD RED RICE NOODLES 200G,14,70,70,0,1
08-05-2025,Snacks & Ready-to-Eat,MIGHTY PUFFS CHEDDAR CHEESE,14,25,25,0,1
08-05-2025,Snacks & Ready-to-Eat,PEANUT CHILLI,14,10,10,0,2
08-05-2025,Snacks & Ready-to-Eat,SOYA MURK,14,60,60,0,1
08-05-2025,"Grains, Flours & Dals",SL Suji Rava 500GM,4,32,32,0,1
08-05-2025,Snacks & Ready-to-Eat,ANNAPURNA APPALAM,14,35,35,0,1
08-05-2025,Snacks & Ready-to-Eat,RINGS 200GM,14,30,30,0,1
08-05-2025,Snacks & Ready-to-Eat,VD Pappu Chekkalu 190gm,14,120,120,0,2
08-05-2025,Snacks & Ready-to-Eat,SIRI ICE CREAM 500ML,14,920,520,400,2
08-05-2025,Pooja & Spiritual Items,GD Aiswarya Deepam 700ML,12,195,195,0,1
08-05-2025,Snacks & Ready-to-Eat,VD MURMURA LADDU,14,50,50,0,1
08-05-2025,Snacks & Ready-to-Eat,VD MIXTURE 175 GM,14,180,180,0,3
08-05-2025,Snacks & Ready-to-Eat,SS IDLY BATTER 1KG,14,60,60,0,1
08-05-2025,Snacks & Ready-to-Eat,SATHVI REGIVADA 200GM,14,320,240,80,4
08-05-2025,Oils & Ghee,Sesame oil 500ml,9,295,280,15,1
08-05-2025,"Grains, Flours & Dals",Wheat Rava M 1KG,4,65,55,10,1
08-05-2025,"Dry Fruits, Nuts & Seeds",SATHVI CHIA SEEDS 100GM,2,100,80,20,1
08-05-2025,"Dry Fruits, Nuts & Seeds",SABJA SEEDS,2,70,70,0,1
08-05-2025,Spices & Seasonings,JEERA 250 gms,15,125,105,20,1
08-05-2025,Personal Care & Cosmetics,GAYATHRI KUMKUDUKAYA,10,150,150,0,1
08-05-2025,"Grains, Flours & Dals",Wheat Flour 1 kg,4,210,180,30,3
08-05-2025,"Dry Fruits, Nuts & Seeds",Groundnuts 1 kg,2,190,165,25,1
08-05-2025,Spices & Seasonings,Tamarind 500GM,15,160,130,30,1
08-05-2025,"Grains, Flours & Dals",FLOUR CHARGE,4,12,12,0,1
08-05-2025,Snacks & Ready-to-Eat,VD Minapa papad 200gm,14,60,60,0,1
08-05-2025,"Grains, Flours & Dals",RICE FLOUR 500 GM,4,35,28,7,1
08-05-2025,Pooja & Spiritual Items,GD Kailash 60 GM,12,60,60,0,1
08-05-2025,"Health, Wellness & Ayurvedic Products",GS Wheat Grass Powder 100GMS,5,349,349,0,1
08-05-2025,Snacks & Ready-to-Eat,ONION MURK,14,60,60,0,1
08-05-2025,Spices & Seasonings,Chilli powder 500 gms,15,290,210,80,1
08-05-2025,Pooja & Spiritual Items,BALAJI BEL PHOOL STICKS 90GM,12,60,60,0,1
08-05-2025,Oils & Ghee,Groundnut oil 1 L,9,330,330,0,1
08-05-2025,"Dry Fruits, Nuts & Seeds",Groundnuts 1 kg,2,190,165,25,1
08-05-2025,"Grains, Flours & Dals",unpolished turdall500grms,4,120,110,10,1
08-05-2025,Oils & Ghee,sesame oil 1L,9,590,560,30,1
08-05-2025,Snacks & Ready-to-Eat,SD JOWAR WITH PALM JAGGERY 250GM,14,135,135,0,1
08-05-2025,Oils & Ghee,Coconut oil 500 ml,9,220,200,20,1
08-05-2025,Spices & Seasonings,LG 50GM,15,92,92,0,1
08-05-2025,"Grains, Flours & Dals",chana flour 500 gms,4,60,54,6,1
08-05-2025,Sweeteners,mishri 500g,16,210,180,30,3
08-05-2025,"Grains, Flours & Dals",Wheat Rava M 1KG,4,65,55,10,1
08-05-2025,Milk & Dairy,HERTG FULL CREAM M,7,41,41,0,1
08-05-2025,Oils & Ghee,Groundnut oil 1 L,9,330,330,0,1
08-05-2025,Snacks & Ready-to-Eat,BB VERMICELLY 500GM,14,53,53,0,1
08-05-2025,Oils & Ghee,sesame oil 1L,9,590,560,30,1
08-05-2025,Snacks & Ready-to-Eat,SD Vamu with palm jaggery 250gm,14,135,135,0,1
08-05-2025,Oils & Ghee,Groundnut oil 1 L,9,330,330,0,1
08-05-2025,"Grains, Flours & Dals",RICE FLOUR 500 GM,4,35,28,7,1
08-05-2025,"Grains, Flours & Dals",CHANA DALL 250GM,4,28,24,4,1
08-05-2025,Oils & Ghee,Groundnut oil 1 L,9,330,330,0,1
08-05-2025,Personal Care & Cosmetics,GOW DURBAR 75G,10,60,60,0,2
08-05-2025,"Grains, Flours & Dals",MELMEKER 250GMS,4,60,45,15,1
08-05-2025,"Grains, Flours & Dals",maida 500grms,4,35,30,5,1
08-05-2025,"Dry Fruits, Nuts & Seeds",Groundnuts 1 kg,2,190,165,25,1
08-05-2025,"Grains, Flours & Dals",DH URAD GOTA 1KG,4,215,190,25,1
08-05-2025,Spices & Seasonings,Jeera 100GM,15,50,45,5,1
08-05-2025,Spices & Seasonings,Avalu small 250 gms,15,60,60,0,1
08-05-2025,"Grains, Flours & Dals",turdal 1kg,4,220,170,50,1
08-05-2025,Spices & Seasonings,Tamarind 250GMS,15,80,65,15,1
08-05-2025,Spices & Seasonings,YB Rock Salt 1KG,15,120,120,0,1
08-05-2025,Household & Cleaning,vim dish liquid,6,55,55,0,1
08-05-2025,"Grains, Flours & Dals",PESARA PAPPU 500GMS,4,85,75,10,1
08-05-2025,Oils & Ghee,Groundnut oil 1 L,9,330,330,0,1
08-05-2025,Snacks & Ready-to-Eat,BELLAM MINAPA SUNADULLU,14,180,180,0,1
08-05-2025,Snacks & Ready-to-Eat,PN ORGANIC PUFFED RICE 200GM,14,55,55,0,1
08-05-2025,"Grains, Flours & Dals",MAAGAANI SP RICE 20 KGS,4,2300,"1,960.00",340,1
08-05-2025,"Grains, Flours & Dals",SA Sprouted Ragi Flour 500GM,4,69,69,0,1
08-05-2025,"Grains, Flours & Dals",Wheat Flour 1 kg,4,140,120,20,2
08-05-2025,"Grains, Flours & Dals",yellow jowar flour 1kg,4,200,184,16,2
08-05-2025,"Health, Wellness & Ayurvedic Products",VAMU WATER,5,198,198,0,2
08-05-2025,"Grains, Flours & Dals",UDALU (Barnyard millet) 1 kg,4,140,115,25,1
08-05-2025,"Grains, Flours & Dals",KORRALU (FOXTAIL M) 1KG,4,150,110,40,1
08-05-2025,Snacks & Ready-to-Eat,BELLAM MINAPA SUNADULLU,14,180,180,0,1
08-05-2025,Snacks & Ready-to-Eat,SD JOWAR WITH PALM JAGGERY 250GM,14,135,135,0,1
08-05-2025,"Grains, Flours & Dals",samalu,4,130,130,0,1
08-05-2025,Sweeteners,MISHRI 250 GM,16,35,30,5,1
08-05-2025,Snacks & Ready-to-Eat,VD PALLI CHIKKI,14,160,160,0,2
08-05-2025,"Grains, Flours & Dals",ANDU KORRALU (Browntop.m) 1 kg,4,260,220,40,1
08-05-2025,"Dry Fruits, Nuts & Seeds",YELLOW KISHMISH 250GM,2,130,110,20,1
08-05-2025,Snacks & Ready-to-Eat,VD Pappu Chekkalu 190gm,14,60,60,0,1
08-05-2025,Snacks & Ready-to-Eat,VD NUVULLU CHIKKI,14,80,80,0,1
08-05-2025,"Grains, Flours & Dals",Arikadu ( kodo),4,140,130,10,1
08-05-2025,"Grains, Flours & Dals",DH URAD GOTA 1KG,4,215,190,25,1
08-05-2025,Milk & Dairy,SANGAM CURD 450GM,7,38,38,0,1
08-05-2025,Spices & Seasonings,BIRYANI LEAF 10GM,15,30,20,10,1
08-05-2025,Spices & Seasonings,lavangam,15,50,50,0,1
08-05-2025,Spices & Seasonings,dalchin chekka,15,50,40,10,1
08-05-2025,Spices & Seasonings,ever c masala,15,48,48,0,1
08-05-2025,Spices & Seasonings,SATHVI ANASAPUVUU 25GM,15,180,130,50,2
08-05-2025,"Grains, Flours & Dals",IG PURE BASMATHI RICE,4,252,227,25,1
08-05-2025,Spices & Seasonings,SAJEERA,15,60,40,20,1
08-05-2025,Spices & Seasonings,ELACHI 25 GM,15,145,120,25,1
08-05-2025,Spices & Seasonings,Japatri 25GM,15,100,80,20,1
08-05-2025,"Grains, Flours & Dals",White jowar.F 1 kg,4,100,80,20,1
08-05-2025,"Grains, Flours & Dals",Wheat Flour 1 kg,4,210,180,30,3
08-05-2025,Pooja & Spiritual Items,GD Aiswarya Deepam 700ML,12,390,390,0,2
08-05-2025,Spices & Seasonings,DURGA SALT CRYSTAL 1KG,15,28,28,0,1
08-05-2025,"Grains, Flours & Dals",turdal 1kg,4,220,170,50,1
08-05-2025,"Grains, Flours & Dals",Em jowar idly R 500G,4,150,150,0,2
08-05-2025,"Grains, Flours & Dals",ANDU KORRALU (Brown top .mlt) 500,4,130,110,20,1
08-05-2025,"Grains, Flours & Dals",SRILATHA RICE RAVVA 500GM,4,70,70,0,2
08-05-2025,"Grains, Flours & Dals",UDALU (Barnyard millet) 500 gms,4,70,60,10,1
08-05-2025,"Grains, Flours & Dals",WHEAT 1 KG,4,120,100,20,2
08-05-2025,Spices & Seasonings,idli karam powdwer,15,65,65,0,1
08-05-2025,"Grains, Flours & Dals",JOWAR WHITE 1 KG,4,40,35,5,0.5
08-05-2025,"Grains, Flours & Dals",FLOUR CHARGE,4,30,30,0,2.5
08-05-2025,Snacks & Ready-to-Eat,VD DAHI MIRCHI(SALTED) 100GM,14,45,45,0,1
08-05-2025,"Grains, Flours & Dals",BARLEY SEEDS 250GMS,4,40,35,5,1
08-05-2025,Snacks & Ready-to-Eat,ANNAPURNA APPALAM,14,70,70,0,2
08-05-2025,"Grains, Flours & Dals",KORRALU (FOXTAIL M) 500GM,4,65,55,10,1
08-05-2025,"Grains, Flours & Dals",KORRALU (FOXTAIL M) 500GM,4,65,55,10,1
08-05-2025,"Grains, Flours & Dals",UDALU (Barnyard millet) 500 gms,4,70,60,10,1
08-05-2025,"Grains, Flours & Dals",Green gram 500 gms,4,75,70,5,1
08-05-2025,"Grains, Flours & Dals",EM Ragi upma R 500g,4,75,75,0,1
08-05-2025,Milk & Dairy,ID PANEER,7,135,135,0,1
08-05-2025,Oils & Ghee,Groundnut oil 1 L,9,330,330,0,1
08-05-2025,"Grains, Flours & Dals",SL Idly Rava 1KG,4,130,110,20,2
08-05-2025,Sweeteners,sugar 500 gms,16,30,28,2,1
08-05-2025,"Dry Fruits, Nuts & Seeds",Groundnuts 1 kg,2,380,330,50,2
08-05-2025,"Grains, Flours & Dals",Green gram 1 kg,4,150,130,20,1
08-05-2025,Spices & Seasonings,AVALU 100GM,15,25,20,5,1
08-05-2025,Oils & Ghee,sesame oil 1L,9,590,560,30,1
08-05-2025,"Grains, Flours & Dals",Wheat Flour 1 kg,4,70,60,10,1
08-05-2025,Spices & Seasonings,Tamarind 250GMS,15,80,65,15,1
08-05-2025,Spices & Seasonings,Jeera 100GM,15,50,45,5,1
08-05-2025,"Grains, Flours & Dals",DH URAD GOTA 1KG,4,430,380,50,2
08-05-2025,Spices & Seasonings,KALONJI SEEDS,15,90,80,10,1
08-05-2025,Personal Care & Cosmetics,UVIS ALOEVERA GEL,10,149,149,0,1
08-05-2025,"Dry Fruits, Nuts & Seeds",SATHVI CHIA SEEDS 100GM,2,100,80,20,1
08-05-2025,"Dry Fruits, Nuts & Seeds",FLAX SEEDS 250GM,2,60,50,10,1
08-05-2025,Snacks & Ready-to-Eat,VD MIXTURE 175 GM,14,60,60,0,1
08-05-2025,Snacks & Ready-to-Eat,VD PALLI CHIKKI,14,80,80,0,1
08-05-2025,"Grains, Flours & Dals",SL Suji Rava 500GM,4,32,32,0,1
08-05-2025,Snacks & Ready-to-Eat,VD DAHI MIRCHI(SALTED) 100GM,14,45,45,0,1
08-05-2025,"Grains, Flours & Dals",split green gram 500 gms,4,75,70,5,1
08-05-2025,Snacks & Ready-to-Eat,KURNOOL MARMURA,14,140,110,30,2
08-05-2025,Milk & Dairy,SANGAM FULL CREAM MILK 500ML,7,76,76,0,2
08-05-2025,Sweeteners,ACHUBELLAM 500GM,16,50,40,10,1
08-05-2025,Pooja & Spiritual Items,SIVA JOOTHI 365 DEEPAPU,12,60,60,0,3
08-05-2025,Snacks & Ready-to-Eat,SAGOPAPAD RED CHILLI VD,14,55,55,0,1
08-05-2025,"Grains, Flours & Dals",UDALU (Barnyard millet) 1 kg,4,140,115,25,1
08-05-2025,"Grains, Flours & Dals",RAGI FLOUR 1KG,4,80,70,10,1
08-05-2025,"Grains, Flours & Dals",ANDU KORRALU (Browntop.m) 1 kg,4,260,220,40,1
08-05-2025,"Grains, Flours & Dals",samalu,4,130,130,0,1
08-05-2025,Snacks & Ready-to-Eat,VD SAGOPAPAD 150GM,14,55,55,0,1
08-05-2025,Oils & Ghee,Safflower oil 500 ml,9,220,200,20,1
08-05-2025,"Grains, Flours & Dals",Arikadu ( kodo),4,140,130,10,1
08-05-2025,Oils & Ghee,Coconut oil 500 ml,9,220,200,20,1
08-05-2025,Spices & Seasonings,EVEREST PANI PURI MASALA 50GM,15,40,40,0,1
08-05-2025,Snacks & Ready-to-Eat,SIRI ICE CREAM 100ML,14,100,80,20,1
08-05-2025,"Grains, Flours & Dals",RAGI FLOUR 500GRMS,4,40,35,5,1
08-05-2025,"Grains, Flours & Dals",Multigrain 1 kg,4,100,85,15,1
08-05-2025,"Grains, Flours & Dals",Multigrain 1 kg,4,100,85,15,1
08-05-2025,Spices & Seasonings,YB Rock Salt 1KG,15,120,120,0,1
08-05-2025,Milk & Dairy,SANGAM FULL CREAM MILK 500ML,7,38,38,0,1
08-05-2025,"Grains, Flours & Dals",SL Idly Rava 1KG,4,65,55,10,1
08-05-2025,"Grains, Flours & Dals",yellow jowar flour 1kg,4,100,92,8,1
08-05-2025,Pooja & Spiritual Items,SOSR SWATHHI 365,12,30,30,0,1
08-05-2025,"Grains, Flours & Dals",YELLOW JOWER 1KG,4,270,240,30,3
08-05-2025,Oils & Ghee,Groundnut oil 1 L,9,1050,"1,050.00",0,3
08-05-2025,"Grains, Flours & Dals",Wheat Flour 1 kg,4,70,60,10,1
08-05-2025,"Grains, Flours & Dals",RAGI FLOUR 500GRMS,4,80,70,10,2
08-05-2025,"Grains, Flours & Dals",FLOUR CHARGE,4,21.6,21.6,0,1.8
08-05-2025,Snacks & Ready-to-Eat,Pani Poori Chips 250GM,14,50,40,10,1
08-05-2025,"Grains, Flours & Dals",white Bobarlu 500 gms,4,80,75,5,1
08-05-2025,"Grains, Flours & Dals",white Bobarlu 1 KG,4,170,150,20,1
08-05-2025,Pooja & Spiritual Items,deep jyothi deepam oil 1000ml,12,198,198,0,1
08-05-2025,Snacks & Ready-to-Eat,SAGOPAPAD RED CHILLI VD,14,55,55,0,1
08-05-2025,Pooja & Spiritual Items,GD SANDAL 150GM,12,110,110,0,1
08-05-2025,Pooja & Spiritual Items,SST 365 PURE COTTON POOJA,12,30,30,0,1
08-05-2025,"Grains, Flours & Dals",RICE FLOUR 1KG,4,70,55,15,1
08-05-2025,Pooja & Spiritual Items,SOSR SWATHHI 365,12,120,120,0,4
08-05-2025,Milk & Dairy,SANGAM TONED MILK 500ML,7,31,31,0,1
08-05-2025,"Dry Fruits, Nuts & Seeds",FLAX SEEDS 250GM,2,60,50,10,1
08-05-2025,"Grains, Flours & Dals",POORI ATTA 1KG,4,70,60,10,1
08-05-2025,"Grains, Flours & Dals",maida 500grms,4,35,30,5,1
08-05-2025,"Grains, Flours & Dals",KORRALU (FOXTAIL M) 500GM,4,65,55,10,1
08-05-2025,"Health, Wellness & Ayurvedic Products",RB Max Protein Choco Almond bar 50g,5,75,75,0,1
08-05-2025,"Grains, Flours & Dals",SAMALU (Little millet) 500 gms,4,85,65,20,1
08-05-2025,"Grains, Flours & Dals",White jowar.F 1 kg,4,100,80,20,1
08-05-2025,Snacks & Ready-to-Eat,PEANUT CHILLI,14,10,10,0,2
08-05-2025,"Grains, Flours & Dals",FLOUR CHARGE,4,60,60,0,5
08-05-2025,"Grains, Flours & Dals",RAGI FLOUR 1KG,4,80,70,10,1
08-05-2025,Sweeteners,YB JAGGERY POWDER 500GMS,16,75,75,0,1
08-05-2025,"Grains, Flours & Dals",Red Chana 500 GM,4,75,60,15,1
08-05-2025,"Dry Fruits, Nuts & Seeds",SABJA SEEDS,2,70,70,0,1
08-05-2025,"Grains, Flours & Dals",FLOUR CHARGE,4,60,60,0,5
08-05-2025,Oils & Ghee,Groundnut oil 1 L,9,330,330,0,1
08-05-2025,"Grains, Flours & Dals",HS MULTI UPMA RAVA,4,65,65,0,1
08-05-2025,"Grains, Flours & Dals",POORI ATTA 1KG,4,70,60,10,1
08-05-2025,"Grains, Flours & Dals",BARLEY SEEDS 250GMS,4,40,35,5,1
08-05-2025,Pooja & Spiritual Items,SOSR SWATHHI 365,12,150,150,0,5
08-05-2025,Pooja & Spiritual Items,BALAJI ROSE DHOOP STIKS 10STK,12,125,125,0,1
08-05-2025,Pooja & Spiritual Items,BALAJI BEL PHOOL DHOOP STICKS 10STK,12,70,70,0,1
08-05-2025,Oils & Ghee,Coconut oil 500 ml,9,220,200,20,1
08-05-2025,Spices & Seasonings,Chilli powder 250 gms,15,145,110,35,1
08-05-2025,Spices & Seasonings,Jeera 100GM,15,50,45,5,1
08-05-2025,"Dry Fruits, Nuts & Seeds",Putnalu 250GM,2,45,38,7,1
08-05-2025,"Dry Fruits, Nuts & Seeds",Groundnuts 1 kg,2,190,165,25,1
08-05-2025,Sweeteners,SUGAR 1KG,16,60,56,4,1
08-05-2025,Snacks & Ready-to-Eat,VD MULTI CHAKKA,14,110,110,0,1
08-05-2025,Personal Care & Cosmetics,MD Bath Powder 100GM,10,40,40,0,1
08-05-2025,"Health, Wellness & Ayurvedic Products",MH Millets Malt 500GM,5,200,190,10,1
08-05-2025,"Grains, Flours & Dals",FLOUR CHARGE,4,21.6,21.6,0,1.8
08-05-2025,"Grains, Flours & Dals",Urad dall 1 Kg,4,92.5,85,7.5,0.5
08-05-2025,"Grains, Flours & Dals",SAMALU (Little millet) 1 kg,4,51,39,12,0.3
08-05-2025,"Grains, Flours & Dals",KORRALU (FOXTAIL M) 1KG,4,45,33,12,0.3
08-05-2025,"Grains, Flours & Dals",UDALU (Barnyard millet) 1 kg,4,42,34.5,7.5,0.3
08-05-2025,"Grains, Flours & Dals",Wheat Flour 1 kg,4,140,120,20,2
08-05-2025,"Grains, Flours & Dals",Arikadu ( kodo),4,42,39,3,0.3
08-05-2025,Snacks & Ready-to-Eat,MILLET NOODLES CURRY MASALA,14,129,129,0,1
08-05-2025,Snacks & Ready-to-Eat,MIGHTY PUFF,14,25,25,0,1
08-05-2025,Snacks & Ready-to-Eat,TILLI CHIKKI,14,10,10,0,2
08-05-2025,Snacks & Ready-to-Eat,PEANUT CHILLI,14,10,10,0,2
08-05-2025,Oils & Ghee,sesame oil 1L,9,590,560,30,1
08-05-2025,Oils & Ghee,Groundnut oil 1 L,9,330,330,0,1
08-05-2025,Milk & Dairy,SANGAM TONED MILK 500ML,7,31,31,0,1
08-05-2025,"Grains, Flours & Dals",Bombay Rava 500GM,4,35,30,5,1
08-05-2025,"Grains, Flours & Dals",THICK POHA 500GM,4,40,35,5,1
08-05-2025,"Grains, Flours & Dals",Em jowar idly R 500G,4,75,75,0,1
08-05-2025,Oils & Ghee,Groundnut oil 1 L,9,330,330,0,1
08-05-2025,Spices & Seasonings,Menthulu 250 gms,15,50,45,5,1
08-05-2025,Snacks & Ready-to-Eat,DOSA BATTER 1KG,14,60,60,0,1
08-05-2025,Spices & Seasonings,MUSTARD POWDER 250G,15,65,55,10,1
08-05-2025,Oils & Ghee,sesame oil 1L,9,590,560,30,1
08-05-2025,"Grains, Flours & Dals",White jowar.F 1 kg,4,200,160,40,2
08-05-2025,Oils & Ghee,Coconut oil 500 ml,9,220,200,20,1
08-05-2025,"Grains, Flours & Dals",Wheat Flour 1 kg,4,140,120,20,2
08-05-2025,"Grains, Flours & Dals",chana flour 500 gms,4,60,54,6,1
08-05-2025,Spices & Seasonings,Jeera 100GM,15,50,45,5,1
08-05-2025,"Grains, Flours & Dals",maida 500grms,4,35,30,5,1
08-05-2025,Spices & Seasonings,AVALU 100GM,15,25,20,5,1
08-05-2025,"Grains, Flours & Dals",RICE FLOUR 1KG,4,70,55,15,1
08-05-2025,"Dry Fruits, Nuts & Seeds",FLAX SEEDS 250GM,2,60,50,10,1
08-05-2025,Sweeteners,SUGAR 1KG,16,60,56,4,1
08-05-2025,"Grains, Flours & Dals",Wheat Rava M 500GM,4,33,30,3,1
08-05-2025,Spices & Seasonings,YB Rock Salt 1KG,15,120,120,0,1
08-05-2025,"Grains, Flours & Dals",Wheat Flour 1 kg,4,70,60,10,1
08-05-2025,"Grains, Flours & Dals",turdal 1kg,4,220,170,50,1
08-05-2025,"Grains, Flours & Dals",DH URAD GOTA 1KG,4,430,380,50,2
08-05-2025,Spices & Seasonings,JEERA 250 gms,15,125,105,20,1
08-05-2025,"Grains, Flours & Dals",VGR rice 1 kg,4,350,325,25,5
08-05-2025,"Dry Fruits, Nuts & Seeds",Groundnuts 1 kg,2,190,165,25,1
08-05-2025,Oils & Ghee,sesame oil 1L,9,590,560,30,1
08-05-2025,"Grains, Flours & Dals",IDLY RAVA 1KG,4,120,100,20,2
08-05-2025,Oils & Ghee,Groundnut oil 1 L,9,660,660,0,2
08-05-2025,"Grains, Flours & Dals",Wheat Flour 1 kg,4,70,60,10,1
08-05-2025,"Grains, Flours & Dals",DH URAD GOTA 1KG,4,430,380,50,2
08-05-2025,Snacks & Ready-to-Eat,SUNNUNDALU,14,120,120,0,1
08-05-2025,Oils & Ghee,sesame oil 1L,9,590,560,30,1
08-05-2025,Oils & Ghee,Groundnut oil 1 L,9,330,330,0,1
08-05-2025,Oils & Ghee,Groundnut oil 1 L,9,660,660,0,2
08-05-2025,Snacks & Ready-to-Eat,VD MIXTURE 175 GM,14,60,60,0,1
08-05-2025,"Grains, Flours & Dals",ragi umpa ravva,4,70,70,0,1
08-05-2025,Oils & Ghee,Coconut oil 1 L,9,440,400,40,1
08-05-2025,"Dry Fruits, Nuts & Seeds",RB FIGS DATES,2,50,50,0,1
08-05-2025,"Grains, Flours & Dals",Em Multimillet idli r 500g,4,129,129,0,1
08-05-2025,Spices & Seasonings,Menthulu 250 gms,15,50,45,5,1
08-05-2025,Spices & Seasonings,JEERA 250 gms,15,125,105,20,1
08-05-2025,Oils & Ghee,sesame oil 1L,9,1770,"1,680.00",90,3
08-05-2025,Spices & Seasonings,telaga pindi,15,70,70,0,1
08-05-2025,Spices & Seasonings,MASALA KAR 500GMS,15,260,240,20,1
08-05-2025,"Grains, Flours & Dals",RICE FLOUR 1KG,4,70,55,15,1
08-05-2025,Oils & Ghee,Groundnut oil 1 L,9,330,330,0,1
08-05-2025,"Grains, Flours & Dals",RAGI FLOUR 1KG,4,80,70,10,1
08-05-2025,"Grains, Flours & Dals",Wheat Flour 1 kg,4,210,180,30,3
08-05-2025,Pooja & Spiritual Items,s karpuram,12,180,180,0,1
08-05-2025,"Grains, Flours & Dals",Wheat Flour 1 kg,4,140,120,20,2
08-05-2025,"Grains, Flours & Dals",RAGULU 1 KG,4,35,30,5,0.5
08-05-2025,Spices & Seasonings,Telaga Pindi 250 GM,15,40,35,5,1
08-05-2025,"Grains, Flours & Dals",White Chana 250 GM,4,60,50,10,1
08-05-2025,Spices & Seasonings,BIRYANI LEAF 10GM,15,30,20,10,1
08-05-2025,"Grains, Flours & Dals",Wheat Rava M 1KG,4,65,55,10,1
08-05-2025,Spices & Seasonings,menthulu,15,90,90,0,1
08-05-2025,Oils & Ghee,sesame oil 1L,9,590,560,30,1
08-05-2025,"Dry Fruits, Nuts & Seeds",SABJA SEEDS,2,70,70,0,1
08-05-2025,"Dry Fruits, Nuts & Seeds",Groundnuts 1 kg,2,190,165,25,1
08-05-2025,"Grains, Flours & Dals",chana flour 500 gms,4,60,54,6,1
08-05-2025,Snacks & Ready-to-Eat,VD ATUKULU MIXTURE 175GM,14,60,60,0,1
08-05-2025,"Grains, Flours & Dals",RAGI FLOUR 1KG,4,80,70,10,1
08-05-2025,Snacks & Ready-to-Eat,VD MIXTURE 175 GM,14,60,60,0,1
08-05-2025,Snacks & Ready-to-Eat,VD PALLI CHIKKI,14,80,80,0,1
08-05-2025,Oils & Ghee,rice bran oil f,9,194,169,25,1
08-05-2025,Personal Care & Cosmetics,MD Henna Choornam 100GM,10,160,160,0,2
08-05-2025,"Health, Wellness & Ayurvedic Products",NEELI LEAF CHOORNAM,5,220,220,0,2
08-05-2025,Oils & Ghee,Coconut oil 500 ml,9,220,200,20,1
08-05-2025,Snacks & Ready-to-Eat,NGT CHATPATTA CHANA 90GM,14,25,25,0,1
08-05-2025,Snacks & Ready-to-Eat,FOXTAIL BIS,14,135,135,0,1
08-05-2025,"Health, Wellness & Ayurvedic Products",MH Millets Malt 500GM,5,200,190,10,1
08-05-2025,"Grains, Flours & Dals",SABDANA,4,40,35,5,1
08-05-2025,Snacks & Ready-to-Eat,VD PALLI CHIKKI,14,80,80,0,1
08-05-2025,"Grains, Flours & Dals",HS BAJRA FLAKES 250GM 1+1,4,59,59,0,1
08-05-2025,"Grains, Flours & Dals",Multigrain 1 kg,4,300,255,45,3
08-05-2025,Snacks & Ready-to-Eat,SATHVI REGIVADA 200GM,14,80,60,20,1
08-05-2025,"Grains, Flours & Dals",Wheat Rava M 1KG,4,65,55,10,1
08-05-2025,Oils & Ghee,OLIVANA 100ML,9,179,169,10,1
08-05-2025,Milk & Dairy,BROWN EGGS 1P,7,56,48,8,4
08-05-2025,"Health, Wellness & Ayurvedic Products",RB FRUITS &amp;seeds Cranberries,5,45,45,0,1
08-05-2025,Snacks & Ready-to-Eat,SD Flax seeds with dates 250gm,14,135,135,0,1
08-05-2025,Personal Care & Cosmetics,SVE TULASI SHAMPOO 200ML,10,90,90,0,1
08-05-2025,Spices & Seasonings,SD Garlic Karam Powder 100GM,15,70,70,0,1
08-05-2025,Spices & Seasonings,SH CASSIA STICKS 50GM,15,75,75,0,1
08-05-2025,"Grains, Flours & Dals",PN ORGANIC URAD WHITE WHOLE 500GM,4,158,158,0,1
08-05-2025,Personal Care & Cosmetics,SVE HIBISCUS SOAP,10,90,90,0,1
08-05-2025,Spices & Seasonings,Turmeric powder 250 gms,15,100,80,20,1
08-05-2025,Snacks & Ready-to-Eat,SD Aswagandha with palm Jaggery250Gm,14,135,135,0,1
08-05-2025,"Grains, Flours & Dals",BARLEY SEEDS 500 GM,4,90,70,20,1
08-05-2025,Oils & Ghee,Safflower oil 5 L,9,2200,"1,950.00",250,1
08-05-2025,Beverages,REFRESH SHARBATH NORMAL,1,199,190,9,1
08-05-2025,Spices & Seasonings,GS PUDINA KARAM,15,75,75,0,1
08-05-2025,Spices & Seasonings,sf black pepper,15,190,190,0,1
08-05-2025,Spices & Seasonings,SD Curry Leaves Karam Powder 100GM,15,390,390,0,6
08-05-2025,Snacks & Ready-to-Eat,SAGOPAPAD GREEN CHILLI VD,14,55,55,0,1
08-05-2025,"Grains, Flours & Dals",RAGI FLOUR 1KG,4,80,70,10,1
08-05-2025,Snacks & Ready-to-Eat,MB LITTLE MILLET NOODLES 180G,14,95,95,0,1
08-05-2025,Snacks & Ready-to-Eat,VD RICE MURUKU 150GM,14,50,50,0,1
08-05-2025,Spices & Seasonings,GS Pink Rock Salt 1KG,15,120,120,0,1
08-05-2025,Spices & Seasonings,DURGA SALT CRYSTAL 1KG,15,25,25,0,1
08-05-2025,"Grains, Flours & Dals",AISHWARYA SP 1KG,4,400,350,50,5
08-05-2025,Spices & Seasonings,pickle chili powder,15,180,165,15,1
08-05-2025,"Grains, Flours & Dals",PRO ORG MEDIUM POHA 500G,4,78,78,0,1
08-05-2025,"Grains, Flours & Dals",Bombay Rava 500GM,4,35,30,5,1
08-05-2025,"Health, Wellness & Ayurvedic Products",MH Millets Malt 1KG,5,400,380,20,1
08-05-2025,"Health, Wellness & Ayurvedic Products",MH Millets Malt 500GM,5,200,190,10,1
08-05-2025,Snacks & Ready-to-Eat,SF MILLET NOODLES MILD MASALA 192GM,14,129,129,0,1
08-05-2025,"Grains, Flours & Dals",White jowar.F 1 kg,4,100,80,20,1
08-05-2025,Beverages,BRU GREEN LABEL 1.2G,1,24,24,0,12
08-05-2025,"Grains, Flours & Dals",KORRALU (FOXTAIL M) 500GM,4,65,55,10,1
08-05-2025,"Grains, Flours & Dals",Wheat Flour 1 kg,4,280,240,40,4
08-05-2025,"Grains, Flours & Dals",RAGI FLOUR 500GRMS,4,120,105,15,3
08-05-2025,Milk & Dairy,SANGAM CURD 450GM,7,40,40,0,1
08-05-2025,Spices & Seasonings,Tamarind 500GM,15,160,130,30,1
08-05-2025,Snacks & Ready-to-Eat,GB SALT COOKIES,14,60,55,5,1
08-05-2025,Snacks & Ready-to-Eat,VD PALLI CHIKKI,14,80,80,0,1
08-05-2025,Snacks & Ready-to-Eat,MILK BREAD,14,55,55,0,1
08-05-2025,Sweeteners,ACHU BELLAM 1KG,16,100,80,20,1
08-05-2025,"Grains, Flours & Dals",RICE FLOUR 500 GM,4,35,28,7,1
08-05-2025,"Grains, Flours & Dals",JOWAR WHITE 1 KG,4,80,70,10,1
08-05-2025,"Grains, Flours & Dals",White jowar.F 1 kg,4,100,80,20,1
08-05-2025,Snacks & Ready-to-Eat,RSC ORANGE 100GMS,14,20,20,0,1
08-05-2025,Spices & Seasonings,Menthulu 250 gms,15,50,45,5,1
08-05-2025,Spices & Seasonings,TATA SALT 1KG,15,90,90,0,3
08-05-2025,Snacks & Ready-to-Eat,PEANUT CHILLI,14,5,5,0,1
08-05-2025,Spices & Seasonings,JEERA 250 gms,15,125,105,20,1
08-05-2025,"Grains, Flours & Dals",JOWAR UPMA RAVA,4,65,65,0,1
08-05-2025,Spices & Seasonings,DRY MIECHI 200GM,15,80,60,20,1
08-05-2025,"Grains, Flours & Dals",Wheat Rava M 1KG,4,130,110,20,2
08-05-2025,Spices & Seasonings,Avalu small 250 gms,15,60,60,0,1
08-05-2025,Spices & Seasonings,NUVVULU 500GM,15,320,260,60,2
08-05-2025,"Grains, Flours & Dals",Em jowar idly R 500G,4,300,300,0,4
08-05-2025,"Grains, Flours & Dals",RAGI FLOUR 500GRMS,4,80,70,10,2
08-05-2025,Oils & Ghee,Safflower oil 1 L,9,400,400,0,1
08-05-2025,"Grains, Flours & Dals",White jowar.F 1 kg,4,200,160,40,2
08-05-2025,Oils & Ghee,Groundnut oil 1 L,9,660,660,0,2
08-05-2025,"Grains, Flours & Dals",RAGI FLOUR 1KG,4,80,70,10,1
08-05-2025,Oils & Ghee,Groundnut oil 1 L,9,660,660,0,2
08-05-2025,Snacks & Ready-to-Eat,NGT CHATPATTA CHANA 90GM,14,75,75,0,3
08-05-2025,Snacks & Ready-to-Eat,RSC ORANGE 100GMS,14,20,20,0,1
08-05-2025,Snacks & Ready-to-Eat,VD PALLI LADDU,14,80,80,0,1
08-05-2025,Spices & Seasonings,Coriander seeds 200 gms,15,48,40,8,1
08-05-2025,Spices & Seasonings,RED COPRA 500GM,15,170,148,22,1
08-05-2025,"Grains, Flours & Dals",RED WHEAT 1 KG,4,650,600,50,5
08-05-2025,Oils & Ghee,sesame oil 1L,9,590,560,30,1
08-05-2025,Oils & Ghee,Groundnut oil 5 L,9,1800,"1,600.00",200,1
08-05-2025,Milk & Dairy,SANGAM CURD 450GM,7,38,38,0,1
08-05-2025,"Grains, Flours & Dals",Wheat Flour 1 kg,4,350,300,50,5
08-05-2025,"Dry Fruits, Nuts & Seeds",Groundnuts 1 kg,2,190,165,25,1
08-05-2025,Snacks & Ready-to-Eat,SOYA MURK,14,60,60,0,1
08-05-2025,Spices & Seasonings,ROYAL SAFFRON 400GRMS,15,130,130,0,2
08-05-2025,"Dry Fruits, Nuts & Seeds",PULMAKHANA 100 GM,2,540,510,30,3
08-05-2025,"Grains, Flours & Dals",Wheat Flour 1 kg,4,770,660,110,11
08-05-2025,Spices & Seasonings,GS Pink Rock Salt 1KG,15,120,120,0,1
08-05-2025,"Dry Fruits, Nuts & Seeds",pn makhana 100 gms,2,288,288,0,1
08-05-2025,Sweeteners,YB N FOREST HONEY 700 GM,16,400,400,0,1
08-05-2025,"Grains, Flours & Dals",WHEAT 1 KG,4,180,150,30,3
08-05-2025,"Grains, Flours & Dals",FLOUR CHARGE,4,73.2,73.2,0,6.1
08-05-2025,"Grains, Flours & Dals",MELMEKER 250GMS,4,60,45,15,1
08-05-2025,Sweeteners,MISHRI 250 GM,16,35,30,5,1
08-05-2025,Beverages,BRU GREEN LABEL 1.2G,1,24,24,0,12
08-05-2025,"Dry Fruits, Nuts & Seeds",Putnalu 250GM,2,45,38,7,1
08-05-2025,"Grains, Flours & Dals",KORRALU (FOXTAIL M) 1KG,4,150,110,40,1
08-05-2025,"Grains, Flours & Dals",CHANA DALL 250GM,4,56,48,8,2
08-05-2025,"Grains, Flours & Dals",SH RED POHA 500GM,4,85,85,0,1
08-05-2025,Personal Care & Cosmetics,DWI FOOT CARE 30G,10,90,90,0,1
08-05-2025,Snacks & Ready-to-Eat,KB MILK JUNNU POW 100GM,14,80,80,0,1
08-05-2025,"Grains, Flours & Dals",White jowar.F 1 kg,4,100,80,20,1
08-05-2025,Snacks & Ready-to-Eat,ELITE MILK RUSK 200GM,14,35,35,0,1
08-05-2025,Beverages,REFRESH SHARBATH SUGAR FREE,1,299,285,14,1
08-05-2025,Personal Care & Cosmetics,GAYATHRI KUMKUDUKAYA,10,150,150,0,1
08-05-2025,Snacks & Ready-to-Eat,RAJGIRA PEANUT CHIKKI,14,25,25,0,5
08-05-2025,"Grains, Flours & Dals",Wheat Flour 1 kg,4,140,120,20,2
08-05-2025,Snacks & Ready-to-Eat,KB MILK JUNNU POW 100GM,14,80,80,0,1
08-05-2025,Snacks & Ready-to-Eat,MIGHTY PUFFS KHATTA METTA,14,25,25,0,1
08-05-2025,"Grains, Flours & Dals",VGR rice 1 kg,4,140,130,10,2
08-05-2025,Snacks & Ready-to-Eat,VD Pappu Chekkalu 190gm,14,60,60,0,1
08-05-2025,Spices & Seasonings,PN ORGANIC PINK SALT 1KG,15,124,124,0,1
08-05-2025,"Dry Fruits, Nuts & Seeds",Groundnuts 1 kg,2,190,165,25,1
08-05-2025,"Grains, Flours & Dals",turdal 1kg,4,220,170,50,1
08-05-2025,"Grains, Flours & Dals",Wheat Flour 1 kg,4,70,60,10,1
08-05-2025,"Health, Wellness & Ayurvedic Products",RB Max Protein Fruit &amp;Nut 50g,5,75,75,0,1
08-05-2025,"Grains, Flours & Dals",BOMBAY RAVA,4,70,55,15,1
08-05-2025,"Grains, Flours & Dals",Wheat Rava M 1KG,4,65,55,10,1
08-05-2025,"Grains, Flours & Dals",RAGI FLOUR 1KG,4,80,70,10,1
08-05-2025,Spices & Seasonings,Menthulu 250 gms,15,50,45,5,1
08-05-2025,"Grains, Flours & Dals",SPLIT BLACK GRAM 500 GM,4,90,85,5,1
08-05-2025,"Grains, Flours & Dals",Green gram 1 kg,4,150,130,20,1
08-05-2025,"Grains, Flours & Dals",Urad dall 500 gms,4,95,85,10,1
07-05-2025,"Dry Fruits, Nuts & Seeds",Groundnuts 500 gms,2,95,85,10,1
07-05-2025,"Dry Fruits, Nuts & Seeds",PUMPKIN SEEDS 250GM,2,200,160,40,1
07-05-2025,"Dry Fruits, Nuts & Seeds",SUNFLOWER SEEDS 250GRM,2,150,130,20,1
07-05-2025,Oils & Ghee,Safflower oil 1 L,9,400,400,0,1
07-05-2025,"Grains, Flours & Dals",Wheat Flour 1 kg,4,70,60,10,1
07-05-2025,"Grains, Flours & Dals",Sathya Javva Wheat Rava 500GM,4,95,95,0,1
07-05-2025,Sweeteners,YB Brown Sugar 500GM,16,75,75,0,1
07-05-2025,Oils & Ghee,Groundnut oil 1 L,9,330,330,0,1
07-05-2025,Snacks & Ready-to-Eat,MILK BREAD,14,30,30,0,1
07-05-2025,"Dry Fruits, Nuts & Seeds",cashew,2,340,310,30,1
07-05-2025,"Health, Wellness & Ayurvedic Products",RB Max Protein Choco Almond bar 50g,5,75,75,0,1
07-05-2025,Milk & Dairy,BROWN EGGS 1P,7,56,48,8,4
07-05-2025,Sweeteners,YB JAGGERY POWDER 500GMS,16,75,75,0,1
07-05-2025,Snacks & Ready-to-Eat,GB SALT COOKIES,14,60,55,5,1
07-05-2025,Snacks & Ready-to-Eat,VD PALLI CHIKKI,14,80,80,0,1
07-05-2025,"Dry Fruits, Nuts & Seeds",Groundnuts 1 kg,2,190,165,25,1
07-05-2025,Snacks & Ready-to-Eat,GROUNDNUT LADDU WITH DATES,14,135,135,0,1
07-05-2025,"Grains, Flours & Dals",samalu,4,260,260,0,2
07-05-2025,"Grains, Flours & Dals",CHANA DAL 500GM,4,56,48,8,1
07-05-2025,"Dry Fruits, Nuts & Seeds",Groundnuts 1 kg,2,190,165,25,1
07-05-2025,"Grains, Flours & Dals",Urad dall 1 Kg,4,185,170,15,1
07-05-2025,"Grains, Flours & Dals",BARLEY SEEDS 250GMS,4,40,35,5,1
07-05-2025,Spices & Seasonings,DURGA SALT CRYSTAL 1KG,15,25,25,0,1
07-05-2025,"Grains, Flours & Dals",AISHWARYA SP 1KG,4,400,350,50,5
07-05-2025,"Grains, Flours & Dals",SL Idly Rava 1KG,4,65,55,10,1
07-05-2025,Snacks & Ready-to-Eat,KB MILK JUNNU POW 100GM,14,160,160,0,2
07-05-2025,Beverages,REFRESH SHARBATH NORMAL,1,199,190,9,1
07-05-2025,Oils & Ghee,Groundnut oil 1 L,9,330,330,0,1
07-05-2025,Oils & Ghee,Coconut oil 500 ml,9,220,200,20,1
07-05-2025,"Grains, Flours & Dals",RAGI FLOUR 500GRMS,4,40,35,5,1
07-05-2025,Snacks & Ready-to-Eat,SF VERMICELLI,14,139,139,0,1
07-05-2025,"Grains, Flours & Dals",turdal 1kg,4,220,170,50,1
07-05-2025,Snacks & Ready-to-Eat,SIRI ICE CREAM 100ML,14,200,160,40,2
07-05-2025,Snacks & Ready-to-Eat,VD NUVULLU CHIKKI,14,80,80,0,1
07-05-2025,"Grains, Flours & Dals",Sathya Javva Wheat Rava 500GM,4,95,95,0,1
07-05-2025,Milk & Dairy,BROWN EGGS 1P,7,168,144,24,12
07-05-2025,Snacks & Ready-to-Eat,Sprouted Ragi Biscuits 450GM,14,150,150,0,1
07-05-2025,"Grains, Flours & Dals",RAGI FLOUR 500GRMS,4,40,35,5,1
07-05-2025,"Grains, Flours & Dals",PESARA PAPPU 500GMS,4,85,75,10,1
07-05-2025,Snacks & Ready-to-Eat,SF CEREAL WHEAT APPLE &amp;,14,299,299,0,1
07-05-2025,Snacks & Ready-to-Eat,ANNAPURNA APPALAM,14,35,35,0,1
07-05-2025,Snacks & Ready-to-Eat,GREEN FRIED batana,14,20,20,0,1
07-05-2025,"Grains, Flours & Dals",JOWAR UPMA RAVA,4,75,75,0,1
07-05-2025,Snacks & Ready-to-Eat,VD PAPPU CHEGODI 200GM,14,60,60,0,1
07-05-2025,Snacks & Ready-to-Eat,SD Vamu with palm jaggery 250gm,14,270,270,0,2
07-05-2025,Snacks & Ready-to-Eat,SATHVI REGIVADA 200GM,14,80,60,20,1
07-05-2025,"Dry Fruits, Nuts & Seeds",SALTED PISTA 250GM,2,400,350,50,1
07-05-2025,Oils & Ghee,Safflower oil 1 L,9,800,800,0,2
07-05-2025,Snacks & Ready-to-Eat,VD MULTI CHAKKA,14,220,220,0,2
07-05-2025,Milk & Dairy,BROWN EGGS TRAY 30P,7,360,330,30,1
07-05-2025,"Grains, Flours & Dals",RAGI FLOUR 1KG,4,80,70,10,1
07-05-2025,Spices & Seasonings,DURGA SALT CRYSTAL 1KG,15,28,28,0,1
07-05-2025,Oils & Ghee,sesame oil 1L,9,1180,"1,120.00",60,2
07-05-2025,Snacks & Ready-to-Eat,VD NUVULLU CHIKKI,14,160,160,0,2
07-05-2025,"Grains, Flours & Dals",Multigrain 1 kg,4,100,85,15,1
07-05-2025,Sweeteners,YB JAGGERY POWDER 500GMS,16,75,75,0,1
07-05-2025,"Grains, Flours & Dals",Wheat Flour 1 kg,4,140,120,20,2
07-05-2025,"Grains, Flours & Dals",DH URAD GOTA 1KG,4,215,190,25,1
07-05-2025,"Grains, Flours & Dals",RICE FLOUR 500 GM,4,35,28,7,1
07-05-2025,"Dry Fruits, Nuts & Seeds",PUTNALU 500GMS,2,90,76,14,1
07-05-2025,"Grains, Flours & Dals",KORRALU (FOXTAIL M) 1KG,4,150,110,40,1
07-05-2025,"Dry Fruits, Nuts & Seeds",PUMPKIN SEEDS 250GM,2,200,160,40,1
07-05-2025,"Grains, Flours & Dals",PRO SOYA CHUNKS 200G,4,79,79,0,1
07-05-2025,"Grains, Flours & Dals",SAMALU (Little millet) 500 gms,4,85,65,20,1
07-05-2025,"Grains, Flours & Dals",UDALU (Barnyard millet) 500 gms,4,70,60,10,1
07-05-2025,"Grains, Flours & Dals",ANDU KORRALU (Brown top .mlt) 500,4,130,110,20,1
07-05-2025,"Grains, Flours & Dals",Arikalu (kodo),4,70,65,5,1
07-05-2025,Snacks & Ready-to-Eat,GB SALT COOKIES,14,60,55,5,1
07-05-2025,"Grains, Flours & Dals",MULTIMILLET IDLY RAVVA,4,65,65,0,1
07-05-2025,"Grains, Flours & Dals",KORRALU (FOXTAIL M) 500GM,4,65,55,10,1
07-05-2025,Snacks & Ready-to-Eat,SOYA MURK,14,60,60,0,1
07-05-2025,"Grains, Flours & Dals",AISHWARYA SP 1KG,4,400,350,50,5
07-05-2025,Oils & Ghee,sesame oil 1L,9,590,560,30,1
07-05-2025,Spices & Seasonings,SATHVI ANASAPUVUU 25GM,15,90,65,25,1
07-05-2025,"Dry Fruits, Nuts & Seeds",ROASTED FLAXSEED,2,75,75,0,1
07-05-2025,Spices & Seasonings,SAJEERA,15,60,40,20,1
07-05-2025,Snacks & Ready-to-Eat,3D PAPAD,14,40,40,0,1
07-05-2025,Spices & Seasonings,fenugreek seeds,15,75,75,0,1
07-05-2025,Spices & Seasonings,Masala Karam 250 gms,15,130,120,10,1
07-05-2025,Spices & Seasonings,BIRYANI LEAF 10GM,15,30,20,10,1
07-05-2025,Snacks & Ready-to-Eat,BATANA NGT 70GMS,14,20,20,0,1
07-05-2025,Snacks & Ready-to-Eat,VD PAPPU CHEGODI 200GM,14,60,60,0,1
07-05-2025,Snacks & Ready-to-Eat,VD MANGO JELLY 250GRMS,14,80,80,0,1
07-05-2025,"Grains, Flours & Dals",Wheat Flour 1 kg,4,140,120,20,2
07-05-2025,"Grains, Flours & Dals",IDLY RAVA 1KG,4,120,100,20,2
07-05-2025,"Grains, Flours & Dals",Urad dall 1 Kg,4,185,170,15,1
07-05-2025,Oils & Ghee,BUFFALLO GHEE 500ML,9,410,370,40,1
07-05-2025,Spices & Seasonings,ROYAL SAFFRON 400GRMS,15,65,65,0,1
07-05-2025,Snacks & Ready-to-Eat,SATHVI REGIVADA 200GM,14,80,60,20,1
07-05-2025,Milk & Dairy,HRITAGE TOTAL CURD 130GM,7,20,20,0,2
07-05-2025,"Grains, Flours & Dals",RAJMA 250GM,4,55,45,10,1
07-05-2025,Sweeteners,YB FOREST H 250 GMS,16,180,180,0,1
07-05-2025,Beverages,BISLERI 100ml,1,10,10,0,1
07-05-2025,Oils & Ghee,Groundnut oil 1 L,9,660,660,0,2
07-05-2025,Snacks & Ready-to-Eat,SF PUFFED RICE,14,55,55,0,1
07-05-2025,Oils & Ghee,Safflower oil 1 L,9,800,800,0,2
07-05-2025,Spices & Seasonings,Jeera 100GM,15,50,45,5,1
07-05-2025,"Grains, Flours & Dals",Multigrain 1 kg,4,100,85,15,1
07-05-2025,"Grains, Flours & Dals",SPLIT URAD DAL,4,45,45,0,1
07-05-2025,"Grains, Flours & Dals",White Chana 250 GM,4,120,100,20,2
07-05-2025,"Grains, Flours & Dals",Wheat Rava M 500GM,4,33,30,3,1
07-05-2025,"Dry Fruits, Nuts & Seeds",Groundnuts 500 gms,2,95,85,10,1
07-05-2025,"Grains, Flours & Dals",turdal 500 gms,4,110,85,25,1
07-05-2025,"Grains, Flours & Dals",MELMEKER 250GMS,4,60,45,15,1
07-05-2025,Spices & Seasonings,DRY MIECHI 200GM,15,80,60,20,1
07-05-2025,"Grains, Flours & Dals",Brown RICE 1KG,4,98,91,7,1.4
07-05-2025,Spices & Seasonings,MTR SAMBAR POW 100GM,15,76,76,0,1
07-05-2025,Spices & Seasonings,AVALU 100GM,15,25,20,5,1
07-05-2025,"Grains, Flours & Dals",Urad dall 1 Kg,4,185,170,15,1
07-05-2025,"Grains, Flours & Dals",Green gram 1 kg,4,150,130,20,1
07-05-2025,"Grains, Flours & Dals",White jowar.F 1 kg,4,100,80,20,1
07-05-2025,"Grains, Flours & Dals",Red Bobarlu 500 gms,4,95,85,10,1
07-05-2025,"Grains, Flours & Dals",chana flour 500 gms,4,60,54,6,1
07-05-2025,"Grains, Flours & Dals",MAIDA 1KG,4,70,60,10,1
07-05-2025,Spices & Seasonings,BIRYANI LEAF 10GM,15,30,20,10,1
07-05-2025,Sweeteners,SUGAR 1KG,16,60,56,4,1
07-05-2025,Spices & Seasonings,pickle chili powder,15,180,165,15,1
07-05-2025,"Grains, Flours & Dals",VGR RICE bag 1,4,1899,"1,650.00",249,1
07-05-2025,Spices & Seasonings,AVALU 250grms,15,60,60,0,1
07-05-2025,Spices & Seasonings,NUVVULU 500GM,15,400,340,60,2
07-05-2025,Beverages,REFRESH SHARBATH NORMAL,1,199,190,9,1
07-05-2025,Spices & Seasonings,ROYAL SAFFRON,15,125,125,0,1
07-05-2025,"Grains, Flours & Dals",CHANA DALL 250GM,4,28,24,4,1
07-05-2025,Spices & Seasonings,MUSTARD POWDER 250G,15,65,55,10,1
07-05-2025,"Dry Fruits, Nuts & Seeds",PULMAKHANA 100 GM,2,180,170,10,1
07-05-2025,Sweeteners,MISHRI 250 GM,16,35,30,5,1
07-05-2025,Spices & Seasonings,Turmeric powder 250 gms,15,100,80,20,1
07-05-2025,Spices & Seasonings,DRY MIECHI 200GM,15,80,60,20,1
07-05-2025,"Grains, Flours & Dals",MELMEKER 250GMS,4,60,45,15,1
07-05-2025,"Grains, Flours & Dals",KORRALU (FOXTAIL M) 500GM,4,65,55,10,1
07-05-2025,Spices & Seasonings,Gasagasalu 50GM,15,130,110,20,1
07-05-2025,Snacks & Ready-to-Eat,VD GUMMADI VADIYAM,14,75,75,0,1
07-05-2025,Spices & Seasonings,Menthulu 250 gms,15,50,45,5,1
07-05-2025,"Grains, Flours & Dals",Red Chana 500 GM,4,75,60,15,1
07-05-2025,Spices & Seasonings,DURGA SALT CRYSTAL 1KG,15,25,25,0,1
07-05-2025,"Grains, Flours & Dals",RED TUDAL 1KG,4,150,140,10,1
07-05-2025,"Grains, Flours & Dals",SABDANA 500GM,4,90,70,20,1
07-05-2025,"Grains, Flours & Dals",turdal 1kg,4,220,170,50,1
07-05-2025,Spices & Seasonings,Elaichi 25GM,15,145,120,25,1
07-05-2025,Baking & Cooking Aids,Baking Soda 50GM,0,20,15,5,1
07-05-2025,Spices & Seasonings,MIRYALU 50 GRMS,15,100,80,20,1
07-05-2025,"Grains, Flours & Dals",PESARA PAPPU 500GMS,4,85,75,10,1
07-05-2025,Spices & Seasonings,Telaga Pindi 250 GM,15,40,35,5,1
07-05-2025,Snacks & Ready-to-Eat,DISANO VERMICELLI 425 GM,14,50,50,0,1
07-05-2025,Spices & Seasonings,Jeera 100GM,15,50,45,5,1
07-05-2025,Oils & Ghee,Safflower oil 1 L,9,400,400,0,1
07-05-2025,"Grains, Flours & Dals",RICE FLOUR 500 GM,4,35,28,7,1
07-05-2025,"Grains, Flours & Dals",RICE FLOUR 1KG,4,70,55,15,1
07-05-2025,Spices & Seasonings,JEERA 250 gms,15,125,105,20,1
07-05-2025,"Grains, Flours & Dals",Red Wheat Flour 1 kg,4,140,130,10,1
07-05-2025,"Dry Fruits, Nuts & Seeds",PULMAKHANA 100 GM,2,180,170,10,1
07-05-2025,"Grains, Flours & Dals",AISHWARAYA IDLY RAVA 1KG,4,198,132,66,2
07-05-2025,"Dry Fruits, Nuts & Seeds",Groundnuts 500 gms,2,190,170,20,2
07-05-2025,"Grains, Flours & Dals",MELMEKER 250GMS,4,60,45,15,1
07-05-2025,Snacks & Ready-to-Eat,RSC ORANGE 100GMS,14,20,20,0,1
07-05-2025,Personal Care & Cosmetics,DETTOL 60ML,10,40,40,0,1
07-05-2025,Spices & Seasonings,Turmeric powder 250 gms,15,100,80,20,1
07-05-2025,Spices & Seasonings,Coriander seeds 200 gms,15,48,40,8,1
07-05-2025,Sweeteners,mishri 500g,16,70,60,10,1
07-05-2025,Snacks & Ready-to-Eat,VD DAHI MIRCHI(SALTED) 100GM,14,45,45,0,1
07-05-2025,"Health, Wellness & Ayurvedic Products",RB Max Protein PERI PERI 60gm,5,45,45,0,1
07-05-2025,"Grains, Flours & Dals",CHANA DAL 500GM,4,112,96,16,2
07-05-2025,Sweeteners,YB Brown Sugar 500GM,16,300,300,0,4
07-05-2025,"Grains, Flours & Dals",Urad dall 1 Kg,4,555,510,45,3
07-05-2025,Spices & Seasonings,JEERA 250 gms,15,250,210,40,2
07-05-2025,Oils & Ghee,GANTASALA A2 COW GHEE 250ML,9,299,299,0,1
07-05-2025,"Grains, Flours & Dals",SRILATHA RICE RAVVA 500GM,4,140,140,0,4
07-05-2025,"Grains, Flours & Dals",White Chana 250 GM,4,180,150,30,3
07-05-2025,"Grains, Flours & Dals",turdal 1kg,4,660,510,150,3
07-05-2025,"Health, Wellness & Ayurvedic Products",RB Max Protein Cheese&amp;,5,45,45,0,1
07-05-2025,Household & Cleaning,vim dish liquid,6,110,110,0,2
07-05-2025,Snacks & Ready-to-Eat,VD MANGO JELLY 250GRMS,14,80,80,0,1
07-05-2025,Snacks & Ready-to-Eat,SF VERMICELLI,14,139,139,0,1
07-05-2025,"Grains, Flours & Dals",DH URAD GOTA 1KG,4,215,190,25,1
07-05-2025,"Dry Fruits, Nuts & Seeds",Putnalu 250GM,2,45,38,7,1
07-05-2025,"Dry Fruits, Nuts & Seeds",SATHVI CHIA SEEDS 100GM,2,100,80,20,1
07-05-2025,Household & Cleaning,comfort lily fresh,6,58,58,0,1
07-05-2025,Spices & Seasonings,ROYAL SAFFRON,15,125,125,0,1
07-05-2025,"Grains, Flours & Dals",RICE FLOUR 500 GM,4,35,28,7,1
07-05-2025,Spices & Seasonings,menthulu,15,90,90,0,1
07-05-2025,Spices & Seasonings,AV Iodized Salt 1KG,15,30,30,0,1
07-05-2025,Beverages,TAJ MAHAL 250GM,1,235,235,0,1
07-05-2025,Oils & Ghee,Black Sesame oil 500 ml,9,440,380,60,2
07-05-2025,Oils & Ghee,A2 BUFFALO GHEE 250ML,9,299,299,0,1
07-05-2025,"Grains, Flours & Dals",WHEAT 1 KG,4,120,100,20,2
07-05-2025,Spices & Seasonings,NUVVULU 500GM,15,200,170,30,1
07-05-2025,"Grains, Flours & Dals",BAJRA 1 KG,4,60,50,10,1
07-05-2025,"Grains, Flours & Dals",split black gram 1 kg,4,180,170,10,1
07-05-2025,Snacks & Ready-to-Eat,PEANUT CHILLI,14,5,5,0,1
07-05-2025,"Grains, Flours & Dals",JOWAR WHITE 1 KG,4,160,140,20,2
07-05-2025,Spices & Seasonings,PICKLES CHILLIP 500 GMS,15,355,325,30,1
07-05-2025,Snacks & Ready-to-Eat,BLACK PEPPER RICEPAPAD VD,14,50,50,0,1
07-05-2025,Pooja & Spiritual Items,s karpuram,12,180,180,0,1
07-05-2025,"Grains, Flours & Dals",PESARA PAPPU 500GMS,4,85,75,10,1
07-05-2025,Sweeteners,yb honey 1 kg,16,550,550,0,1
07-05-2025,General Household & Kitchenware,MATCH BOX,3,10,10,0,1
07-05-2025,Spices & Seasonings,Turmeric powder 250 gms,15,100,80,20,1
07-05-2025,General Household & Kitchenware,chalk piece 1b,3,15,10,5,1
07-05-2025,Snacks & Ready-to-Eat,MIGHTY PUFFS CHEESE AND HERBS,14,25,25,0,1
07-05-2025,Milk & Dairy,BUTTER MILK,7,10,10,0,1
07-05-2025,"Grains, Flours & Dals",Multigrain 1 kg,4,300,255,45,3
07-05-2025,"Grains, Flours & Dals",Wheat Flour 1 kg,4,70,60,10,1
07-05-2025,"Grains, Flours & Dals",RED WHEAT 1 KG,4,390,360,30,3
07-05-2025,"Grains, Flours & Dals",WHEAT 1 KG,4,120,100,20,2
07-05-2025,Snacks & Ready-to-Eat,BATANA NGT 70GMS,14,20,20,0,1
07-05-2025,Snacks & Ready-to-Eat,VD PALLI LADDU,14,80,80,0,1
07-05-2025,Snacks & Ready-to-Eat,NGT CHATPATTA CHANA 90GM,14,25,25,0,1
07-05-2025,Snacks & Ready-to-Eat,GREEN FRIED BATANA,14,20,20,0,1
07-05-2025,"Grains, Flours & Dals",Multigrain 1 kg,4,100,85,15,1
07-05-2025,Snacks & Ready-to-Eat,SD Vamu with palm jaggery 250gm,14,135,135,0,1
07-05-2025,"Grains, Flours & Dals",yellow jowar flour 1kg,4,200,184,16,2
07-05-2025,"Grains, Flours & Dals",SL Suji Rava 500GM,4,32,32,0,1
07-05-2025,"Grains, Flours & Dals",White jowar.F 1 kg,4,100,80,20,1
07-05-2025,Spices & Seasonings,3M.MIRCHI POWDER,15,720,640,80,2
07-05-2025,Spices & Seasonings,AV Iodized Salt 1KG,15,30,30,0,1
07-05-2025,Oils & Ghee,Groundnut oil 500ml,9,180,165,15,1
07-05-2025,Spices & Seasonings,AVALU 250grms,15,60,60,0,1
07-05-2025,Sweeteners,Natural Honey 500 gms,16,280,240,40,1
07-05-2025,Spices & Seasonings,MASALA KAR 500GMS,15,260,240,20,1
07-05-2025,"Dry Fruits, Nuts & Seeds",SUNFLOWER SEEDS 250GRM,2,150,130,20,1
07-05-2025,Household & Cleaning,mostick,6,20,20,0,1
07-05-2025,Spices & Seasonings,SAJEERA,15,60,40,20,1
07-05-2025,Spices & Seasonings,BIRYANI LEAF 10GM,15,30,20,10,1
07-05-2025,Snacks & Ready-to-Eat,RITEBITE BLUEBERRY BLAST,14,50,50,0,1
07-05-2025,Sweeteners,YB FOREST H 250 GMS,16,180,180,0,1
07-05-2025,Pooja & Spiritual Items,VRP APOORVA JAVADHU POW,12,30,30,0,1
07-05-2025,"Health, Wellness & Ayurvedic Products",MADDI NEEM OIL 100ML,5,110,110,0,1
07-05-2025,Oils & Ghee,Safflower oil 1 L,9,400,400,0,1
07-05-2025,Snacks & Ready-to-Eat,RI Yogurt Berry Oats 35g,14,45,45,0,1
07-05-2025,Snacks & Ready-to-Eat,VD CORNFLAKES MIXTURE 175GM,14,60,60,0,1
07-05-2025,Spices & Seasonings,Jeera 100GM,15,50,45,5,1
07-05-2025,"Health, Wellness & Ayurvedic Products",RB FRUITS &amp;seeds Cranberries,5,45,45,0,1
07-05-2025,Snacks & Ready-to-Eat,WHOLE WHEAT BREAD,14,55,55,0,1
07-05-2025,"Dry Fruits, Nuts & Seeds",SABJA SEEDS,2,70,70,0,1
07-05-2025,Sweeteners,MISHRI 250 GM,16,35,30,5,1
07-05-2025,Snacks & Ready-to-Eat,SIRI ICE CREAM 500ML,14,460,260,200,1
07-05-2025,Snacks & Ready-to-Eat,SUNNUNDALU,14,120,120,0,1
07-05-2025,"Grains, Flours & Dals",AISHWARYA SP 1KG,4,400,350,50,5
07-05-2025,"Grains, Flours & Dals",BAJRA 1 KG,4,60,50,10,1
07-05-2025,Snacks & Ready-to-Eat,GROUNDNUT LADDU WITH DATES,14,135,135,0,1
07-05-2025,Snacks & Ready-to-Eat,MIGHTY PUFFS KHATTA METTA,14,25,25,0,1
07-05-2025,Snacks & Ready-to-Eat,BB VERMICELLI 1KG,14,95,90,5,1
07-05-2025,Snacks & Ready-to-Eat,KARIVEPAKU MUR,14,60,60,0,1
07-05-2025,"Grains, Flours & Dals",RAGI FLOUR 1KG,4,80,70,10,1
07-05-2025,"Health, Wellness & Ayurvedic Products",MAX PROTEIN PEANUT,5,175,175,0,1
07-05-2025,"Grains, Flours & Dals",Wheat Rava M 1KG,4,65,55,10,1
07-05-2025,"Grains, Flours & Dals",Bombay Rava 500GM,4,35,30,5,1
07-05-2025,Sweeteners,SUGAR 1KG,16,180,168,12,3
07-05-2025,"Grains, Flours & Dals",SRILATHA RICE RAVVA 500GM,4,35,35,0,1
07-05-2025,"Grains, Flours & Dals",turdal 1kg,4,660,510,150,3
07-05-2025,"Grains, Flours & Dals",PESARA PAPPU 500GMS,4,85,75,10,1
07-05-2025,Snacks & Ready-to-Eat,ELITE ELAICHI RUSK 200GM,14,35,35,0,1
07-05-2025,"Dry Fruits, Nuts & Seeds",Groundnuts 500 gms,2,95,85,10,1
07-05-2025,"Grains, Flours & Dals",CHANA DAL 500GM,4,56,48,8,1
07-05-2025,Spices & Seasonings,MTR SAMBAR POW 100GM,15,76,76,0,1
07-05-2025,Spices & Seasonings,DRY MIECHI 200GM,15,80,60,20,1
07-05-2025,Snacks & Ready-to-Eat,VD Pappu Chekkalu 190gm,14,120,120,0,2
07-05-2025,Snacks & Ready-to-Eat,VD PAPPU CHEGODI 200GM,14,60,60,0,1
07-05-2025,"Grains, Flours & Dals",Sathya Javva Wheat Rava 500GM,4,95,95,0,1
07-05-2025,"Grains, Flours & Dals",Multigrain 1 kg,4,200,170,30,2
07-05-2025,Oils & Ghee,Groundnut oil 1 L,9,330,330,0,1
07-05-2025,"Grains, Flours & Dals",SL Idly Rava 1KG,4,65,55,10,1
07-05-2025,Oils & Ghee,Groundnut oil 1 L,9,990,990,0,3
07-05-2025,Sweeteners,NATURAL HONEY 1KG,16,560,480,80,1
07-05-2025,"Grains, Flours & Dals",CHANA DAL 1KG,4,112,96,16,1
07-05-2025,"Grains, Flours & Dals",SABDANA 500GM,4,90,70,20,1
07-05-2025,"Grains, Flours & Dals",Wheat Flour 1 kg,4,70,60,10,1
07-05-2025,Spices & Seasonings,JEERA 250 gms,15,125,105,20,1
07-05-2025,Sweeteners,mishri 500g,16,70,60,10,1
07-05-2025,Spices & Seasonings,Turmeric powder 250 gms,15,100,80,20,1
07-05-2025,Pooja & Spiritual Items,GD Dhoop Sticks 26GM,12,20,20,0,1
07-05-2025,Spices & Seasonings,Black Till 250GM,15,90,75,15,1
07-05-2025,Snacks & Ready-to-Eat,PEANUT CHIKKI 450GM,14,125,125,0,1
07-05-2025,"Health, Wellness & Ayurvedic Products",HARITHAKI CHOORNAM,5,80,80,0,1
07-05-2025,Oils & Ghee,Groundnut oil 1 L,9,330,330,0,1
07-05-2025,Household & Cleaning,ROOPERI PITAMBARI SILVER 50ML,6,110,110,0,1
07-05-2025,"Grains, Flours & Dals",RAGI FLOUR 500GRMS,4,40,35,5,1
07-05-2025,"Health, Wellness & Ayurvedic Products",MD Aamlaki Choornam 100GM,5,80,80,0,1
07-05-2025,"Health, Wellness & Ayurvedic Products",MD Mandara Leaf Powder 50GM,5,100,100,0,1
07-05-2025,Spices & Seasonings,YB PINK ROCK SALT 1KG,15,120,120,0,1
07-05-2025,"Grains, Flours & Dals",Wheat Flour 1 kg,4,280,240,40,4
07-05-2025,"Grains, Flours & Dals",RAGI FLOUR 500GRMS,4,40,35,5,1
07-05-2025,"Grains, Flours & Dals",Chana Flour 500 gms,4,140,110,30,1
07-05-2025,Milk & Dairy,SANGAM TONED MILK 500ML,7,31,31,0,1
07-05-2025,Spices & Seasonings,Masala Karam 250 gms,15,130,120,10,1
07-05-2025,Spices & Seasonings,MASALA KAR 500GMS,15,260,240,20,1
07-05-2025,Snacks & Ready-to-Eat,NGT CHATPATTA CHANA 90GM,14,25,25,0,1
07-05-2025,"Grains, Flours & Dals",Quinova 1 kg,4,660,585,75,3
07-05-2025,"Grains, Flours & Dals",Sathya Javva Wheat Rava 500GM,4,190,190,0,2
07-05-2025,"Grains, Flours & Dals",Multigrain 1 kg,4,200,170,30,2
07-05-2025,Oils & Ghee,GANTASALA A2 COW GHEE 250ML,9,299,299,0,1
07-05-2025,Snacks & Ready-to-Eat,NGT CHATPATTA CHANA 90GM,14,50,50,0,2
07-05-2025,"Grains, Flours & Dals",Wheat Flour 1 kg,4,140,120,20,2
07-05-2025,Spices & Seasonings,Elaichi 25GM,15,290,240,50,2
07-05-2025,Spices & Seasonings,Vamu 100GM,15,60,50,10,1
07-05-2025,Snacks & Ready-to-Eat,SD FLAX SEED APPADALU,14,90,90,0,1
07-05-2025,Spices & Seasonings,Turmeric powder 250 gms,15,100,80,20,1
07-05-2025,"Grains, Flours & Dals",White jowar.F 1 kg,4,200,160,40,2
07-05-2025,"Grains, Flours & Dals",Brown RICE 1KG,4,350,325,25,5
07-05-2025,Spices & Seasonings,JEERA 250 gms,15,125,105,20,1
07-05-2025,Snacks & Ready-to-Eat,SD Aswagandha with palm Jaggery250Gm,14,135,135,0,1
07-05-2025,Oils & Ghee,sesame oil 1L,9,1180,"1,120.00",60,2
07-05-2025,Spices & Seasonings,Tamalapaku Karam Powder 100GM,15,80,80,0,1
07-05-2025,Spices & Seasonings,AVALU 250grms,15,60,60,0,1
07-05-2025,Spices & Seasonings,ROYAL SAFFRON,15,125,125,0,1
07-05-2025,Snacks & Ready-to-Eat,BB ROASTED VERMICELLY 850GM,14,117,117,0,1
07-05-2025,Spices & Seasonings,MASALA KAR 500GMS,15,260,240,20,1
07-05-2025,"Dry Fruits, Nuts & Seeds",FLAX SEEDS 250GM,2,60,50,10,1
07-05-2025,General Household & Kitchenware,IRN WDN HDL DOSA TAWA 11,3,245,245,0,1
07-05-2025,Sweeteners,MISHRI 250 GM,16,35,30,5,1
07-05-2025,Snacks & Ready-to-Eat,PEANUT CHIKKI 450GM,14,250,250,0,2
07-05-2025,Snacks & Ready-to-Eat,Pani Poori Chips 250GM,14,50,40,10,1
07-05-2025,Oils & Ghee,sesame oil 1L,9,590,560,30,1
07-05-2025,Oils & Ghee,Safflower oil 1 L,9,400,400,0,1
07-05-2025,Milk & Dairy,BROWN EGGS 1P,7,168,144,24,12
07-05-2025,"Grains, Flours & Dals",RAGI FLOUR 500GRMS,4,40,35,5,1
07-05-2025,Household & Cleaning,SURFEXCEL BAR 80G,6,30,30,0,3
07-05-2025,Personal Care & Cosmetics,GAYATHRI KUMKUDUKAYA,10,300,300,0,2
07-05-2025,"Grains, Flours & Dals",HS JOWAR IDLY RAWA,4,65,65,0,1
07-05-2025,Sweeteners,YB JAGGERY POWDER 500GMS,16,75,75,0,1
07-05-2025,"Grains, Flours & Dals",SRILATHA RICE RAVVA 500GM,4,35,35,0,1
07-05-2025,Spices & Seasonings,SV Sambar Powder 100GM,15,80,80,0,1
07-05-2025,Oils & Ghee,Groundnut oil 1 L,9,330,330,0,1
07-05-2025,"Grains, Flours & Dals",EM Ragi upma R 500g,4,75,75,0,1
07-05-2025,Oils & Ghee,sesame oil 1L,9,590,560,30,1
07-05-2025,"Grains, Flours & Dals",White jowar.F 1 kg,4,100,80,20,1
07-05-2025,Spices & Seasonings,ROYAL SAFFRON 400GRMS,15,130,130,0,2
07-05-2025,Household & Cleaning,vim pudina fresh,6,20,20,0,2
07-05-2025,"Grains, Flours & Dals",Quinova 500 gms,4,110,100,10,1
07-05-2025,"Grains, Flours & Dals",AISHWARYA SP 1KG,4,800,700,100,10
07-05-2025,"Grains, Flours & Dals",HEALTH JOWAR RAWA,4,99,99,0,1
07-05-2025,"Grains, Flours & Dals",SH KABULI CHANA,4,180,180,0,1
07-05-2025,"Dry Fruits, Nuts & Seeds",KAJU HALF 250GM,2,620,580,40,2
07-05-2025,"Grains, Flours & Dals",samalu,4,130,130,0,1
07-05-2025,Sweeteners,MISHRI 250 GM,16,70,60,10,2
07-05-2025,Oils & Ghee,sesame oil 1L,9,590,560,30,1
07-05-2025,"Grains, Flours & Dals",RED TUDAL 1KG,4,150,140,10,1
07-05-2025,Spices & Seasonings,Elaichi 25GM,15,145,120,25,1
07-05-2025,"Grains, Flours & Dals",RAGI FLOUR 500GRMS,4,40,35,5,1
07-05-2025,Snacks & Ready-to-Eat,Corn Chips 250GM,14,40,35,5,1
07-05-2025,"Grains, Flours & Dals",SA Sprouted Ragi Flour 500GM,4,69,69,0,1
07-05-2025,Sweeteners,SD PALM JAGGERY 500GM,16,200,200,0,1
07-05-2025,Spices & Seasonings,SH MUSTARD 100GM,15,30,30,0,1
07-05-2025,"Grains, Flours & Dals",Chana Flour 500 gms,4,280,220,60,2
07-05-2025,"Grains, Flours & Dals",RICE FLOUR 500 GM,4,70,56,14,2
07-05-2025,Snacks & Ready-to-Eat,SAGOPAPAD RED CHILLI VD,14,55,55,0,1
07-05-2025,Milk & Dairy,BROWN EGGS TRAY 30P,7,360,330,30,1
07-05-2025,Oils & Ghee,Groundnut oil 5 L,9,1800,"1,600.00",200,1
07-05-2025,Snacks & Ready-to-Eat,RINGS 200GM,14,30,30,0,1
07-05-2025,Spices & Seasonings,Turmeric powder 250 gms,15,100,80,20,1
07-05-2025,Pooja & Spiritual Items,GB Bharatha Woods 75GM,12,60,60,0,1
07-05-2025,"Grains, Flours & Dals",RAGI FLOUR 500GRMS,4,80,70,10,2
07-05-2025,Snacks & Ready-to-Eat,GREEN FRIED BATANA,14,20,20,0,1
07-05-2025,Snacks & Ready-to-Eat,Sprouted Ragi Biscuits 450GM,14,150,150,0,1
07-05-2025,Spices & Seasonings,DURGA SALT CRYSTAL 1KG,15,84,84,0,3
07-05-2025,Spices & Seasonings,Menthulu 250 gms,15,50,45,5,1
07-05-2025,Spices & Seasonings,ROYAL SAFFRON 400GRMS,15,65,65,0,1
07-05-2025,Spices & Seasonings,MUSTARD POWDR 500G,15,260,220,40,2
07-05-2025,Spices & Seasonings,DURGA SALT CRYSTAL 1KG,15,28,28,0,1
07-05-2025,Oils & Ghee,Groundnut oil 1 L,9,330,330,0,1
07-05-2025,Snacks & Ready-to-Eat,BELLAM MINAPA SUNADULLU,14,180,180,0,1
07-05-2025,"Grains, Flours & Dals",Wheat Flour 1 kg,4,70,60,10,1
07-05-2025,Oils & Ghee,Coconut oil 500 ml,9,220,200,20,1
07-05-2025,Snacks & Ready-to-Eat,SIRI ICE CREAM 100ML,14,200,160,40,2
07-05-2025,Oils & Ghee,sesame oil 1L,9,590,560,30,1
07-05-2025,Milk & Dairy,BROWN EGGS TRAY 30P,7,360,330,30,1
07-05-2025,Oils & Ghee,Groundnut oil 1 L,9,330,330,0,1
07-05-2025,Spices & Seasonings,THREE MANGO RAI 200G,15,126,126,0,3
07-05-2025,Pickles & Cooking Pastes,DURGA BRAND TM PICKLES SPECIAL,11,56,56,0,2
07-05-2025,Spices & Seasonings,3M.MIRCHI POWDER,15,720,640,80,2
07-05-2025,Pickles & Cooking Pastes,DURGA BRAND TM PICKLES SPECIAL,11,28,28,0,1
07-05-2025,"Grains, Flours & Dals",SB Javva Wheat Ravva 500GM,4,190,190,0,2
07-05-2025,"Grains, Flours & Dals",SH TUR DAL 500GM,4,175,175,0,1
07-05-2025,Sweeteners,SH KHANDSARI SUGAR 500GM,16,80,80,0,1
07-05-2025,"Grains, Flours & Dals",White jowar.F 1 kg,4,100,80,20,1
07-05-2025,"Grains, Flours & Dals",RAGI FLOUR 500GRMS,4,80,70,10,2
07-05-2025,"Grains, Flours & Dals",Wheat Flour 1 kg,4,210,180,30,3
07-05-2025,Spices & Seasonings,LG 50GM,15,92,92,0,1
07-05-2025,Oils & Ghee,Safflower oil 1 L,9,800,800,0,2
07-05-2025,Oils & Ghee,Groundnut oil 1 L,9,660,660,0,2
07-05-2025,Oils & Ghee,sesame oil 1L,9,3540,"3,360.00",180,6
07-05-2025,Snacks & Ready-to-Eat,SIRI ICE CREAM 100ML,14,100,80,20,1
07-05-2025,Milk & Dairy,BROWN EGGS 1P,7,84,72,12,6
07-05-2025,"Grains, Flours & Dals",BAJRA 1 KG,4,30,25,5,0.5
07-05-2025,Snacks & Ready-to-Eat,RAGI GAVVALU,14,60,60,0,1
07-05-2025,Snacks & Ready-to-Eat,SOYA MURK,14,60,60,0,1
07-05-2025,Snacks & Ready-to-Eat,VD Pappu Chekkalu 190gm,14,60,60,0,1
07-05-2025,Oils & Ghee,Groundnut oil 1 L,9,330,330,0,1
07-05-2025,"Grains, Flours & Dals",Wheat Rava M 1KG,4,65,55,10,1
07-05-2025,Personal Care & Cosmetics,SVE KHADI RED ONION SHAMPOO,10,398,398,0,2
07-05-2025,Snacks & Ready-to-Eat,VD MULTI CHAKKA,14,110,110,0,1
07-05-2025,"Grains, Flours & Dals",RAGI FLOUR 500GRMS,4,40,35,5,1
07-05-2025,Pooja & Spiritual Items,deep jyothi deepam oil 1000ml,12,198,198,0,1
07-05-2025,"Dry Fruits, Nuts & Seeds",PULMAKHANA 100 GM,2,360,340,20,2
07-05-2025,"Grains, Flours & Dals",KORRALU (FOXTAIL M) 500GM,4,65,55,10,1
07-05-2025,Snacks & Ready-to-Eat,JONNA RIBAN,14,60,60,0,1
07-05-2025,"Grains, Flours & Dals",BAJRA 1 KG,4,60,50,10,1
07-05-2025,Snacks & Ready-to-Eat,RAJGIRA PEANUT CHIKKI 450GM,14,125,125,0,1
07-05-2025,Snacks & Ready-to-Eat,JONNA RIBAN,14,60,60,0,1
07-05-2025,Spices & Seasonings,AVALU 100GM,15,25,20,5,1
07-05-2025,Snacks & Ready-to-Eat,SD Aswagandha with palm Jaggery250Gm,14,135,135,0,1
07-05-2025,"Health, Wellness & Ayurvedic Products",MH Millets Malt 500GM,5,200,190,10,1
07-05-2025,Snacks & Ready-to-Eat,KARIVEPAKU MUR,14,60,60,0,1
07-05-2025,"Grains, Flours & Dals",Multigrain 1 kg,4,100,85,15,1
07-05-2025,Milk & Dairy,BROWN EGGS 1P,7,140,120,20,10
07-05-2025,Snacks & Ready-to-Eat,VD MURUKU 175GM,14,60,60,0,1
07-05-2025,"Grains, Flours & Dals",Wheat Flour 1 kg,4,70,60,10,1
07-05-2025,Misc,VD00014,8,100,90,10,1
07-05-2025,Sweeteners,ACHU BELLAM 1KG,16,100,80,20,1
07-05-2025,Household & Cleaning,vim pudina fresh,6,20,20,0,2
07-05-2025,Oils & Ghee,rice bran oil f,9,194,169,25,1
07-05-2025,Snacks & Ready-to-Eat,VD PALLI CHIKKI,14,80,80,0,1
07-05-2025,Snacks & Ready-to-Eat,VD PAPPU CHEGODI 200GM,14,60,60,0,1
07-05-2025,Snacks & Ready-to-Eat,VD NUVULLU CHIKKI,14,80,80,0,1
07-05-2025,Snacks & Ready-to-Eat,VD GUMMADI CHAKKA,14,130,130,0,1
07-05-2025,Snacks & Ready-to-Eat,VD MURUKU 175GM,14,120,120,0,2
07-05-2025,Misc,VD00014,8,100,90,10,1
07-05-2025,Milk & Dairy,BROWN EGGS 1P,7,168,144,24,12
07-05-2025,Snacks & Ready-to-Eat,VD MURMURA LADDU,14,50,50,0,1
07-05-2025,Snacks & Ready-to-Eat,SD FINGER Millet with palm Jaggery 250gm,14,135,135,0,1
07-05-2025,"Grains, Flours & Dals",SL Idly Rava 1KG,4,130,110,20,2
07-05-2025,"Grains, Flours & Dals",VGR RICE bag 1,4,1899,"1,650.00",249,1
07-05-2025,"Dry Fruits, Nuts & Seeds",Groundnuts 1 kg,2,380,330,50,2
07-05-2025,"Grains, Flours & Dals",Urad dall 1 Kg,4,370,340,30,2
07-05-2025,"Dry Fruits, Nuts & Seeds",PUTNALU 500GMS,2,90,76,14,1
07-05-2025,"Grains, Flours & Dals",Wheat Flour 1 kg,4,140,120,20,2
07-05-2025,"Dry Fruits, Nuts & Seeds",Groundnuts 1 kg,2,380,330,50,2
07-05-2025,"Grains, Flours & Dals",UDALU (Barnyard millet) 1 kg,4,560,460,100,4
07-05-2025,"Grains, Flours & Dals",yellow jowar flour 1kg,4,200,184,16,2
07-05-2025,"Grains, Flours & Dals",Brown RICE 1KG,4,140,130,10,2
07-05-2025,"Grains, Flours & Dals",AISHWARYA SP 25KG,4,3998,"3,380.00",618,2
07-05-2025,Oils & Ghee,sesame oil 1L,9,590,560,30,1
07-05-2025,Oils & Ghee,Groundnut oil 1 L,9,330,330,0,1
07-05-2025,"Dry Fruits, Nuts & Seeds",Putnalu 250GM,2,45,38,7,1
07-05-2025,Spices & Seasonings,Tamarind 250GMS,15,80,65,15,1
07-05-2025,Snacks & Ready-to-Eat,VD CORNFLAKES MIXTURE 175GM,14,60,60,0,1
07-05-2025,"Grains, Flours & Dals",UNPOLISHED TURDALL 1KG,4,240,210,30,1
07-05-2025,Snacks & Ready-to-Eat,VD CORNFLAKES MIXTURE 175GM,14,60,60,0,1
07-05-2025,Snacks & Ready-to-Eat,SD JOWAR WITH PALM JAGGERY 250GM,14,135,135,0,1
07-05-2025,Snacks & Ready-to-Eat,VD BOONDI 175GM,14,60,60,0,1
07-05-2025,Sweeteners,YB JAGGERY POWDER 1KG,16,140,140,0,1
07-05-2025,Snacks & Ready-to-Eat,GROUNDNUT LADDU WITH DATES,14,135,135,0,1
07-05-2025,Sweeteners,PN ORGANIC BROWN SUGAR 500GM,16,78,78,0,1
07-05-2025,"Grains, Flours & Dals",RAGI FLOUR 500GRMS,4,40,35,5,1
07-05-2025,"Grains, Flours & Dals",BARLEY SEEDS 500 GM,4,90,70,20,1
07-05-2025,"Grains, Flours & Dals",AISHWARYA SP 25KG,4,1999,"1,690.00",309,1
07-05-2025,Oils & Ghee,Groundnut oil 1 L,9,330,330,0,1
07-05-2025,"Grains, Flours & Dals",Em Little idli R 500g,4,129,129,0,1
07-05-2025,Oils & Ghee,Groundnut oil 1 L,9,660,660,0,2
07-05-2025,Spices & Seasonings,Coriander seeds 200 gms,15,48,40,8,1
07-05-2025,Spices & Seasonings,ROYAL SAFFRON 400GRMS,15,65,65,0,1
07-05-2025,"Grains, Flours & Dals",AISHWARYA LOW GI RICE 5KG,4,700,525,175,1
07-05-2025,"Grains, Flours & Dals",turdal 1kg,4,440,340,100,2
07-05-2025,Oils & Ghee,Coconut oil 500 ml,9,220,200,20,1
07-05-2025,Spices & Seasonings,NUVVULU 500GM,15,160,130,30,1
07-05-2025,Spices & Seasonings,Vamu 100GM,15,60,50,10,1
07-05-2025,Spices & Seasonings,Telaga Pindi 250 GM,15,40,35,5,1
07-05-2025,"Grains, Flours & Dals",RAGI FLOUR 500GRMS,4,40,35,5,1
07-05-2025,Pooja & Spiritual Items,s karpuram,12,180,180,0,1
07-05-2025,"Grains, Flours & Dals",SRILATHA RICE RAVVA 500GM,4,70,70,0,2
07-05-2025,"Grains, Flours & Dals",SL Idly Rava 1KG,4,65,55,10,1
07-05-2025,Spices & Seasonings,ROYAL SAFFRON,15,250,250,0,2
07-05-2025,Pooja & Spiritual Items,kasturi b.,12,140,140,0,2
07-05-2025,"Grains, Flours & Dals",Wheat Rava S 500GM,4,66,60,6,2
07-05-2025,Oils & Ghee,Groundnut oil 1 L,9,330,330,0,1
07-05-2025,"Grains, Flours & Dals",RICE FLOUR 500 GM,4,35,28,7,1
07-05-2025,General Household & Kitchenware,MATCH BOX,3,40,40,0,4
07-05-2025,"Grains, Flours & Dals",CHANA DAL 1KG,4,112,96,16,1
07-05-2025,"Grains, Flours & Dals",CHANA DALL 250GM,4,28,24,4,1
07-05-2025,"Grains, Flours & Dals",MAIDA 1KG,4,70,60,10,1
07-05-2025,Spices & Seasonings,Coriander seeds 200 gms,15,48,40,8,1
07-05-2025,Pooja & Spiritual Items,GD TULASI 75GM,12,120,120,0,2
07-05-2025,"Grains, Flours & Dals",RED TUDAL 1KG,4,150,140,10,1
07-05-2025,"Grains, Flours & Dals",SPLIT BLACK GRAM 500 GM,4,90,85,5,1
07-05-2025,"Grains, Flours & Dals",PESARA PAPPU 1 KG,4,170,145,25,1
07-05-2025,"Grains, Flours & Dals",Red Chana 500 GM,4,75,60,15,1
07-05-2025,"Grains, Flours & Dals",Green gram 1 kg,4,150,130,20,1
07-05-2025,Spices & Seasonings,Menthulu 250 gms,15,50,45,5,1
07-05-2025,"Grains, Flours & Dals",SL Suji Rava 500GM,4,64,64,0,2
07-05-2025,Spices & Seasonings,Tamarind 500GM,15,160,130,30,1
07-05-2025,Sweeteners,organic jaggery powder,16,99,99,0,1
07-05-2025,"Dry Fruits, Nuts & Seeds",Groundnuts 1 kg,2,190,165,25,1
07-05-2025,Spices & Seasonings,DRY MIECHI 200GM,15,80,60,20,1
07-05-2025,"Dry Fruits, Nuts & Seeds",Groundnuts 1 kg,2,190,165,25,1
07-05-2025,"Grains, Flours & Dals",samalu,4,130,130,0,1
07-05-2025,"Grains, Flours & Dals",UDALU (Barnyard millet) 1 kg,4,140,115,25,1
07-05-2025,"Grains, Flours & Dals",RAGI FLOUR 1KG,4,80,70,10,1
07-05-2025,Milk & Dairy,BROWN EGGS 1P,7,84,72,12,6
07-05-2025,Oils & Ghee,Safflower oil 1 L,9,400,400,0,1
07-05-2025,Misc,ROLL D C,8,70,45,25,1
07-05-2025,"Dry Fruits, Nuts & Seeds",Putnalu 250GM,2,45,38,7,1
07-05-2025,"Grains, Flours & Dals",Chana Flour 500 gms,4,140,110,30,1
07-05-2025,Spices & Seasonings,BIRYANI LEAF 10GM,15,30,20,10,1
07-05-2025,Spices & Seasonings,Japatri 25GM,15,100,80,20,1
07-05-2025,Spices & Seasonings,SATHVI ANASAPUVUU 25GM,15,90,65,25,1
07-05-2025,Spices & Seasonings,ELACHI 25 GM,15,145,120,25,1
07-05-2025,Spices & Seasonings,SAJEERA,15,60,40,20,1
07-05-2025,"Grains, Flours & Dals",THICK POHA 500GM,4,40,35,5,1
07-05-2025,Milk & Dairy,SANGAM TONED MILK 500ML,7,31,31,0,1
07-05-2025,Sweeteners,ACHU BELLAM 1KG,16,100,80,20,1
07-05-2025,Sweeteners,YB FOREST H 250 GMS,16,180,180,0,1
07-05-2025,Milk & Dairy,BROWN EGGS TRAY 30P,7,360,330,30,1
07-05-2025,Snacks & Ready-to-Eat,MILLET NOODLES CURRY MASALA,14,129,129,0,1
06-05-2025,Oils & Ghee,Coconut oil 500 ml,9,220,200,20,1
06-05-2025,"Grains, Flours & Dals",HS JOWAR IDLY RAWA,4,65,65,0,1
06-05-2025,"Grains, Flours & Dals",Urad dall 1 Kg,4,185,170,15,1
06-05-2025,Spices & Seasonings,sf jeera,15,120,120,0,1
06-05-2025,Snacks & Ready-to-Eat,BROWN BREAD,14,55,55,0,1
06-05-2025,Snacks & Ready-to-Eat,BB ROASTED VERMICELLY 500GM,14,70,70,0,1
06-05-2025,Snacks & Ready-to-Eat,BB ROASTED VERMICELLY 500GM,14,70,70,0,1
06-05-2025,Snacks & Ready-to-Eat,BROWN BREAD,14,55,55,0,1
06-05-2025,"Grains, Flours & Dals",PRO SOYA CHUNKS 200G,4,79,79,0,1
06-05-2025,Oils & Ghee,Coconut oil 500 ml,9,220,200,20,1
06-05-2025,"Grains, Flours & Dals",PRO ORG RED POHA 500GM,4,89,89,0,1
06-05-2025,"Grains, Flours & Dals",HS JOWAR IDLY RAWA,4,65,65,0,1
06-05-2025,"Dry Fruits, Nuts & Seeds",PULMAKHANA 100 GM,2,180,170,10,1
06-05-2025,General Household & Kitchenware,WOODEN SPOON SMALL,3,15,15,0,1
06-05-2025,Oils & Ghee,Safflower oil 500 ml,9,220,200,20,1
06-05-2025,"Grains, Flours & Dals",Urad dall 1 Kg,4,185,170,15,1
06-05-2025,"Dry Fruits, Nuts & Seeds",Groundnuts 500 gms,2,95,85,10,1
06-05-2025,Spices & Seasonings,JEERA 250 gms,15,125,105,20,1
06-05-2025,Spices & Seasonings,RED COPRA 250GMS,15,85,74,11,1
06-05-2025,Spices & Seasonings,GS Pink Rock Salt 1KG,15,120,120,0,1
06-05-2025,"Grains, Flours & Dals",EM Ragi idli R 500G,4,75,75,0,1
06-05-2025,"Grains, Flours & Dals",PESARA PAPPU 500GMS,4,85,75,10,1
06-05-2025,Baking & Cooking Aids,GONDKATIRA Ag,0,85,75,10,1
06-05-2025,"Grains, Flours & Dals",JOWAR UPMA RAVA,4,150,150,0,2
06-05-2025,"Grains, Flours & Dals",Wheat Rava S 1KG,4,65,55,10,1
06-05-2025,Spices & Seasonings,Jeera 100GM,15,50,45,5,1
06-05-2025,"Grains, Flours & Dals",turdal 1kg,4,660,510,150,3
06-05-2025,"Grains, Flours & Dals",BOMBAY RAVA,4,70,55,15,1
06-05-2025,Sweeteners,SUGAR 1KG,16,120,112,8,2
06-05-2025,Spices & Seasonings,pickle chili powder,15,180,165,15,1
06-05-2025,"Grains, Flours & Dals",RICE FLOUR 500 GM,4,35,28,7,1
06-05-2025,Sweeteners,MISHRI D,16,40,30,10,1
06-05-2025,Pooja & Spiritual Items,BALAJI BEL PHOOL DHOOP STICKS 10STK,12,70,70,0,1
06-05-2025,Personal Care & Cosmetics,GOW DURBAR 75G,10,30,30,0,1
06-05-2025,Snacks & Ready-to-Eat,Pani Poori Chips 250GM,14,50,40,10,1
06-05-2025,Sweeteners,YB Brown Sugar 500GM,16,140,140,0,2
06-05-2025,General Household & Kitchenware,chalk piece 1b,3,15,10,5,1
06-05-2025,"Grains, Flours & Dals",Urad dall 1 Kg,4,370,340,30,2
06-05-2025,"Dry Fruits, Nuts & Seeds",PUTNALU 500GMS,2,90,76,14,1
06-05-2025,"Grains, Flours & Dals",CHANA DAL 500GM,4,56,48,8,1
06-05-2025,"Dry Fruits, Nuts & Seeds",SABJA SEEDS,2,70,70,0,1
06-05-2025,"Grains, Flours & Dals",Green gram 1 kg,4,150,130,20,1
06-05-2025,Spices & Seasonings,MUSTARD POWDER 250G,15,65,55,10,1
06-05-2025,Personal Care & Cosmetics,DETTOL ORIGINAL,10,80,80,0,1
06-05-2025,"Dry Fruits, Nuts & Seeds",Groundnuts 500 gms,2,95,85,10,1
06-05-2025,Spices & Seasonings,DRY MIECHI 200GM,15,80,60,20,1
06-05-2025,Pooja & Spiritual Items,vibudhi,12,30,30,0,3
06-05-2025,Personal Care & Cosmetics,dettol,10,0,0,0,1
06-05-2025,"Grains, Flours & Dals",SPLIT URAD DHAL,4,80,80,0,1
06-05-2025,Spices & Seasonings,Turmeric powder 250 gms,15,100,80,20,1
06-05-2025,"Grains, Flours & Dals",BARLEY SEEDS 250GMS,4,40,35,5,1
06-05-2025,Pooja & Spiritual Items,GD Sambrani Cup Dhoop 10 PC,12,96,96,0,1
06-05-2025,Snacks & Ready-to-Eat,VD MINAPA VADIYAM,14,65,65,0,1
06-05-2025,Snacks & Ready-to-Eat,VD GUMMADI VADIYAM,14,75,75,0,1
06-05-2025,Snacks & Ready-to-Eat,BLACK PEPPER RICEPAPAD VD,14,50,50,0,1
06-05-2025,Snacks & Ready-to-Eat,SAGOPAPAD GREEN CHILLI VD,14,55,55,0,1
06-05-2025,Oils & Ghee,Groundnut oil 1 L,9,660,660,0,2
06-05-2025,Snacks & Ready-to-Eat,MIGHTY PUFF,14,25,25,0,1
06-05-2025,"Dry Fruits, Nuts & Seeds",Groundnuts 500 gms,2,95,85,10,1
06-05-2025,"Grains, Flours & Dals",SL Suji Rava 500GM,4,32,32,0,1
06-05-2025,"Grains, Flours & Dals",turdal 500 gms,4,110,85,25,1
06-05-2025,Personal Care & Cosmetics,SOFTTOUCH 2X FRENCH PERFUME,10,58,58,0,1
06-05-2025,Sweeteners,sugar 500 gms,16,30,28,2,1
06-05-2025,Personal Care & Cosmetics,DWI FOOT CARE 30G,10,90,90,0,1
06-05-2025,"Grains, Flours & Dals",SRILATHA RICE RAVVA 500GM,4,35,35,0,1
06-05-2025,Oils & Ghee,Coconut oil 500 ml,9,220,200,20,1
06-05-2025,"Dry Fruits, Nuts & Seeds",Putnalu 250GM,2,45,38,7,1
06-05-2025,Pooja & Spiritual Items,BALAJI BEL PHOOL STICKS 90GM,12,60,60,0,1
06-05-2025,"Grains, Flours & Dals",Wheat Flour 1 kg,4,70,60,10,1
06-05-2025,"Grains, Flours & Dals",chana flour 500 gms,4,60,54,6,1
06-05-2025,"Grains, Flours & Dals",Wheat Flour 1 kg,4,140,120,20,2
06-05-2025,"Grains, Flours & Dals",Wheat Rava S 1KG,4,65,55,10,1
06-05-2025,Snacks & Ready-to-Eat,RI SPORTS BAR 40G,14,45,45,0,1
06-05-2025,"Grains, Flours & Dals",SL Idly Rava 1KG,4,65,55,10,1
06-05-2025,Oils & Ghee,Groundnut oil 1 L,9,330,330,0,1
06-05-2025,"Dry Fruits, Nuts & Seeds",wallnuts,2,380,320,60,1
06-05-2025,Personal Care & Cosmetics,HERBAL LAVENDER 250ML,10,225,225,0,1
06-05-2025,Pickles & Cooking Pastes,DURGA BRAND TM PICKLES SPECIAL,11,28,28,0,1
06-05-2025,Spices & Seasonings,SAMBAR POWDER 200GM,15,130,110,20,1
06-05-2025,"Dry Fruits, Nuts & Seeds",Groundnuts 500 gms,2,95,85,10,1
06-05-2025,"Grains, Flours & Dals",VGR rice 1 kg,4,140,130,10,2
06-05-2025,Snacks & Ready-to-Eat,VD BOONDI 175GM,14,60,60,0,1
06-05-2025,Snacks & Ready-to-Eat,JONNA RIBAN,14,60,60,0,1
06-05-2025,Oils & Ghee,Safflower oil 500 ml,9,220,200,20,1
06-05-2025,Oils & Ghee,Sesame oil 500ml,9,295,280,15,1
06-05-2025,Snacks & Ready-to-Eat,VD BELLAM GAVVALU 200GM,14,60,60,0,1
06-05-2025,Oils & Ghee,Coconut oil 1 L,9,880,800,80,2
06-05-2025,Beverages,REFRESH SHARBATH SUGAR FREE,1,299,285,14,1
06-05-2025,"Grains, Flours & Dals",RAJMA 250GM,4,55,45,10,1
06-05-2025,Snacks & Ready-to-Eat,VD NUVULU CHEGODI 175GM,14,60,60,0,1
06-05-2025,Snacks & Ready-to-Eat,GROUNDNUT LADDU WITH DATES,14,135,135,0,1
06-05-2025,Snacks & Ready-to-Eat,ragi chegodi,14,60,60,0,1
06-05-2025,Snacks & Ready-to-Eat,VD Pappu Chekkalu 190gm,14,60,60,0,1
06-05-2025,Snacks & Ready-to-Eat,BEETROOT MURK,14,60,60,0,1
06-05-2025,"Grains, Flours & Dals",white Bobarlu 500 gms,4,80,75,5,1
06-05-2025,"Grains, Flours & Dals",MAAGAANI LOW GI SP L 1KG,4,360,315,45,3
06-05-2025,Personal Care & Cosmetics,GOW DURBAR 75G,10,125,125,0,1
06-05-2025,Pooja & Spiritual Items,BALAJI BEL PHOOL DHOOP STICKS 10STK,12,70,70,0,1
06-05-2025,"Grains, Flours & Dals",Wheat Rava M 1KG,4,65,55,10,1
06-05-2025,"Grains, Flours & Dals",Bombay Rava 500GM,4,35,30,5,1
06-05-2025,"Grains, Flours & Dals",SL Idly Rava 1KG,4,65,55,10,1
06-05-2025,"Grains, Flours & Dals",RICE FLOUR 1KG,4,70,55,15,1
06-05-2025,"Grains, Flours & Dals",PESARA PAPPU 500GMS,4,85,75,10,1
06-05-2025,"Grains, Flours & Dals",THICK POHA 500GM,4,40,35,5,1
06-05-2025,"Grains, Flours & Dals",THICK POHA 1KG,4,80,70,10,1
06-05-2025,"Grains, Flours & Dals",BOMBAY RAVA,4,70,55,15,1
06-05-2025,"Grains, Flours & Dals",Wheat Flour 1 kg,4,140,120,20,2
06-05-2025,"Dry Fruits, Nuts & Seeds",Putnalu 250GM,2,45,38,7,1
06-05-2025,"Health, Wellness & Ayurvedic Products",MXP CREAM ONION,5,45,45,0,1
06-05-2025,"Dry Fruits, Nuts & Seeds",Groundnuts 1 kg,2,190,165,25,1
06-05-2025,"Grains, Flours & Dals",turdal 500 gms,4,220,170,50,2
06-05-2025,"Grains, Flours & Dals",CHANA DAL 500GM,4,56,48,8,1
06-05-2025,"Grains, Flours & Dals",Urad dall 1 Kg,4,185,170,15,1
06-05-2025,Oils & Ghee,sesame oil 1L,9,590,560,30,1
06-05-2025,Spices & Seasonings,telaga pindi,15,70,70,0,1
06-05-2025,"Grains, Flours & Dals",SL Idly Rava 1KG,4,130,110,20,2
06-05-2025,Spices & Seasonings,FLAXSEED KARAM,15,75,75,0,1
06-05-2025,"Grains, Flours & Dals",turdal 1kg,4,220,170,50,1
06-05-2025,"Grains, Flours & Dals",DH URAD GOTA 1KG,4,215,190,25,1
06-05-2025,Spices & Seasonings,SD Redgram Karam Powder 100GM,15,65,65,0,1
06-05-2025,"Grains, Flours & Dals",turdal 1kg,4,220,170,50,1
06-05-2025,Spices & Seasonings,JEERA 250 gms,15,125,105,20,1
06-05-2025,Spices & Seasonings,RED COPRA 250GMS,15,85,74,11,1
06-05-2025,"Grains, Flours & Dals",Urad dall 1 Kg,4,185,170,15,1
06-05-2025,"Grains, Flours & Dals",SL Idly Rava 1KG,4,65,55,10,1
06-05-2025,Sweeteners,YB FOREST H 250 GMS,16,180,180,0,1
06-05-2025,Snacks & Ready-to-Eat,SIRI ICE CREAM 100ML,14,100,80,20,1
06-05-2025,"Grains, Flours & Dals",SA Sprouted Ragi Flour 500GM,4,69,69,0,1
06-05-2025,Spices & Seasonings,Masala Karam 250 gms,15,130,120,10,1
06-05-2025,"Health, Wellness & Ayurvedic Products",MH Millets Malt 1KG,5,400,380,20,1
06-05-2025,Household & Cleaning,ROOPERI PITAMBARI SILVER 50ML,6,110,110,0,1
06-05-2025,Pooja & Spiritual Items,VRP APOORVA JAVADHU POW,12,105,105,0,3
06-05-2025,Pooja & Spiritual Items,javadhu,12,120,120,0,1
06-05-2025,"Dry Fruits, Nuts & Seeds",SABJA SEEDS,2,70,70,0,1
06-05-2025,"Dry Fruits, Nuts & Seeds",SABJA SEEDS,2,70,70,0,1
06-05-2025,Oils & Ghee,Groundnut oil 1 L,9,660,660,0,2
06-05-2025,Oils & Ghee,Groundnut oil 1 L,9,660,660,0,2
06-05-2025,Milk & Dairy,BUTTER MILK,7,10,10,0,1
06-05-2025,"Grains, Flours & Dals",RAGI FLOUR 500GRMS,4,40,35,5,1
06-05-2025,"Grains, Flours & Dals",BAJRA 1 KG,4,60,50,10,1
06-05-2025,"Grains, Flours & Dals",KORRALU (FOXTAIL M) 1KG,4,150,110,40,1
06-05-2025,"Grains, Flours & Dals",WHEAT 1 KG,4,240,200,40,4
06-05-2025,"Grains, Flours & Dals",FLOUR CHARGE,4,48,48,0,4
06-05-2025,"Dry Fruits, Nuts & Seeds",Groundnuts 500 gms,2,95,85,10,1
06-05-2025,Spices & Seasonings,Coriander seeds 200 gms,15,48,40,8,1
06-05-2025,Snacks & Ready-to-Eat,VD PALLI LADDU,14,80,80,0,1
06-05-2025,Snacks & Ready-to-Eat,VD MINAPA VADIYAM,14,65,65,0,1
06-05-2025,Spices & Seasonings,PN ORGANIC PINK SALT 1KG,15,124,124,0,1
06-05-2025,Oils & Ghee,Groundnut oil 500ml,9,180,165,15,1
06-05-2025,Misc,VD00014,8,100,90,10,1
06-05-2025,"Grains, Flours & Dals",Green gram 500 gms,4,75,70,5,1
06-05-2025,"Dry Fruits, Nuts & Seeds",Putnalu 250GM,2,90,76,14,2
06-05-2025,Oils & Ghee,Coconut oil 500 ml,9,220,200,20,1
06-05-2025,Household & Cleaning,LIZOL JASMINE 200ML,6,48,48,0,1
06-05-2025,General Household & Kitchenware,ODONIL JASMINE FRESH 150ML,3,120,120,0,1
06-05-2025,Snacks & Ready-to-Eat,RINGS 200GM,14,10,10,0,1
06-05-2025,General Household & Kitchenware,MATCH BOX,3,10,10,0,1
06-05-2025,Spices & Seasonings,AVALU 250grms,15,60,60,0,1
06-05-2025,Sweeteners,SUGAR 1KG,16,60,56,4,1
06-05-2025,Spices & Seasonings,AV Iodized Salt 1KG,15,30,30,0,1
06-05-2025,"Grains, Flours & Dals",KORRALU (FOXTAIL M) 1KG,4,150,110,40,1
06-05-2025,"Grains, Flours & Dals",Wheat Rava M 1KG,4,195,165,30,3
06-05-2025,Household & Cleaning,HARPIC 200ML,6,46,46,0,1
06-05-2025,Household & Cleaning,LIZOL 200ML,6,45,45,0,1
06-05-2025,"Grains, Flours & Dals",RAGI FLOUR 1KG,4,160,140,20,2
06-05-2025,Household & Cleaning,vim small,6,30,30,0,2
06-05-2025,"Grains, Flours & Dals",Green gram 500 gms,4,75,70,5,1
06-05-2025,"Grains, Flours & Dals",White Chana 250 GM,4,60,50,10,1
06-05-2025,"Grains, Flours & Dals",turdal 1kg,4,440,340,100,2
06-05-2025,"Grains, Flours & Dals",idly rava 1kg,4,60,50,10,1
06-05-2025,Household & Cleaning,TIDE MATIC TL 850ML,6,30,30,0,3
06-05-2025,Spices & Seasonings,NUVVULU 250GM,15,80,65,15,1
06-05-2025,"Grains, Flours & Dals",BOMBAY RAVA,4,140,110,30,2
06-05-2025,"Grains, Flours & Dals",Red Chana 500 GM,4,75,60,15,1
06-05-2025,Spices & Seasonings,DRY MIECHI 200GM,15,80,60,20,1
06-05-2025,"Grains, Flours & Dals",Urad dall 1 Kg,4,370,340,30,2
06-05-2025,Pooja & Spiritual Items,GD Dhoop Sticks 26GM,12,20,20,0,1
06-05-2025,Spices & Seasonings,Tamarind 500GM,15,160,130,30,1
06-05-2025,"Dry Fruits, Nuts & Seeds",Groundnuts 1 kg,2,380,330,50,2
06-05-2025,Spices & Seasonings,JEERA 250 gms,15,125,105,20,1
06-05-2025,Spices & Seasonings,Coriander seeds 200 gms,15,48,40,8,1
06-05-2025,"Dry Fruits, Nuts & Seeds",PUTNALU 500GMS,2,270,228,42,3
06-05-2025,Snacks & Ready-to-Eat,VD PALLI LADDU,14,160,160,0,2
06-05-2025,"Grains, Flours & Dals",Chittimuthaylu rice 1 kg,4,160,140,20,1
06-05-2025,Oils & Ghee,Groundnut oil 1 L,9,330,330,0,1
06-05-2025,Snacks & Ready-to-Eat,NGT CHATPATTA CHANA 90GM,14,75,75,0,3
06-05-2025,"Health, Wellness & Ayurvedic Products",RB Max Protein DESI MASALA 60gm,5,45,45,0,1
06-05-2025,Misc,VD00014,8,100,90,10,1
06-05-2025,"Grains, Flours & Dals",Green gram 500 gms,4,75,70,5,1
06-05-2025,Snacks & Ready-to-Eat,VD PALLI LADDU,14,80,80,0,1
06-05-2025,"Grains, Flours & Dals",samalu,4,130,130,0,1
06-05-2025,"Dry Fruits, Nuts & Seeds",Groundnuts 500 gms,2,95,85,10,1
06-05-2025,Snacks & Ready-to-Eat,GB SALT COOKIES,14,60,55,5,1
06-05-2025,"Grains, Flours & Dals",UDALU (Barnyard millet) 1 kg,4,140,115,25,1
06-05-2025,Oils & Ghee,sesame oil 1L,9,1770,"1,680.00",90,3
06-05-2025,"Dry Fruits, Nuts & Seeds",PULMAKHANA 100 GM,2,180,170,10,1
06-05-2025,"Grains, Flours & Dals",turdal 1kg,4,220,170,50,1
06-05-2025,Snacks & Ready-to-Eat,SIRI ICE CREAM 100ML,14,100,80,20,1
06-05-2025,"Health, Wellness & Ayurvedic Products",MXP CHOCO CLASSIC BAR,5,70,70,0,1
06-05-2025,"Grains, Flours & Dals",SB Javva Wheat Ravva 500GM,4,190,190,0,2
06-05-2025,"Grains, Flours & Dals",SL Idly Rava 1KG,4,130,110,20,2
06-05-2025,"Health, Wellness & Ayurvedic Products",MH Millets Milk Powder 250GM,5,250,250,0,1
06-05-2025,"Grains, Flours & Dals",split black gram 1 kg,4,360,340,20,2
06-05-2025,"Grains, Flours & Dals",turdal 500 gms,4,110,85,25,1
06-05-2025,"Grains, Flours & Dals",KORRALU (FOXTAIL M) 500GM,4,65,55,10,1
06-05-2025,Snacks & Ready-to-Eat,PN ORGANIC PUFFED RICE 200GM,14,55,55,0,1
06-05-2025,Snacks & Ready-to-Eat,RINGS 200GM,14,30,30,0,1
06-05-2025,General Household & Kitchenware,B3 BOWL,3,294,294,0,1
06-05-2025,"Grains, Flours & Dals",SAMALU (Little millet) 500 gms,4,85,65,20,1
06-05-2025,Oils & Ghee,Safflower oil 1 L,9,400,400,0,1
06-05-2025,"Grains, Flours & Dals",chana flour 500 gms,4,60,54,6,1
06-05-2025,Misc,C123,8,95,80,15,1
06-05-2025,Personal Care & Cosmetics,swastik gulab,10,145,145,0,1
06-05-2025,Spices & Seasonings,3M.MIRCHI POWDER,15,360,320,40,1
06-05-2025,Pickles & Cooking Pastes,DURGA BRAND TM PICKLES SPECIAL,11,28,28,0,1
06-05-2025,"Grains, Flours & Dals",RAGI FLOUR 1KG,4,80,70,10,1
06-05-2025,"Grains, Flours & Dals",White jowar.F 1 kg,4,100,80,20,1
06-05-2025,Oils & Ghee,Coconut oil 1 L,9,440,400,40,1
06-05-2025,Oils & Ghee,Safflower oil 1 L,9,400,400,0,1
06-05-2025,"Grains, Flours & Dals",yellow jowar flour 1kg,4,100,92,8,1
06-05-2025,Milk & Dairy,SANGAM TONED MILK 500ML,7,31,31,0,1
06-05-2025,Snacks & Ready-to-Eat,SD barnyard Millet with palm jaggery,14,135,135,0,1
06-05-2025,"Dry Fruits, Nuts & Seeds",PUMPKIN SEEDS 250GM,2,200,160,40,1
06-05-2025,"Dry Fruits, Nuts & Seeds",FLAX SEEDS 250GM,2,60,50,10,1
06-05-2025,"Dry Fruits, Nuts & Seeds",WATERMELON SEEDS 250GRM,2,320,280,40,1
06-05-2025,Spices & Seasonings,ROYAL SAFFRON 400GRMS,15,65,65,0,1
06-05-2025,Snacks & Ready-to-Eat,SD Bajra with palm Jaggery 250gm,14,135,135,0,1
06-05-2025,Spices & Seasonings,NUVVULU 250GM,15,80,65,15,1
06-05-2025,"Dry Fruits, Nuts & Seeds",SUNFLOWER SEEDS 250GRM,2,150,130,20,1
06-05-2025,"Dry Fruits, Nuts & Seeds",ANJEER 250GM,2,400,360,40,1
06-05-2025,"Grains, Flours & Dals",Green gram 500 gms,4,75,70,5,1
06-05-2025,Snacks & Ready-to-Eat,GREEN FRIED batana,14,20,20,0,1
06-05-2025,"Grains, Flours & Dals",KORRALU (FOXTAIL M) 500GM,4,65,55,10,1
06-05-2025,Snacks & Ready-to-Eat,GREEN FRIED batana,14,20,20,0,1
06-05-2025,Snacks & Ready-to-Eat,TILLI CHIKKI,14,10,10,0,2
06-05-2025,Snacks & Ready-to-Eat,RSC ORANGE 100GMS,14,20,20,0,1
06-05-2025,Snacks & Ready-to-Eat,RAJGIRA PEANUT CHIKKI,14,10,10,0,2
06-05-2025,Snacks & Ready-to-Eat,NGT CHATPATTA CHANA 90GM,14,50,50,0,2
06-05-2025,"Grains, Flours & Dals",SAMALU (Little millet) 500 gms,4,85,65,20,1
06-05-2025,"Grains, Flours & Dals",UDALU (Barnyard millet) 500 gms,4,70,60,10,1
06-05-2025,"Grains, Flours & Dals",ANDU KORRALU (Brown top .mlt) 500,4,130,110,20,1
06-05-2025,Oils & Ghee,Sesame oil 500ml,9,295,280,15,1
06-05-2025,"Grains, Flours & Dals",SPLIT BLACK GRAM 500 GM,4,90,85,5,1
06-05-2025,Snacks & Ready-to-Eat,SD Aswagandha with palm Jaggery250Gm,14,135,135,0,1
06-05-2025,Snacks & Ready-to-Eat,SUNNUNDALU,14,120,120,0,1
06-05-2025,"Grains, Flours & Dals",Arikalu (kodo),4,70,65,5,1
06-05-2025,Oils & Ghee,sesame oil 1L,9,590,560,30,1
06-05-2025,Oils & Ghee,Groundnut oil 1 L,9,330,330,0,1
06-05-2025,Oils & Ghee,Safflower oil 1 L,9,400,400,0,1
06-05-2025,"Grains, Flours & Dals",SPLIT BLACK GRAM 500 GM,4,90,85,5,1
06-05-2025,"Dry Fruits, Nuts & Seeds",Groundnuts 1 kg,2,190,165,25,1
06-05-2025,"Dry Fruits, Nuts & Seeds",ALMONDS 250GM,2,280,260,20,1
06-05-2025,Beverages,REFRESH SHARBATH NORMAL,1,199,190,9,1
06-05-2025,"Grains, Flours & Dals",SL Idly Rava 1KG,4,65,55,10,1
06-05-2025,Pooja & Spiritual Items,GD Aiswarya Deepam 700ML,12,195,195,0,1
06-05-2025,Pooja & Spiritual Items,VRP APOORVA JAVADHU POW,12,35,35,0,1
06-05-2025,"Grains, Flours & Dals",Bombay Rava 500GM,4,35,30,5,1
06-05-2025,Snacks & Ready-to-Eat,VD NUVULLU CHIKKI,14,80,80,0,1
06-05-2025,Sweeteners,YB JAGGERY POWDER 500GMS,16,75,75,0,1
06-05-2025,"Grains, Flours & Dals",THICK POHA 500GM,4,40,35,5,1
06-05-2025,"Grains, Flours & Dals",Wheat Flour 1 kg,4,70,60,10,1
06-05-2025,Spices & Seasonings,AVALU 100GM,15,25,20,5,1
06-05-2025,Snacks & Ready-to-Eat,RSC ORANGE 100GMS,14,20,20,0,1
06-05-2025,Snacks & Ready-to-Eat,VD GUMMADI VADIYAM,14,75,75,0,1
06-05-2025,Pooja & Spiritual Items,GD Dhoop Sticks 26GM,12,60,60,0,3
06-05-2025,Milk & Dairy,SANGAM TONED MILK 500ML,7,31,31,0,1
06-05-2025,Milk & Dairy,SANGAM TONED MILK 500ML,7,31,31,0,1
06-05-2025,Oils & Ghee,BUFFALLO GHEE 500ML,9,410,370,40,1
06-05-2025,Household & Cleaning,SURFEXCEL BAR 80G,6,10,10,0,1
06-05-2025,Milk & Dairy,HERITAGE TOTAL CURD 500GM,7,50,50,0,1
06-05-2025,Snacks & Ready-to-Eat,SIRI ICE CREAM 500ML,14,460,260,200,1
06-05-2025,Snacks & Ready-to-Eat,SD SESAME PAPAD,14,80,80,0,1
06-05-2025,Snacks & Ready-to-Eat,VD DAHI MIRCHI(SALTED) 100GM,14,45,45,0,1
06-05-2025,General Household & Kitchenware,chalk piece 1b,3,15,10,5,1
06-05-2025,"Grains, Flours & Dals",Wheat Flour 1 kg,4,140,120,20,2
06-05-2025,Spices & Seasonings,MUSTARD POWDR 500G,15,780,660,120,6
06-05-2025,Oils & Ghee,sesame oil 1L,9,1180,"1,120.00",60,2
06-05-2025,"Grains, Flours & Dals",Urad dall 1 Kg,4,370,340,30,2
06-05-2025,Sweeteners,SUGAR 1KG,16,60,56,4,1
06-05-2025,Snacks & Ready-to-Eat,VD NUVULU CHEGODI 175GM,14,60,60,0,1
06-05-2025,Spices & Seasonings,NUVVULU 500GM,15,200,170,30,1
06-05-2025,"Grains, Flours & Dals",BARLEY SEEDS 500 GM,4,90,70,20,1
06-05-2025,Snacks & Ready-to-Eat,VD MURMURA LADDU,14,50,50,0,1
06-05-2025,Snacks & Ready-to-Eat,NGT CHATPATTA CHANA 90GM,14,25,25,0,1
06-05-2025,"Grains, Flours & Dals",RAGULU 1 KG,4,30,30,0,1
06-05-2025,"Grains, Flours & Dals",chana flour 500 gms,4,60,54,6,1
06-05-2025,"Dry Fruits, Nuts & Seeds",Groundnuts 1 kg,2,190,165,25,1
06-05-2025,"Grains, Flours & Dals",KORRALU (FOXTAIL M) 500GM,4,65,55,10,1
06-05-2025,"Grains, Flours & Dals",unpolished turdall500grms,4,120,110,10,1
06-05-2025,Snacks & Ready-to-Eat,VD DAHI MIRCHI(SALTED) 100GM,14,45,45,0,1
06-05-2025,Spices & Seasonings,MUSTARD POWDER 250G,15,65,55,10,1
06-05-2025,Spices & Seasonings,Coriander seeds 200 gms,15,48,40,8,1
06-05-2025,"Grains, Flours & Dals",PESARA PAPPU 1 KG,4,170,145,25,1
06-05-2025,Milk & Dairy,BROWN EGGS TRAY 30P,7,360,330,30,1
06-05-2025,Snacks & Ready-to-Eat,NGT CHATPATTA CHANA 90GM,14,225,225,0,9
06-05-2025,Misc,VD00014,8,200,180,20,2
06-05-2025,Spices & Seasonings,GS Pink Rock Salt 1KG,15,120,120,0,1
06-05-2025,Spices & Seasonings,DURGA SALT CRYSTAL 1KG,15,25,25,0,1
06-05-2025,General Household & Kitchenware,RED LINE 20GM,3,75,75,0,1
06-05-2025,"Grains, Flours & Dals",HS JOWAR FLAKES 250GM 1+1,4,119,119,0,1
06-05-2025,Spices & Seasonings,gd asafoetida,15,0,0,0,1
06-05-2025,Spices & Seasonings,3M.MIRCHI POWDER,15,360,320,40,1
06-05-2025,"Grains, Flours & Dals",chana flour 500 gms,4,120,108,12,2
06-05-2025,"Grains, Flours & Dals",Wheat Flour 1 kg,4,70,60,10,1
06-05-2025,"Grains, Flours & Dals",COW B rice 1 kg,4,504,483,21,7
06-05-2025,"Grains, Flours & Dals",SL Idly Rava 1KG,4,65,55,10,1
06-05-2025,"Grains, Flours & Dals",AISHWARYA SP 1KG,4,400,350,50,5
06-05-2025,Spices & Seasonings,DRY MIECHI 200GM,15,160,120,40,2
06-05-2025,"Dry Fruits, Nuts & Seeds",PUTNALU 500GMS,2,180,152,28,2
06-05-2025,"Grains, Flours & Dals",samalu,4,260,260,0,2
06-05-2025,"Grains, Flours & Dals",CHANA DAL 500GM,4,56,48,8,1
06-05-2025,"Grains, Flours & Dals",split black gram 1 kg,4,360,340,20,2
06-05-2025,"Grains, Flours & Dals",PESARA PAPPU 1 KG,4,170,145,25,1
06-05-2025,"Dry Fruits, Nuts & Seeds",Groundnuts 1 kg,2,190,165,25,1
06-05-2025,Spices & Seasonings,AVALU 100GM,15,25,20,5,1
06-05-2025,"Grains, Flours & Dals",Urad dall 1 Kg,4,370,340,30,2
06-05-2025,"Grains, Flours & Dals",Green gram 1 kg,4,150,130,20,1
06-05-2025,Sweeteners,ACHU BELLAM 1KG,16,100,80,20,1
06-05-2025,"Grains, Flours & Dals",SL Idly Rava 1KG,4,260,220,40,4
06-05-2025,Spices & Seasonings,Turmeric powder 1 kg,15,400,300,100,1
06-05-2025,"Grains, Flours & Dals",KORRALU (FOXTAIL M) 1KG,4,300,220,80,2
06-05-2025,Spices & Seasonings,Jeera 100GM,15,50,45,5,1
06-05-2025,Spices & Seasonings,Vamu 100GM,15,60,50,10,1
06-05-2025,"Grains, Flours & Dals",Arikadu ( kodo),4,280,260,20,2
06-05-2025,"Grains, Flours & Dals",turdal 1kg,4,440,340,100,2
06-05-2025,Oils & Ghee,Groundnut oil 5 L,9,1800,"1,600.00",200,1
06-05-2025,Oils & Ghee,Groundnut oil 500ml,9,360,330,30,2
06-05-2025,"Grains, Flours & Dals",ULAVALU RED,4,90,75,15,1
06-05-2025,Milk & Dairy,SANGAM TONED MILK 500ML,7,31,31,0,1
06-05-2025,Personal Care & Cosmetics,dabur red 200 grms,10,136,136,0,1
06-05-2025,"Dry Fruits, Nuts & Seeds",FLAX SEEDS 250GM,2,60,50,10,1
06-05-2025,"Dry Fruits, Nuts & Seeds",Groundnuts 1 kg,2,190,165,25,1
06-05-2025,General Household & Kitchenware,chalk piece 1b,3,15,10,5,1
06-05-2025,Spices & Seasonings,TATA SALT 1KG,15,30,30,0,1
06-05-2025,Milk & Dairy,SANGAM FULL CREAM MILK 500ML,7,38,38,0,1
06-05-2025,Snacks & Ready-to-Eat,SD Flax seeds with dates 250gm,14,135,135,0,1
06-05-2025,Snacks & Ready-to-Eat,PUMPKIN CHIKKI 200GM,14,140,120,20,1
06-05-2025,Snacks & Ready-to-Eat,VD PALLI LADDU,14,80,80,0,1
05-05-2025,Milk & Dairy,BROWN EGGS TRAY 30P,7,360,330,30,1
05-05-2025,"Grains, Flours & Dals",Multigrain 1 kg,4,100,85,15,1
05-05-2025,Snacks & Ready-to-Eat,VD Pappu Chekkalu 190gm,14,60,60,0,1
05-05-2025,Snacks & Ready-to-Eat,VD MURMURA LADDU,14,100,100,0,2
05-05-2025,Snacks & Ready-to-Eat,VD MURMURA LADDU,14,50,50,0,1
05-05-2025,Snacks & Ready-to-Eat,RINGS 200GM,14,30,30,0,1
05-05-2025,Spices & Seasonings,Turmeric powder 250 gms,15,100,80,20,1
05-05-2025,Snacks & Ready-to-Eat,DOSA BATTER 1KG,14,60,60,0,1
05-05-2025,Snacks & Ready-to-Eat,BD PEARL MILLET NOODLES 200G,14,70,70,0,1
05-05-2025,"Grains, Flours & Dals",SA WHITE JOWAR RAVA 500GM,4,69,69,0,1
05-05-2025,"Grains, Flours & Dals",SRILATHA RICE RAVVA 500GM,4,35,35,0,1
05-05-2025,"Grains, Flours & Dals",HS RAGI IDLY R,4,70,70,0,1
05-05-2025,"Grains, Flours & Dals",SL Idly Rava 1KG,4,65,55,10,1
05-05-2025,Snacks & Ready-to-Eat,SS IDLY BATTER 1KG,14,60,60,0,1
05-05-2025,Sweeteners,SUGAR 1KG,16,60,56,4,1
05-05-2025,Oils & Ghee,Groundnut oil 5 L,9,1800,"1,600.00",200,1
05-05-2025,Sweeteners,MADHUR SUGAR 1KG,16,130,110,20,2
05-05-2025,Oils & Ghee,Groundnut oil 1 L,9,330,330,0,1
05-05-2025,Spices & Seasonings,Turmeric powder 250 gms,15,100,80,20,1
05-05-2025,Snacks & Ready-to-Eat,VD MURUKU 175GM,14,60,60,0,1
05-05-2025,Oils & Ghee,Safflower oil 1 L,9,400,400,0,1
05-05-2025,Spices & Seasonings,PICKLES CHILLIP 500 GMS,15,710,650,60,2
05-05-2025,Snacks & Ready-to-Eat,SIRI ICE CREAM 100ML,14,200,160,40,2
05-05-2025,Oils & Ghee,Sesame oil 500ml,9,295,280,15,1
05-05-2025,"Grains, Flours & Dals",KORRALU (FOXTAIL M) 500GM,4,65,55,10,1
05-05-2025,Spices & Seasonings,ROYAL SAFFRON 400GRMS,15,65,65,0,1
05-05-2025,Snacks & Ready-to-Eat,VD Pappu Chekkalu 190gm,14,60,60,0,1
05-05-2025,"Grains, Flours & Dals",yellow jowar flour 1kg,4,100,92,8,1
05-05-2025,"Grains, Flours & Dals",RAGI FLOUR 1KG,4,80,70,10,1
05-05-2025,Milk & Dairy,HERITAGE BUTTERMILK,7,20,20,0,2
05-05-2025,Sweeteners,YB FOREST H 250 GMS,16,180,180,0,1
05-05-2025,"Grains, Flours & Dals",Wheat Flour 1 kg,4,70,60,10,1
05-05-2025,Beverages,REFRESH SHARBATH SUGAR FREE,1,299,285,14,1
05-05-2025,"Grains, Flours & Dals",SA Sprouted Ragi Flour 500GM,4,69,69,0,1
05-05-2025,Snacks & Ready-to-Eat,VD RICE MURUKU 150GM,14,100,100,0,2
05-05-2025,"Dry Fruits, Nuts & Seeds",ANJEER 250GM,2,400,360,40,1
05-05-2025,"Grains, Flours & Dals",chana flour 500 gms,4,60,54,6,1
05-05-2025,Snacks & Ready-to-Eat,SD Flax seeds with dates 250gm,14,135,135,0,1
05-05-2025,"Dry Fruits, Nuts & Seeds",YELLOW KISHMISH 250GM,2,130,110,20,1
05-05-2025,Snacks & Ready-to-Eat,SD Sesame laddu with dates250gm,14,135,135,0,1
05-05-2025,Spices & Seasonings,telaga pindi,15,70,70,0,1
05-05-2025,Snacks & Ready-to-Eat,SD Aswagandha with palm Jaggery250Gm,14,135,135,0,1
05-05-2025,Oils & Ghee,Groundnut oil 1 L,9,330,330,0,1
05-05-2025,"Grains, Flours & Dals",WHEAT 1 KG,4,120,100,20,2
05-05-2025,Milk & Dairy,ID PANEER,7,135,135,0,1
05-05-2025,"Grains, Flours & Dals",SAMALU (Little millet) 500 gms,4,85,65,20,1
05-05-2025,Spices & Seasonings,Coriander seeds 200 gms,15,240,200,40,5
05-05-2025,Snacks & Ready-to-Eat,DOSA BATTER 1KG,14,60,60,0,1
05-05-2025,"Grains, Flours & Dals",SA YELLOW JOWAR RAVA 500GM,4,190,190,0,2
05-05-2025,"Grains, Flours & Dals",SA WHITE JOWAR RAVA 500GM,4,138,138,0,2
05-05-2025,"Grains, Flours & Dals",White jowar.F 1 kg,4,100,80,20,1
05-05-2025,"Grains, Flours & Dals",YB CHITTIMUTYALU RICE 1KG,4,200,200,0,1
05-05-2025,"Grains, Flours & Dals",ANDU KORRALU (Browntop.m) 1 kg,4,260,220,40,1
05-05-2025,"Grains, Flours & Dals",RAGI FLOUR 1KG,4,80,70,10,1
05-05-2025,"Grains, Flours & Dals",SF MASOOR DAL,4,119,119,0,1
05-05-2025,Milk & Dairy,HERITAGE BUTTERMILK,7,30,30,0,3
05-05-2025,"Grains, Flours & Dals",RICE FLOUR 1KG,4,70,55,15,1
05-05-2025,"Grains, Flours & Dals",KORRALU (FOXTAIL M) 1KG,4,150,110,40,1
05-05-2025,"Grains, Flours & Dals",yellow jowar flour 1kg,4,100,92,8,1
05-05-2025,Snacks & Ready-to-Eat,SS IDLY BATTER 1KG,14,60,60,0,1
05-05-2025,Beverages,BISLERI WATER 1L,1,20,20,0,1
05-05-2025,Spices & Seasonings,NUVVULU 250GM,15,80,65,15,1
05-05-2025,"Grains, Flours & Dals",chana flour 500 gms,4,60,54,6,1
05-05-2025,"Grains, Flours & Dals",Quinova 1 kg,4,220,195,25,1
05-05-2025,"Grains, Flours & Dals",UDALU (Barnyard millet) 500 gms,4,70,60,10,1
05-05-2025,"Grains, Flours & Dals",RAGI FLOUR 500GRMS,4,40,35,5,1
05-05-2025,Spices & Seasonings,GS Pink Rock Salt 1KG,15,120,120,0,1
05-05-2025,Milk & Dairy,BUTTER MILK,7,10,10,0,1
05-05-2025,"Grains, Flours & Dals",Wheat Flour 1 kg,4,140,120,20,2
05-05-2025,"Grains, Flours & Dals",MELMEKER 250GMS,4,60,45,15,1
05-05-2025,"Grains, Flours & Dals",SL Idly Rava 1KG,4,65,55,10,1
05-05-2025,"Grains, Flours & Dals",RICE FLOUR 500 GM,4,70,56,14,2
05-05-2025,Pooja & Spiritual Items,GD Aiswarya Deepam 700ML,12,195,195,0,1
05-05-2025,"Grains, Flours & Dals",EM Ragi upma R 500g,4,75,75,0,1
05-05-2025,"Grains, Flours & Dals",Multigrain 1 kg,4,300,255,45,3
05-05-2025,"Grains, Flours & Dals",chana flour 500 gms,4,120,108,12,2
05-05-2025,General Household & Kitchenware,chalk piece 1b,3,15,10,5,1
05-05-2025,"Grains, Flours & Dals",BAJRA 1 KG,4,30,25,5,0.5
05-05-2025,"Grains, Flours & Dals",JOWAR WHITE 1 KG,4,40,35,5,0.5
05-05-2025,"Grains, Flours & Dals",KORRALU (FOXTAIL M) 500GM,4,65,55,10,1
05-05-2025,"Grains, Flours & Dals",FLOUR CHARGE,4,24,24,0,2
05-05-2025,Oils & Ghee,Groundnut oil 500ml,9,180,165,15,1
05-05-2025,"Grains, Flours & Dals",WHEAT 1 KG,4,30,25,5,0.5
05-05-2025,"Grains, Flours & Dals",CHANA DALL 250GM,4,28,24,4,1
05-05-2025,Household & Cleaning,vim small,6,30,30,0,2
05-05-2025,General Household & Kitchenware,MATCH BOX,3,20,20,0,1
05-05-2025,"Grains, Flours & Dals",Wheat Rava S 500GM,4,33,30,3,1
05-05-2025,Spices & Seasonings,Masala Karam 250 gms,15,130,120,10,1
05-05-2025,Sweeteners,MISHRI 250 GM,16,35,30,5,1
05-05-2025,Oils & Ghee,rice bran oil f,9,194,169,25,1
05-05-2025,Personal Care & Cosmetics,MYSORE SANDAL SOAP 75G,10,126,126,0,3
05-05-2025,Snacks & Ready-to-Eat,VD PALLI LADDU,14,80,80,0,1
05-05-2025,Household & Cleaning,vim pudina fresh,6,40,40,0,4
05-05-2025,Pooja & Spiritual Items,deep jyothi deepam oil 1000ml,12,198,198,0,1
05-05-2025,"Grains, Flours & Dals",RAGULU 1 KG,4,70,60,10,1
05-05-2025,Sweeteners,YB N FOREST HONEY 700 GM,16,400,400,0,1
05-05-2025,Spices & Seasonings,GS Pink Rock Salt 1KG,15,120,120,0,1
05-05-2025,"Dry Fruits, Nuts & Seeds",ANJEER 250GM,2,400,360,40,1
05-05-2025,"Dry Fruits, Nuts & Seeds",ALMONDS 250GM,2,280,260,20,1
05-05-2025,"Dry Fruits, Nuts & Seeds",cashew,2,340,310,30,1
05-05-2025,"Dry Fruits, Nuts & Seeds",PUMPKIN SEEDS 250GM,2,200,160,40,1
05-05-2025,"Dry Fruits, Nuts & Seeds",YELLOW KISHMISH 250GM,2,130,110,20,1
05-05-2025,"Dry Fruits, Nuts & Seeds",PULMAKHANA 100 GM,2,180,170,10,1
05-05-2025,Oils & Ghee,Coconut oil 500 ml,9,220,200,20,1
05-05-2025,"Grains, Flours & Dals",MAAGAANI W RICE 5KGS,4,899,535,364,1
05-05-2025,Oils & Ghee,Groundnut oil 1 L,9,330,330,0,1
05-05-2025,"Grains, Flours & Dals",Arikalu (kodo),4,70,65,5,1
05-05-2025,"Grains, Flours & Dals",SAMALU (Little millet) 500 gms,4,85,65,20,1
05-05-2025,Sweeteners,NATURAL HONEY 1KG,16,560,480,80,1
05-05-2025,"Grains, Flours & Dals",Multigrain 1 kg,4,200,170,30,2
05-05-2025,"Grains, Flours & Dals",RAGI FLOUR 500GRMS,4,40,35,5,1
05-05-2025,Snacks & Ready-to-Eat,SATHVI REGIVADA 200GM,14,160,120,40,2
05-05-2025,Household & Cleaning,vim dish liquid,6,55,55,0,1
05-05-2025,Oils & Ghee,Coconut oil 500 ml,9,220,200,20,1
05-05-2025,Snacks & Ready-to-Eat,VD PAPPU CHEGODI 200GM,14,60,60,0,1
05-05-2025,Snacks & Ready-to-Eat,VD KOBARI LADDU,14,160,160,0,2
05-05-2025,Oils & Ghee,Black Sesame oil 500 ml,9,220,190,30,1
05-05-2025,"Grains, Flours & Dals",RAGI FLOUR 1KG,4,80,70,10,1
05-05-2025,"Grains, Flours & Dals",SL Idly Rava 1KG,4,65,55,10,1
05-05-2025,Beverages,TAJ MAHAL 250GM,1,235,235,0,1
05-05-2025,Snacks & Ready-to-Eat,SD FINGER Millet with palm Jaggery 250gm,14,135,135,0,1
05-05-2025,Sweeteners,sugar 500 gms,16,30,28,2,1
05-05-2025,"Grains, Flours & Dals",White jowar.F 1 kg,4,100,80,20,1
05-05-2025,Snacks & Ready-to-Eat,VD PALLI CHIKKI,14,80,80,0,1
05-05-2025,Snacks & Ready-to-Eat,GB SALT COOKIES,14,60,55,5,1
05-05-2025,Beverages,BRU GREEN LABEL 1.2G,1,48,48,0,24
05-05-2025,Snacks & Ready-to-Eat,VD KOBARI LADDU,14,80,80,0,1
05-05-2025,Snacks & Ready-to-Eat,BATANA NGT 70GMS,14,20,20,0,1
05-05-2025,"Grains, Flours & Dals",Multigrain 1 kg,4,270,229.5,40.5,2.7
05-05-2025,Milk & Dairy,BROWN EGGS 1P,7,224,192,32,16
05-05-2025,"Grains, Flours & Dals",AISHWARYA SP 25KG,4,1999,"1,690.00",309,1
05-05-2025,Snacks & Ready-to-Eat,SIRI ICE CREAM 100ML,14,200,160,40,2
05-05-2025,Snacks & Ready-to-Eat,VD CORNFLAKES MIXTURE 175GM,14,60,60,0,1
05-05-2025,Snacks & Ready-to-Eat,VD NUVULLU CHIKKI,14,80,80,0,1
05-05-2025,"Dry Fruits, Nuts & Seeds",SATHVI CHIA SEEDS 100GM,2,100,80,20,1
05-05-2025,"Grains, Flours & Dals",UDALU (Barnyard millet) 500 gms,4,70,60,10,1
05-05-2025,Spices & Seasonings,SONTI 50GM,15,30,20,10,1
05-05-2025,Sweeteners,MISHRI 250 GM,16,35,30,5,1
05-05-2025,"Grains, Flours & Dals",KORRALU (FOXTAIL M) 500GM,4,65,55,10,1
05-05-2025,Milk & Dairy,BROWN EGGS 1P,7,224,192,32,16
05-05-2025,"Grains, Flours & Dals",MAGHANI SP RICE 5KG B,4,4995,"3,000.00","1,995.00",5
05-05-2025,"Grains, Flours & Dals",MAAGAANI SP RICE 5KGS,4,3245,"2,800.00",445,5
05-05-2025,Milk & Dairy,BROWN EGGS 1P,7,224,192,32,16
05-05-2025,"Grains, Flours & Dals",Wheat Flour 1 kg,4,70,60,10,1
05-05-2025,"Grains, Flours & Dals",SABDANA 500GM,4,90,70,20,1
05-05-2025,Oils & Ghee,Groundnut oil 500ml,9,180,165,15,1
05-05-2025,Sweeteners,MISHRI 250 GM,16,35,30,5,1
05-05-2025,Oils & Ghee,sesame oil 1L,9,590,560,30,1
05-05-2025,"Grains, Flours & Dals",White jowar.F 1 kg,4,100,80,20,1
05-05-2025,"Dry Fruits, Nuts & Seeds",PN ORGANIC MAKHANA 50GM,2,125,125,0,1
05-05-2025,Milk & Dairy,SANGAM FULL CREAM MILK 500ML,7,76,76,0,2
05-05-2025,"Dry Fruits, Nuts & Seeds",cashew,2,340,310,30,1
05-05-2025,Sweeteners,YB FOREST H 250 GMS,16,180,180,0,1
05-05-2025,Snacks & Ready-to-Eat,GB SALT COOKIES,14,60,55,5,1
05-05-2025,"Grains, Flours & Dals",White jowar.F 1 kg,4,100,80,20,1
05-05-2025,"Grains, Flours & Dals",FLOUR CHARGE,4,50.4,50.4,0,4.2
05-05-2025,"Grains, Flours & Dals",MAAGAANI W RICE 5KGS,4,4495,"2,675.00","1,820.00",5
05-05-2025,Milk & Dairy,BROWN EGGS 1P,7,224,192,32,16
05-05-2025,Oils & Ghee,Coconut oil 500 ml,9,220,200,20,1
05-05-2025,"Dry Fruits, Nuts & Seeds",Groundnuts 1 kg,2,190,165,25,1
05-05-2025,Spices & Seasonings,RASAM POWDER MTR,15,95,95,0,1
05-05-2025,Spices & Seasonings,MTR SAMBAR POW 100GM,15,76,76,0,1
05-05-2025,"Dry Fruits, Nuts & Seeds",Groundnuts 1 kg,2,190,165,25,1
05-05-2025,"Grains, Flours & Dals",Urad dall 1 Kg,4,185,170,15,1
05-05-2025,"Grains, Flours & Dals",Green gram 1 kg,4,150,130,20,1
05-05-2025,"Grains, Flours & Dals",VGR RICE 10 KGS,4,700,650,50,1
05-05-2025,"Grains, Flours & Dals",Wheat Flour 1 kg,4,70,60,10,1
05-05-2025,"Grains, Flours & Dals",turdal 1kg,4,220,170,50,1
05-05-2025,"Grains, Flours & Dals",AISHWARYA SP 25KG,4,1999,"1,690.00",309,1
05-05-2025,Personal Care & Cosmetics,SVE NALAPAMARAM SOAP 100GM,10,100,100,0,1
05-05-2025,"Grains, Flours & Dals",PRO ORG MEDIUM POHA 500G,4,78,78,0,1
05-05-2025,Snacks & Ready-to-Eat,VD MURMURA LADDU,14,50,50,0,1
05-05-2025,"Grains, Flours & Dals",Wheat Flour 1 kg,4,140,120,20,2
05-05-2025,"Grains, Flours & Dals",SABDANA 500GM,4,90,70,20,1
05-05-2025,"Grains, Flours & Dals",chana flour 500 gms,4,60,54,6,1
05-05-2025,Snacks & Ready-to-Eat,VD DAHI MIRCHI(SALTED) 100GM,14,45,45,0,1
05-05-2025,Snacks & Ready-to-Eat,VD PALLI CHIKKI,14,80,80,0,1
05-05-2025,Snacks & Ready-to-Eat,MIGHTY PUFFS CHEESE AND HERBS,14,25,25,0,1
05-05-2025,Spices & Seasonings,SH MUSTARD 100GM,15,90,90,0,3
05-05-2025,Oils & Ghee,Groundnut oil 1 L,9,330,330,0,1
05-05-2025,"Health, Wellness & Ayurvedic Products",MD Aamlaki Choornam 100GM,5,80,80,0,1
05-05-2025,"Health, Wellness & Ayurvedic Products",NEELI LEAF CHOORNAM,5,110,110,0,1
05-05-2025,Personal Care & Cosmetics,MD Henna Choornam 100GM,10,80,80,0,1
05-05-2025,Pooja & Spiritual Items,javadhu,12,120,120,0,1
05-05-2025,Pooja & Spiritual Items,SWASTIK CAMPHORE,12,90,90,0,1
05-05-2025,"Health, Wellness & Ayurvedic Products",ZINDA TILISMATH 5ML,5,70,70,0,1
05-05-2025,Spices & Seasonings,SH CLOVES,15,185,185,0,1
05-05-2025,Personal Care & Cosmetics,VASELINE 5GM,10,20,20,0,1
05-05-2025,Spices & Seasonings,BIRYANI LEAF 10GM,15,30,20,10,1
05-05-2025,Pickles & Cooking Pastes,DURGA BRAND TM PICKLES SPECIAL,11,56,56,0,2
05-05-2025,Oils & Ghee,Groundnut oil 1 L,9,330,330,0,1
05-05-2025,Spices & Seasonings,SH CASSIA STICKS 50GM,15,75,75,0,1
05-05-2025,Spices & Seasonings,Telaga Pindi 250 GM,15,40,35,5,1
05-05-2025,"Dry Fruits, Nuts & Seeds",SATHVI CHIA SEEDS 100GM,2,100,80,20,1
05-05-2025,"Grains, Flours & Dals",SA WHITE JOWAR RAVA 500GM,4,69,69,0,1
05-05-2025,Spices & Seasonings,Black Till 250GM,15,180,150,30,2
05-05-2025,"Dry Fruits, Nuts & Seeds",MAHA BEERA SEEDS 100GM,2,120,120,0,2
05-05-2025,"Dry Fruits, Nuts & Seeds",SABJA SEEDS,2,70,70,0,1
05-05-2025,"Dry Fruits, Nuts & Seeds",FLAX SEEDS 250GM,2,60,50,10,1
05-05-2025,"Grains, Flours & Dals",RAGI FLOUR 1KG,4,80,70,10,1
05-05-2025,Sweeteners,MADHUR SUGAR 1KG,16,65,55,10,1
05-05-2025,Oils & Ghee,DURGA GHEE 200ML,9,175,175,0,1
05-05-2025,"Grains, Flours & Dals",FLOUR CHARGE,4,12,12,0,1
05-05-2025,"Grains, Flours & Dals",CORN FOUR 250GM,4,40,35,5,1
05-05-2025,Oils & Ghee,sesame oil 1L,9,1180,"1,120.00",60,2
05-05-2025,Snacks & Ready-to-Eat,RSC ORANGE 100GMS,14,20,20,0,1
05-05-2025,Snacks & Ready-to-Eat,MIGHTY PUFFS CHEDDAR CHEESE,14,50,50,0,2
05-05-2025,Snacks & Ready-to-Eat,BELLAM MINAPA SUNADULLU,14,180,180,0,1
05-05-2025,"Grains, Flours & Dals",Wheat Rava M 1KG,4,65,55,10,1
05-05-2025,Spices & Seasonings,LG 50GM,15,92,92,0,1
05-05-2025,"Grains, Flours & Dals",RAGI FLOUR 500GRMS,4,40,35,5,1
05-05-2025,"Grains, Flours & Dals",POORI ATTA 1KG,4,70,60,10,1
05-05-2025,Oils & Ghee,Groundnut oil 1 L,9,330,330,0,1
05-05-2025,Oils & Ghee,Black Sesame oil 1 L,9,440,380,60,1
05-05-2025,Snacks & Ready-to-Eat,PEANUT CHILLI,14,10,10,0,2
05-05-2025,Snacks & Ready-to-Eat,SOYA MURK,14,60,60,0,1
05-05-2025,Snacks & Ready-to-Eat,VD Pappu Chekkalu 190gm,14,60,60,0,1
05-05-2025,Snacks & Ready-to-Eat,VD MIXTURE 175 GM,14,60,60,0,1
05-05-2025,Oils & Ghee,Groundnut oil 1 L,9,330,330,0,1
05-05-2025,"Grains, Flours & Dals",Wheat Rava M 1KG,4,65,55,10,1
05-05-2025,Snacks & Ready-to-Eat,SIRI ICE CREAM 100ML,14,100,80,20,1
05-05-2025,Snacks & Ready-to-Eat,VD KOBARI LADDU,14,80,80,0,1
05-05-2025,Snacks & Ready-to-Eat,RI Yogurt Berry Oats 35g,14,45,45,0,1
05-05-2025,Spices & Seasonings,GS Pink Rock Salt 1KG,15,120,120,0,1
05-05-2025,"Dry Fruits, Nuts & Seeds",SABJA SEEDS,2,70,70,0,1
05-05-2025,"Health, Wellness & Ayurvedic Products",RB Max Protein Choco Berry bar 50g,5,75,75,0,1
05-05-2025,Oils & Ghee,Sesame oil 500ml,9,295,280,15,1
05-05-2025,Oils & Ghee,Groundnut oil 1 L,9,330,330,0,1
05-05-2025,Snacks & Ready-to-Eat,VD MURMURA LADDU,14,50,50,0,1
05-05-2025,"Grains, Flours & Dals",RAGI FLOUR 1KG,4,160,140,20,2
05-05-2025,"Grains, Flours & Dals",SB Javva Wheat Ravva 500GM,4,95,95,0,1
05-05-2025,Spices & Seasonings,sf black pepper,15,190,190,0,1
05-05-2025,"Dry Fruits, Nuts & Seeds",Groundnuts 1 kg,2,190,165,25,1
05-05-2025,Spices & Seasonings,telaga pindi,15,70,70,0,1
05-05-2025,"Grains, Flours & Dals",White jowar.F 1 kg,4,100,80,20,1
05-05-2025,"Grains, Flours & Dals",JOWAR UPMA RAVA,4,75,75,0,1
05-05-2025,Oils & Ghee,Groundnut oil 1 L,9,330,330,0,1
05-05-2025,Oils & Ghee,sesame oil 1L,9,590,560,30,1
05-05-2025,Spices & Seasonings,PN ORGANIC PINK SALT 1KG,15,124,124,0,1
05-05-2025,Spices & Seasonings,DURGA SALT CRYSTAL 1KG,15,25,25,0,1
05-05-2025,"Grains, Flours & Dals",chana flour 500 gms,4,60,54,6,1
05-05-2025,"Grains, Flours & Dals",RAGI FLOUR 500GRMS,4,40,35,5,1
05-05-2025,"Grains, Flours & Dals",RAGI FLOUR 1KG,4,80,70,10,1
05-05-2025,Spices & Seasonings,Menthulu 250 gms,15,50,45,5,1
05-05-2025,Oils & Ghee,sesame oil 1L,9,590,560,30,1
05-05-2025,Spices & Seasonings,TATA SALT 1KG,15,30,30,0,1
05-05-2025,Spices & Seasonings,PICKLES CHILLIP 500 GMS,15,355,325,30,1
05-05-2025,"Dry Fruits, Nuts & Seeds",Putnalu 250GM,2,45,38,7,1
05-05-2025,Milk & Dairy,BROWN EGGS 1P,7,168,144,24,12
05-05-2025,Snacks & Ready-to-Eat,NGT CHATPATTA CHANA 90GM,14,50,50,0,2
05-05-2025,Snacks & Ready-to-Eat,SIRI ICE CREAM 100ML,14,100,80,20,1
05-05-2025,Oils & Ghee,Groundnut oil 1 L,9,330,330,0,1
05-05-2025,Spices & Seasonings,AVALU 250grms,15,160,160,0,4
05-05-2025,Spices & Seasonings,Menthulu 250 gms,15,50,45,5,1
05-05-2025,Spices & Seasonings,ROYAL SAFFRON 400GRMS,15,65,65,0,1
05-05-2025,"Grains, Flours & Dals",RED TUDAL 1KG,4,150,140,10,1
05-05-2025,"Grains, Flours & Dals",PESARA PAPPU 1 KG,4,170,145,25,1
05-05-2025,Snacks & Ready-to-Eat,GREEN FRIED batana,14,40,40,0,2
05-05-2025,Oils & Ghee,sesame oil 1L,9,590,560,30,1
05-05-2025,"Grains, Flours & Dals",KORRALU (FOXTAIL M) 500GM,4,65,55,10,1
05-05-2025,Oils & Ghee,BUFFALLO GHEE 500ML,9,410,370,40,1
05-05-2025,"Grains, Flours & Dals",Arikalu (kodo),4,70,65,5,1
05-05-2025,"Grains, Flours & Dals",UDALU (Barnyard millet) 500 gms,4,70,60,10,1
05-05-2025,"Grains, Flours & Dals",SAMALU (Little millet) 500 gms,4,85,65,20,1
05-05-2025,"Grains, Flours & Dals",Multigrain 1 kg,4,100,85,15,1
05-05-2025,"Dry Fruits, Nuts & Seeds",SUNFLOWER SEEDS 250GRM,2,150,130,20,1
05-05-2025,"Dry Fruits, Nuts & Seeds",ALMONDS 250GM,2,280,260,20,1
05-05-2025,"Dry Fruits, Nuts & Seeds",PUMPKIN SEEDS 250GM,2,200,160,40,1
05-05-2025,"Dry Fruits, Nuts & Seeds",DRYDATES YELLOW 250GM,2,135,120,15,1
05-05-2025,"Dry Fruits, Nuts & Seeds",KAJU HALF 250GM,2,310,290,20,1
05-05-2025,"Dry Fruits, Nuts & Seeds",ANJEER 250GM,2,400,360,40,1
05-05-2025,Spices & Seasonings,Chilli powder 500 gms,15,290,210,80,1
05-05-2025,Spices & Seasonings,pickle chili powder,15,180,165,15,1
05-05-2025,Snacks & Ready-to-Eat,VD GUMMADI VADIYAM,14,150,150,0,2
05-05-2025,Oils & Ghee,Groundnut oil 1 L,9,330,330,0,1
05-05-2025,Oils & Ghee,Groundnut oil 5 L,9,1800,"1,600.00",200,1
05-05-2025,Beverages,BISLERI 100ml,1,10,10,0,1
05-05-2025,Snacks & Ready-to-Eat,SD FINGER Millet with palm Jaggery 250gm,14,270,270,0,2
05-05-2025,Sweeteners,SD PALM JAGGERY 500GM,16,200,200,0,1
05-05-2025,"Grains, Flours & Dals",Multigrain 1 kg,4,600,510,90,6
05-05-2025,Snacks & Ready-to-Eat,SD JOWAR WITH PALM JAGGERY 250GM,14,135,135,0,1
05-05-2025,Snacks & Ready-to-Eat,VD PALLI CHIKKI,14,80,80,0,1
05-05-2025,Snacks & Ready-to-Eat,NAVARATNA MIX,14,60,60,0,1
05-05-2025,Snacks & Ready-to-Eat,VD PALLI LADDU,14,80,80,0,1
05-05-2025,Beverages,BISLERI 100ml,1,10,10,0,1
05-05-2025,Snacks & Ready-to-Eat,VD MURMURA LADDU,14,50,50,0,1
05-05-2025,"Grains, Flours & Dals",SL Idly Rava 1KG,4,65,55,10,1
05-05-2025,Snacks & Ready-to-Eat,BATANA NGT 70GMS,14,20,20,0,1
05-05-2025,Misc,VD0001,8,100,100,0,1
05-05-2025,"Dry Fruits, Nuts & Seeds",DIANUTS 500GM,2,120,120,0,1
05-05-2025,"Grains, Flours & Dals",unpolished turdall500grms,4,120,110,10,1
05-05-2025,Spices & Seasonings,3M.MIRCHI POWDER,15,360,320,40,1
05-05-2025,Spices & Seasonings,MUSTARD POWDER 250G,15,65,55,10,1
05-05-2025,Snacks & Ready-to-Eat,SD JOWAR WITH PALM JAGGERY 250GM,14,135,135,0,1
05-05-2025,Spices & Seasonings,Menthulu 250 gms,15,50,45,5,1
05-05-2025,Snacks & Ready-to-Eat,GREEN FRIED BATANA,14,20,20,0,1
05-05-2025,"Health, Wellness & Ayurvedic Products",SAI DURGA MORINGA LEAVES 100GM,5,75,75,0,1
05-05-2025,"Health, Wellness & Ayurvedic Products",MD Aamlaki Choornam 100GM,5,80,80,0,1
05-05-2025,"Grains, Flours & Dals",HS RAGI FLAKES 250GM 1+1,4,119,119,0,1
05-05-2025,"Health, Wellness & Ayurvedic Products",MD Aamlaki Choornam 100GM,5,400,400,0,5
05-05-2025,Spices & Seasonings,Lavangam 50GM,15,300,250,50,5
05-05-2025,Spices & Seasonings,dalchin chekka,15,250,200,50,5
05-05-2025,Spices & Seasonings,SAJEERA,15,300,200,100,5
05-05-2025,Spices & Seasonings,SATHVI ANASAPUVUU 25GM,15,450,325,125,5
05-05-2025,Spices & Seasonings,Menthulu 250 gms,15,50,45,5,1
05-05-2025,Spices & Seasonings,Coriander seeds 200 gms,15,48,40,8,1
05-05-2025,"Grains, Flours & Dals",KORRALU (FOXTAIL M) 500GM,4,65,55,10,1
05-05-2025,"Health, Wellness & Ayurvedic Products",MD Aamlaki Choornam 100GM,5,80,80,0,1
05-05-2025,Oils & Ghee,Coconut oil 500 ml,9,220,200,20,1
05-05-2025,"Grains, Flours & Dals",Multigrain 1 kg,4,100,85,15,1
05-05-2025,Spices & Seasonings,menthulu,15,90,90,0,1
05-05-2025,Oils & Ghee,Groundnut oil 1 L,9,330,330,0,1
05-05-2025,"Grains, Flours & Dals",BARLEY SEEDS 500 GM,4,90,70,20,1
05-05-2025,"Grains, Flours & Dals",RAGI FLOUR 500GRMS,4,40,35,5,1
05-05-2025,Oils & Ghee,Coconut oil 500 ml,9,220,200,20,1
05-05-2025,"Grains, Flours & Dals",Wheat Flour 1 kg,4,140,120,20,2
05-05-2025,Spices & Seasonings,JEERA 250 gms,15,125,105,20,1
05-05-2025,"Grains, Flours & Dals",Wheat Rava M 1KG,4,65,55,10,1
05-05-2025,Snacks & Ready-to-Eat,GANTASALA FLAX SEEDS SPICY,14,240,240,0,3
05-05-2025,Oils & Ghee,Groundnut oil 1 L,9,330,330,0,1
05-05-2025,"Grains, Flours & Dals",Wheat Flour 1 kg,4,140,120,20,2
05-05-2025,Snacks & Ready-to-Eat,VD MINAPA VADIYAM,14,65,65,0,1
05-05-2025,Spices & Seasonings,SAJEERA,15,60,40,20,1
05-05-2025,Oils & Ghee,sesame oil 1L,9,590,560,30,1
05-05-2025,Snacks & Ready-to-Eat,VD MINAPA VADIYAM,14,65,65,0,1
05-05-2025,Spices & Seasonings,SAJEERA,15,60,40,20,1
05-05-2025,Spices & Seasonings,lavangam,15,50,50,0,1
05-05-2025,"Grains, Flours & Dals",Wheat Flour 1 kg,4,140,120,20,2
05-05-2025,"Grains, Flours & Dals",yellow jowar flour 1kg,4,100,92,8,1
05-05-2025,"Grains, Flours & Dals",Bajra Flour 1 kg,4,70,60,10,1
05-05-2025,Spices & Seasonings,AVALU 250grms,15,80,80,0,2
05-05-2025,"Grains, Flours & Dals",Urad dall 1 Kg,4,185,170,15,1
05-05-2025,"Dry Fruits, Nuts & Seeds",Groundnuts 1 kg,2,190,165,25,1
05-05-2025,Spices & Seasonings,Menthulu 250 gms,15,50,45,5,1
05-05-2025,"Grains, Flours & Dals",Quinova 500 gms,4,110,100,10,1
05-05-2025,"Dry Fruits, Nuts & Seeds",SABJA SEEDS,2,70,70,0,1
05-05-2025,Snacks & Ready-to-Eat,VD PALLI CHIKKI,14,80,80,0,1
05-05-2025,Snacks & Ready-to-Eat,NGT CHATPATTA CHANA 90GM,14,50,50,0,2
05-05-2025,Snacks & Ready-to-Eat,SD Moringa with plam jaggery 250gm,14,135,135,0,1
05-05-2025,Oils & Ghee,Coconut oil 500 ml,9,220,200,20,1
05-05-2025,Snacks & Ready-to-Eat,SD Flax seeds with dates 250gm,14,135,135,0,1
05-05-2025,Personal Care & Cosmetics,KHADI MIX FRUIT SOAP 125GM,10,80,80,0,1
05-05-2025,Personal Care & Cosmetics,MYSORE SANDAL SOAP 75G,10,168,168,0,4
05-05-2025,Snacks & Ready-to-Eat,SD Aswagandha with palm Jaggery250Gm,14,135,135,0,1
05-05-2025,Spices & Seasonings,JEERA 250 gms,15,125,105,20,1
05-05-2025,"Grains, Flours & Dals",Green Batani 250GM,4,55,45,10,1
05-05-2025,Spices & Seasonings,Coriander seeds 200 gms,15,48,40,8,1
05-05-2025,"Dry Fruits, Nuts & Seeds",PUMPKIN SEEDS 250GM,2,200,160,40,1
05-05-2025,Milk & Dairy,BROWN EGGS TRAY 30P,7,360,330,30,1
05-05-2025,Oils & Ghee,Sesame oil 500ml,9,295,280,15,1
05-05-2025,Spices & Seasonings,Telaga Pindi 250 GM,15,40,35,5,1
05-05-2025,Personal Care & Cosmetics,GAYATHRI KUMKUDUKAYA,10,900,900,0,6
05-05-2025,"Grains, Flours & Dals",White jowar.F 1 kg,4,100,80,20,1
05-05-2025,"Grains, Flours & Dals",DOCTOR RICE DIABETIC SFR 5KG,4,600,600,0,1
05-05-2025,Milk & Dairy,SANGAM TONED MILK 500ML,7,31,31,0,1
05-05-2025,Sweeteners,Natural Honey 500 gms,16,280,240,40,1
05-05-2025,Snacks & Ready-to-Eat,SUNNUNDALU,14,120,120,0,1
05-05-2025,Spices & Seasonings,SAJEERA,15,60,40,20,1
05-05-2025,Milk & Dairy,BROWN EGGS 1P,7,140,120,20,10
05-05-2025,"Grains, Flours & Dals",Multigrain 1 kg,4,200,170,30,2
05-05-2025,Snacks & Ready-to-Eat,Sprouted Ragi Biscuits 450GM,14,150,150,0,1
05-05-2025,Spices & Seasonings,Elaichi 25GM,15,145,120,25,1
05-05-2025,"Dry Fruits, Nuts & Seeds",FLAX SEEDS 250GM,2,60,50,10,1
05-05-2025,Snacks & Ready-to-Eat,BD KODO MILLET NOODLES 200GM,14,75,75,0,1
05-05-2025,Snacks & Ready-to-Eat,VD MINAPA VADIYAM,14,65,65,0,1
05-05-2025,"Grains, Flours & Dals",EM kodo upma R 500g,4,129,129,0,1
05-05-2025,"Grains, Flours & Dals",Urad dall 1 Kg,4,185,170,15,1
05-05-2025,"Grains, Flours & Dals",white Bobarlu 500 gms,4,80,75,5,1
05-05-2025,Spices & Seasonings,MUSTARD POWDER 250G,15,65,55,10,1
05-05-2025,"Grains, Flours & Dals",split green gram 500 gms,4,75,70,5,1
05-05-2025,Spices & Seasonings,AVALU 100GM,15,25,20,5,1
05-05-2025,Spices & Seasonings,SAJEERA,15,60,40,20,1
05-05-2025,Spices & Seasonings,LG 50GM,15,92,92,0,1
05-05-2025,Milk & Dairy,BROWN EGGS 1P,7,168,144,24,12
05-05-2025,"Grains, Flours & Dals",chana flour 500 gms,4,60,54,6,1
05-05-2025,"Grains, Flours & Dals",Wheat Flour 1 kg,4,140,120,20,2
05-05-2025,Spices & Seasonings,Jeera 100GM,15,50,45,5,1
05-05-2025,Milk & Dairy,HRITAGE TOTAL CURD 130GM,7,10,10,0,1
05-05-2025,General Household & Kitchenware,MATCH BOX,3,10,10,0,1
05-05-2025,Spices & Seasonings,pickle chili powder,15,180,165,15,1
05-05-2025,Spices & Seasonings,idli karam powdwer,15,70,70,0,1
05-05-2025,Sweeteners,sugar 500 gms,16,30,28,2,1
05-05-2025,Oils & Ghee,Groundnut oil 1 L,9,330,330,0,1
05-05-2025,"Grains, Flours & Dals",SL Idly Rava 1KG,4,130,110,20,2
05-05-2025,Milk & Dairy,HERITAGE TONED MILK 500ML,7,31,31,0,1
05-05-2025,Milk & Dairy,HERTG FULL CREAM M,7,41,41,0,1
05-05-2025,Snacks & Ready-to-Eat,SATHVI REGIVADA 200GM,14,80,60,20,1
05-05-2025,Milk & Dairy,BROWN EGGS 1P,7,350,300,50,25
05-05-2025,"Health, Wellness & Ayurvedic Products",MH Millets Malt 500GM,5,400,380,20,2
05-05-2025,Oils & Ghee,sesame oil 1L,9,1180,"1,120.00",60,2
05-05-2025,Oils & Ghee,Sesame oil 500ml,9,295,280,15,1
05-05-2025,Snacks & Ready-to-Eat,SD SESAME PAPAD,14,80,80,0,1
05-05-2025,"Grains, Flours & Dals",AISHWARYA SP 1KG,4,160,140,20,2
05-05-2025,"Grains, Flours & Dals",VGR rice 1 kg,4,350,325,25,5
05-05-2025,Snacks & Ready-to-Eat,VD MINAPA VADIYAM,14,65,65,0,1
05-05-2025,Beverages,GANTASALA TEJ DRY GINGER COFFEE,1,149,149,0,1
05-05-2025,Snacks & Ready-to-Eat,VD PAPPU CHEGODI 200GM,14,60,60,0,1
05-05-2025,Milk & Dairy,BUTTER MILK,7,20,20,0,2
05-05-2025,Spices & Seasonings,Turmeric powder 250 gms,15,100,80,20,1
05-05-2025,Oils & Ghee,sesame oil 1L,9,1770,"1,680.00",90,3
05-05-2025,"Dry Fruits, Nuts & Seeds",Groundnuts 1 kg,2,190,165,25,1
05-05-2025,Oils & Ghee,Groundnut oil 1 L,9,330,330,0,1
05-05-2025,"Grains, Flours & Dals",yellow jowar flour 1kg,4,100,92,8,1
05-05-2025,"Dry Fruits, Nuts & Seeds",FLAX SEEDS 250GM,2,120,100,20,2
05-05-2025,"Grains, Flours & Dals",Multigrain 1 kg,4,100,85,15,1
05-05-2025,Oils & Ghee,Coconut oil 500 ml,9,220,200,20,1
05-05-2025,Milk & Dairy,BROWN EGGS 1P,7,336,288,48,24
05-05-2025,"Grains, Flours & Dals",Wheat Flour 1 kg,4,140,120,20,2
05-05-2025,"Grains, Flours & Dals",Brown RICE 1KG,4,210,195,15,3
05-05-2025,"Dry Fruits, Nuts & Seeds",Groundnuts 1 kg,2,190,165,25,1
05-05-2025,"Grains, Flours & Dals",unpolished turdall500grms,4,120,110,10,1
05-05-2025,"Grains, Flours & Dals",turdal 500 gms,4,110,85,25,1
05-05-2025,"Dry Fruits, Nuts & Seeds",Putnalu 250GM,2,45,38,7,1
05-05-2025,"Grains, Flours & Dals",turdal 1kg,4,220,170,50,1
05-05-2025,"Grains, Flours & Dals",Wheat Flour 1 kg,4,210,180,30,3
05-05-2025,Snacks & Ready-to-Eat,BROWN BREAD,14,55,55,0,1
05-05-2025,"Dry Fruits, Nuts & Seeds",SABJA SEEDS,2,70,70,0,1
05-05-2025,Personal Care & Cosmetics,MD Henna Choornam 100GM,10,80,80,0,1
05-05-2025,"Grains, Flours & Dals",Wheat Flour 1 kg,4,70,60,10,1
05-05-2025,Misc,ROLL D C,8,70,45,25,1
05-05-2025,General Household & Kitchenware,MATCH BOX,3,20,20,0,1
05-05-2025,Oils & Ghee,Groundnut oil 1 L,9,990,990,0,3
05-05-2025,Spices & Seasonings,beetroot powder,15,149,149,0,1
05-05-2025,"Health, Wellness & Ayurvedic Products",MD Hibiscus Flower Choornam 30GM,5,100,100,0,1
05-05-2025,Oils & Ghee,Groundnut oil 1 L,9,660,660,0,2
05-05-2025,Snacks & Ready-to-Eat,RINGS 200GM,14,30,30,0,1
05-05-2025,"Grains, Flours & Dals",AISHWARYA SP 1KG,4,320,280,40,4
05-05-2025,"Grains, Flours & Dals",VGR rice 1 kg,4,140,130,10,2
05-05-2025,"Grains, Flours & Dals",Urad dall 1 Kg,4,185,170,15,1
05-05-2025,Snacks & Ready-to-Eat,FOXTAIL BIS,14,135,135,0,1
05-05-2025,"Grains, Flours & Dals",Wheat Rava S 500GM,4,66,60,6,2
05-05-2025,Oils & Ghee,Groundnut oil 500ml,9,180,165,15,1
05-05-2025,Snacks & Ready-to-Eat,VD MURMURA LADDU,14,50,50,0,1
05-05-2025,"Grains, Flours & Dals",MELMEKER 250GMS,4,60,45,15,1
05-05-2025,Spices & Seasonings,Turmeric powder 250 gms,15,100,80,20,1
05-05-2025,"Grains, Flours & Dals",Multigrain 1 kg,4,200,170,30,2
05-05-2025,Snacks & Ready-to-Eat,VD RIBBON PAKODI 175GM,14,60,60,0,1
05-05-2025,Spices & Seasonings,Chilli powder 500 gms,15,290,210,80,1
05-05-2025,Snacks & Ready-to-Eat,KB MILK JUNNU POW 100GM,14,160,160,0,2
05-05-2025,Sweeteners,sugar 500 gms,16,30,28,2,1
05-05-2025,Beverages,BRU GREEN LABEL 1.2G,1,10,10,0,5
05-05-2025,Snacks & Ready-to-Eat,GB SALT COOKIES,14,60,55,5,1
05-05-2025,"Grains, Flours & Dals",FLOUR CHARGE,4,12,12,0,1
05-05-2025,Spices & Seasonings,GREEN SOUNF,15,60,40,20,1
05-05-2025,"Grains, Flours & Dals",Green gram 500 gms,4,75,70,5,1
05-05-2025,Snacks & Ready-to-Eat,VD MURUKU 175GM,14,60,60,0,1
05-05-2025,Snacks & Ready-to-Eat,VD MIXTURE 175 GM,14,60,60,0,1
05-05-2025,Snacks & Ready-to-Eat,VD MURMURA LADDU,14,50,50,0,1
05-05-2025,Spices & Seasonings,gd asafoetida,15,90,90,0,1
05-05-2025,"Grains, Flours & Dals",Multigrain 1 kg,4,300,255,45,3
05-05-2025,"Health, Wellness & Ayurvedic Products",MADDI NEEM OIL 100ML,5,110,110,0,1
05-05-2025,"Grains, Flours & Dals",SH PANCHARATNA DALL,4,384,384,0,3
05-05-2025,"Grains, Flours & Dals",DH URAD GOTA 1KG,4,215,190,25,1
05-05-2025,"Grains, Flours & Dals",SAMALU (Little millet) 500 gms,4,85,65,20,1
05-05-2025,"Grains, Flours & Dals",UNPOLISHED TURDALL 1KG,4,240,210,30,1
05-05-2025,Spices & Seasonings,Coriander seeds 200 gms,15,48,40,8,1
05-05-2025,"Grains, Flours & Dals",Quinova 500 gms,4,110,100,10,1
05-05-2025,"Grains, Flours & Dals",KORRALU (FOXTAIL M) 500GM,4,65,55,10,1
05-05-2025,"Grains, Flours & Dals",Arikalu (kodo),4,70,65,5,1
04-05-2025,"Grains, Flours & Dals",AISHWARYA SP 1KG,4,80,70,10,1
04-05-2025,Snacks & Ready-to-Eat,VD PAPPU CHEGODI 200GM,14,60,60,0,1
04-05-2025,"Grains, Flours & Dals",Em kodo idli R 500G,4,258,258,0,2
04-05-2025,"Dry Fruits, Nuts & Seeds",PUMPKIN SEEDS 250GM,2,200,160,40,1
04-05-2025,"Dry Fruits, Nuts & Seeds",ALMONDS 250GM,2,280,260,20,1
04-05-2025,"Dry Fruits, Nuts & Seeds",cashew,2,340,310,30,1
04-05-2025,"Dry Fruits, Nuts & Seeds",FLAX SEEDS 250GM,2,120,100,20,2
04-05-2025,Snacks & Ready-to-Eat,MB FOXTAIL MILLET NOODLES 180GM,14,95,95,0,1
04-05-2025,Spices & Seasonings,AV Iodized Salt 1KG,15,28,25,3,1
04-05-2025,Spices & Seasonings,AVALU 250grms,15,60,60,0,1
04-05-2025,Household & Cleaning,VIM MAHA BAR,6,50,50,0,5
04-05-2025,"Dry Fruits, Nuts & Seeds",PUMPKIN SEEDS 250GM,2,200,160,40,1
04-05-2025,Spices & Seasonings,JEERA 250 gms,15,125,105,20,1
04-05-2025,Snacks & Ready-to-Eat,MB LITTLE MILLET NOODLES 180G,14,95,95,0,1
04-05-2025,"Grains, Flours & Dals",Wheat Flour 1 kg,4,140,120,20,2
04-05-2025,"Dry Fruits, Nuts & Seeds",ANJEER 250GM,2,400,360,40,1
04-05-2025,"Grains, Flours & Dals",RAGULU 1 KG,4,70,60,10,1
04-05-2025,Oils & Ghee,cow ghee 500 ml,9,430,390,40,1
04-05-2025,"Grains, Flours & Dals",Bajra Flour 1 kg,4,70,60,10,1
04-05-2025,"Grains, Flours & Dals",SL Idly Rava 1KG,4,65,55,10,1
04-05-2025,Sweeteners,Natural Honey 500 gms,16,280,240,40,1
04-05-2025,Spices & Seasonings,DURGA SALT CRYSTAL 1KG,15,75,75,0,3
04-05-2025,Oils & Ghee,sesame oil 1L,9,590,560,30,1
04-05-2025,"Grains, Flours & Dals",Urad dall 1 Kg,4,185,170,15,1
04-05-2025,"Grains, Flours & Dals",JOWAR WHITE 1 KG,4,80,70,10,1
04-05-2025,"Grains, Flours & Dals",BAJRA 1 KG,4,30,25,5,0.5
04-05-2025,"Grains, Flours & Dals",White jowar.F 1 kg,4,100,80,20,1
04-05-2025,Beverages,BISLERI 100ml,1,10,10,0,1
04-05-2025,Snacks & Ready-to-Eat,VD DAHI MIRCHI(SALTED) 100GM,14,45,45,0,1
04-05-2025,Snacks & Ready-to-Eat,SD SESAME PAPAD,14,80,80,0,1
04-05-2025,Spices & Seasonings,PALLI KARAM G,15,75,75,0,1
04-05-2025,Spices & Seasonings,SD Garlic Karam Powder 100GM,15,70,70,0,1
04-05-2025,Milk & Dairy,HRITAGE TOTAL CURD 130GM,7,10,10,0,1
04-05-2025,"Health, Wellness & Ayurvedic Products",SAI DURGA MORINGA LEAVES 100GM,5,75,75,0,1
04-05-2025,"Grains, Flours & Dals",chana flour 500 gms,4,60,54,6,1
04-05-2025,Spices & Seasonings,Jeera 100GM,15,50,45,5,1
04-05-2025,Spices & Seasonings,RED COPRA 250GMS,15,85,74,11,1
04-05-2025,Beverages,BISLERI SODA 750ML,1,40,40,0,2
04-05-2025,"Grains, Flours & Dals",CHANA DALL 250GM,4,28,24,4,1
04-05-2025,"Grains, Flours & Dals",Wheat Rava M 1KG,4,65,55,10,1
04-05-2025,"Grains, Flours & Dals",HS MULTI UPMA RAVA,4,65,65,0,1
04-05-2025,Oils & Ghee,Groundnut oil 1 L,9,330,330,0,1
04-05-2025,Snacks & Ready-to-Eat,BATANA NGT 70GMS,14,40,40,0,2
04-05-2025,Spices & Seasonings,lavangam,15,50,50,0,1
04-05-2025,Snacks & Ready-to-Eat,HS JOWAR BISCUITS,14,50,50,0,1
04-05-2025,"Grains, Flours & Dals",ragi umpa ravva,4,70,70,0,1
04-05-2025,Snacks & Ready-to-Eat,NGT CHATPATTA CHANA 90GM,14,25,25,0,1
04-05-2025,Snacks & Ready-to-Eat,VD CORNFLAKES MIXTURE 175GM,14,60,60,0,1
04-05-2025,Pooja & Spiritual Items,s karpuram,12,180,180,0,1
04-05-2025,"Grains, Flours & Dals",Sathya Javva Wheat Rava 500GM,4,95,90,5,1
04-05-2025,"Grains, Flours & Dals",JOWAR UPMA RAVA,4,65,65,0,1
04-05-2025,Sweeteners,YB Brown Sugar 500GM,16,140,140,0,2
04-05-2025,"Grains, Flours & Dals",MULTIMILLET IDLY RAVVA,4,65,65,0,1
04-05-2025,"Grains, Flours & Dals",MELMEKER 250GMS,4,60,45,15,1
04-05-2025,"Grains, Flours & Dals",AISHWARYA SP 1KG,4,880,770,110,11
04-05-2025,Snacks & Ready-to-Eat,SAGOPAPAD RED CHILLI VD,14,55,55,0,1
04-05-2025,Snacks & Ready-to-Eat,BATANA NGT 70GMS,14,20,20,0,1
04-05-2025,Snacks & Ready-to-Eat,SD FINGER Millet with palm Jaggery 250gm,14,135,135,0,1
04-05-2025,Snacks & Ready-to-Eat,NGT CHATPATTA CHANA 90GM,14,50,50,0,2
04-05-2025,"Grains, Flours & Dals",Multigrain 1 kg,4,100,85,15,1
04-05-2025,Personal Care & Cosmetics,GOW DURBAR 75G,10,96,96,0,1
04-05-2025,"Grains, Flours & Dals",KORRALU (FOXTAIL M) 1KG,4,150,110,40,1
04-05-2025,"Dry Fruits, Nuts & Seeds",wallnuts,2,380,320,60,1
04-05-2025,"Grains, Flours & Dals",BARLEY SEEDS 500 GM,4,90,70,20,1
04-05-2025,"Dry Fruits, Nuts & Seeds",FLAX SEEDS 250GM,2,60,50,10,1
04-05-2025,"Grains, Flours & Dals",HEALTH JOWAR RAWA,4,99,99,0,1
04-05-2025,"Grains, Flours & Dals",BARLEY SEEDS 500 GM,4,90,70,20,1
04-05-2025,"Grains, Flours & Dals",SL Idly Rava 1KG,4,65,55,10,1
04-05-2025,"Grains, Flours & Dals",EM Ragi upma R 500g,4,75,75,0,1
04-05-2025,"Grains, Flours & Dals",JOWAR UPMA RAVA,4,75,75,0,1
04-05-2025,"Grains, Flours & Dals",turdal 1kg,4,440,340,100,2
04-05-2025,Spices & Seasonings,NUVVULU 500GM,15,160,130,30,1
04-05-2025,Spices & Seasonings,Chilli powder 250 gms,15,145,110,35,1
04-05-2025,"Grains, Flours & Dals",POORI ATTA 500GM,4,70,60,10,2
04-05-2025,Snacks & Ready-to-Eat,SD Sesame laddu with dates250gm,14,135,135,0,1
04-05-2025,"Dry Fruits, Nuts & Seeds",Groundnuts 1 kg,2,190,165,25,1
04-05-2025,Snacks & Ready-to-Eat,BD RED RICE NOODLES 200G,14,70,70,0,1
04-05-2025,Snacks & Ready-to-Eat,VD MURMURA LADDU,14,50,50,0,1
04-05-2025,"Grains, Flours & Dals",HS BARLEY FLAKES 250GM 1+1,4,119,119,0,1
04-05-2025,"Grains, Flours & Dals",RAGI FLOUR 1KG,4,80,70,10,1
04-05-2025,Spices & Seasonings,sf jeera,15,120,120,0,1
04-05-2025,"Grains, Flours & Dals",Multigrain 1 kg,4,100,85,15,1
04-05-2025,Snacks & Ready-to-Eat,DISANO MACARONI 850GM,14,105,105,0,1
04-05-2025,Personal Care & Cosmetics,GAYATHRI KUMKUDUKAYA,10,150,150,0,1
04-05-2025,Snacks & Ready-to-Eat,SIRI ICE CREAM 100ML,14,100,80,20,1
04-05-2025,"Grains, Flours & Dals",doctor rice 1kg,4,120,120,0,1
04-05-2025,"Dry Fruits, Nuts & Seeds",DRYDATES 250GM,2,150,120,30,1
04-05-2025,Personal Care & Cosmetics,SVE SHIKAKAI SOAP 100GM,10,100,100,0,1
04-05-2025,Oils & Ghee,cow ghee 500 ml,9,430,390,40,1
04-05-2025,Oils & Ghee,sesame oil 1L,9,590,560,30,1
04-05-2025,Snacks & Ready-to-Eat,VD DAHI MIRCHI(SALTED) 100GM,14,45,45,0,1
04-05-2025,"Grains, Flours & Dals",YELLOW JOWER 1KG,4,180,160,20,2
04-05-2025,"Grains, Flours & Dals",KORRALU (FOXTAIL M) 1KG,4,150,110,40,1
04-05-2025,Snacks & Ready-to-Eat,SD Atreyapuram DRY Fruit ghee,14,150,150,0,1
04-05-2025,"Grains, Flours & Dals",Em kodo idli R 500G,4,129,129,0,1
04-05-2025,"Grains, Flours & Dals",AISHWARYA SP 1KG,4,240,210,30,3
04-05-2025,"Grains, Flours & Dals",RICE FLOUR 500 GM,4,70,56,14,2
04-05-2025,"Grains, Flours & Dals",Wheat Flour 1 kg,4,140,120,20,2
04-05-2025,"Grains, Flours & Dals",RAGULU 1 KG,4,35,30,5,0.5
04-05-2025,"Grains, Flours & Dals",SA Sprouted Ragi Flour 500GM,4,69,69,0,1
04-05-2025,"Grains, Flours & Dals",AISHWARYA SP 5KG,4,400,375,25,1
04-05-2025,"Grains, Flours & Dals",SL Idly Rava 1KG,4,65,55,10,1
04-05-2025,Snacks & Ready-to-Eat,VD DRY FRUIT PUTHAREKULU,14,120,120,0,1
04-05-2025,"Grains, Flours & Dals",chana flour 500 gms,4,60,54,6,1
04-05-2025,"Grains, Flours & Dals",Multigrain 1 kg,4,100,85,15,1
04-05-2025,Spices & Seasonings,PICKLES CHILLIP 500 GMS,15,355,325,30,1
04-05-2025,"Grains, Flours & Dals",White jowar.F 1 kg,4,100,80,20,1
04-05-2025,Spices & Seasonings,GT PUDINA KARAM 100GM,15,75,75,0,1
04-05-2025,Personal Care & Cosmetics,MYSORE SANDAL SOAP 75G,10,42,42,0,1
04-05-2025,Household & Cleaning,vim pudina fresh,6,30,30,0,3
04-05-2025,"Grains, Flours & Dals",Green gram 1 kg,4,150,130,20,1
04-05-2025,"Dry Fruits, Nuts & Seeds",Groundnuts 500 gms,2,95,85,10,1
04-05-2025,"Grains, Flours & Dals",turdal 500 gms,4,110,85,25,1
04-05-2025,"Grains, Flours & Dals",CHANA DAL 500GM,4,56,48,8,1
04-05-2025,"Grains, Flours & Dals",Red Chana 500 GM,4,75,60,15,1
04-05-2025,"Grains, Flours & Dals",SABDANA,4,40,35,5,1
04-05-2025,"Grains, Flours & Dals",ULAVALU RED,4,90,75,15,1
04-05-2025,Misc,C123,8,95,80,15,1
04-05-2025,Oils & Ghee,cow ghee 500 ml,9,430,390,40,1
04-05-2025,Personal Care & Cosmetics,GOW DURBAR 75G,10,125,125,0,1
04-05-2025,"Dry Fruits, Nuts & Seeds",PUMPKIN SEEDS 250GM,2,200,160,40,1
04-05-2025,Snacks & Ready-to-Eat,KB MILK JUNNU POW 100GM,14,80,80,0,1
04-05-2025,"Grains, Flours & Dals",THICK POHA 500GM,4,40,35,5,1
04-05-2025,"Dry Fruits, Nuts & Seeds",Putnalu 250GM,2,45,38,7,1
04-05-2025,"Grains, Flours & Dals",PESARA PAPPU 500GMS,4,85,75,10,1
04-05-2025,Oils & Ghee,Coconut oil 1 L,9,440,400,40,1
04-05-2025,Household & Cleaning,vim dish liquid,6,55,55,0,1
04-05-2025,"Grains, Flours & Dals",Wheat Flour 1 kg,4,140,120,20,2
04-05-2025,"Dry Fruits, Nuts & Seeds",SATHVI CHIA SEEDS 100GM,2,100,80,20,1
04-05-2025,"Dry Fruits, Nuts & Seeds",SUNFLOWER SEEDS 250GRM,2,150,130,20,1
04-05-2025,Sweeteners,YB N FOREST HONEY 700 GM,16,400,400,0,1
04-05-2025,"Dry Fruits, Nuts & Seeds",ALMONDS 250GM,2,280,260,20,1
04-05-2025,Oils & Ghee,Groundnut oil 1 L,9,330,330,0,1
04-05-2025,Household & Cleaning,MR WHITE 500GM,6,48,48,0,1
04-05-2025,Oils & Ghee,sesame oil 1L,9,1180,"1,120.00",60,2
04-05-2025,Oils & Ghee,Groundnut oil 1 L,9,330,330,0,1
04-05-2025,Oils & Ghee,Black Sesame oil 1 L,9,440,380,60,1
04-05-2025,Spices & Seasonings,NUVVULU 500GM,15,160,130,30,1
04-05-2025,Spices & Seasonings,Jeera 100GM,15,50,45,5,1
04-05-2025,"Health, Wellness & Ayurvedic Products",SHIKAKAI CHOORNAM,5,80,80,0,1
04-05-2025,Spices & Seasonings,Jeera 100GM,15,100,90,10,2
04-05-2025,"Health, Wellness & Ayurvedic Products",MD Aamlaki Choornam 100GM,5,80,80,0,1
04-05-2025,Personal Care & Cosmetics,MD Henna Choornam 100GM,10,80,80,0,1
04-05-2025,Spices & Seasonings,Coriander seeds 200 gms,15,96,80,16,2
04-05-2025,Oils & Ghee,sesame oil 1L,9,590,560,30,1
04-05-2025,"Grains, Flours & Dals",Urad dall 1 Kg,4,277.5,255,22.5,1.5
04-05-2025,"Grains, Flours & Dals",Green gram 1 kg,4,150,130,20,1
04-05-2025,Spices & Seasonings,ROYAL SAFFRON 400GRMS,15,65,65,0,1
04-05-2025,"Dry Fruits, Nuts & Seeds",Groundnuts 500 gms,2,95,85,10,1
04-05-2025,Sweeteners,sugar 500 gms,16,30,28,2,1
04-05-2025,"Grains, Flours & Dals",SL Idly Rava 1KG,4,65,55,10,1
04-05-2025,"Grains, Flours & Dals",Wheat Rava S 1KG,4,65,55,10,1
04-05-2025,"Grains, Flours & Dals",Wheat Flour 1 kg,4,140,120,20,2
04-05-2025,"Grains, Flours & Dals",THICK POHA 500GM,4,40,35,5,1
04-05-2025,"Grains, Flours & Dals",Multigrain 1 kg,4,100,85,15,1
04-05-2025,"Grains, Flours & Dals",EM Foxtail idli r 500 g,4,109,109,0,1
04-05-2025,"Grains, Flours & Dals",SA YELLOW JOWAR RAVA 500GM,4,95,95,0,1
04-05-2025,Oils & Ghee,Safflower oil 500 ml,9,220,200,20,1
04-05-2025,"Dry Fruits, Nuts & Seeds",Groundnuts 500 gms,2,95,85,10,1
04-05-2025,"Grains, Flours & Dals",turdal 500 gms,4,110,85,25,1
04-05-2025,"Grains, Flours & Dals",SL Idly Rava 1KG,4,65,55,10,1
04-05-2025,Spices & Seasonings,Jeera 100GM,15,50,45,5,1
04-05-2025,"Grains, Flours & Dals",SA Sprouted Ragi Flour 500GM,4,69,69,0,1
04-05-2025,Pooja & Spiritual Items,s karpuram,12,180,180,0,1
04-05-2025,Milk & Dairy,BROWN EGGS 1P,7,84,72,12,6
04-05-2025,Snacks & Ready-to-Eat,NGT CHATPATTA CHANA 90GM,14,25,25,0,1
04-05-2025,Snacks & Ready-to-Eat,VD RIBBON PAKODI 175GM,14,60,60,0,1
04-05-2025,"Grains, Flours & Dals",JOWAR UPMA RAVA,4,75,75,0,1
04-05-2025,"Grains, Flours & Dals",UDALU (Barnyard millet) 500 gms,4,70,60,10,1
04-05-2025,"Grains, Flours & Dals",SAMALU (Little millet) 500 gms,4,85,65,20,1
04-05-2025,Spices & Seasonings,PRO ORG CORIANDER WHOLE 100G,15,70,70,0,1
04-05-2025,"Grains, Flours & Dals",Green gram 500 gms,4,75,70,5,1
04-05-2025,Spices & Seasonings,Menthulu 250 gms,15,50,45,5,1
04-05-2025,"Grains, Flours & Dals",SPLIT BLACK GRAM 500 GM,4,90,85,5,1
04-05-2025,"Grains, Flours & Dals",Arikalu (kodo),4,70,65,5,1
04-05-2025,"Grains, Flours & Dals",SA WHITE JOWAR RAVA 500GM,4,69,69,0,1
04-05-2025,"Grains, Flours & Dals",WHITE BATANI,4,40,30,10,1
04-05-2025,"Grains, Flours & Dals",Red Chana 250GM,4,35,30,5,1
04-05-2025,"Grains, Flours & Dals",split green gram 500 gms,4,75,70,5,1
04-05-2025,Snacks & Ready-to-Eat,ONION MURK,14,60,60,0,1
04-05-2025,"Grains, Flours & Dals",AISHWARYA SP 1KG,4,160,140,20,2
04-05-2025,"Grains, Flours & Dals",unpolished turdall500grms,4,120,110,10,1
04-05-2025,Spices & Seasonings,BIRYANI LEAF 10GM,15,30,20,10,1
04-05-2025,"Dry Fruits, Nuts & Seeds",wallnuts,2,380,320,60,1
04-05-2025,Milk & Dairy,SANGAM TONED MILK 500ML,7,31,31,0,1
04-05-2025,Spices & Seasonings,dalchin chekka,15,50,40,10,1
04-05-2025,Milk & Dairy,ID PANEER,7,135,135,0,1
04-05-2025,Pooja & Spiritual Items,GD SANDAL 150GM,12,110,110,0,1
04-05-2025,"Grains, Flours & Dals",HS JOWAR FLAKES 250GM 1+1,4,119,59.5,59.5,1
04-05-2025,Milk & Dairy,BROWN EGGS TRAY 30P,7,360,330,30,1
04-05-2025,Snacks & Ready-to-Eat,SD FINGER Millet with palm Jaggery 250gm,14,135,135,0,1
04-05-2025,Sweeteners,Natural Honey 500 gms,16,280,240,40,1
04-05-2025,Oils & Ghee,Groundnut oil 1 L,9,660,660,0,2
04-05-2025,Snacks & Ready-to-Eat,VD PAPPU CHEGODI 200GM,14,60,60,0,1
04-05-2025,Snacks & Ready-to-Eat,SATHVI REGIVADA 200GM,14,80,60,20,1
04-05-2025,Oils & Ghee,sesame oil 1L,9,1180,"1,120.00",60,2
04-05-2025,Spices & Seasonings,SATHVI ANASAPUVUU 25GM,15,90,65,25,1
04-05-2025,Personal Care & Cosmetics,MD Henna Choornam 100GM,10,80,80,0,1
04-05-2025,"Grains, Flours & Dals",Urad dall 500 gms,4,95,85,10,1
04-05-2025,"Grains, Flours & Dals",SL Suji Rava 500GM,4,32,32,0,1
04-05-2025,"Dry Fruits, Nuts & Seeds",Groundnuts 500 gms,2,95,85,10,1
04-05-2025,Milk & Dairy,HERITAGE TOTAL CURD 500GM,7,50,50,0,1
04-05-2025,"Health, Wellness & Ayurvedic Products",MD Aamlaki Choornam 100GM,5,100,100,0,1
04-05-2025,Oils & Ghee,Coconut oil 500 ml,9,220,200,20,1
04-05-2025,Oils & Ghee,sesame oil 1L,9,590,560,30,1
04-05-2025,Oils & Ghee,Sesame oil 500ml,9,295,280,15,1
04-05-2025,Oils & Ghee,Groundnut oil 1 L,9,660,660,0,2
04-05-2025,Spices & Seasonings,RED COPRA 500GM,15,170,148,22,1
04-05-2025,Misc,C123,8,95,80,15,1
04-05-2025,General Household & Kitchenware,MATCH BOX,3,20,20,0,1
04-05-2025,Oils & Ghee,Black Sesame oil 1 L,9,440,380,60,1
04-05-2025,"Dry Fruits, Nuts & Seeds",FLAX SEEDS 250GM,2,60,50,10,1
04-05-2025,"Health, Wellness & Ayurvedic Products",MD Mandara Leaf Powder 50GM,5,100,100,0,1
04-05-2025,Oils & Ghee,Sesame oil 5 L,9,2950,"2,750.00",200,1
04-05-2025,"Grains, Flours & Dals",JOWAR UPMA RAVA,4,65,65,0,1
04-05-2025,"Grains, Flours & Dals",yellow jowar flour 1kg,4,100,92,8,1
04-05-2025,Oils & Ghee,Groundnut oil 1 L,9,990,990,0,3
04-05-2025,"Grains, Flours & Dals",IDLY RAVA 1KG,4,60,50,10,1
04-05-2025,Oils & Ghee,rice bran oil f,9,194,169,25,1
04-05-2025,"Grains, Flours & Dals",Multigrain 1 kg,4,200,170,30,2
04-05-2025,"Grains, Flours & Dals",RAGI FLOUR 1KG,4,80,70,10,1
04-05-2025,Sweeteners,organic jaggery powder,16,99,99,0,1
04-05-2025,Sweeteners,YB JAGGERY POWDER 1KG,16,140,140,0,1
04-05-2025,"Dry Fruits, Nuts & Seeds",Groundnuts 1 kg,2,190,165,25,1
04-05-2025,Snacks & Ready-to-Eat,PEANUT CHILLI,14,25,25,0,5
04-05-2025,"Grains, Flours & Dals",split black gram 1 kg,4,180,170,10,1
04-05-2025,"Dry Fruits, Nuts & Seeds",SABJA SEEDS,2,70,70,0,1
04-05-2025,Spices & Seasonings,TATA SALT 1KG,15,30,30,0,1
04-05-2025,"Grains, Flours & Dals",POORI ATTA 500GM,4,35,30,5,1
04-05-2025,"Grains, Flours & Dals",MELMEKER 250GMS,4,60,45,15,1
04-05-2025,Snacks & Ready-to-Eat,SF MIGHTY PUFFS,14,25,25,0,1
04-05-2025,"Grains, Flours & Dals",SABDANA,4,40,35,5,1
04-05-2025,Snacks & Ready-to-Eat,NGT CHATPATTA CHANA 90GM,14,20,20,0,1
04-05-2025,Oils & Ghee,Groundnut oil 1 L,9,330,330,0,1
04-05-2025,"Dry Fruits, Nuts & Seeds",FLAX SEEDS 250GM,2,60,50,10,1
04-05-2025,"Dry Fruits, Nuts & Seeds",PUMPKIN SEEDS 250GM,2,200,160,40,1
04-05-2025,"Dry Fruits, Nuts & Seeds",WATERMELON SEEDS 250GRM,2,320,280,40,1
04-05-2025,"Dry Fruits, Nuts & Seeds",SUNFLOWER SEEDS 250GRM,2,150,130,20,1
04-05-2025,Snacks & Ready-to-Eat,SIRI ICE CREAM 500ML,14,460,260,200,1
04-05-2025,"Grains, Flours & Dals",JOWAR WHITE 1 KG,4,80,70,10,1
04-05-2025,Oils & Ghee,sesame oil 1L,9,1180,"1,120.00",60,2
04-05-2025,"Grains, Flours & Dals",Red Wheat Flour 1 kg,4,140,130,10,1
04-05-2025,"Grains, Flours & Dals",RAGI FLOUR 500GRMS,4,40,35,5,1
04-05-2025,"Grains, Flours & Dals",Wheat Flour 1 kg,4,70,60,10,1
04-05-2025,Snacks & Ready-to-Eat,SIRI ICE CREAM 100ML,14,300,240,60,3
04-05-2025,"Grains, Flours & Dals",Multigrain 1 kg,4,100,85,15,1
04-05-2025,Oils & Ghee,Groundnut oil 1 L,9,660,660,0,2
04-05-2025,Snacks & Ready-to-Eat,VD MURMURA LADDU,14,50,50,0,1
04-05-2025,Snacks & Ready-to-Eat,VD PALLI LADDU,14,80,80,0,1
04-05-2025,"Grains, Flours & Dals",SRILATHA RICE RAVVA 500GM,4,35,35,0,1
04-05-2025,"Grains, Flours & Dals",SRILATHA RICE RAVVA 500GM,4,70,70,0,2
04-05-2025,Oils & Ghee,Groundnut oil 1 L,9,330,330,0,1
04-05-2025,Snacks & Ready-to-Eat,VD PALLI LADDU,14,80,80,0,1
04-05-2025,"Health, Wellness & Ayurvedic Products",ORGANIC MORINGA POWER 100GM,5,249,249,0,1
04-05-2025,Snacks & Ready-to-Eat,SIRI ICE CREAM 100ML,14,100,80,20,1
04-05-2025,Snacks & Ready-to-Eat,SIRI ICE CREAM 100ML,14,100,80,20,1
04-05-2025,Spices & Seasonings,ROYAL SAFFRON 400GRMS,15,195,195,0,3
04-05-2025,Spices & Seasonings,RED COPRA 250GMS,15,85,74,11,1
04-05-2025,"Grains, Flours & Dals",EM Foxtail idli r 500 g,4,109,109,0,1
04-05-2025,"Grains, Flours & Dals",SL Suji Rava 500GM,4,32,32,0,1
04-05-2025,"Grains, Flours & Dals",SH WHITE POHA 500GM,4,75,75,0,1
04-05-2025,Spices & Seasonings,SONTI 50GM,15,30,20,10,1
04-05-2025,Snacks & Ready-to-Eat,VD DAHI MIRCHI(SALTED) 100GM,14,45,45,0,1
04-05-2025,Oils & Ghee,Safflower oil 500 ml,9,220,200,20,1
04-05-2025,Spices & Seasonings,DURGA SALT CRYSTAL 1KG,15,25,25,0,1
04-05-2025,Snacks & Ready-to-Eat,VD Pappu Chekkalu 190gm,14,60,60,0,1
04-05-2025,Snacks & Ready-to-Eat,VD BOONDI 175GM,14,60,60,0,1
04-05-2025,Snacks & Ready-to-Eat,SATHVI REGIVADA 200GM,14,80,60,20,1
04-05-2025,Spices & Seasonings,Jeera 100GM,15,50,45,5,1
04-05-2025,Snacks & Ready-to-Eat,VD GUMMADI CHAKKA,14,130,130,0,1
04-05-2025,Snacks & Ready-to-Eat,NGT CHATPATTA CHANA 90GM,14,25,25,0,1
04-05-2025,"Grains, Flours & Dals",Em jowar idly R 500G,4,75,75,0,1
04-05-2025,Oils & Ghee,Groundnut oil 500ml,9,180,165,15,1
04-05-2025,Spices & Seasonings,white miryalu,15,60,50,10,1
04-05-2025,"Grains, Flours & Dals",SL Idly Rava 1KG,4,65,55,10,1
04-05-2025,Spices & Seasonings,AVALU 250grms,15,60,60,0,1
04-05-2025,"Grains, Flours & Dals",CHANA DALL 250GM,4,28,24,4,1
04-05-2025,Sweeteners,MADHUR SUGAR 1KG,16,65,55,10,1
04-05-2025,"Grains, Flours & Dals",Wheat Rava M 500GM,4,33,30,3,1
04-05-2025,"Grains, Flours & Dals",MAIDA 1KG,4,70,60,10,1
04-05-2025,"Grains, Flours & Dals",PESARA PAPPU 1 KG,4,170,145,25,1
04-05-2025,Spices & Seasonings,DURGA SALT CRYSTAL 1KG,15,25,25,0,1
04-05-2025,"Dry Fruits, Nuts & Seeds",Groundnuts 1 kg,2,190,165,25,1
04-05-2025,"Grains, Flours & Dals",IDLY RAVA 1KG,4,120,100,20,2
04-05-2025,Spices & Seasonings,TATA SALT 1KG,15,30,30,0,1
04-05-2025,"Grains, Flours & Dals",split black gram 1 kg,4,540,510,30,3
04-05-2025,"Grains, Flours & Dals",Wheat Flour 1 kg,4,70,60,10,1
04-05-2025,Oils & Ghee,Coconut oil 1 L,9,440,400,40,1
04-05-2025,Spices & Seasonings,Tamarind 250GMS,15,160,130,30,2
04-05-2025,Sweeteners,YB JAGGERY POWDER 500GMS,16,150,150,0,2
04-05-2025,"Grains, Flours & Dals",turdal 1kg,4,220,170,50,1
04-05-2025,"Dry Fruits, Nuts & Seeds",ANJEER 250GM,2,400,360,40,1
04-05-2025,"Grains, Flours & Dals",DH URAD GOTA 1KG,4,215,190,25,1
04-05-2025,"Grains, Flours & Dals",PESARA PAPPU 500GMS,4,85,75,10,1
04-05-2025,"Dry Fruits, Nuts & Seeds",wallnuts,2,380,320,60,1
04-05-2025,"Grains, Flours & Dals",Bombay Rava 500GM,4,35,30,5,1
04-05-2025,"Grains, Flours & Dals",CHANA DALL 250GM,4,28,24,4,1
04-05-2025,"Grains, Flours & Dals",SL Idly Rava 1KG,4,65,55,10,1
04-05-2025,Spices & Seasonings,dalchin chekka,15,50,40,10,1
04-05-2025,"Dry Fruits, Nuts & Seeds",ALMONDS 250GM,2,560,520,40,2
04-05-2025,Spices & Seasonings,gd asafoetida,15,90,90,0,1
04-05-2025,Spices & Seasonings,AVALU 250grms,15,60,60,0,1
04-05-2025,"Grains, Flours & Dals",Wheat Rava M 500GM,4,33,30,3,1
04-05-2025,Spices & Seasonings,lavangam,15,200,200,0,4
04-05-2025,Spices & Seasonings,JEERA 250 gms,15,125,105,20,1
04-05-2025,"Dry Fruits, Nuts & Seeds",Groundnuts 1 kg,2,190,165,25,1
04-05-2025,"Grains, Flours & Dals",ulavalu red,4,40,40,0,1
04-05-2025,Spices & Seasonings,SAJEERA,15,60,40,20,1
04-05-2025,"Dry Fruits, Nuts & Seeds",SABJA SEEDS,2,70,70,0,1
04-05-2025,"Grains, Flours & Dals",Green Batani 500GM,4,110,90,20,1
04-05-2025,Spices & Seasonings,DURGA SALT CRYSTAL 1KG,15,25,25,0,1
04-05-2025,Spices & Seasonings,DRY MIECHI 200GM,15,80,60,20,1
04-05-2025,Spices & Seasonings,Chilli powder 500 gms,15,1160,840,320,4
04-05-2025,Oils & Ghee,Groundnut oil 1 L,9,1320,"1,320.00",0,4
04-05-2025,Oils & Ghee,Groundnut oil 1 L,9,660,660,0,2
04-05-2025,"Grains, Flours & Dals",Chana Flour 500 gms,4,140,110,30,1
04-05-2025,Oils & Ghee,Groundnut oil 1 L,9,330,330,0,1
04-05-2025,"Grains, Flours & Dals",RICE FLOUR 500 GM,4,70,56,14,2
04-05-2025,"Grains, Flours & Dals",Wheat Flour 1 kg,4,70,60,10,1
04-05-2025,"Grains, Flours & Dals",Red Bobarlu 1 kg,4,190,170,20,1
04-05-2025,"Grains, Flours & Dals",HS JOWAR IDLY RAWA,4,65,65,0,1
04-05-2025,"Grains, Flours & Dals",RAGI FLOUR 500GRMS,4,40,35,5,1
04-05-2025,"Grains, Flours & Dals",turdal 1kg,4,220,170,50,1
04-05-2025,"Grains, Flours & Dals",EM Ragi idli R 500G,4,75,75,0,1
04-05-2025,Spices & Seasonings,Chilli powder 250 gms,15,145,110,35,1
04-05-2025,"Dry Fruits, Nuts & Seeds",Groundnuts 1 kg,2,190,165,25,1
04-05-2025,"Grains, Flours & Dals",Green gram 1 kg,4,150,130,20,1
04-05-2025,"Grains, Flours & Dals",split black gram 1 kg,4,180,170,10,1
04-05-2025,Sweeteners,YB Brown Sugar 500GM,16,75,75,0,1
04-05-2025,"Grains, Flours & Dals",PESARA PAPPU 1 KG,4,170,145,25,1
04-05-2025,"Grains, Flours & Dals",SL Idly Rava 1KG,4,65,55,10,1
04-05-2025,"Grains, Flours & Dals",Em Little idli R 500g,4,129,129,0,1
04-05-2025,Misc,VD0001,8,100,100,0,1
04-05-2025,"Grains, Flours & Dals",EM Ragi upma R 500g,4,75,75,0,1
04-05-2025,Household & Cleaning,VIM MAHA BAR,6,20,20,0,2
04-05-2025,"Grains, Flours & Dals",White Chana 500GM,4,120,100,20,1
04-05-2025,Snacks & Ready-to-Eat,GS Moongdal Dosa Mix 400GM,14,140,140,0,1
04-05-2025,"Grains, Flours & Dals",Wheat Rava M 1KG,4,130,110,20,2
04-05-2025,Oils & Ghee,Groundnut oil 1 L,9,330,330,0,1
04-05-2025,Oils & Ghee,Safflower oil 1 L,9,400,400,0,1
04-05-2025,"Grains, Flours & Dals",EM Ragi idli R 500G,4,75,75,0,1
04-05-2025,Snacks & Ready-to-Eat,VD ARISELU,14,100,100,0,1
04-05-2025,Household & Cleaning,SURFEXCEL BAR 80G,6,10,10,0,1
04-05-2025,"Grains, Flours & Dals",Green gram 500 gms,4,75,70,5,1
04-05-2025,"Dry Fruits, Nuts & Seeds",FLAX SEEDS 250GM,2,60,50,10,1
04-05-2025,"Grains, Flours & Dals",KORRALU (FOXTAIL M) 500GM,4,65,55,10,1
04-05-2025,Milk & Dairy,BROWN EGGS TRAY 30P,7,720,660,60,2
04-05-2025,Snacks & Ready-to-Eat,SD FINGER Millet with palm Jaggery 250gm,14,135,135,0,1
04-05-2025,Milk & Dairy,BROWN EGGS 1P,7,84,72,12,6
04-05-2025,"Dry Fruits, Nuts & Seeds",Putnalu 250GM,2,45,38,7,1
04-05-2025,"Dry Fruits, Nuts & Seeds",Groundnuts 500 gms,2,95,85,10,1
04-05-2025,"Grains, Flours & Dals",Urad dall 500 gms,4,95,85,10,1
04-05-2025,"Grains, Flours & Dals",AISHWARYA SP 1KG,4,320,280,40,4
04-05-2025,Oils & Ghee,rice bran oil f,9,194,169,25,1
04-05-2025,Beverages,BRU GREEN LABEL 1.2G,1,192,192,0,96
04-05-2025,Snacks & Ready-to-Eat,NGT CHATPATTA CHANA 90GM,14,50,50,0,2
04-05-2025,"Grains, Flours & Dals",BOMBAY RAVA,4,70,55,15,1
04-05-2025,"Grains, Flours & Dals",Wheat Flour 1 kg,4,140,120,20,2
04-05-2025,"Grains, Flours & Dals",RICE FLOUR 1KG,4,70,55,15,1
04-05-2025,"Grains, Flours & Dals",RICE FLOUR 500 GM,4,70,56,14,2
04-05-2025,"Grains, Flours & Dals",Chana Flour 500 gms,4,140,110,30,1
04-05-2025,"Grains, Flours & Dals",Bombay Rava 500GM,4,35,30,5,1
04-05-2025,Oils & Ghee,Groundnut oil 1 L,9,330,330,0,1
04-05-2025,"Grains, Flours & Dals",SRILATHA RICE RAVVA 500GM,4,70,70,0,2
04-05-2025,Spices & Seasonings,Menthulu 250 gms,15,50,45,5,1
04-05-2025,Oils & Ghee,sesame oil 1L,9,590,560,30,1
04-05-2025,"Grains, Flours & Dals",SABDANA,4,40,35,5,1
04-05-2025,Spices & Seasonings,MUSTARD POWDR 500G,15,130,110,20,1
04-05-2025,Spices & Seasonings,TATA SALT 1KG,15,30,30,0,1
04-05-2025,Snacks & Ready-to-Eat,RSC ORANGE 100GMS,14,20,20,0,1
04-05-2025,"Grains, Flours & Dals",Brown RICE 1KG,4,140,130,10,2
04-05-2025,Oils & Ghee,Sesame oil 500ml,9,295,280,15,1
04-05-2025,"Grains, Flours & Dals",RAGI FLOUR 1KG,4,80,70,10,1
04-05-2025,"Grains, Flours & Dals",Multigrain 1 kg,4,100,85,15,1
04-05-2025,Milk & Dairy,BROWN EGGS 1P,7,42,36,6,3
04-05-2025,Milk & Dairy,BROWN EGGS 1P,7,126,108,18,9
04-05-2025,Milk & Dairy,HERITAGE TONED MILK 500ML,7,62,62,0,2
04-05-2025,Oils & Ghee,Groundnut oil 1 L,9,330,330,0,1
04-05-2025,"Grains, Flours & Dals",Multigrain 1 kg,4,100,85,15,1
04-05-2025,"Grains, Flours & Dals",White jowar.F 1 kg,4,100,80,20,1
04-05-2025,Snacks & Ready-to-Eat,JONNA RIBAN,14,120,120,0,2
04-05-2025,Spices & Seasonings,MUSTARD POWDR 500G,15,130,110,20,1
04-05-2025,Sweeteners,SD PALM JAGGERY 500GM,16,200,200,0,1
04-05-2025,"Dry Fruits, Nuts & Seeds",SATHVI CHIA SEEDS 100GM,2,100,80,20,1
04-05-2025,Snacks & Ready-to-Eat,VD BELLAM GAVVALU 200GM,14,60,60,0,1
04-05-2025,"Health, Wellness & Ayurvedic Products",SAI DURGA MORINGA LEAVES 100GM,5,75,75,0,1
04-05-2025,Misc,NNF00NNF001016,8,30,30,0,1
04-05-2025,Spices & Seasonings,SD Garlic Karam Powder 100GM,15,140,140,0,2
04-05-2025,Oils & Ghee,Coconut oil 500 ml,9,220,200,20,1
04-05-2025,Snacks & Ready-to-Eat,NGT CHATPATTA CHANA 90GM,14,50,50,0,2
04-05-2025,"Grains, Flours & Dals",Wheat Flour 1 kg,4,350,300,50,5
04-05-2025,"Grains, Flours & Dals",PESARA PAPPU 1 KG,4,170,145,25,1
04-05-2025,"Grains, Flours & Dals",IG PURE BASMATHI RICE,4,252,227,25,1
04-05-2025,Personal Care & Cosmetics,DWI ROSE WATER 120ML,10,90,90,0,1
04-05-2025,Misc,C123,8,95,80,15,1
04-05-2025,"Dry Fruits, Nuts & Seeds",YB GRANMA NUTS,2,180,180,0,2
04-05-2025,Misc,VD0001,8,100,100,0,1
04-05-2025,"Dry Fruits, Nuts & Seeds",PUMPKIN SEEDS 250GM,2,200,160,40,1
04-05-2025,"Dry Fruits, Nuts & Seeds",SUNFLOWER SEEDS 250GRM,2,150,120,30,1
04-05-2025,Snacks & Ready-to-Eat,VD Pappu Chekkalu 190gm,14,60,60,0,1
04-05-2025,Snacks & Ready-to-Eat,VD PALLI CHIKKI,14,80,80,0,1
04-05-2025,Snacks & Ready-to-Eat,VD RICE PAPAD 150GM,14,50,50,0,1
04-05-2025,"Grains, Flours & Dals",White jowar.F 1 kg,4,100,80,20,1
04-05-2025,"Grains, Flours & Dals",White jowar.F 1 kg,4,100,80,20,1
04-05-2025,Pickles & Cooking Pastes,DURGA BRAND TM PICKLES SPECIAL,11,56,56,0,2
04-05-2025,"Grains, Flours & Dals",RAGI FLOUR 1KG,4,160,140,20,2
04-05-2025,Snacks & Ready-to-Eat,NGT CHATPATTA CHANA 90GM,14,50,50,0,2
04-05-2025,"Grains, Flours & Dals",chana flour 500 gms,4,60,54,6,1
04-05-2025,Oils & Ghee,Groundnut oil 1 L,9,660,660,0,2
04-05-2025,"Grains, Flours & Dals",Chana Flour 500 gms,4,140,110,30,1
04-05-2025,"Grains, Flours & Dals",SA Multi Grain Mix 500GM,4,159,159,0,1
04-05-2025,Spices & Seasonings,menthulu,15,90,90,0,1
04-05-2025,Spices & Seasonings,lavangam,15,50,50,0,1
04-05-2025,Sweeteners,ACHUBELLAM 500GM,16,50,40,10,1
04-05-2025,"Grains, Flours & Dals",yellow jowar flour 1kg,4,100,92,8,1
04-05-2025,Spices & Seasonings,Tamarind 500GM,15,160,130,30,1
04-05-2025,"Grains, Flours & Dals",DH URAD GOTA 1KG,4,430,380,50,2
04-05-2025,Spices & Seasonings,Tamarind 250GMS,15,160,130,30,2
04-05-2025,"Grains, Flours & Dals",UDALU (Barnyard millet) 500 gms,4,70,60,10,1
04-05-2025,"Grains, Flours & Dals",ANDU KORRALU (Brown top .mlt) 500,4,130,110,20,1
04-05-2025,Snacks & Ready-to-Eat,Sprouted Ragi Biscuits 450GM,14,150,150,0,1
04-05-2025,"Grains, Flours & Dals",KORRALU (FOXTAIL M) 500GM,4,65,55,10,1
04-05-2025,Spices & Seasonings,SAJEERA,15,60,40,20,1
04-05-2025,Spices & Seasonings,TATA SALT 1KG,15,30,30,0,1
04-05-2025,Oils & Ghee,rice bran oil f,9,194,169,25,1
04-05-2025,"Grains, Flours & Dals",KORRALU (FOXTAIL M) 500GM,4,65,55,10,1
04-05-2025,Spices & Seasonings,AVALU 100GM,15,25,20,5,1
04-05-2025,Milk & Dairy,HRITAGE TOTAL CURD 130GM,7,10,10,0,1
04-05-2025,Spices & Seasonings,MIRYALU 50 GRMS,15,100,80,20,1
04-05-2025,Spices & Seasonings,Jeera 100GM,15,50,45,5,1
04-05-2025,Spices & Seasonings,PRO ORG TURMERIC POWDER 100G,15,70,70,0,1
04-05-2025,"Grains, Flours & Dals",SL Idly Rava 1KG,4,130,110,20,2
04-05-2025,Oils & Ghee,sesame oil 1L,9,3540,"3,360.00",180,6
04-05-2025,Spices & Seasonings,Menthulu 250 gms,15,50,45,5,1
04-05-2025,Snacks & Ready-to-Eat,ANNAPURNA APPALAM,14,35,35,0,1
04-05-2025,Spices & Seasonings,3M.MIRCHI POWDER,15,360,320,40,1
04-05-2025,Oils & Ghee,sesame oil 1L,9,590,560,30,1
04-05-2025,"Grains, Flours & Dals",RAGULU 1 KG,4,70,60,10,1
04-05-2025,Spices & Seasonings,AVALU 250grms,15,120,120,0,2
04-05-2025,"Dry Fruits, Nuts & Seeds",FLAX SEEDS 250GM,2,60,50,10,1
04-05-2025,"Grains, Flours & Dals",RAJMA 250GM,4,55,45,10,1
04-05-2025,"Grains, Flours & Dals",KORRALU (FOXTAIL M) 500GM,4,65,55,10,1
04-05-2025,"Grains, Flours & Dals",turdal 1kg,4,220,170,50,1
04-05-2025,"Grains, Flours & Dals",chana flour 500 gms,4,60,54,6,1
04-05-2025,"Grains, Flours & Dals",SAMALU (Little millet) 500 gms,4,85,65,20,1
04-05-2025,"Grains, Flours & Dals",Wheat Flour 1 kg,4,210,180,30,3
04-05-2025,"Grains, Flours & Dals",Wheat Flour 1 kg,4,70,60,10,1
04-05-2025,"Grains, Flours & Dals",SL Idly Rava 1KG,4,65,55,10,1
04-05-2025,Sweeteners,MADHUR SUGAR 1KG,16,65,55,10,1
04-05-2025,"Grains, Flours & Dals",COW B rice 1 kg,4,360,345,15,5
04-05-2025,Pickles & Cooking Pastes,DURGA BRAND TM PICKLES SPECIAL,11,28,28,0,1
04-05-2025,"Dry Fruits, Nuts & Seeds",Groundnuts 1 kg,2,190,165,25,1
04-05-2025,"Grains, Flours & Dals",Red Chana 500 GM,4,75,60,15,1
04-05-2025,Snacks & Ready-to-Eat,RINGS 200GM,14,30,30,0,1
04-05-2025,Snacks & Ready-to-Eat,SIRI ICE CREAM 100ML,14,100,80,20,1
04-05-2025,"Grains, Flours & Dals",Green gram 500 gms,4,75,70,5,1
04-05-2025,"Grains, Flours & Dals",RAGI FLOUR 1KG,4,160,140,20,2
04-05-2025,"Grains, Flours & Dals",RAGI FLOUR 1KG,4,80,70,10,1
04-05-2025,"Grains, Flours & Dals",White jowar.F 1 kg,4,100,80,20,1
04-05-2025,"Dry Fruits, Nuts & Seeds",SD Mango cubes 100gm,2,45,45,0,1
04-05-2025,"Grains, Flours & Dals",Wheat Flour 1 kg,4,210,180,30,3
04-05-2025,Snacks & Ready-to-Eat,RAJGIRA PEANUT CHIKKI,14,10,10,0,2
04-05-2025,"Grains, Flours & Dals",Wheat Rava S 500GM,4,33,30,3,1
04-05-2025,Spices & Seasonings,NUVVULU 500GM,15,200,170,30,1
04-05-2025,Spices & Seasonings,NUVVULU 250GM,15,200,170,30,2
04-05-2025,Spices & Seasonings,ROYAL SAFFRON 400GRMS,15,325,325,0,5
04-05-2025,Sweeteners,MISHRI 250 GM,16,35,30,5,1
04-05-2025,Spices & Seasonings,KARAKAYA,15,50,30,20,1
04-05-2025,Spices & Seasonings,Japatri 25GM,15,100,80,20,1
04-05-2025,Spices & Seasonings,SATHVI ANASAPUVUU 25GM,15,90,65,25,1
04-05-2025,Spices & Seasonings,Elaichi 25GM,15,145,120,25,1
04-05-2025,"Grains, Flours & Dals",DH URAD GOTA 1KG,4,215,190,25,1
04-05-2025,Spices & Seasonings,BIRYANI LEAF 10GM,15,30,20,10,1
04-05-2025,"Grains, Flours & Dals",SL Idly Rava 1KG,4,65,55,10,1
04-05-2025,"Grains, Flours & Dals",RAGI FLOUR 1KG,4,160,140,20,2
04-05-2025,"Grains, Flours & Dals",DH URAD GOTA 1KG,4,215,190,25,1
04-05-2025,Oils & Ghee,Safflower oil 1 L,9,400,400,0,1
04-05-2025,Spices & Seasonings,telaga pindi,15,70,70,0,1
04-05-2025,Oils & Ghee,Groundnut oil 1 L,9,330,330,0,1
04-05-2025,Oils & Ghee,Groundnut oil 1 L,9,990,990,0,3
04-05-2025,"Grains, Flours & Dals",RICE FLOUR 1KG,4,70,55,15,1
04-05-2025,"Grains, Flours & Dals",MAIDA 1KG,4,70,60,10,1
04-05-2025,Snacks & Ready-to-Eat,SD Flax seeds with dates 250gm,14,135,135,0,1
04-05-2025,Oils & Ghee,sesame oil 1L,9,590,560,30,1
04-05-2025,"Grains, Flours & Dals",POORI ATTA 1KG,4,70,60,10,1
04-05-2025,"Grains, Flours & Dals",VGR rice 1 kg,4,140,130,10,2
04-05-2025,"Grains, Flours & Dals",AISHWARYA SP 1KG,4,80,70,10,1
04-05-2025,Snacks & Ready-to-Eat,SATHVI REGIVADA 200GM,14,80,60,20,1
04-05-2025,Milk & Dairy,BROWN EGGS 1P,7,112,96,16,8
04-05-2025,Spices & Seasonings,NUVVULU 250GM,15,100,85,15,1
04-05-2025,Pooja & Spiritual Items,GD SANDAL 150GM,12,110,110,0,1
04-05-2025,Pooja & Spiritual Items,SWASTIK CAMPHOR 25GM,12,90,90,0,2
04-05-2025,"Grains, Flours & Dals",samalu,4,130,130,0,1
04-05-2025,Snacks & Ready-to-Eat,MIGHTY PUFFS TOMATO,14,25,25,0,1
04-05-2025,Oils & Ghee,sesame oil 1L,9,590,560,30,1
04-05-2025,Oils & Ghee,Safflower oil 1 L,9,400,400,0,1
04-05-2025,Pooja & Spiritual Items,GD Aiswarya Deepam 700ML,12,195,195,0,1
04-05-2025,Oils & Ghee,Groundnut oil 1 L,9,330,330,0,1
04-05-2025,Oils & Ghee,sesame oil 1L,9,590,560,30,1
04-05-2025,Oils & Ghee,sesame oil 1L,9,1770,"1,680.00",90,3
04-05-2025,"Dry Fruits, Nuts & Seeds",cashew,2,680,620,60,2
04-05-2025,Personal Care & Cosmetics,SVE PREMIUM PAPAYA SOAP 100GM,10,110,110,0,1
04-05-2025,Personal Care & Cosmetics,SVE PREMIUM PAPAYA SOAP 100GM,10,110,110,0,1
04-05-2025,Oils & Ghee,sesame oil 1L,9,1770,"1,680.00",90,3
04-05-2025,Milk & Dairy,HERITAGE TONED MILK 500ML,7,31,31,0,1
04-05-2025,"Grains, Flours & Dals",THICK POHA 500GM,4,40,35,5,1
04-05-2025,Household & Cleaning,SURFEXCEL BAR 80G,6,10,10,0,1
04-05-2025,"Grains, Flours & Dals",RICE FLOUR 500 GM,4,35,28,7,1
04-05-2025,Household & Cleaning,VIM MAHA BAR,6,10,10,0,1
04-05-2025,Pooja & Spiritual Items,SWASTIK CAMPHOR 25GM,12,45,45,0,1
04-05-2025,"Grains, Flours & Dals",IDLY RAVA 1KG,4,120,100,20,2
04-05-2025,Spices & Seasonings,DURGA SALT CRYSTAL 1KG,15,25,25,0,1
04-05-2025,"Grains, Flours & Dals",Wheat Flour 1 kg,4,140,120,20,2
04-05-2025,Snacks & Ready-to-Eat,SIRI ICE CREAM 100ML,14,100,80,20,1
04-05-2025,"Health, Wellness & Ayurvedic Products",MADDI NEEM OIL 100ML,5,110,110,0,1
04-05-2025,"Grains, Flours & Dals",Multigrain 1 kg,4,100,85,15,1
04-05-2025,Household & Cleaning,SURFEXCEL BAR 80G,6,60,60,0,6
04-05-2025,Oils & Ghee,Groundnut oil 1 L,9,330,330,0,1
04-05-2025,Spices & Seasonings,MUSTARD POWDR 500G,15,130,110,20,1
04-05-2025,Spices & Seasonings,Menthulu 250 gms,15,50,45,5,1
04-05-2025,"Grains, Flours & Dals",Chittimuthaylu rice 1 kg,4,160,140,20,1
04-05-2025,Spices & Seasonings,AVALU 250grms,15,40,40,0,1
04-05-2025,Spices & Seasonings,menthulu,15,90,90,0,1
04-05-2025,Spices & Seasonings,MUSTARD POWDR 500G,15,130,110,20,1
04-05-2025,Spices & Seasonings,3M.MIRCHI POWDER,15,1080,960,120,3
04-05-2025,Spices & Seasonings,avalu,15,80,80,0,1
04-05-2025,Oils & Ghee,sesame oil 1L,9,1770,"1,680.00",90,3
04-05-2025,Beverages,REFRESH SHARBATH NORMAL,1,199,190,9,1
04-05-2025,"Health, Wellness & Ayurvedic Products",RB Max Protein Salt & Caramel Bar 50g,5,150,150,0,2
04-05-2025,Milk & Dairy,SANGAM TONED MILK 500ML,7,124,124,0,4
04-05-2025,Sweeteners,yb honey 1 kg,16,550,550,0,1
04-05-2025,Sweeteners,YB N FOREST HONEY 700 GM,16,400,400,0,1
03-05-2025,Sweeteners,GS Palm Jaggery Powder 400GM,16,180,180,0,1
03-05-2025,Snacks & Ready-to-Eat,VD MURUKU 175GM,14,60,60,0,1
03-05-2025,"Grains, Flours & Dals",RAGI FLOUR 1KG,4,80,70,10,1
03-05-2025,Pooja & Spiritual Items,BALAJI BEL PHOOL DHOOP STICKS 10STK,12,70,70,0,1
03-05-2025,"Grains, Flours & Dals",White jowar.F 1 kg,4,100,80,20,1
03-05-2025,"Grains, Flours & Dals",AISHWARYA SP 1KG,4,800,700,100,10
03-05-2025,Snacks & Ready-to-Eat,ONION MURK,14,60,60,0,1
03-05-2025,Snacks & Ready-to-Eat,VD MINAPA SUNNUNDALU 12P,14,180,180,0,1
03-05-2025,Oils & Ghee,Coconut oil 500 ml,9,220,200,20,1
03-05-2025,"Grains, Flours & Dals",Quinova 1 kg,4,440,390,50,2
03-05-2025,Oils & Ghee,Groundnut oil 500ml,9,180,165,15,1
03-05-2025,Sweeteners,SD PALM JAGGERY 500GM,16,200,200,0,1
03-05-2025,"Grains, Flours & Dals",RAGI FLOUR 500GRMS,4,80,70,10,2
03-05-2025,"Grains, Flours & Dals",Wheat Flour 1 kg,4,420,360,60,6
03-05-2025,"Grains, Flours & Dals",VGR rice 1 kg,4,105,97.5,7.5,1.5
03-05-2025,Snacks & Ready-to-Eat,VD PALLI CHIKKI,14,80,80,0,1
03-05-2025,Milk & Dairy,BROWN EGGS 1P,7,84,72,12,6
03-05-2025,Misc,VD0001,8,100,100,0,1
03-05-2025,Snacks & Ready-to-Eat,VD MULTI CHAKKA,14,220,220,0,2
03-05-2025,Snacks & Ready-to-Eat,VD PALLI CHIKKI,14,80,80,0,1
03-05-2025,"Health, Wellness & Ayurvedic Products",MXP CREAM ONION,5,45,45,0,1
03-05-2025,"Health, Wellness & Ayurvedic Products",MORINGA LEAF POWDER M,5,160,150,10,2
03-05-2025,"Health, Wellness & Ayurvedic Products",RB Max Protein Spanish Tomato,5,90,90,0,2
03-05-2025,Snacks & Ready-to-Eat,MB LITTLE MILLET NOODLES 180G,14,95,95,0,1
03-05-2025,"Health, Wellness & Ayurvedic Products",DWI EUCALYPTUS 8ML,5,80,80,0,1
03-05-2025,"Health, Wellness & Ayurvedic Products",RB Max Protein Cheese&amp;,5,45,45,0,1
03-05-2025,Spices & Seasonings,Chilli powder 500 gms,15,580,420,160,2
03-05-2025,Household & Cleaning,SURFEXCEL BAR 80G,6,20,20,0,2
03-05-2025,Spices & Seasonings,Turmeric powder 250 gms,15,200,150,50,2
03-05-2025,"Health, Wellness & Ayurvedic Products",DWI MANDARA TAILAM 100ML,5,160,160,0,1
03-05-2025,Household & Cleaning,vim pudina fresh,6,50,50,0,5
03-05-2025,Snacks & Ready-to-Eat,VD MURMURA LADDU,14,50,50,0,1
03-05-2025,Household & Cleaning,vim small,6,15,15,0,1
03-05-2025,Pooja & Spiritual Items,SOSR SWATHHI 365,12,60,60,0,2
03-05-2025,"Grains, Flours & Dals",Bajra Flour 1 kg,4,70,60,10,1
03-05-2025,Oils & Ghee,Groundnut oil 1 L,9,660,660,0,2
03-05-2025,Oils & Ghee,Safflower oil 1 L,9,400,400,0,1
03-05-2025,Sweeteners,YB Brown Sugar 500GM,16,75,75,0,1
03-05-2025,Oils & Ghee,sesame oil 1L,9,1770,"1,680.00",90,3
03-05-2025,"Dry Fruits, Nuts & Seeds",SD Mango cubes 100gm,2,95,95,0,1
03-05-2025,Snacks & Ready-to-Eat,VD MURMURA LADDU,14,50,50,0,1
03-05-2025,"Grains, Flours & Dals",RAGI FLOUR 500GRMS,4,40,35,5,1
03-05-2025,"Grains, Flours & Dals",ANDU KORRALU (Brown top .mlt) 500,4,130,110,20,1
03-05-2025,"Grains, Flours & Dals",SAMALU (Little millet) 500 gms,4,85,65,20,1
03-05-2025,Personal Care & Cosmetics,GAYATHRI KUMKUDUKAYA,10,150,150,0,1
03-05-2025,"Grains, Flours & Dals",KORRALU (FOXTAIL M) 500GM,4,65,55,10,1
03-05-2025,"Grains, Flours & Dals",Arikalu (kodo),4,70,65,5,1
03-05-2025,Pickles & Cooking Pastes,SD MANGO PICKLE,11,110,110,0,1
03-05-2025,Pooja & Spiritual Items,VRP APOORVA JAVADHU POW,12,35,35,0,1
03-05-2025,"Dry Fruits, Nuts & Seeds",wallnuts,2,380,320,60,1
03-05-2025,"Dry Fruits, Nuts & Seeds",PUMPKIN SEEDS 250GM,2,200,160,40,1
03-05-2025,"Dry Fruits, Nuts & Seeds",ALMONDS 250GM,2,560,520,40,2
03-05-2025,"Dry Fruits, Nuts & Seeds",cashew,2,340,310,30,1
03-05-2025,"Grains, Flours & Dals",Wheat Flour 1 kg,4,70,60,10,1
03-05-2025,"Dry Fruits, Nuts & Seeds",SATHVI CHIA SEEDS 100GM,2,100,80,20,1
03-05-2025,Misc,ROLL D C,8,140,90,50,2
03-05-2025,"Grains, Flours & Dals",Em jowar idly R 500G,4,150,150,0,2
03-05-2025,Oils & Ghee,Safflower oil 1 L,9,400,400,0,1
03-05-2025,"Dry Fruits, Nuts & Seeds",SALTED PISTA 250GM,2,400,350,50,1
03-05-2025,Spices & Seasonings,Vamu 100GM,15,60,50,10,1
03-05-2025,"Grains, Flours & Dals",Quinova 1 kg,4,220,195,25,1
03-05-2025,Spices & Seasonings,SV Dried Kasuri Methi 100GM,15,95,95,0,1
03-05-2025,"Dry Fruits, Nuts & Seeds",SUNFLOWER SEEDS 250GRM,2,150,130,20,1
03-05-2025,"Grains, Flours & Dals",Green gram 1 kg,4,150,130,20,1
03-05-2025,Spices & Seasonings,Menthulu 250 gms,15,50,45,5,1
03-05-2025,"Grains, Flours & Dals",split black gram 1 kg,4,180,170,10,1
03-05-2025,"Dry Fruits, Nuts & Seeds",PULMAKHANA 100 GM,2,360,340,20,2
03-05-2025,"Grains, Flours & Dals",JOWAR WHITE 1 KG,4,80,70,10,1
03-05-2025,Spices & Seasonings,JEERA 250 gms,15,250,210,40,2
03-05-2025,Spices & Seasonings,AVALU 250grms,15,60,60,0,1
03-05-2025,Oils & Ghee,Groundnut oil 1 L,9,330,330,0,1
03-05-2025,"Grains, Flours & Dals",Wheat Flour 1 kg,4,70,60,10,1
03-05-2025,"Grains, Flours & Dals",turdal 1kg,4,220,170,50,1
03-05-2025,Snacks & Ready-to-Eat,BELLAM GHEE SUNIUNDALU 250,14,120,120,0,1
03-05-2025,Snacks & Ready-to-Eat,BELLAM MINAPA SUNADULLU,14,180,180,0,1
03-05-2025,Milk & Dairy,BROWN EGGS 1P,7,42,36,6,3
03-05-2025,"Grains, Flours & Dals",Brown RICE 1KG,4,70,65,5,1
03-05-2025,Beverages,BRU GREEN LABEL 1.2G,1,20,20,0,10
03-05-2025,Milk & Dairy,BROWN EGGS TRAY 30P,7,360,330,30,1
03-05-2025,Spices & Seasonings,Chilli powder 500 gms,15,290,210,80,1
03-05-2025,"Grains, Flours & Dals",Multigrain 1 kg,4,100,85,15,1
03-05-2025,"Grains, Flours & Dals",Wheat Flour 1 kg,4,70,60,10,1
03-05-2025,Spices & Seasonings,THREE MANGO RAI 200G,15,420,420,0,10
03-05-2025,"Grains, Flours & Dals",yellow jowar flour 1kg,4,100,92,8,1
03-05-2025,Milk & Dairy,SANGAM TONED MILK 500ML,7,62,62,0,2
03-05-2025,Snacks & Ready-to-Eat,KURNOOL MARMURA,14,70,55,15,1
03-05-2025,Snacks & Ready-to-Eat,MIGHTY PUFFS CHEESE AND HERBS,14,25,25,0,1
03-05-2025,"Grains, Flours & Dals",RAGI FLOUR 500GRMS,4,40,35,5,1
03-05-2025,"Grains, Flours & Dals",Wheat Flour 1 kg,4,70,60,10,1
03-05-2025,"Grains, Flours & Dals",Multigrain 1 kg,4,100,85,15,1
03-05-2025,"Grains, Flours & Dals",Wheat Flour 1 kg,4,70,60,10,1
03-05-2025,Oils & Ghee,Groundnut oil 500ml,9,180,165,15,1
03-05-2025,Snacks & Ready-to-Eat,VD GUMMADI VADIYAM,14,75,75,0,1
03-05-2025,"Grains, Flours & Dals",turdal 500 gms,4,110,85,25,1
03-05-2025,Oils & Ghee,Sesame oil 500ml,9,295,280,15,1
03-05-2025,Snacks & Ready-to-Eat,DINNER PAPAD,14,80,80,0,1
03-05-2025,Snacks & Ready-to-Eat,KURNOOL MARMURA,14,140,110,30,2
03-05-2025,Sweeteners,YB JAGGERY POWDER 500GMS,16,140,140,0,2
03-05-2025,"Grains, Flours & Dals",Wheat Rava M 500GM,4,33,30,3,1
03-05-2025,Spices & Seasonings,idli karam powdwer,15,65,65,0,1
03-05-2025,"Grains, Flours & Dals",CHANA DAL 1KG,4,112,96,16,1
03-05-2025,Sweeteners,sugar 500 gms,16,30,28,2,1
03-05-2025,Snacks & Ready-to-Eat,KURNOOL MARMURA,14,70,55,15,1
03-05-2025,"Grains, Flours & Dals",White jowar.F 1 kg,4,100,80,20,1
03-05-2025,"Dry Fruits, Nuts & Seeds",Groundnuts 500 gms,2,95,85,10,1
03-05-2025,"Grains, Flours & Dals",POORI ATTA 500GM,4,35,30,5,1
03-05-2025,"Grains, Flours & Dals",Multigrain 1 kg,4,100,85,15,1
03-05-2025,Spices & Seasonings,Jeera 100GM,15,50,45,5,1
03-05-2025,Sweeteners,YB JAGGERY POWDER 500GMS,16,75,75,0,1
03-05-2025,Spices & Seasonings,GS Pink Rock Salt 1KG,15,120,120,0,1
03-05-2025,Snacks & Ready-to-Eat,VD MURUKU 175GM,14,60,60,0,1
03-05-2025,Snacks & Ready-to-Eat,VD MURMURA LADDU,14,50,50,0,1
03-05-2025,"Grains, Flours & Dals",yellow jowar flour 1kg,4,100,92,8,1
03-05-2025,"Grains, Flours & Dals",MAATEJA rice 1 kg,4,216,207,9,3
03-05-2025,Snacks & Ready-to-Eat,RINGS 200GM,14,30,30,0,1
03-05-2025,Snacks & Ready-to-Eat,SOYA MURK,14,60,60,0,1
03-05-2025,"Grains, Flours & Dals",BASMATHI RICE 1KG,4,150,135,15,1
03-05-2025,"Dry Fruits, Nuts & Seeds",Groundnuts 500 gms,2,95,85,10,1
03-05-2025,Snacks & Ready-to-Eat,VD KOBARI LADDU,14,80,80,0,1
03-05-2025,Misc,VD0009,8,100,100,0,1
03-05-2025,Pooja & Spiritual Items,GD WOODS 150GM,12,110,110,0,1
03-05-2025,Spices & Seasonings,PN ORGANIC PINK SALT 1KG,15,124,124,0,1
03-05-2025,"Dry Fruits, Nuts & Seeds",SABJA SEEDS,2,140,140,0,2
03-05-2025,"Grains, Flours & Dals",ANDU KORRALU (Brown top .mlt) 500,4,130,110,20,1
03-05-2025,"Grains, Flours & Dals",SAMALU (Little millet) 500 gms,4,85,65,20,1
03-05-2025,Snacks & Ready-to-Eat,Sprouted Ragi Biscuits 450GM,14,150,150,0,1
03-05-2025,Spices & Seasonings,GREEN SOUNF,15,60,40,20,1
03-05-2025,Baking & Cooking Aids,GONDKATIRA Ag,0,85,75,10,1
03-05-2025,Sweeteners,MISHRI 250 GM,16,35,30,5,1
03-05-2025,"Grains, Flours & Dals",COW B rice 1 kg,4,612,586.5,25.5,8.5
03-05-2025,Spices & Seasonings,EV Chicken Masala 50GM,15,48,48,0,1
03-05-2025,"Grains, Flours & Dals",chana flour 500 gms,4,60,54,6,1
03-05-2025,"Grains, Flours & Dals",RAGI FLOUR 500GRMS,4,80,70,10,2
03-05-2025,Spices & Seasonings,Tamarind 250GMS,15,80,65,15,1
03-05-2025,Personal Care & Cosmetics,DABUR MESWAK,10,20,20,0,1
03-05-2025,Spices & Seasonings,MIRYALU 50 GRMS,15,100,80,20,1
03-05-2025,"Grains, Flours & Dals",White Chana 500GM,4,120,100,20,1
03-05-2025,Spices & Seasonings,FLAXSEED KARAM,15,75,75,0,1
03-05-2025,"Grains, Flours & Dals",CHANA DAL 500GM,4,56,48,8,1
03-05-2025,Personal Care & Cosmetics,MYSORE SANDAL SOAP 75G,10,84,84,0,2
03-05-2025,Oils & Ghee,Sesame oil 500ml,9,295,280,15,1
03-05-2025,Spices & Seasonings,JEERA 250 gms,15,125,105,20,1
03-05-2025,Snacks & Ready-to-Eat,ELITE ELAICHI RUSK 200GM,14,35,35,0,1
03-05-2025,Misc,C123,8,95,80,15,1
03-05-2025,Snacks & Ready-to-Eat,VD MURMURA LADDU,14,50,50,0,1
03-05-2025,Oils & Ghee,Groundnut oil 500ml,9,180,165,15,1
03-05-2025,"Grains, Flours & Dals",Bombay Rava 500GM,4,35,30,5,1
03-05-2025,Spices & Seasonings,SAJEERA,15,60,40,20,1
03-05-2025,Oils & Ghee,Sesame oil 500ml,9,295,280,15,1
03-05-2025,"Dry Fruits, Nuts & Seeds",Groundnuts 500 gms,2,95,85,10,1
03-05-2025,"Grains, Flours & Dals",IDLY RAVA 1KG,4,180,150,30,3
03-05-2025,Snacks & Ready-to-Eat,SATHVI REGIVADA 200GM,14,80,60,20,1
03-05-2025,"Grains, Flours & Dals",SRILATHA RICE RAVVA 500GM,4,35,35,0,1
03-05-2025,Spices & Seasonings,Tamarind 250GMS,15,80,65,15,1
03-05-2025,"Grains, Flours & Dals",chana flour 500 gms,4,60,54,6,1
03-05-2025,Snacks & Ready-to-Eat,BB VERMICELLI 1KG,14,95,90,5,1
03-05-2025,"Grains, Flours & Dals",MELMEKER 250GMS,4,60,45,15,1
03-05-2025,"Dry Fruits, Nuts & Seeds",PULMAKHANA 100 GM,2,180,170,10,1
03-05-2025,Spices & Seasonings,Menthulu 250 gms,15,50,45,5,1
03-05-2025,"Grains, Flours & Dals",SABDANA,4,40,35,5,1
03-05-2025,Spices & Seasonings,Jeera 100GM,15,50,45,5,1
03-05-2025,"Health, Wellness & Ayurvedic Products",MADDI NEEM OIL 100ML,5,75,75,0,1
03-05-2025,Snacks & Ready-to-Eat,VD MURUKU 175GM,14,120,120,0,2
03-05-2025,Snacks & Ready-to-Eat,VD PAPPU CHEGODI 200GM,14,60,60,0,1
03-05-2025,"Health, Wellness & Ayurvedic Products",DWI EUCALYPTUS 30ML,5,130,130,0,1
03-05-2025,Spices & Seasonings,GS Pink Rock Salt 1KG,15,120,120,0,1
03-05-2025,"Health, Wellness & Ayurvedic Products",MD Trikatu Choornam 30GM,5,150,150,0,1
03-05-2025,Personal Care & Cosmetics,APPLE BC POWDER,10,400,400,0,2
03-05-2025,Snacks & Ready-to-Eat,VD MANGO JELLY 250GRMS,14,80,80,0,1
03-05-2025,Spices & Seasonings,Vamu 100GM,15,60,50,10,1
03-05-2025,"Grains, Flours & Dals",SL Idly Rava 1KG,4,65,55,10,1
03-05-2025,Snacks & Ready-to-Eat,HS Ragi biscuits,14,270,270,0,2
03-05-2025,"Dry Fruits, Nuts & Seeds",mango cubes s,2,95,95,0,1
03-05-2025,Snacks & Ready-to-Eat,BD RAGI NOODLES,14,75,75,0,1
03-05-2025,Snacks & Ready-to-Eat,VD MURMURA LADDU,14,50,50,0,1
03-05-2025,Snacks & Ready-to-Eat,VD Pappu Chekkalu 190gm,14,60,60,0,1
03-05-2025,Personal Care & Cosmetics,OLD SPICE MUSK 70GM,10,200,200,0,2
03-05-2025,Snacks & Ready-to-Eat,SUNNUNDALU,14,120,120,0,1
03-05-2025,Pooja & Spiritual Items,javadhu,12,300,300,0,3
03-05-2025,Snacks & Ready-to-Eat,BEETROOT MURK,14,300,300,0,2
03-05-2025,Snacks & Ready-to-Eat,NAVARATNA MIX,14,120,120,0,2
03-05-2025,"Dry Fruits, Nuts & Seeds",PUTNALU 500GMS,2,90,76,14,1
03-05-2025,Snacks & Ready-to-Eat,VD PALLI CHIKKI,14,80,80,0,1
03-05-2025,Snacks & Ready-to-Eat,VD NUVULLU CHIKKI,14,80,80,0,1
03-05-2025,Snacks & Ready-to-Eat,VD MANGO JELLY 250GRMS,14,80,80,0,1
03-05-2025,Spices & Seasonings,MUSTARD POWDR 500G,15,130,110,20,1
03-05-2025,Spices & Seasonings,Menthulu 250 gms,15,50,45,5,1
03-05-2025,Spices & Seasonings,3M.MIRCHI POWDER,15,360,320,40,1
03-05-2025,Snacks & Ready-to-Eat,VD PALLI LADDU,14,80,80,0,1
03-05-2025,Spices & Seasonings,MUSTARD POWDER 250G,15,65,55,10,1
03-05-2025,Spices & Seasonings,pickle chili powder,15,360,330,30,2
03-05-2025,Pickles & Cooking Pastes,DURGA BRAND TM PICKLES SPECIAL,11,28,28,0,1
03-05-2025,Misc,VD0001,8,100,100,0,1
03-05-2025,"Grains, Flours & Dals",CHANA DALL 250GM,4,28,24,4,1
03-05-2025,Spices & Seasonings,Coriander seeds 200 gms,15,48,40,8,1
03-05-2025,Snacks & Ready-to-Eat,VD PALLI LADDU,14,80,80,0,1
03-05-2025,Snacks & Ready-to-Eat,ONION MURK,14,60,60,0,1
03-05-2025,Spices & Seasonings,Gasagasalu 50GM,15,130,110,20,1
03-05-2025,"Grains, Flours & Dals",AISHWARYA SP 1KG,4,800,700,100,10
03-05-2025,Snacks & Ready-to-Eat,VD Pappu Chekkalu 190gm,14,60,60,0,1
03-05-2025,Milk & Dairy,SANGAM TONED MILK 500ML,7,124,124,0,4
03-05-2025,"Grains, Flours & Dals",Sathya Javva Wheat Rava 500GM,4,95,90,5,1
03-05-2025,Milk & Dairy,BROWN EGGS 1P,7,140,120,20,10
03-05-2025,Spices & Seasonings,Elaichi 25GM,15,145,120,25,1
03-05-2025,Spices & Seasonings,DURGA SALT CRYSTAL 1KG,15,25,25,0,1
03-05-2025,Spices & Seasonings,DURGA SALT CRYSTAL 1KG,15,25,25,0,1
03-05-2025,"Grains, Flours & Dals",JOWAR WHITE 1 KG,4,80,70,10,1
03-05-2025,"Grains, Flours & Dals",SL Suji Rava 500GM,4,32,32,0,1
03-05-2025,"Grains, Flours & Dals",yellow jowar flour 1kg,4,100,92,8,1
03-05-2025,"Grains, Flours & Dals",Wheat Flour 1 kg,4,70,60,10,1
03-05-2025,"Grains, Flours & Dals",RAGI FLOUR 500GRMS,4,40,35,5,1
03-05-2025,"Grains, Flours & Dals",VL Sabdana 500GM,4,77,77,0,1
03-05-2025,Snacks & Ready-to-Eat,Sprouted Ragi Biscuits 450GM,14,135,135,0,1
03-05-2025,"Grains, Flours & Dals",maagaani low gi white rice 1kg,4,229,115,114,1
03-05-2025,Sweeteners,YB Brown Sugar 500GM,16,140,140,0,2
03-05-2025,"Health, Wellness & Ayurvedic Products",MD Gandha Karchural Choornam 30GM,5,100,100,0,1
03-05-2025,"Grains, Flours & Dals",COW B rice 1 kg,4,216,207,9,3
03-05-2025,"Grains, Flours & Dals",RAGI FLOUR 500GRMS,4,40,35,5,1
03-05-2025,"Grains, Flours & Dals",Wheat Flour 1 kg,4,140,120,20,2
03-05-2025,Snacks & Ready-to-Eat,SD Moringa with plam jaggery 250gm,14,270,270,0,2
03-05-2025,Snacks & Ready-to-Eat,BD LITTLE MILLET NOODLES 200G,14,75,75,0,1
03-05-2025,Snacks & Ready-to-Eat,BD RED RICE NOODLES 200G,14,70,70,0,1
03-05-2025,Snacks & Ready-to-Eat,BD KODO MILLET NOODLES 200GM,14,75,75,0,1
03-05-2025,Snacks & Ready-to-Eat,SUNNUNDALU,14,120,120,0,1
03-05-2025,"Grains, Flours & Dals",CHANA DAL 500GM,4,56,48,8,1
03-05-2025,Snacks & Ready-to-Eat,DOSA BATTER 1KG,14,60,60,0,1
03-05-2025,Milk & Dairy,HERITAGE BUTTERMILK,7,20,20,0,2
03-05-2025,Pooja & Spiritual Items,SIVA JOOTHI 365 DEEPAPU,12,25,25,0,1
03-05-2025,Spices & Seasonings,MASALA KAR 500GMS,15,260,240,20,1
03-05-2025,Snacks & Ready-to-Eat,sannakarampusa,14,60,60,0,1
03-05-2025,Milk & Dairy,HRITAGE TOTAL CURD 130GM,7,20,20,0,2
03-05-2025,Oils & Ghee,Safflower oil 1 L,9,400,400,0,1
03-05-2025,Pooja & Spiritual Items,GD Dhoop Sticks 26GM,12,20,20,0,1
03-05-2025,Oils & Ghee,rice bran oil f,9,194,169,25,1
03-05-2025,Milk & Dairy,BROWN EGGS TRAY 30P,7,360,330,30,1
03-05-2025,Oils & Ghee,Groundnut oil 1 L,9,330,330,0,1
03-05-2025,Spices & Seasonings,RED COPRA 500GM,15,170,148,22,1
03-05-2025,"Grains, Flours & Dals",MAAGAANI LOW GI SP L 1KG,4,360,315,45,3
03-05-2025,Sweeteners,ACHU BELLAM 1KG,16,100,80,20,1
03-05-2025,Spices & Seasonings,lavangam,15,50,50,0,1
03-05-2025,Spices & Seasonings,dalchin chekka,15,50,40,10,1
03-05-2025,Pickles & Cooking Pastes,DURGA BRAND TM PICKLES SPECIAL,11,28,28,0,1
03-05-2025,"Grains, Flours & Dals",CHANA DAL 1KG,4,112,96,16,1
03-05-2025,Spices & Seasonings,MASALA KAR 500GMS,15,260,240,20,1
03-05-2025,"Grains, Flours & Dals",turdal 1kg,4,440,340,100,2
03-05-2025,"Grains, Flours & Dals",PESARA PAPPU 500GMS,4,85,75,10,1
03-05-2025,Spices & Seasonings,Elaichi 25GM,15,145,120,25,1
03-05-2025,"Grains, Flours & Dals",BOMBAY RAVA,4,70,55,15,1
03-05-2025,"Grains, Flours & Dals",THICK POHA 1KG,4,80,70,10,1
03-05-2025,"Grains, Flours & Dals",SABDANA 500GM,4,90,70,20,1
03-05-2025,"Grains, Flours & Dals",white Bobarlu 1 KG,4,170,150,20,1
03-05-2025,"Grains, Flours & Dals",Wheat Rava S 1KG,4,130,110,20,2
03-05-2025,Spices & Seasonings,Tamarind 250GMS,15,80,65,15,1
03-05-2025,Spices & Seasonings,NUVVULU 500GM,15,160,130,30,1
03-05-2025,"Grains, Flours & Dals",Green gram 1 kg,4,150,130,20,1
03-05-2025,"Dry Fruits, Nuts & Seeds",PUTNALU 500GMS,2,90,76,14,1
03-05-2025,"Grains, Flours & Dals",Urad dall 1 Kg,4,185,170,15,1
03-05-2025,Spices & Seasonings,AVALU 100GM,15,25,20,5,1
03-05-2025,Snacks & Ready-to-Eat,BB VERMICELLI 1KG,14,95,90,5,1
03-05-2025,Spices & Seasonings,DURGA SALT CRYSTAL 1KG,15,25,25,0,1
03-05-2025,Spices & Seasonings,Turmeric powder 250 gms,15,100,75,25,1
03-05-2025,"Grains, Flours & Dals",split black gram 1 kg,4,180,170,10,1
03-05-2025,Spices & Seasonings,Coriander seeds 200 gms,15,48,40,8,1
03-05-2025,Spices & Seasonings,JEERA 250 gms,15,125,105,20,1
03-05-2025,Snacks & Ready-to-Eat,KURNOOL MARMURA,14,70,55,15,1
03-05-2025,"Dry Fruits, Nuts & Seeds",Groundnuts 1 kg,2,190,165,25,1
03-05-2025,"Grains, Flours & Dals",split greengram,4,280,280,0,2
03-05-2025,"Grains, Flours & Dals",Wheat Flour 1 kg,4,70,60,10,1
03-05-2025,Spices & Seasonings,Turmeric powder 250 gms,15,100,75,25,1
03-05-2025,"Grains, Flours & Dals",KORRALU (FOXTAIL M) 500GM,4,65,55,10,1
03-05-2025,"Grains, Flours & Dals",Arikalu (kodo),4,70,65,5,1
03-05-2025,"Grains, Flours & Dals",UDALU (Barnyard millet) 500 gms,4,70,60,10,1
03-05-2025,"Grains, Flours & Dals",SAMALU (Little millet) 500 gms,4,85,65,20,1
03-05-2025,"Grains, Flours & Dals",ANDU KORRALU (Brown top .mlt) 500,4,130,110,20,1
03-05-2025,Oils & Ghee,Coconut oil 500 ml,9,220,200,20,1
03-05-2025,"Grains, Flours & Dals",BOMBAY RAVA,4,70,55,15,1
03-05-2025,"Grains, Flours & Dals",RICE FLOUR 1KG,4,70,55,15,1
03-05-2025,"Grains, Flours & Dals",MAIDA 1KG,4,70,60,10,1
03-05-2025,"Grains, Flours & Dals",POORI ATTA 1KG,4,70,60,10,1
03-05-2025,Snacks & Ready-to-Eat,3D PAPAD,14,40,40,0,1
03-05-2025,"Grains, Flours & Dals",bengal gram 500 gm,4,210,210,0,2
03-05-2025,"Grains, Flours & Dals",chana flour 500 gms,4,60,54,6,1
03-05-2025,Misc,VD0001,8,100,100,0,1
03-05-2025,Spices & Seasonings,MASALA KAR 500GMS,15,260,240,20,1
03-05-2025,"Health, Wellness & Ayurvedic Products",MH Baby Food 400GM,5,200,200,0,1
03-05-2025,Milk & Dairy,BROWN EGGS 1P,7,98,84,14,7
03-05-2025,Spices & Seasonings,Menthulu 250 gms,15,50,45,5,1
03-05-2025,Oils & Ghee,sesame oil 1L,9,1180,"1,120.00",60,2
03-05-2025,Sweeteners,organic jaggery powder,16,99,99,0,1
03-05-2025,Spices & Seasonings,MUSTARD POWDR 500G,15,260,220,40,2
03-05-2025,Spices & Seasonings,3M.MIRCHI POWDER,15,360,320,40,1
03-05-2025,Pickles & Cooking Pastes,DURGA BRAND TM PICKLES SPECIAL,11,56,56,0,2
03-05-2025,Spices & Seasonings,pickle chili powder,15,330,300,30,2
03-05-2025,Milk & Dairy,BROWN EGGS 1P,7,280,240,40,20
03-05-2025,"Grains, Flours & Dals",PESARA PAPPU 500GMS,4,85,75,10,1
03-05-2025,"Grains, Flours & Dals",Wheat Flour 1 kg,4,140,120,20,2
03-05-2025,"Grains, Flours & Dals",THICK POHA 500GM,4,40,35,5,1
03-05-2025,"Grains, Flours & Dals",SRILATHA RICE RAVVA 500GM,4,70,70,0,2
03-05-2025,"Grains, Flours & Dals",Bombay Rava 500GM,4,35,30,5,1
03-05-2025,Oils & Ghee,Groundnut oil 1 L,9,330,330,0,1
03-05-2025,"Grains, Flours & Dals",Wheat Rava M 500GM,4,33,30,3,1
03-05-2025,Snacks & Ready-to-Eat,BB ROASTED VERMICELLY 500GM,14,70,70,0,1
03-05-2025,Snacks & Ready-to-Eat,KURNOOL MARMURA,14,70,55,15,1
03-05-2025,"Dry Fruits, Nuts & Seeds",Groundnuts 500 gms,2,95,85,10,1
03-05-2025,Spices & Seasonings,avalu,15,160,160,0,2
03-05-2025,"Grains, Flours & Dals",split green gram 500 gms,4,75,70,5,1
03-05-2025,Spices & Seasonings,Tamarind 500GM,15,320,260,60,2
03-05-2025,Oils & Ghee,sesame oil 1L,9,1180,"1,120.00",60,2
03-05-2025,"Grains, Flours & Dals",CHANA DAL 500GM,4,56,48,8,1
03-05-2025,Personal Care & Cosmetics,garnier black naturals,10,45,45,0,1
03-05-2025,Milk & Dairy,HERITAGE TOTAL CURD 500GM,7,50,50,0,1
03-05-2025,"Grains, Flours & Dals",RICE FLOUR 1KG,4,70,55,15,1
03-05-2025,"Grains, Flours & Dals",Chana Flour 500 gms,4,140,110,30,1
03-05-2025,"Grains, Flours & Dals",chana flour 500 gms,4,60,54,6,1
03-05-2025,"Grains, Flours & Dals",Wheat Flour 1 kg,4,140,120,20,2
03-05-2025,"Grains, Flours & Dals",KORRALU (FOXTAIL M) 1KG,4,150,110,40,1
03-05-2025,"Grains, Flours & Dals",VGR RICE bag 1,4,1899,"1,650.00",249,1
03-05-2025,"Grains, Flours & Dals",BARLEY SEEDS 500 GM,4,90,70,20,1
03-05-2025,"Grains, Flours & Dals",White jowar.F 1 kg,4,100,80,20,1
03-05-2025,Spices & Seasonings,JEERA 250 gms,15,125,105,20,1
03-05-2025,Sweeteners,mishri 500g,16,70,60,10,1
03-05-2025,"Grains, Flours & Dals",Urad dall 1 Kg,4,370,340,30,2
03-05-2025,"Dry Fruits, Nuts & Seeds",Groundnuts 1 kg,2,380,330,50,2
03-05-2025,"Dry Fruits, Nuts & Seeds",Groundnuts 1 kg,2,190,165,25,1
03-05-2025,"Grains, Flours & Dals",Urad dall 1 Kg,4,185,170,15,1
03-05-2025,"Grains, Flours & Dals",Chana Flour 500 gms,4,140,110,30,1
03-05-2025,"Grains, Flours & Dals",yellow jowar flour 1kg,4,100,92,8,1
03-05-2025,"Grains, Flours & Dals",SH RED POHA 500GM,4,85,85,0,1
03-05-2025,Spices & Seasonings,Jeera 100GM,15,50,45,5,1
03-05-2025,"Grains, Flours & Dals",Red Wheat Flour 1 kg,4,140,130,10,1
03-05-2025,Oils & Ghee,sesame oil 1L,9,590,560,30,1
03-05-2025,Milk & Dairy,HERITAGE BUTTERMILK,7,10,10,0,1
03-05-2025,Sweeteners,MADHUR SUGAR 1KG,16,65,55,10,1
03-05-2025,Milk & Dairy,SANGAM FULL CREAM MILK 500ML,7,39,39,0,1
03-05-2025,"Grains, Flours & Dals",RAGI FLOUR 500GRMS,4,80,70,10,2
03-05-2025,"Grains, Flours & Dals",VL Sabdana 500GM,4,77,77,0,1
03-05-2025,Oils & Ghee,BUFFALLO GHEE 500ML,9,410,370,40,1
03-05-2025,Pooja & Spiritual Items,BLACK DRAGON AGABATHI,12,240,240,0,1
03-05-2025,Spices & Seasonings,MASALA KAR 500GMS,15,260,240,20,1
03-05-2025,Sweeteners,Natural Honey 500 gms,16,280,240,40,1
03-05-2025,Sweeteners,MADHUR SUGAR 1KG,16,65,55,10,1
03-05-2025,Snacks & Ready-to-Eat,VD KOBARI LADDU,14,160,160,0,2
03-05-2025,Oils & Ghee,Safflower oil 1 L,9,800,800,0,2
03-05-2025,"Grains, Flours & Dals",Wheat Flour 1 kg,4,70,60,10,1
03-05-2025,"Grains, Flours & Dals",Wheat Rava S 1KG,4,65,55,10,1
03-05-2025,"Grains, Flours & Dals",RAGI FLOUR 1KG,4,80,70,10,1
03-05-2025,Oils & Ghee,Safflower oil 5 L,9,2200,"1,950.00",250,1
03-05-2025,"Grains, Flours & Dals",RICE FLOUR 1KG,4,70,55,15,1
03-05-2025,"Grains, Flours & Dals",unpolished turdall500grms,4,240,220,20,2
03-05-2025,"Dry Fruits, Nuts & Seeds",Groundnuts 500 gms,2,95,85,10,1
03-05-2025,"Dry Fruits, Nuts & Seeds",PUTNALU 500GMS,2,90,76,14,1
03-05-2025,Snacks & Ready-to-Eat,TILLI CHIKKI,14,25,25,0,5
03-05-2025,Snacks & Ready-to-Eat,PEANUT CHILLI,14,25,25,0,5
03-05-2025,Spices & Seasonings,NUVVULU 250GM,15,160,130,30,2
03-05-2025,"Grains, Flours & Dals",PESARA PAPPU 500GMS,4,85,75,10,1
03-05-2025,Oils & Ghee,Groundnut oil 500ml,9,180,165,15,1
03-05-2025,Oils & Ghee,Groundnut oil 1 L,9,330,330,0,1
03-05-2025,Misc,VD0009,8,100,100,0,1
03-05-2025,Milk & Dairy,HERITAGE BUTTERMILK,7,20,20,0,2
03-05-2025,Snacks & Ready-to-Eat,SS IDLY BATTER 1KG,14,60,60,0,1
03-05-2025,Snacks & Ready-to-Eat,RINGS 200GM,14,30,30,0,1
03-05-2025,Snacks & Ready-to-Eat,GB SALT COOKIES,14,60,55,5,1
03-05-2025,Milk & Dairy,HRITAGE TOTAL CURD 130GM,7,10,10,0,1
03-05-2025,"Grains, Flours & Dals",Wheat Rava S 1KG,4,65,55,10,1
03-05-2025,Sweeteners,SUGAR 1KG,16,60,56,4,1
03-05-2025,Sweeteners,sugar 500 gms,16,60,56,4,2
03-05-2025,"Grains, Flours & Dals",VGR rice 1 kg,4,210,195,15,3
03-05-2025,"Grains, Flours & Dals",SL Suji Rava 500GM,4,64,64,0,2
03-05-2025,Milk & Dairy,HRITAGE TOTAL CURD 130GM,7,10,10,0,1
03-05-2025,Oils & Ghee,Safflower oil 1 L,9,400,400,0,1
03-05-2025,Oils & Ghee,Groundnut oil 1 L,9,330,330,0,1
03-05-2025,"Grains, Flours & Dals",KORRALU (FOXTAIL M) 1KG,4,300,220,80,2
03-05-2025,"Grains, Flours & Dals",UDALU (Barnyard millet) 1 kg,4,140,115,25,1
03-05-2025,"Grains, Flours & Dals",Arikadu ( kodo),4,280,260,20,2
03-05-2025,Beverages,REFRESH SHARBATH NORMAL,1,199,190,9,1
03-05-2025,Beverages,REFRESH SHARBATH NORMAL,1,199,190,9,1
03-05-2025,Beverages,REFRESH SHARBATH SUGAR FREE,1,299,285,14,1
03-05-2025,"Grains, Flours & Dals",Wheat Flour 1 kg,4,70,60,10,1
03-05-2025,"Grains, Flours & Dals",turdal 1kg,4,220,170,50,1
03-05-2025,"Grains, Flours & Dals",Wheat Rava S 1KG,4,65,55,10,1
03-05-2025,"Grains, Flours & Dals",PESARA PAPPU 1 KG,4,170,145,25,1
03-05-2025,"Grains, Flours & Dals",Urad dall 1 Kg,4,370,340,30,2
03-05-2025,Sweeteners,SUGAR 1KG,16,60,56,4,1
03-05-2025,Pooja & Spiritual Items,SWASTIK CAMPHOR 25GM,12,90,80,10,2
03-05-2025,"Grains, Flours & Dals",CHANA DAL 1KG,4,112,96,16,1
03-05-2025,General Household & Kitchenware,wooden sb,3,45,40,5,1
03-05-2025,Snacks & Ready-to-Eat,Corn Chips 250GM,14,40,35,5,1
03-05-2025,Snacks & Ready-to-Eat,VD KOBARI LADDU,14,80,80,0,1
03-05-2025,General Household & Kitchenware,FANCY JHALI,3,42,42,0,1
03-05-2025,Sweeteners,YB JAGGERY POWDER 500GMS,16,75,75,0,1
03-05-2025,Snacks & Ready-to-Eat,KURNOOL MARMURA,14,70,55,15,1
03-05-2025,Milk & Dairy,HERITAGE TONED MILK 500ML,7,31,31,0,1
03-05-2025,"Grains, Flours & Dals",AISHWARAYA IDLY RAVA 1KG,4,99,66,33,1
03-05-2025,"Grains, Flours & Dals",turdal 500 gms,4,110,85,25,1
03-05-2025,Snacks & Ready-to-Eat,KURNOOL MARMURA,14,70,55,15,1
03-05-2025,"Grains, Flours & Dals",unpolished turdall500grms,4,120,110,10,1
03-05-2025,"Grains, Flours & Dals",JOWAR UPMA RAVA,4,75,75,0,1
03-05-2025,"Grains, Flours & Dals",Sathya Javva Wheat Rava 500GM,4,95,90,5,1
02-05-2025,Oils & Ghee,Groundnut oil 1 L,9,330,330,0,1
02-05-2025,"Dry Fruits, Nuts & Seeds",Groundnuts 1 kg,2,190,165,25,1
02-05-2025,Snacks & Ready-to-Eat,VD Pappu Chekkalu 190gm,14,60,60,0,1
02-05-2025,Snacks & Ready-to-Eat,VD KOBARI LADDU,14,80,80,0,1
02-05-2025,Snacks & Ready-to-Eat,VD PAPPU CHEGODI 200GM,14,60,60,0,1
02-05-2025,Spices & Seasonings,SAFE HARVEST FENNEL SANUF,15,110,110,0,1
02-05-2025,Spices & Seasonings,sf jeera,15,120,120,0,1
02-05-2025,"Health, Wellness & Ayurvedic Products",VAMU WATER,5,99,99,0,1
02-05-2025,Snacks & Ready-to-Eat,VD DRY FRUIT PUTHAREKULU,14,120,120,0,1
02-05-2025,Snacks & Ready-to-Eat,SD FINGER Millet with palm Jaggery 250gm,14,135,135,0,1
02-05-2025,"Grains, Flours & Dals",Multigrain 1 kg,4,300,255,45,3
02-05-2025,"Grains, Flours & Dals",JOWAR UPMA RAVA,4,75,75,0,1
02-05-2025,"Grains, Flours & Dals",Wheat Rava S 1KG,4,65,55,10,1
02-05-2025,Household & Cleaning,vim small,6,30,30,0,2
02-05-2025,Snacks & Ready-to-Eat,VD BOONDI 175GM,14,60,60,0,1
02-05-2025,"Grains, Flours & Dals",Wheat Flour 1 kg,4,70,60,10,1
02-05-2025,Oils & Ghee,Groundnut oil 1 L,9,330,330,0,1
02-05-2025,Oils & Ghee,Black Sesame oil 500 ml,9,220,190,30,1
02-05-2025,Snacks & Ready-to-Eat,MIGHTY PUFFS TOMATO,14,25,25,0,1
02-05-2025,"Grains, Flours & Dals",samalu,4,130,130,0,1
02-05-2025,"Dry Fruits, Nuts & Seeds",PULMAKHANA 100 GM,2,180,170,10,1
02-05-2025,"Grains, Flours & Dals",KORRALU (FOXTAIL M) 500GM,4,65,55,10,1
02-05-2025,"Grains, Flours & Dals",MULTIMILLET IDLY RAVVA,4,130,130,0,2
02-05-2025,"Grains, Flours & Dals",Arikadu ( kodo),4,140,130,10,1
02-05-2025,"Grains, Flours & Dals",Multigrain 1 kg,4,200,170,30,2
02-05-2025,Oils & Ghee,Safflower oil 1 L,9,800,800,0,2
02-05-2025,Snacks & Ready-to-Eat,RAJGIRA PEANUT CHIKKI,14,30,30,0,6
02-05-2025,Snacks & Ready-to-Eat,VD RED CHILLI RICEPAPAD 150GM,14,50,50,0,1
02-05-2025,"Grains, Flours & Dals",DISANO OATS 1KG,4,285,142.5,142.5,1
02-05-2025,Snacks & Ready-to-Eat,SD FINGER Millet with palm Jaggery 250gm,14,135,135,0,1
02-05-2025,Snacks & Ready-to-Eat,SD Moringa with plam jaggery 250gm,14,135,135,0,1
02-05-2025,"Grains, Flours & Dals",HS BAJRA FLAKES 250GM 1+1,4,119,119,0,1
02-05-2025,"Grains, Flours & Dals",split black gram 1 kg,4,180,170,10,1
02-05-2025,"Grains, Flours & Dals",SPLIT BLACK GRAM 500 GM,4,90,85,5,1
02-05-2025,"Health, Wellness & Ayurvedic Products",MD Gandha Karchural Choornam 30GM,5,60,60,0,1
02-05-2025,Pooja & Spiritual Items,GD Yagnadhara 31PC,12,70,70,0,1
02-05-2025,"Grains, Flours & Dals",DR.RICE 5KG,4,600,600,0,1
02-05-2025,Oils & Ghee,Coconut oil 500 ml,9,220,200,20,1
02-05-2025,"Health, Wellness & Ayurvedic Products",MD Trikatu Choornam 30GM,5,300,300,0,2
02-05-2025,Pooja & Spiritual Items,s karpuram,12,180,180,0,1
02-05-2025,Spices & Seasonings,GS Pink Rock Salt 1KG,15,120,120,0,1
02-05-2025,"Grains, Flours & Dals",JOWAR WHITE 1 KG,4,40,35,5,0.5
02-05-2025,Oils & Ghee,Sesame oil 500ml,9,295,280,15,1
02-05-2025,Oils & Ghee,Black Sesame oil 1 L,9,440,380,60,1
02-05-2025,Pooja & Spiritual Items,SOSR SWATHHI 365,12,150,150,0,5
02-05-2025,"Health, Wellness & Ayurvedic Products",MD Triphala Chorrnam 100GM,5,80,80,0,1
02-05-2025,Oils & Ghee,Coconut oil 1 L,9,440,400,40,1
02-05-2025,Oils & Ghee,sesame oil 1L,9,2360,"2,240.00",120,4
02-05-2025,"Grains, Flours & Dals",MULTIMILLET IDLY RAVVA,4,65,65,0,1
02-05-2025,Sweeteners,YB Brown Sugar 500GM,16,150,150,0,2
02-05-2025,"Health, Wellness & Ayurvedic Products",RAMA BALM 10ML,5,50,50,0,1
02-05-2025,Snacks & Ready-to-Eat,MB SORGHUM NOODLES 180GM,14,190,190,0,2
02-05-2025,Snacks & Ready-to-Eat,Fiery hot c,14,170,170,0,1
02-05-2025,Snacks & Ready-to-Eat,PEANUT CHIKKI 450GM,14,125,125,0,1
02-05-2025,"Health, Wellness & Ayurvedic Products",MXP CREAM ONION,5,45,45,0,1
02-05-2025,Snacks & Ready-to-Eat,SF MILLET PANCAKE BLUEBERRY,14,199,199,0,1
02-05-2025,Personal Care & Cosmetics,MANDARA SHAMPOO 200ML,10,175,175,0,1
02-05-2025,Milk & Dairy,HERITAGE BUTTERMILK,7,10,10,0,1
02-05-2025,Personal Care & Cosmetics,SVE PREMIUM WILD TURMEIC 100GM,10,110,110,0,1
02-05-2025,Snacks & Ready-to-Eat,VD MURMURA LADDU,14,50,50,0,1
02-05-2025,Snacks & Ready-to-Eat,MB FOXTAIL MILLET NOODLES 180GM,14,95,95,0,1
02-05-2025,Personal Care & Cosmetics,SVE SHIKAKAI SOAP 100GM,10,90,90,0,1
02-05-2025,Personal Care & Cosmetics,BIOTIQUE ORANGE PEEL BAR 150G,10,120,120,0,1
02-05-2025,Spices & Seasonings,Tamarind 250GMS,15,80,65,15,1
02-05-2025,Snacks & Ready-to-Eat,ELITE MILK RUSK 200GM,14,35,35,0,1
02-05-2025,"Dry Fruits, Nuts & Seeds",PLAIN PISTA 250GM,2,660,550,110,1
02-05-2025,Personal Care & Cosmetics,BIOTIQUE MORNING NECTAR MOISTURING,10,120,120,0,1
02-05-2025,Personal Care & Cosmetics,BIO HIMALAYAN PLUM BATHING BAR 150GM,10,105,105,0,1
02-05-2025,Spices & Seasonings,Tamarind 250GMS,15,80,65,15,1
02-05-2025,Spices & Seasonings,Elaichi 25GM,15,145,120,25,1
02-05-2025,Misc,ROLL D C,8,140,90,50,2
02-05-2025,Spices & Seasonings,Coriander seeds 200 gms,15,240,200,40,5
02-05-2025,Spices & Seasonings,SH CLOVES,15,185,185,0,1
02-05-2025,Snacks & Ready-to-Eat,VD PALLI LADDU,14,80,80,0,1
02-05-2025,"Grains, Flours & Dals",Bombay Rava 500GM,4,35,30,5,1
02-05-2025,"Grains, Flours & Dals",RICE FLOUR 500 GM,4,70,56,14,2
02-05-2025,Misc,VD0009,8,100,100,0,1
02-05-2025,"Grains, Flours & Dals",Wheat Flour 1 kg,4,70,60,10,1
02-05-2025,"Grains, Flours & Dals",Sathya Javva Wheat Rava 500GM,4,95,95,0,1
02-05-2025,"Grains, Flours & Dals",Multigrain 1 kg,4,100,85,15,1
02-05-2025,"Dry Fruits, Nuts & Seeds",Groundnuts 1 kg,2,190,165,25,1
02-05-2025,Spices & Seasonings,asafoetida,15,0,0,0,1
02-05-2025,"Health, Wellness & Ayurvedic Products",MXP CREAM ONION,5,45,45,0,1
02-05-2025,Sweeteners,YB FOREST H 250 GMS,16,180,180,0,1
02-05-2025,"Health, Wellness & Ayurvedic Products",MXP CHOCO CLASSIC BAR,5,70,70,0,1
02-05-2025,Snacks & Ready-to-Eat,VD NUVULLU CHIKKI,14,80,80,0,1
02-05-2025,Snacks & Ready-to-Eat,NGT CHATPATTA CHANA 90GM,14,25,25,0,1
02-05-2025,"Health, Wellness & Ayurvedic Products",RB Max Protein Fruit &amp;Nut 50g,5,75,75,0,1
02-05-2025,Snacks & Ready-to-Eat,RI SPORTS BAR 40G,14,90,90,0,2
02-05-2025,"Grains, Flours & Dals",Sathya Javva Wheat Rava 500GM,4,95,95,0,1
02-05-2025,"Dry Fruits, Nuts & Seeds",Groundnuts 1 kg,2,190,165,25,1
02-05-2025,"Health, Wellness & Ayurvedic Products",MH Millets Malt 500GM,5,200,190,10,1
02-05-2025,"Grains, Flours & Dals",White jowar.F 1 kg,4,200,160,40,2
02-05-2025,"Grains, Flours & Dals",BOMBAY RAVA,4,70,55,15,1
02-05-2025,"Grains, Flours & Dals",RAGI FLOUR 500GRMS,4,80,70,10,2
02-05-2025,"Grains, Flours & Dals",Kandulu 250GM,4,160,140,20,4
02-05-2025,Snacks & Ready-to-Eat,VD MURMURA LADDU,14,100,100,0,2
02-05-2025,Oils & Ghee,Groundnut oil 1 L,9,330,330,0,1
02-05-2025,Snacks & Ready-to-Eat,VD MURUKU 175GM,14,60,60,0,1
02-05-2025,"Grains, Flours & Dals",Multigrain 1 kg,4,100,85,15,1
02-05-2025,"Grains, Flours & Dals",JOWAR WHITE 1 KG,4,160,140,20,2
02-05-2025,"Grains, Flours & Dals",FLOUR CHARGE,4,24,24,0,2
02-05-2025,Beverages,BRU GREEN LABEL 1.2G,1,48,48,0,24
02-05-2025,Misc,C123,8,95,80,15,1
02-05-2025,Household & Cleaning,HARPIC 200ML,6,46,46,0,1
02-05-2025,"Grains, Flours & Dals",chana flour 500 gms,4,60,54,6,1
02-05-2025,"Grains, Flours & Dals",RAGI FLOUR 500GRMS,4,40,35,5,1
02-05-2025,Oils & Ghee,Coconut oil 1 L,9,440,400,40,1
02-05-2025,"Grains, Flours & Dals",SL Idly Rava 1KG,4,65,55,10,1
02-05-2025,Oils & Ghee,Groundnut oil 5 L,9,1800,"1,600.00",200,1
02-05-2025,Sweeteners,SUGAR 1KG,16,120,112,8,2
02-05-2025,Spices & Seasonings,dalchin chekka,15,250,200,50,5
02-05-2025,Spices & Seasonings,lavangam,15,100,100,0,2
02-05-2025,Household & Cleaning,ARIEL MATIC FL 2KG,6,660,660,0,1
02-05-2025,Spices & Seasonings,JEERA 250 gms,15,250,210,40,2
02-05-2025,Spices & Seasonings,Coriander seeds 200 gms,15,192,160,32,4
02-05-2025,Spices & Seasonings,SATHVI ANASAPUVUU 25GM,15,360,260,100,4
02-05-2025,Pooja & Spiritual Items,JAGI KAYA 25GM,12,160,120,40,2
02-05-2025,Spices & Seasonings,TATA SALT 1KG,15,60,60,0,2
02-05-2025,Spices & Seasonings,Elaichi 25GM,15,580,480,100,4
02-05-2025,Spices & Seasonings,Avalu small 250 gms,15,240,240,0,4
02-05-2025,"Grains, Flours & Dals",Wheat Flour 1 kg,4,70,60,10,1
02-05-2025,Oils & Ghee,Safflower oil 1 L,9,400,400,0,1
02-05-2025,Beverages,BISLERI SODA 750ML,1,20,20,0,1
02-05-2025,Misc,C123,8,95,80,15,1
02-05-2025,Snacks & Ready-to-Eat,VD GUMMADI VADIYAM,14,75,75,0,1
02-05-2025,Snacks & Ready-to-Eat,RB Choco Delite Almonds Raisins 40g,14,45,45,0,1
02-05-2025,Snacks & Ready-to-Eat,MIGHTY PUFF,14,25,25,0,1
02-05-2025,Pooja & Spiritual Items,GD KASTHURI,12,60,60,0,1
02-05-2025,Household & Cleaning,vim dish liquid,6,55,55,0,1
02-05-2025,"Grains, Flours & Dals",Wheat Flour 1 kg,4,70,60,10,1
02-05-2025,Snacks & Ready-to-Eat,VD KOBARI LADDU,14,80,80,0,1
02-05-2025,Snacks & Ready-to-Eat,ONION MURK,14,60,60,0,1
02-05-2025,Snacks & Ready-to-Eat,VD MINAPA SUNNUNDALU 12P,14,120,120,0,1
02-05-2025,Spices & Seasonings,ROYAL SAFFRON 400GRMS,15,130,130,0,2
02-05-2025,"Grains, Flours & Dals",RAGI FLOUR 1KG,4,80,70,10,1
02-05-2025,Sweeteners,YB JAGGERY POWDER 500GMS,16,75,75,0,1
02-05-2025,Snacks & Ready-to-Eat,RAJGIRA PEANUT CHIKKI,14,20,20,0,4
02-05-2025,Snacks & Ready-to-Eat,SUNNUNDALU,14,120,120,0,1
02-05-2025,"Grains, Flours & Dals",POORI ATTA 500GM,4,35,30,5,1
02-05-2025,Oils & Ghee,mustard oil 1l,9,440,390,50,1
02-05-2025,"Grains, Flours & Dals",RED WHEAT 1 KG,4,32.5,30,2.5,0.25
02-05-2025,"Grains, Flours & Dals",SH CHANA DAL 500GM,4,89,89,0,1
02-05-2025,Baking & Cooking Aids,GONDKATIRA Ag,0,85,75,10,1
02-05-2025,Snacks & Ready-to-Eat,BLACK PEPPER RICEPAPAD VD,14,50,50,0,1
02-05-2025,Spices & Seasonings,SH BAY LEAF / TEJ PATTA 30GM,15,35,35,0,1
02-05-2025,"Grains, Flours & Dals",SH KABULI CHANA 1KG,4,180,180,0,1
02-05-2025,Snacks & Ready-to-Eat,Sprouted Ragi Biscuits 450GM,14,150,150,0,1
02-05-2025,Pooja & Spiritual Items,GD Bhagavatha Mallika 75GM,12,60,60,0,1
02-05-2025,Snacks & Ready-to-Eat,SF COOKIES BANANA OATS,14,99,99,0,1
02-05-2025,Snacks & Ready-to-Eat,BD RAGI NOODLES,14,75,75,0,1
02-05-2025,"Grains, Flours & Dals",SL Idly Rava 1KG,4,65,55,10,1
02-05-2025,General Household & Kitchenware,MATCH BOX,3,10,10,0,1
02-05-2025,Pooja & Spiritual Items,GD Aiswarya Deepam 700ML,12,195,195,0,1
02-05-2025,"Grains, Flours & Dals",SH WHITE POHA 500GM,4,56,56,0,1
02-05-2025,Snacks & Ready-to-Eat,RSC ORANGE 100GMS,14,40,40,0,2
02-05-2025,"Grains, Flours & Dals",BOMBAY RAVA,4,70,55,15,1
02-05-2025,Snacks & Ready-to-Eat,SD Flax seeds with dates 250gm,14,135,135,0,1
02-05-2025,"Grains, Flours & Dals",UNPOLISHED TURDALL 1KG,4,240,210,30,1
02-05-2025,Snacks & Ready-to-Eat,PEANUT BUTTER,14,60,60,0,1
02-05-2025,Snacks & Ready-to-Eat,VD MURMURA LADDU,14,50,50,0,1
02-05-2025,Sweeteners,YB FOREST H 250 GMS,16,180,180,0,1
02-05-2025,"Grains, Flours & Dals",VGR RICE bag 1,4,1899,"1,650.00",249,1
02-05-2025,Snacks & Ready-to-Eat,VD DAHI MIRCHI(SALTED) 100GM,14,45,45,0,1
02-05-2025,Snacks & Ready-to-Eat,VD MURUKU 175GM,14,60,60,0,1
02-05-2025,Beverages,REFRESH SHARBATH SUGAR FREE,1,299,285,14,1
02-05-2025,Oils & Ghee,Groundnut oil 1 L,9,330,330,0,1
02-05-2025,Oils & Ghee,Groundnut oil 5 L,9,1800,"1,600.00",200,1
02-05-2025,Snacks & Ready-to-Eat,VD MURMURA LADDU,14,50,50,0,1
02-05-2025,Misc,C123,8,190,160,30,2
02-05-2025,"Grains, Flours & Dals",Wheat Flour 1 kg,4,420,360,60,6
02-05-2025,"Grains, Flours & Dals",White Chana 250 GM,4,60,50,10,1
02-05-2025,Oils & Ghee,Coconut oil 500 ml,9,220,200,20,1
02-05-2025,Spices & Seasonings,NUVVULU 250GM,15,80,65,15,1
02-05-2025,"Grains, Flours & Dals",SB Javva Wheat Ravva 500GM,4,95,95,0,1
02-05-2025,Oils & Ghee,Groundnut oil 1 L,9,660,660,0,2
02-05-2025,Misc,C123,8,95,80,15,1
02-05-2025,Household & Cleaning,vim small,6,30,30,0,2
02-05-2025,Oils & Ghee,sesame oil 1L,9,590,560,30,1
02-05-2025,Snacks & Ready-to-Eat,VD PALLI CHIKKI,14,80,80,0,1
02-05-2025,Snacks & Ready-to-Eat,SF PUFFED RICE,14,55,55,0,1
02-05-2025,"Grains, Flours & Dals",Wheat Flour 1 kg,4,140,120,20,2
02-05-2025,Oils & Ghee,Black Sesame oil 1 L,9,440,380,60,1
02-05-2025,"Grains, Flours & Dals",RICE FLOUR 1KG,4,70,55,15,1
02-05-2025,Pooja & Spiritual Items,GD Bhagavatha Mallika 75GM,12,60,60,0,1
02-05-2025,Beverages,BISLERI 100ml,1,10,10,0,1
02-05-2025,Snacks & Ready-to-Eat,MILK BREAD,14,55,55,0,1
02-05-2025,"Grains, Flours & Dals",turdal 500 gms,4,110,85,25,1
02-05-2025,"Grains, Flours & Dals",Multigrain 1 kg,4,100,85,15,1
02-05-2025,"Grains, Flours & Dals",RAGULU 1 KG,4,35,30,5,0.5
02-05-2025,"Grains, Flours & Dals",Wheat Rava S 1KG,4,65,55,10,1
02-05-2025,Spices & Seasonings,PICKLES CHILLIP 500 GMS,15,355,325,30,1
02-05-2025,Household & Cleaning,LIZOL JASMINE 200ML,6,96,96,0,2
02-05-2025,"Grains, Flours & Dals",turdal 1kg,4,220,170,50,1
02-05-2025,Household & Cleaning,LIZOL 200ML,6,45,45,0,1
02-05-2025,Personal Care & Cosmetics,DETTOL AL 125 ML,10,80,80,0,1
02-05-2025,Snacks & Ready-to-Eat,MIGHTY PUFF,14,25,25,0,1
02-05-2025,Spices & Seasonings,DURGA SALT CRYSTAL 1KG,15,25,25,0,1
02-05-2025,"Grains, Flours & Dals",CHANA DAL 500GM,4,56,48,8,1
02-05-2025,Pooja & Spiritual Items,GD KASTHURI,12,60,60,0,1
02-05-2025,Snacks & Ready-to-Eat,MIGHTY PUFFS CHEESE AND HERBS,14,25,25,0,1
02-05-2025,"Grains, Flours & Dals",RAJMA 250GM,4,55,45,10,1
02-05-2025,Oils & Ghee,Groundnut oil 5 L,9,1800,"1,600.00",200,1
02-05-2025,Oils & Ghee,sesame oil 1L,9,1180,"1,120.00",60,2
02-05-2025,"Grains, Flours & Dals",White jowar.F 1 kg,4,300,240,60,3
02-05-2025,Oils & Ghee,Coconut oil 500 ml,9,440,400,40,2
02-05-2025,Oils & Ghee,Safflower oil 1 L,9,400,400,0,1
02-05-2025,"Grains, Flours & Dals",Wheat Flour 1 kg,4,140,120,20,2
02-05-2025,"Grains, Flours & Dals",Wheat Flour 1 kg,4,210,180,30,3
02-05-2025,"Grains, Flours & Dals",Red Wheat Flour 1 kg,4,140,130,10,1
02-05-2025,"Grains, Flours & Dals",White jowar.F 1 kg,4,400,320,80,4
02-05-2025,Oils & Ghee,Sesame oil 500ml,9,295,280,15,1
02-05-2025,Snacks & Ready-to-Eat,VD BELLAM GAVVALU 200GM,14,60,60,0,1
02-05-2025,Oils & Ghee,Safflower oil 1 L,9,400,400,0,1
02-05-2025,Spices & Seasonings,YB PINK ROCK SALT 1KG,15,120,120,0,1
02-05-2025,Spices & Seasonings,DURGA SALT CRYSTAL 1KG,15,25,25,0,1
02-05-2025,"Grains, Flours & Dals",Wheat Rava M 500GM,4,33,30,3,1
02-05-2025,Beverages,BISLERI 100ml,1,10,10,0,1
02-05-2025,Spices & Seasonings,pickle chili powder,15,180,165,15,1
02-05-2025,"Dry Fruits, Nuts & Seeds",Putnalu 250GM,2,45,38,7,1
02-05-2025,Misc,ROLL D C,8,70,45,25,1
02-05-2025,Spices & Seasonings,Tamarind 250GMS,15,80,65,15,1
02-05-2025,Spices & Seasonings,DRY MIECHI 200GM,15,80,60,20,1
02-05-2025,"Grains, Flours & Dals",VGR rice 1 kg,4,350,325,25,5
02-05-2025,Snacks & Ready-to-Eat,VD PALLI LADDU,14,80,80,0,1
02-05-2025,"Grains, Flours & Dals",Chana Flour 500 gms,4,140,110,30,1
02-05-2025,"Grains, Flours & Dals",RICE FLOUR 500 GM,4,35,28,7,1
02-05-2025,"Grains, Flours & Dals",MAAGAANI LOW GI SP L 1KG,4,600,525,75,5
02-05-2025,Oils & Ghee,Safflower oil 1 L,9,400,400,0,1
02-05-2025,"Grains, Flours & Dals",Wheat Flour 1 kg,4,140,120,20,2
02-05-2025,Spices & Seasonings,DB SAFRON,15,180,180,0,1
02-05-2025,"Health, Wellness & Ayurvedic Products",AMLA PACHAK,5,100,100,0,1
02-05-2025,"Dry Fruits, Nuts & Seeds",FLAX SEEDS 250GM,2,60,50,10,1
02-05-2025,Oils & Ghee,Groundnut oil 1 L,9,330,330,0,1
02-05-2025,"Dry Fruits, Nuts & Seeds",Groundnuts 1 kg,2,190,165,25,1
02-05-2025,"Dry Fruits, Nuts & Seeds",Groundnuts 500 gms,2,190,170,20,2
02-05-2025,"Dry Fruits, Nuts & Seeds",PULMAKHANA 100 GM,2,180,170,10,1
02-05-2025,"Dry Fruits, Nuts & Seeds",Groundnuts 1 kg,2,380,330,50,2
02-05-2025,Spices & Seasonings,Elaichi 25GM,15,290,240,50,2
02-05-2025,"Grains, Flours & Dals",DH URAD GOTA 1KG,4,430,380,50,2
02-05-2025,Snacks & Ready-to-Eat,ELITE ELAICHI RUSK 200GM,14,35,35,0,1
02-05-2025,Snacks & Ready-to-Eat,VD KOBARI LADDU,14,80,80,0,1
02-05-2025,Pooja & Spiritual Items,PACHAKARPURAM,12,60,50,10,1
02-05-2025,Beverages,BISLERI 100ml,1,10,10,0,1
02-05-2025,Snacks & Ready-to-Eat,BB ROASTED VERMICELLY 500GM,14,70,70,0,1
02-05-2025,"Grains, Flours & Dals",Wheat Rava M 500GM,4,66,60,6,2
02-05-2025,"Grains, Flours & Dals",Bombay Rava 500GM,4,70,60,10,2
02-05-2025,Oils & Ghee,Groundnut oil 1 L,9,330,330,0,1
02-05-2025,"Dry Fruits, Nuts & Seeds",FLAX SEEDS 250GM,2,120,100,20,2
02-05-2025,Spices & Seasonings,NUVVULU 500GM,15,200,170,30,1
02-05-2025,"Grains, Flours & Dals",DISANO OATS 1KG,4,142.5,142.5,0,0.5
02-05-2025,"Grains, Flours & Dals",RAGI FLOUR 1KG,4,80,70,10,1
02-05-2025,Sweeteners,YB JAGGERY POWDER 1KG,16,140,140,0,1
02-05-2025,Spices & Seasonings,NUVVULU 500GM,15,160,130,30,1
02-05-2025,Snacks & Ready-to-Eat,RAJGIRA PEANUT CHIKKI,14,15,15,0,3
02-05-2025,"Grains, Flours & Dals",SL Idly Rava 1KG,4,65,55,10,1
02-05-2025,"Grains, Flours & Dals",Chana Flour 500 gms,4,140,110,30,1
02-05-2025,Oils & Ghee,sesame oil 1L,9,1180,"1,120.00",60,2
02-05-2025,Spices & Seasonings,Menthulu 250 gms,15,50,45,5,1
02-05-2025,Spices & Seasonings,BLACK JEERA 50 GM,15,45,30,15,1
02-05-2025,Snacks & Ready-to-Eat,GB SALT COOKIES,14,60,55,5,1
02-05-2025,Milk & Dairy,BUTTER MILK,7,20,20,0,2
02-05-2025,"Grains, Flours & Dals",turdal 1kg,4,220,170,50,1
02-05-2025,"Grains, Flours & Dals",CHANA DAL 1KG,4,112,96,16,1
02-05-2025,Household & Cleaning,vim small,6,90,90,0,6
02-05-2025,Snacks & Ready-to-Eat,MIGHTY PUFFS KHATTA METTA,14,25,25,0,1
02-05-2025,Snacks & Ready-to-Eat,MIGHTY PUFFS CHEESE AND HERBS,14,100,100,0,4
02-05-2025,Snacks & Ready-to-Eat,SF MIGHTY PUFFS,14,25,25,0,1
02-05-2025,"Dry Fruits, Nuts & Seeds",YELLOW KISHMISH 250GM,2,130,110,20,1
02-05-2025,Spices & Seasonings,SATHVI ANASAPUVUU 25GM,15,90,65,25,1
02-05-2025,Pooja & Spiritual Items,JAGI KAYA 25GM,12,80,60,20,1
02-05-2025,Snacks & Ready-to-Eat,RSC ORANGE 100GMS,14,20,20,0,1
02-05-2025,Spices & Seasonings,Japatri 25GM,15,100,80,20,1
02-05-2025,Spices & Seasonings,SAJEERA,15,60,40,20,1
02-05-2025,Oils & Ghee,Groundnut oil 1 L,9,330,330,0,1
02-05-2025,Milk & Dairy,SANGAM TONED MILK 500ML,7,62,62,0,2
02-05-2025,Spices & Seasonings,BIRYANI LEAF 10GM,15,60,40,20,2
02-05-2025,"Grains, Flours & Dals",White Chana 250 GM,4,60,50,10,1
02-05-2025,Snacks & Ready-to-Eat,NGT CHATPATTA CHANA 90GM,14,25,25,0,1
02-05-2025,Misc,ROLL D C,8,70,45,25,1
02-05-2025,"Grains, Flours & Dals",doctor rice 1kg,4,1800,"1,800.00",0,15
02-05-2025,"Grains, Flours & Dals",SA Multi Grain Mix 500GM,4,159,159,0,1
02-05-2025,Snacks & Ready-to-Eat,GRA IDLY PRE POW 450G,14,95,95,0,1
02-05-2025,Snacks & Ready-to-Eat,GRA DOSA PRE POW450G,14,95,95,0,1
02-05-2025,Snacks & Ready-to-Eat,MB LITTLE MILLET NOODLES 180G,14,95,95,0,1
02-05-2025,Oils & Ghee,Safflower oil 1 L,9,800,800,0,2
02-05-2025,Sweeteners,YB JAGGERY POWDER 500GMS,16,150,150,0,2
02-05-2025,"Health, Wellness & Ayurvedic Products",ORGANIC MORINGA POWER 100GM,5,249,249,0,1
02-05-2025,Oils & Ghee,BUFFALLO GHEE 500ML,9,410,370,40,1
02-05-2025,Oils & Ghee,Groundnut oil 1 L,9,990,990,0,3
02-05-2025,"Dry Fruits, Nuts & Seeds",SALTED PISTA 250GM,2,400,350,50,1
02-05-2025,"Grains, Flours & Dals",Wheat Flour 1 kg,4,140,120,20,2
02-05-2025,"Grains, Flours & Dals",Wheat Flour 1 kg,4,70,60,10,1
02-05-2025,"Grains, Flours & Dals",RAGI FLOUR 500GRMS,4,80,70,10,2
02-05-2025,"Grains, Flours & Dals",White jowar.F 1 kg,4,100,80,20,1
02-05-2025,"Grains, Flours & Dals",turdal 500 gms,4,110,85,25,1
02-05-2025,Oils & Ghee,Groundnut oil 1 L,9,990,990,0,3
02-05-2025,Spices & Seasonings,THREE MANGO RAI 200G,15,84,84,0,2
02-05-2025,Oils & Ghee,Groundnut oil 1 L,9,330,330,0,1
02-05-2025,"Grains, Flours & Dals",SL Idly Rava 1KG,4,65,55,10,1
02-05-2025,Oils & Ghee,sesame oil 1L,9,590,560,30,1
02-05-2025,Spices & Seasonings,3M.MIRCHI POWDER,15,360,320,40,1
02-05-2025,"Grains, Flours & Dals",Em Multimillet idli r 500g,4,129,129,0,1
02-05-2025,Oils & Ghee,sesame oil 1L,9,590,560,30,1
02-05-2025,"Grains, Flours & Dals",White jowar.F 1 kg,4,100,80,20,1
02-05-2025,Spices & Seasonings,NUVVULU 250GM,15,80,65,15,1
02-05-2025,Spices & Seasonings,Chilli powder 250 gms,15,145,110,35,1
02-05-2025,"Grains, Flours & Dals",RAGI FLOUR 500GRMS,4,40,35,5,1
02-05-2025,"Grains, Flours & Dals",Wheat Flour 1 kg,4,70,60,10,1
02-05-2025,"Grains, Flours & Dals",AISHWARYA SP 1KG,4,1200,"1,050.00",150,15
02-05-2025,"Grains, Flours & Dals",RICE FLOUR 500 GM,4,35,28,7,1
02-05-2025,"Grains, Flours & Dals",CHANA DAL 1KG,4,112,96,16,1
02-05-2025,Oils & Ghee,Groundnut oil 1 L,9,660,660,0,2
02-05-2025,Spices & Seasonings,Turmeric powder 250 gms,15,100,80,20,1
02-05-2025,Beverages,BRU GREEN LABEL 1.2G,1,96,96,0,48
02-05-2025,"Dry Fruits, Nuts & Seeds",SABJA SEEDS,2,70,70,0,1
02-05-2025,"Health, Wellness & Ayurvedic Products",MD Trikatu Choornam 30GM,5,150,150,0,1
02-05-2025,Oils & Ghee,Coconut oil 1 L,9,440,400,40,1
02-05-2025,Oils & Ghee,Groundnut oil 1 L,9,660,660,0,2
02-05-2025,"Health, Wellness & Ayurvedic Products",MD Triphala Chorrnam 100GM,5,80,80,0,1
02-05-2025,Pooja & Spiritual Items,GD Aiswarya Deepam 700ML,12,195,195,0,1
02-05-2025,Oils & Ghee,sesame oil 1L,9,590,560,30,1
02-05-2025,Sweeteners,YB N FOREST HONEY 700 GM,16,400,400,0,1
02-05-2025,"Grains, Flours & Dals",SPLIT URAD DAL,4,45,45,0,1
02-05-2025,Misc,ROLL D C,8,70,45,25,1
02-05-2025,"Grains, Flours & Dals",turdal 1kg,4,220,170,50,1
02-05-2025,"Grains, Flours & Dals",DH URAD GOTA 1KG,4,215,190,25,1
02-05-2025,Spices & Seasonings,Jeera 100GM,15,100,90,10,2
02-05-2025,Spices & Seasonings,Elaichi 25GM,15,145,120,25,1
02-05-2025,Spices & Seasonings,lavangam,15,100,100,0,2
02-05-2025,Spices & Seasonings,menthulu,15,90,90,0,1
02-05-2025,"Grains, Flours & Dals",Wheat Rava M 500GM,4,66,60,6,2
02-05-2025,"Grains, Flours & Dals",Bombay Rava 500GM,4,35,30,5,1
02-05-2025,Sweeteners,sugar 500 gms,16,30,28,2,1
02-05-2025,Spices & Seasonings,Tamarind 500GM,15,320,260,60,2
02-05-2025,Spices & Seasonings,DRY MIECHI 200GM,15,80,60,20,1
02-05-2025,Spices & Seasonings,AVALU 100GM,15,50,40,10,2
02-05-2025,"Grains, Flours & Dals",VGR rice 1 kg,4,70,65,5,1
02-05-2025,Oils & Ghee,OLEEV POMACE OIL 1LTR,9,1100,935,165,1
02-05-2025,"Grains, Flours & Dals",turdal 500 gms,4,110,85,25,1
02-05-2025,"Grains, Flours & Dals",CHANA DAL 500GM,4,56,48,8,1
02-05-2025,"Grains, Flours & Dals",IDLY RAVA 1KG,4,60,50,10,1
02-05-2025,Spices & Seasonings,Coriander seeds 200 gms,15,48,40,8,1
02-05-2025,"Grains, Flours & Dals",AISHWARYA SP 1KG,4,240,210,30,3
02-05-2025,Spices & Seasonings,AVALU 100GM,15,25,20,5,1
02-05-2025,"Grains, Flours & Dals",unpolished turdall500grms,4,120,110,10,1
02-05-2025,"Grains, Flours & Dals",Multigrain 1 kg,4,100,85,15,1
02-05-2025,"Grains, Flours & Dals",split greengram,4,140,140,0,1
02-05-2025,Misc,VD0001,8,100,100,0,1
02-05-2025,Snacks & Ready-to-Eat,PEANUT CHIKKI,14,44,44,0,2
02-05-2025,"Dry Fruits, Nuts & Seeds",FLAX SEEDS 250GM,2,60,50,10,1
02-05-2025,Sweeteners,YB JAGGERY POWDER 500GMS,16,75,75,0,1
02-05-2025,"Grains, Flours & Dals",RAGI FLOUR 500GRMS,4,40,35,5,1
02-05-2025,"Grains, Flours & Dals",Wheat Flour 1 kg,4,70,60,10,1
02-05-2025,Spices & Seasonings,GREEN SOUNF,15,60,40,20,1
02-05-2025,"Health, Wellness & Ayurvedic Products",RB Max Protein Cheese&amp;,5,45,45,0,1
02-05-2025,"Health, Wellness & Ayurvedic Products",ORGANIC MORINGA POWER 100GM,5,249,249,0,1
02-05-2025,"Dry Fruits, Nuts & Seeds",KAJU HALF 250GM,2,310,290,20,1
02-05-2025,Oils & Ghee,Cow ghee 500 ml,9,860,780,80,2
02-05-2025,Milk & Dairy,HERITAGE TONED MILK 500ML,7,31,31,0,1
02-05-2025,"Dry Fruits, Nuts & Seeds",Groundnuts 500 gms,2,95,85,10,1
02-05-2025,"Grains, Flours & Dals",SAMALU (Little millet) 500 gms,4,85,65,20,1
02-05-2025,Oils & Ghee,cow ghee 500 ml,9,430,390,40,1
01-05-2025,"Dry Fruits, Nuts & Seeds",FLAX SEEDS 250GM,2,60,50,10,1
01-05-2025,Snacks & Ready-to-Eat,SD Atreyapuram DRY Fruit ghee,14,150,150,0,1
01-05-2025,Spices & Seasonings,Masala Karam 250 gms,15,130,120,10,1
01-05-2025,"Grains, Flours & Dals",KORRALU (FOXTAIL M) 1KG,4,150,110,40,1
01-05-2025,"Grains, Flours & Dals",BAJRA 1 KG,4,60,50,10,1
01-05-2025,Sweeteners,YB Brown Sugar 500GM,16,75,75,0,1
01-05-2025,"Grains, Flours & Dals",Wheat Flour 1 kg,4,140,120,20,2
01-05-2025,"Grains, Flours & Dals",Wheat Rava S 1KG,4,65,55,10,1
01-05-2025,"Grains, Flours & Dals",RAGULU 1 KG,4,70,60,10,1
01-05-2025,Pooja & Spiritual Items,deep jyothi deepam oil 1000ml,12,198,198,0,1
01-05-2025,Oils & Ghee,sesame oil 1L,9,1770,"1,680.00",90,3
01-05-2025,"Grains, Flours & Dals",SH WHITE POHA 500GM,4,75,56,19,1
01-05-2025,"Grains, Flours & Dals",AISHWARYA SP 1KG,4,1200,"1,050.00",150,15
01-05-2025,Snacks & Ready-to-Eat,VD Minapa papad 200gm,14,60,60,0,1
01-05-2025,"Grains, Flours & Dals",Chana Flour 500 gms,4,120,108,12,1
01-05-2025,"Grains, Flours & Dals",RAGI FLOUR 500GRMS,4,40,35,5,1
01-05-2025,"Grains, Flours & Dals",Wheat Flour 1 kg,4,70,60,10,1
01-05-2025,"Grains, Flours & Dals",chana flour 500 gms,4,60,54,6,1
01-05-2025,Snacks & Ready-to-Eat,SF MILLET PANCAKE BANANA CC,14,199,199,0,1
01-05-2025,"Grains, Flours & Dals",MAAGAANI LOW GI SP L 1KG,4,180,157.5,22.5,1.5
01-05-2025,General Household & Kitchenware,B3 BOWL,3,295,295,0,1
01-05-2025,Spices & Seasonings,SATHVI ANASAPUVUU 25GM,15,90,65,25,1
01-05-2025,"Grains, Flours & Dals",White jowar.F 1 kg,4,50,40,10,0.5
01-05-2025,Spices & Seasonings,ROYAL SAFFRON 400GRMS,15,65,65,0,1
01-05-2025,"Grains, Flours & Dals",IDLY RAVA 1KG,4,60,50,10,1
01-05-2025,General Household & Kitchenware,B3 BOWL,3,290,290,0,1
01-05-2025,"Grains, Flours & Dals",Wheat Flour 1 kg,4,140,120,20,2
01-05-2025,Sweeteners,MADHUR SUGAR 1KG,16,65,55,10,1
01-05-2025,"Grains, Flours & Dals",MELMEKER 250GMS,4,60,45,15,1
01-05-2025,"Grains, Flours & Dals",Sathya Javva Wheat Rava 500GM,4,95,95,0,1
01-05-2025,Sweeteners,YB JAGGERY POWDER 500GMS,16,75,75,0,1
01-05-2025,"Grains, Flours & Dals",Multigrain 1 kg,4,100,85,15,1
01-05-2025,"Grains, Flours & Dals",MAATEJA rice 5 kg,4,360,345,15,1
01-05-2025,Snacks & Ready-to-Eat,MB FOXTAIL MILLET NOODLES 180GM,14,95,95,0,1
01-05-2025,"Grains, Flours & Dals",IDLY RAVA 1KG,4,120,100,20,2
01-05-2025,"Dry Fruits, Nuts & Seeds",YELLOW KISHMISH 250GM,2,130,110,20,1
01-05-2025,"Dry Fruits, Nuts & Seeds",PUMPKIN SEEDS 250GM,2,200,160,40,1
01-05-2025,Snacks & Ready-to-Eat,SS IDLY BATTER 1KG,14,60,60,0,1
01-05-2025,Spices & Seasonings,menthulu,15,90,90,0,1
01-05-2025,Spices & Seasonings,Jeera 100GM,15,50,45,5,1
01-05-2025,Spices & Seasonings,MIRYALU 50 GRMS,15,100,80,20,1
01-05-2025,Snacks & Ready-to-Eat,NGT CHATPATTA CHANA 90GM,14,25,25,0,1
01-05-2025,"Grains, Flours & Dals",chana flour 500 gms,4,60,54,6,1
01-05-2025,Snacks & Ready-to-Eat,PEANUT BUTTER,14,60,60,0,1
01-05-2025,"Grains, Flours & Dals",RAGI FLOUR 1KG,4,80,70,10,1
01-05-2025,"Grains, Flours & Dals",yellow jowar flour 1kg,4,100,92,8,1
01-05-2025,Oils & Ghee,Groundnut oil 1 L,9,330,330,0,1
01-05-2025,Sweeteners,NATURAL HONEY 1KG,16,560,480,80,1
01-05-2025,Oils & Ghee,Sesame oil 5 L,9,2950,"2,750.00",200,1
01-05-2025,"Grains, Flours & Dals",MELMEKER 250GMS,4,60,45,15,1
01-05-2025,"Grains, Flours & Dals",AISHWARYA SP 5KG,4,400,375,25,1
01-05-2025,"Dry Fruits, Nuts & Seeds",PULMAKHANA 100 GM,2,180,170,10,1
01-05-2025,Snacks & Ready-to-Eat,VD MINAPA VADIYAM,14,65,65,0,1
01-05-2025,Snacks & Ready-to-Eat,VD PALLI LADDU,14,80,80,0,1
01-05-2025,"Dry Fruits, Nuts & Seeds",cashew,2,340,310,30,1
01-05-2025,Snacks & Ready-to-Eat,SD Atreyapuram DRY Fruit ghee,14,150,150,0,1
01-05-2025,Oils & Ghee,Groundnut oil 1 L,9,330,330,0,1
01-05-2025,Oils & Ghee,sesame oil 1L,9,590,560,30,1
01-05-2025,"Grains, Flours & Dals",Chittimuthaylu rice 1 kg,4,160,140,20,1
01-05-2025,Oils & Ghee,sesame oil 1L,9,590,560,30,1
01-05-2025,"Grains, Flours & Dals",IDLY RAVA 1KG,4,120,100,20,2
01-05-2025,Sweeteners,YB JAGGERY POWDER 1KG,16,140,140,0,1
01-05-2025,Oils & Ghee,rice bran oil f,9,388,338,50,2
01-05-2025,Household & Cleaning,vim 500ml,6,125,125,0,1
01-05-2025,"Grains, Flours & Dals",Red Wheat Flour 1 kg,4,140,130,10,1
01-05-2025,Pooja & Spiritual Items,deep jyothi deepam oil 1000ml,12,198,198,0,1
01-05-2025,Oils & Ghee,Groundnut oil 1 L,9,330,330,0,1
01-05-2025,Pooja & Spiritual Items,GD Bhagavatha Mallika 75GM,12,60,60,0,1
01-05-2025,Sweeteners,sugar 500 gms,16,30,28,2,1
01-05-2025,Sweeteners,SUGAR 1KG,16,60,56,4,1
01-05-2025,"Dry Fruits, Nuts & Seeds",SABJA SEEDS,2,70,70,0,1
01-05-2025,General Household & Kitchenware,chalk piece 1b,3,30,20,10,2
01-05-2025,"Grains, Flours & Dals",turdal 500 gms,4,110,85,25,1
01-05-2025,"Grains, Flours & Dals",RAGI FLOUR 500GRMS,4,40,35,5,1
01-05-2025,"Grains, Flours & Dals",Wheat Flour 1 kg,4,70,60,10,1
01-05-2025,"Grains, Flours & Dals",RAGI FLOUR 500GRMS,4,40,35,5,1
01-05-2025,Oils & Ghee,Groundnut oil 1 L,9,990,990,0,3
01-05-2025,General Household & Kitchenware,chalk piece 1b,3,15,10,5,1
01-05-2025,"Grains, Flours & Dals",White jowar.F 1 kg,4,100,80,20,1
01-05-2025,Snacks & Ready-to-Eat,PEANUT CHILLI,14,20,20,0,4
01-05-2025,Beverages,BRU GREEN LABEL 1.2G,1,8,8,0,4
01-05-2025,Spices & Seasonings,PRO HIMALAYAN PINK SALT 500GM,15,68,68,0,1
01-05-2025,"Grains, Flours & Dals",Quinova 1 kg,4,220,195,25,1
01-05-2025,"Health, Wellness & Ayurvedic Products",NEELI LEAF CHOORNAM,5,110,110,0,1
01-05-2025,"Grains, Flours & Dals",SL Idly Rava 1KG,4,65,55,10,1
01-05-2025,Spices & Seasonings,menthulu,15,90,90,0,1
01-05-2025,"Grains, Flours & Dals",CHANA DALL 250GM,4,28,24,4,1
01-05-2025,"Dry Fruits, Nuts & Seeds",cashew,2,340,310,30,1
01-05-2025,Sweeteners,Natural Honey 500 gms,16,280,240,40,1
01-05-2025,"Grains, Flours & Dals",JOWAR WHITE 1 KG,4,40,35,5,0.5
01-05-2025,"Grains, Flours & Dals",Urad dall 1 Kg,4,185,170,15,1
01-05-2025,"Dry Fruits, Nuts & Seeds",Groundnuts 1 kg,2,190,165,25,1
01-05-2025,Spices & Seasonings,PN ORGANIC PINK SALT 1KG,15,124,124,0,1
01-05-2025,"Grains, Flours & Dals",AISHWARYA SP 1KG,4,1200,"1,050.00",150,15
01-05-2025,Spices & Seasonings,Tamarind 500GM,15,160,130,30,1
01-05-2025,"Grains, Flours & Dals",BAJRA 1 KG,4,30,25,5,0.5
01-05-2025,"Grains, Flours & Dals",Multigrain 1 kg,4,100,85,15,1
01-05-2025,"Grains, Flours & Dals",PESARA PAPPU 500GMS,4,85,75,10,1
01-05-2025,"Grains, Flours & Dals",PN ORGANIC KALA CHANA 500GM,4,196,196,0,1
01-05-2025,Oils & Ghee,cow ghee 500 ml,9,430,390,40,1
01-05-2025,"Grains, Flours & Dals",Green gram 500 gms,4,75,70,5,1
01-05-2025,"Grains, Flours & Dals",Multigrain 1 kg,4,100,85,15,1
01-05-2025,"Grains, Flours & Dals",Wheat Flour 1 kg,4,70,60,10,1
01-05-2025,Oils & Ghee,Groundnut oil 5 L,9,1800,"1,600.00",200,1
01-05-2025,"Health, Wellness & Ayurvedic Products",RB Max Protein Spanish Tomato,5,45,45,0,1
01-05-2025,Oils & Ghee,Groundnut oil 1 L,9,330,330,0,1
01-05-2025,"Grains, Flours & Dals",SL Idly Rava 1KG,4,65,55,10,1
01-05-2025,Snacks & Ready-to-Eat,Corn Chips 250GM,14,40,35,5,1
01-05-2025,"Grains, Flours & Dals",Multigrain 1 kg,4,100,85,15,1
01-05-2025,Sweeteners,Natural Honey 500 gms,16,280,240,40,1
01-05-2025,"Grains, Flours & Dals",RAGI FLOUR 1KG,4,80,70,10,1
01-05-2025,"Health, Wellness & Ayurvedic Products",MORINGA LEAF POWDER M,5,80,80,0,1
01-05-2025,Snacks & Ready-to-Eat,DINNER PAPAD,14,80,80,0,1
01-05-2025,Beverages,GEMINI TEA 500GRMS,1,275,275,0,1
01-05-2025,"Grains, Flours & Dals",FLOUR CHARGE,4,72,72,0,6
01-05-2025,"Grains, Flours & Dals",JOWAR WHITE 1 KG,4,400,350,50,5
01-05-2025,"Grains, Flours & Dals",VGR rice 1 kg,4,70,65,5,1
01-05-2025,"Grains, Flours & Dals",KORRALU (FOXTAIL M) 500GM,4,65,55,10,1
01-05-2025,"Grains, Flours & Dals",Arikalu (kodo),4,70,65,5,1
01-05-2025,"Grains, Flours & Dals",UDALU (Barnyard millet) 500 gms,4,70,60,10,1
01-05-2025,"Grains, Flours & Dals",SAMALU (Little millet) 500 gms,4,85,65,20,1
01-05-2025,"Grains, Flours & Dals",RAGULU 1 KG,4,35,30,5,0.5
01-05-2025,Milk & Dairy,HRITAGE TOTAL CURD 130GM,7,10,10,0,1
01-05-2025,Snacks & Ready-to-Eat,Popcorn Seeds 250GM,14,90,80,10,2
01-05-2025,Snacks & Ready-to-Eat,RAJGIRA PEANUT CHIKKI 450GM,14,125,125,0,1
01-05-2025,"Grains, Flours & Dals",Em Foxtail upma r 500 g,4,218,218,0,2
01-05-2025,"Grains, Flours & Dals",EM kodo upma R 500g,4,129,129,0,1
01-05-2025,"Grains, Flours & Dals",multi mllit umpa ravva,4,258,258,0,2
01-05-2025,"Grains, Flours & Dals",Em little upma R 500g,4,258,258,0,2
01-05-2025,Sweeteners,SD PALM JAGGERY 500GM,16,200,200,0,1
01-05-2025,"Grains, Flours & Dals",SH RED POHA 500GM,4,170,170,0,2
01-05-2025,Oils & Ghee,Groundnut oil 1 L,9,660,660,0,2
01-05-2025,Snacks & Ready-to-Eat,MILK BREAD,14,30,30,0,1
01-05-2025,Oils & Ghee,Safflower oil 1 L,9,400,400,0,1
01-05-2025,"Grains, Flours & Dals",SRILATHA RICE RAVVA 500GM,4,35,35,0,1
01-05-2025,"Grains, Flours & Dals",Wheat Flour 1 kg,4,70,60,10,1
01-05-2025,"Grains, Flours & Dals",SABDANA 500GM,4,180,140,40,2
01-05-2025,Snacks & Ready-to-Eat,BD BARELY NOODLES 200G,14,70,70,0,1
01-05-2025,"Dry Fruits, Nuts & Seeds",YELLOW KISHMISH 250GM,2,130,110,20,1
01-05-2025,Spices & Seasonings,AVALU 100GM,15,25,20,5,1
01-05-2025,"Dry Fruits, Nuts & Seeds",PULMAKHANA 100 GM,2,180,170,10,1
01-05-2025,Snacks & Ready-to-Eat,BD PEARL MILLET NOODLES 200G,14,70,70,0,1
01-05-2025,Snacks & Ready-to-Eat,Popcorn Seeds 250GM,14,45,40,5,1
01-05-2025,Pooja & Spiritual Items,GD SANDAL 150GM,12,110,110,0,1
01-05-2025,Personal Care & Cosmetics,GOW DURBAR NAVA 100GM SOAP,10,160,160,0,4
01-05-2025,Personal Care & Cosmetics,tongue cleaner,10,20,15,5,1
01-05-2025,Snacks & Ready-to-Eat,FOXTAIL NOODLES,14,75,75,0,1
01-05-2025,Pooja & Spiritual Items,GD WOODS 150GM,12,110,110,0,1
01-05-2025,"Dry Fruits, Nuts & Seeds",FLAX SEEDS 250GM,2,120,100,20,2
01-05-2025,General Household & Kitchenware,MATCH BOX,3,10,10,0,1
01-05-2025,Oils & Ghee,Black Sesame oil 1 L,9,880,760,120,2
01-05-2025,Pooja & Spiritual Items,BALAJI KASTURI DHOOP STICKS,12,70,70,0,1
01-05-2025,Oils & Ghee,Groundnut oil 1 L,9,330,330,0,1
01-05-2025,Pickles & Cooking Pastes,DURGA BRAND TM PICKLES SPECIAL,11,28,28,0,1
01-05-2025,"Health, Wellness & Ayurvedic Products",UVIS NEEM OIL 100ML,5,120,120,0,1
01-05-2025,Sweeteners,MISHRI D,16,40,30,10,1
01-05-2025,"Grains, Flours & Dals",Green gram 1 kg,4,150,130,20,1
01-05-2025,Snacks & Ready-to-Eat,SD Bajra with palm Jaggery 250gm,14,135,135,0,1
01-05-2025,Oils & Ghee,sesame oil 1L,9,590,560,30,1
01-05-2025,Snacks & Ready-to-Eat,RAJGIRA PEANUT CHIKKI 450GM,14,125,125,0,1
01-05-2025,Spices & Seasonings,PN ORGANIC PINK SALT 1KG,15,124,124,0,1
01-05-2025,"Grains, Flours & Dals",BAJRA 1 KG,4,60,50,10,1
01-05-2025,"Grains, Flours & Dals",YELLOW JOWER 1KG,4,90,80,10,1
01-05-2025,"Dry Fruits, Nuts & Seeds",cashew,2,340,310,30,1
01-05-2025,Milk & Dairy,HERITAGE BUTTERMILK,7,10,10,0,1
01-05-2025,Snacks & Ready-to-Eat,BATANA NGT 70GMS,14,20,20,0,1
01-05-2025,Snacks & Ready-to-Eat,NGT CHATPATTA CHANA 90GM,14,25,25,0,1
01-05-2025,Pooja & Spiritual Items,deep jyothi deepam oil 1000ml,12,198,198,0,1
01-05-2025,Milk & Dairy,HRITAGE TOTAL CURD 130GM,7,20,20,0,2
01-05-2025,"Grains, Flours & Dals",RAGULU 1 KG,4,17.5,15,2.5,0.25
01-05-2025,"Health, Wellness & Ayurvedic Products",SAI DURGA MORINGA LEAVES 100GM,5,75,75,0,1
01-05-2025,"Grains, Flours & Dals",Multigrain 1 kg,4,100,85,15,1
01-05-2025,Spices & Seasonings,SD Curry Leaves Karam Powder 100GM,15,65,65,0,1
01-05-2025,Sweeteners,MADHUR SUGAR 1KG,16,65,55,10,1
01-05-2025,Oils & Ghee,Groundnut oil 1 L,9,330,330,0,1
01-05-2025,Oils & Ghee,rice bran oil f,9,194,169,25,1
01-05-2025,Spices & Seasonings,DRY MIECHI 200GM,15,80,60,20,1
01-05-2025,Sweeteners,MISHRI 250 GM,16,35,30,5,1
01-05-2025,Beverages,BRU GREEN LABEL 1.2G,1,76,76,0,38
01-05-2025,"Grains, Flours & Dals",Urad dall 500 gms,4,95,85,10,1
01-05-2025,"Dry Fruits, Nuts & Seeds",Groundnuts 500 gms,2,95,85,10,1
01-05-2025,"Grains, Flours & Dals",JOWAR WHITE 1 KG,4,20,17.5,2.5,0.25
01-05-2025,Sweeteners,mishri 500g,16,70,60,10,1
01-05-2025,Snacks & Ready-to-Eat,SD JOWAR WITH PALM JAGGERY 250GM,14,135,135,0,1
01-05-2025,"Grains, Flours & Dals",UNPOLISHED TURDALL 1KG,4,240,210,30,1
01-05-2025,Snacks & Ready-to-Eat,SD FINGER Millet with palm Jaggery 250gm,14,135,135,0,1
01-05-2025,Oils & Ghee,Groundnut oil 1 L,9,990,990,0,3
01-05-2025,Oils & Ghee,Groundnut oil 1 L,9,330,330,0,1
01-05-2025,"Grains, Flours & Dals",yellow jowar flour 1kg,4,100,92,8,1
01-05-2025,General Household & Kitchenware,chalk piece 1b,3,17,12,5,1
01-05-2025,"Grains, Flours & Dals",Wheat Flour 1 kg,4,70,60,10,1
01-05-2025,Oils & Ghee,Safflower oil 1 L,9,400,400,0,1
01-05-2025,"Grains, Flours & Dals",Multigrain 1 kg,4,100,85,15,1
01-05-2025,Oils & Ghee,Coconut oil 500 ml,9,220,200,20,1
01-05-2025,Sweeteners,Natural Honey 500 gms,16,280,240,40,1
01-05-2025,Misc,VD0009,8,100,100,0,1
01-05-2025,"Grains, Flours & Dals",RAGULU 1 KG,4,70,60,10,1
01-05-2025,"Grains, Flours & Dals",BAJRA 1 KG,4,60,50,10,1
01-05-2025,"Grains, Flours & Dals",FLOUR CHARGE,4,36,36,0,3
01-05-2025,Oils & Ghee,Groundnut oil 1 L,9,330,330,0,1
01-05-2025,Sweeteners,NATURAL HONEY 1KG,16,560,480,80,1
01-05-2025,"Dry Fruits, Nuts & Seeds",PUMPKIN SEEDS 250GM,2,200,160,40,1
01-05-2025,"Dry Fruits, Nuts & Seeds",FLAX SEEDS 250GM,2,60,50,10,1
01-05-2025,Snacks & Ready-to-Eat,KB MILK JUNNU POW 100GM,14,80,80,0,1
01-05-2025,"Dry Fruits, Nuts & Seeds",SUNFLOWER SEEDS 250GRM,2,150,130,20,1
01-05-2025,Snacks & Ready-to-Eat,CHOCO BROWINE,14,20,20,0,1
01-05-2025,"Dry Fruits, Nuts & Seeds",SATHVI CHIA SEEDS 100GM,2,100,80,20,1
01-05-2025,"Health, Wellness & Ayurvedic Products",RB Max Protein Choco chips 55gm,5,50,50,0,1
01-05-2025,"Grains, Flours & Dals",Wheat Flour 1 kg,4,70,60,10,1
01-05-2025,"Grains, Flours & Dals",Wheat Flour 1 kg,4,70,60,10,1
01-05-2025,Oils & Ghee,sesame oil 1L,9,1770,"1,680.00",90,3
01-05-2025,Pickles & Cooking Pastes,DURGA BRAND TM PICKLES SPECIAL,11,56,56,0,2
01-05-2025,Snacks & Ready-to-Eat,SD KODO MILLET WITH PALM JAGGERY,14,135,135,0,1
01-05-2025,Spices & Seasonings,AVALU 250grms,15,120,120,0,2
01-05-2025,"Grains, Flours & Dals",SL Idly Rava 1KG,4,65,55,10,1
01-05-2025,Pooja & Spiritual Items,SWASTIK CAMPHOR 25GM,12,90,90,0,2
01-05-2025,Pooja & Spiritual Items,GD SANDAL 150GM,12,110,110,0,1
01-05-2025,Pooja & Spiritual Items,GD WOODS 150GM,12,110,110,0,1
01-05-2025,Snacks & Ready-to-Eat,SATHVI REGIVADA 200GM,14,80,60,20,1
01-05-2025,Spices & Seasonings,SONTI 50GM,15,60,40,20,2
01-05-2025,Spices & Seasonings,Coriander seeds 200 gms,15,48,40,8,1
01-05-2025,"Health, Wellness & Ayurvedic Products",JAMBU SEED CHOORNAM 100GM,5,80,80,0,1
01-05-2025,Pooja & Spiritual Items,javadhu,12,60,60,0,1
01-05-2025,General Household & Kitchenware,SIRIDHANYALU BOOK,3,200,180,20,1
01-05-2025,Snacks & Ready-to-Eat,VD Pappu Chekkalu 190gm,14,60,60,0,1
01-05-2025,General Household & Kitchenware,chalk piece 1b,3,15,10,5,1
01-05-2025,Personal Care & Cosmetics,Soapnut 250GM,10,60,45,15,1
01-05-2025,Personal Care & Cosmetics,YB Bath Powder 200GM,10,100,100,0,1
01-05-2025,Oils & Ghee,Groundnut oil 1 L,9,330,330,0,1
01-05-2025,"Grains, Flours & Dals",Chana Flour 500 gms,4,140,110,30,1
01-05-2025,"Grains, Flours & Dals",Wheat Flour 1 kg,4,70,60,10,1
01-05-2025,"Grains, Flours & Dals",chana flour 500 gms,4,60,54,6,1
01-05-2025,"Dry Fruits, Nuts & Seeds",Putnalu 250GM,2,45,38,7,1
01-05-2025,"Grains, Flours & Dals",Multigrain 1 kg,4,100,85,15,1
01-05-2025,Personal Care & Cosmetics,UVIS MULTANI MITTI PW 100GM,10,49,49,0,1
01-05-2025,"Grains, Flours & Dals",UNPOLISHED TURDALL 1KG,4,240,210,30,1
01-05-2025,"Grains, Flours & Dals",THICK POHA 1KG,4,80,70,10,1
01-05-2025,"Grains, Flours & Dals",SABDANA 500GM,4,90,70,20,1
01-05-2025,"Grains, Flours & Dals",Urad dall 1 Kg,4,185,170,15,1
01-05-2025,Spices & Seasonings,TATA SALT 1KG,15,30,30,0,1
01-05-2025,Snacks & Ready-to-Eat,MILK BREAD,14,55,55,0,1
01-05-2025,Spices & Seasonings,ROYAL SAFFRON 400GRMS,15,65,65,0,1
01-05-2025,Spices & Seasonings,DURGA SALT CRYSTAL 1KG,15,25,25,0,1
01-05-2025,Household & Cleaning,vim 500ml,6,125,125,0,1
01-05-2025,"Grains, Flours & Dals",Green Batani 500GM,4,110,90,20,1
01-05-2025,"Grains, Flours & Dals",Urad dall 500 gms,4,95,85,10,1
01-05-2025,"Grains, Flours & Dals",PESARA PAPPU 1 KG,4,170,145,25,1
01-05-2025,Snacks & Ready-to-Eat,KURNOOL MARMURA,14,70,55,15,1
01-05-2025,"Dry Fruits, Nuts & Seeds",Groundnuts 500 gms,2,95,85,10,1
01-05-2025,Personal Care & Cosmetics,KHADI ACTIVATED CHARCOAL SOAP,10,80,80,0,1
01-05-2025,Pooja & Spiritual Items,GD Bhagavatha Mallika 75GM,12,60,60,0,1
01-05-2025,Snacks & Ready-to-Eat,OK PENNE 400GM,14,120,120,0,1
01-05-2025,"Grains, Flours & Dals",Bajra Flour 1 kg,4,70,60,10,1
01-05-2025,Pooja & Spiritual Items,SST 365 PURE COTTON POOJA,12,30,30,0,1
01-05-2025,Sweeteners,SUGAR 1KG,16,60,56,4,1
01-05-2025,"Grains, Flours & Dals",SL Idly Rava 1KG,4,65,55,10,1
01-05-2025,Spices & Seasonings,AVALU 250grms,15,60,60,0,1
01-05-2025,"Grains, Flours & Dals",Wheat Flour 1 kg,4,140,120,20,2
01-05-2025,Spices & Seasonings,GREEN SOUNF,15,60,40,20,1
01-05-2025,Spices & Seasonings,ROYAL SAFFRON 400GRMS,15,130,130,0,2
01-05-2025,Sweeteners,Natural Honey 500 gms,16,280,240,40,1
01-05-2025,Household & Cleaning,vim small,6,15,15,0,1
01-05-2025,Oils & Ghee,Groundnut oil 1 L,9,330,330,0,1
01-05-2025,Oils & Ghee,Safflower oil 1 L,9,400,400,0,1
01-05-2025,Oils & Ghee,Coconut oil 500 ml,9,220,200,20,1
01-05-2025,Beverages,BISLERI WATER 1L,1,20,20,0,1
01-05-2025,Snacks & Ready-to-Eat,MIGHTY PUFFS CHEESE AND HERBS,14,25,25,0,1
01-05-2025,Snacks & Ready-to-Eat,MIGHTY PUFFS CHEDDAR CHEESE,14,25,25,0,1
01-05-2025,"Grains, Flours & Dals",Arikadu ( kodo),4,140,130,10,1
01-05-2025,Oils & Ghee,Groundnut oil 1 L,9,330,330,0,1
01-05-2025,Snacks & Ready-to-Eat,DOSA BATTER 1KG,14,60,60,0,1
01-05-2025,Snacks & Ready-to-Eat,KURNOOL MARMURA,14,70,55,15,1
01-05-2025,"Grains, Flours & Dals",MAAGAANI W RICE 5KGS,4,899,535,364,1
01-05-2025,"Grains, Flours & Dals",THICK POHA 500GM,4,40,35,5,1
01-05-2025,"Grains, Flours & Dals",Wheat Flour 1 kg,4,70,60,10,1
01-05-2025,"Grains, Flours & Dals",RAGI FLOUR 500GRMS,4,40,35,5,1
01-05-2025,Spices & Seasonings,SH MUSTARD 100GM,15,30,30,0,1
01-05-2025,Oils & Ghee,Groundnut oil 1 L,9,660,660,0,2
01-05-2025,"Dry Fruits, Nuts & Seeds",FLAX SEEDS 250GM,2,60,50,10,1
01-05-2025,"Grains, Flours & Dals",maida 500grms,4,35,30,5,1
01-05-2025,"Grains, Flours & Dals",Black uluvalu 500 gms,4,90,70,20,1
01-05-2025,Oils & Ghee,sesame oil 1L,9,590,560,30,1
01-05-2025,Snacks & Ready-to-Eat,ANNAPURNA APPALAM,14,35,35,0,1
01-05-2025,"Grains, Flours & Dals",WHITE BATANI,4,40,30,10,1
01-05-2025,"Grains, Flours & Dals",White jowar.F 1 kg,4,200,160,40,2
01-05-2025,"Grains, Flours & Dals",RAGI FLOUR 1KG,4,160,140,20,2
01-05-2025,"Grains, Flours & Dals",RAGI FLOUR 1KG,4,80,70,10,1
01-05-2025,"Dry Fruits, Nuts & Seeds",cashew,2,340,310,30,1
01-05-2025,"Dry Fruits, Nuts & Seeds",ALMONDS 250GM,2,280,260,20,1
01-05-2025,Snacks & Ready-to-Eat,SAGOPAPAD GREEN CHILLI VD,14,55,55,0,1
01-05-2025,Snacks & Ready-to-Eat,3D PAPAD,14,40,40,0,1
01-05-2025,"Grains, Flours & Dals",split green gram 500 gms,4,75,70,5,1
01-05-2025,"Grains, Flours & Dals",Brown RICE 1KG,4,700,650,50,10
01-05-2025,"Grains, Flours & Dals",JOWAR UPMA RAVA,4,75,75,0,1
01-05-2025,"Grains, Flours & Dals",Wheat Flour 1 kg,4,70,60,10,1
01-05-2025,"Grains, Flours & Dals",Multigrain 1 kg,4,100,85,15,1
01-05-2025,Oils & Ghee,Black Sesame oil 1 L,9,440,380,60,1
01-05-2025,Milk & Dairy,SANGAM TONED MILK 500ML,7,31,31,0,1
01-05-2025,Oils & Ghee,Groundnut oil 1 L,9,330,330,0,1
01-05-2025,Spices & Seasonings,PN ORGANIC PINK SALT 1KG,15,124,124,0,1
01-05-2025,"Grains, Flours & Dals",Wheat Flour 1 kg,4,140,120,20,2
01-05-2025,Pooja & Spiritual Items,deep jyothi deepam oil 1000ml,12,198,198,0,1
01-05-2025,"Grains, Flours & Dals",RICE FLOUR 500 GM,4,35,28,7,1
01-05-2025,Snacks & Ready-to-Eat,SD Atreyapuram DRY Fruit ghee,14,150,150,0,1
01-05-2025,Snacks & Ready-to-Eat,BELLAM MINAPA SUNADULLU,14,180,180,0,1
01-05-2025,Snacks & Ready-to-Eat,PEANUT CHIKKI,14,22,22,0,1
01-05-2025,Snacks & Ready-to-Eat,RI Yogurt Berry Oats 35g,14,45,45,0,1
01-05-2025,"Grains, Flours & Dals",SRILATHA RICE RAVVA 500GM,4,35,35,0,1
01-05-2025,Snacks & Ready-to-Eat,NGT CHATPATTA CHANA 90GM,14,25,25,0,1
01-05-2025,Pickles & Cooking Pastes,SD CABBAGE PICKLE,11,110,110,0,1
01-05-2025,Oils & Ghee,BUFFALLO GHEE 500ML,9,410,370,40,1
01-05-2025,Snacks & Ready-to-Eat,SF MIGHTY PUFFS,14,25,25,0,1
01-05-2025,"Dry Fruits, Nuts & Seeds",Groundnuts 1 kg,2,190,165,25,1
01-05-2025,"Dry Fruits, Nuts & Seeds",PULMAKHANA 100 GM,2,180,170,10,1
01-05-2025,Spices & Seasonings,JEERA 250 gms,15,125,105,20,1
01-05-2025,"Grains, Flours & Dals",SB Javva Wheat Ravva 500GM,4,95,95,0,1
01-05-2025,Pooja & Spiritual Items,GD Aiswarya Deepam 700ML,12,195,195,0,1
01-05-2025,"Dry Fruits, Nuts & Seeds",cashew,2,340,310,30,1
01-05-2025,Pooja & Spiritual Items,GOW DURBAR GEETHA CAMPHOR,12,60,60,0,1
01-05-2025,"Grains, Flours & Dals",SA Sprouted Ragi Flour 500GM,4,69,69,0,1
01-05-2025,Milk & Dairy,SANGAM CURD 450GM,7,38,38,0,1
01-05-2025,"Grains, Flours & Dals",RAGI FLOUR 500GRMS,4,40,35,5,1
01-05-2025,Snacks & Ready-to-Eat,KURNOOL MARMURA,14,70,55,15,1
01-05-2025,Snacks & Ready-to-Eat,VD MULTI CHAKKA,14,110,110,0,1
01-05-2025,"Grains, Flours & Dals",RICE FLOUR 1KG,4,70,55,15,1
01-05-2025,"Grains, Flours & Dals",RAGI FLOUR 500GRMS,4,80,70,10,2
01-05-2025,"Dry Fruits, Nuts & Seeds",PUTNALU 500GMS,2,270,228,42,3
01-05-2025,Spices & Seasonings,Black Till 250GM,15,180,150,30,2
01-05-2025,"Grains, Flours & Dals",White jowar.F 1 kg,4,200,160,40,2
01-05-2025,"Grains, Flours & Dals",VGR RICE bag 1,4,1899,"1,650.00",249,1
01-05-2025,Oils & Ghee,Black Sesame oil 500 ml,9,220,190,30,1
01-05-2025,Sweeteners,SD PALM JAGGERY 500GM,16,200,200,0,1
01-05-2025,"Grains, Flours & Dals",MELMEKER 250GMS,4,60,45,15,1
01-05-2025,"Dry Fruits, Nuts & Seeds",PULMAKHANA 100 GM,2,180,170,10,1
01-05-2025,Snacks & Ready-to-Eat,VD DAHI MIRCHI(SALTED) 100GM,14,225,225,0,5
01-05-2025,Snacks & Ready-to-Eat,NGT CHATPATTA CHANA 90GM,14,50,50,0,2
01-05-2025,"Grains, Flours & Dals",PESARA PAPPU 500GMS,4,85,75,10,1
01-05-2025,Oils & Ghee,Safflower oil 1 L,9,400,400,0,1
01-05-2025,"Grains, Flours & Dals",RAGI FLOUR 500GRMS,4,40,35,5,1
01-05-2025,"Grains, Flours & Dals",chana flour 500 gms,4,60,54,6,1
01-05-2025,Oils & Ghee,Coconut oil 1 L,9,440,400,40,1
01-05-2025,Oils & Ghee,mustard oil,9,195,195,0,1
01-05-2025,Snacks & Ready-to-Eat,MB LITTLE MILLET NOODLES 180G,14,95,95,0,1
01-05-2025,Milk & Dairy,SANGAM TONED MILK 500ML,7,62,62,0,2
01-05-2025,"Grains, Flours & Dals",BARLEY SEEDS 500 GM,4,180,140,40,2
01-05-2025,"Grains, Flours & Dals",UDALU (Barnyard millet) 1 kg,4,140,115,25,1
01-05-2025,"Grains, Flours & Dals",Wheat Rava M 500GM,4,66,60,6,2
01-05-2025,Spices & Seasonings,coconut powder,15,90,70,20,1
01-05-2025,"Grains, Flours & Dals",SB Javva Wheat Ravva 500GM,4,95,95,0,1
01-05-2025,Spices & Seasonings,menthulu,15,90,90,0,1
01-05-2025,"Grains, Flours & Dals",MELMEKER 250GMS,4,60,45,15,1
01-05-2025,"Grains, Flours & Dals",samalu,4,130,130,0,1
01-05-2025,"Grains, Flours & Dals",Quinova 500 gms,4,110,100,10,1
01-05-2025,"Grains, Flours & Dals",ulavalu red,4,40,40,0,1
01-05-2025,Snacks & Ready-to-Eat,KURNOOL MARMURA,14,70,55,15,1
01-05-2025,General Household & Kitchenware,WOODEN SPATULA 11,3,15,15,0,1
01-05-2025,"Grains, Flours & Dals",SABDANA,4,40,35,5,1
01-05-2025,"Dry Fruits, Nuts & Seeds",Groundnuts 500 gms,2,95,85,10,1
01-05-2025,Snacks & Ready-to-Eat,KURNOOL MARMURA,14,70,55,15,1
01-05-2025,"Dry Fruits, Nuts & Seeds",PUTNALU 500GMS,2,90,76,14,1
01-05-2025,Beverages,BRU GREEN LABEL 1.2G,1,24,24,0,12
01-05-2025,Pooja & Spiritual Items,s karpuram,12,180,180,0,1
01-05-2025,Spices & Seasonings,Chilli powder 500 gms,15,290,210,80,1
01-05-2025,Spices & Seasonings,menthulu,15,90,90,0,1
01-05-2025,Oils & Ghee,Groundnut oil 1 L,9,330,330,0,1
01-05-2025,"Grains, Flours & Dals",COW B rice 1 kg,4,360,345,15,5
01-05-2025,Milk & Dairy,HERITAGE TOTAL CURD 500GM,7,50,50,0,1
01-05-2025,Spices & Seasonings,menthulu,15,90,90,0,1
01-05-2025,Pickles & Cooking Pastes,DURGA BRAND TM PICKLES SPECIAL,11,56,56,0,2
01-05-2025,Spices & Seasonings,MUSTARD POWDER 250G,15,65,55,10,1
01-05-2025,Milk & Dairy,HERTG FULL CREAM M,7,41,41,0,1
01-05-2025,"Grains, Flours & Dals",Wheat Flour 1 kg,4,70,60,10,1
01-05-2025,"Grains, Flours & Dals",SPLIT URAD DAL,4,45,45,0,1
01-05-2025,Spices & Seasonings,Tamarind 250GMS,15,80,65,15,1
01-05-2025,"Grains, Flours & Dals",turdal 1kg,4,220,170,50,1
01-05-2025,"Grains, Flours & Dals",CHANA DALL 250GM,4,28,24,4,1
01-05-2025,"Grains, Flours & Dals",SL Idly Rava 1KG,4,65,55,10,1
01-05-2025,Oils & Ghee,Groundnut oil 1 L,9,330,330,0,1
01-05-2025,Sweeteners,SUGAR 1KG,16,60,56,4,1
01-05-2025,"Grains, Flours & Dals",VYS HMT 26KG,4,1650,"1,650.00",0,1
01-05-2025,"Dry Fruits, Nuts & Seeds",Groundnuts 1 kg,2,190,165,25,1
01-05-2025,Spices & Seasonings,Coriander seeds 200 gms,15,48,40,8,1
01-05-2025,Spices & Seasonings,TATA SALT 1KG,15,30,30,0,1
01-05-2025,"Grains, Flours & Dals",Urad dall 1 Kg,4,370,340,30,2
01-05-2025,"Grains, Flours & Dals",White jowar.F 1 kg,4,100,80,20,1
01-05-2025,Spices & Seasonings,RED COPRA 250GMS,15,85,74,11,1
01-05-2025,"Grains, Flours & Dals",SL Suji Rava 500GM,4,32,32,0,1
01-05-2025,"Grains, Flours & Dals",turdal 500 gms,4,110,85,25,1
01-05-2025,"Grains, Flours & Dals",chana flour 500 gms,4,60,54,6,1
01-05-2025,"Grains, Flours & Dals",Wheat Flour 1 kg,4,140,120,20,2
01-05-2025,"Grains, Flours & Dals",RICE FLOUR 500 GM,4,35,28,7,1
01-05-2025,"Dry Fruits, Nuts & Seeds",ALMONDS 250GM,2,280,260,20,1
01-05-2025,"Dry Fruits, Nuts & Seeds",DRYDATES 250GM,2,150,120,30,1
01-05-2025,"Dry Fruits, Nuts & Seeds",YELLOW KISHMISH 250GM,2,130,110,20,1
01-05-2025,Snacks & Ready-to-Eat,MIGHTY PUFFS KHATTA METTA,14,25,25,0,1
01-05-2025,"Grains, Flours & Dals",Green gram 1 kg,4,150,130,20,1
01-05-2025,Snacks & Ready-to-Eat,VD Pappu Chekkalu 190gm,14,60,60,0,1
01-05-2025,"Health, Wellness & Ayurvedic Products",RB Max Protein Choco Berry bar 50g,5,75,75,0,1
01-05-2025,Snacks & Ready-to-Eat,VD MINAPA VADIYAM,14,65,65,0,1
01-05-2025,Spices & Seasonings,3M.MIRCHI POWDER,15,360,320,40,1
01-05-2025,"Grains, Flours & Dals",White jowar.F 1 kg,4,100,80,20,1
01-05-2025,Pooja & Spiritual Items,GD SANDAL 150GM,12,110,110,0,1
01-05-2025,Spices & Seasonings,THREE MANGO RAI 200G,15,42,42,0,1
01-05-2025,Pooja & Spiritual Items,GD WOODS 150GM,12,110,110,0,1
01-05-2025,Pooja & Spiritual Items,s karpuram,12,180,180,0,1
01-05-2025,Personal Care & Cosmetics,HIMALAYA LIP BALM 10GM,10,40,40,0,1
01-05-2025,Spices & Seasonings,Telaga Pindi 250 GM,15,40,35,5,1
01-05-2025,Snacks & Ready-to-Eat,VD ATUKULU MIXTURE 175GM,14,60,60,0,1
01-05-2025,Spices & Seasonings,Elaichi 25GM,15,145,120,25,1
01-05-2025,"Grains, Flours & Dals",Wheat Flour 1 kg,4,70,60,10,1
01-05-2025,"Grains, Flours & Dals",SRILATHA RICE RAVVA 500GM,4,35,35,0,1
01-05-2025,Spices & Seasonings,Tamarind 250GMS,15,80,65,15,1
01-05-2025,Snacks & Ready-to-Eat,VD PALLI LADDU,14,80,80,0,1
01-05-2025,"Dry Fruits, Nuts & Seeds",Groundnuts 1 kg,2,380,330,50,2
01-05-2025,"Dry Fruits, Nuts & Seeds",SATHVI CHIA SEEDS 100GM,2,100,80,20,1
01-05-2025,"Grains, Flours & Dals",Wheat Flour 1 kg,4,70,60,10,1
01-05-2025,Oils & Ghee,Groundnut oil 1 L,9,330,330,0,1
01-05-2025,"Grains, Flours & Dals",RAGI FLOUR 1KG,4,160,140,20,2
01-05-2025,Spices & Seasonings,TATA SALT 1KG,15,30,30,0,1
01-05-2025,Spices & Seasonings,Jeera 100GM,15,50,45,5,1
01-05-2025,"Grains, Flours & Dals",UNPOLISHED TURDALL 1KG,4,240,210,30,1
01-05-2025,Snacks & Ready-to-Eat,Corn Chips 250GM,14,40,35,5,1
01-05-2025,Milk & Dairy,SANGAM CURD 450GM,7,38,38,0,1
01-05-2025,Spices & Seasonings,AVALU 250grms,15,60,60,0,1
01-05-2025,Snacks & Ready-to-Eat,VD MULTI CHAKKA,14,110,110,0,1
01-05-2025,Spices & Seasonings,3M.MIRCHI POWDER,15,360,320,40,1
01-05-2025,Oils & Ghee,sesame oil 1L,9,1180,"1,120.00",60,2
01-05-2025,Spices & Seasonings,MUSTARD POWDR 500G,15,130,110,20,1
01-05-2025,Oils & Ghee,sesame oil 1L,9,590,560,30,1
01-05-2025,Oils & Ghee,groundnet oil,9,1600,"1,600.00",0,1
01-05-2025,Oils & Ghee,Groundnut oil 1 L,9,330,330,0,1
01-05-2025,"Dry Fruits, Nuts & Seeds",cashew,2,340,310,30,1
01-05-2025,"Grains, Flours & Dals",doctor rice 1kg,4,120,120,0,1
01-05-2025,"Grains, Flours & Dals",RAGI FLOUR 1KG,4,80,70,10,1
01-05-2025,Snacks & Ready-to-Eat,SD Moringa with plam jaggery 250gm,14,135,135,0,1
01-05-2025,"Grains, Flours & Dals",Wheat Flour 1 kg,4,70,60,10,1
01-05-2025,Sweeteners,GS Palm Jaggery Powder 400GM,16,180,180,0,1
01-05-2025,Spices & Seasonings,PICKLES CHILLIP 500 GMS,15,355,325,30,1
01-05-2025,Personal Care & Cosmetics,ROUND LOOFAH,10,65,65,0,1
01-05-2025,"Dry Fruits, Nuts & Seeds",ALMONDS 250GM,2,280,260,20,1
01-05-2025,Snacks & Ready-to-Eat,KURNOOL MARMURA,14,70,55,15,1
01-05-2025,"Dry Fruits, Nuts & Seeds",Groundnuts 500 gms,2,95,85,10,1
01-05-2025,Oils & Ghee,sesame oil 1L,9,590,560,30,1
01-05-2025,"Grains, Flours & Dals",Chittimuthaylu rice 1 kg,4,160,140,20,1
01-05-2025,Spices & Seasonings,3M.MIRCHI POWDER,15,360,320,40,1
01-05-2025,"Grains, Flours & Dals",MELMEKER 250GMS,4,60,45,15,1
01-05-2025,Household & Cleaning,HENKO STAIN CARE 500GM,6,79,79,0,1
01-05-2025,Pooja & Spiritual Items,GB Bharatha Woods 75GM,12,60,60,0,1
01-05-2025,"Dry Fruits, Nuts & Seeds",Groundnuts 500 gms,2,95,85,10,1
01-05-2025,Pooja & Spiritual Items,bilwa patra,12,60,60,0,1
01-05-2025,Oils & Ghee,Safflower oil 1 L,9,800,800,0,2
01-05-2025,"Grains, Flours & Dals",COW B rice 1 kg,4,144,138,6,2
01-05-2025,Oils & Ghee,sesame oil 1L,9,590,560,30,1
01-05-2025,Oils & Ghee,Safflower oil 1 L,9,400,400,0,1
01-05-2025,Spices & Seasonings,Telaga Pindi 250 GM,15,40,35,5,1
01-05-2025,Oils & Ghee,sesame oil 1L,9,590,560,30,1
01-05-2025,Snacks & Ready-to-Eat,SF MIGHTY PUFFS,14,25,25,0,1
01-05-2025,"Dry Fruits, Nuts & Seeds",Groundnuts 500 gms,2,190,170,20,2
01-05-2025,"Grains, Flours & Dals",Urad dall 1 Kg,4,185,170,15,1
01-05-2025,"Grains, Flours & Dals",PESARA PAPPU 1 KG,4,340,290,50,2
01-05-2025,Oils & Ghee,Sesame oil 5 L,9,2950,"2,750.00",200,1
01-05-2025,Spices & Seasonings,JEERA 250 gms,15,125,105,20,1
01-05-2025,Snacks & Ready-to-Eat,ONION MURK,14,60,60,0,1
01-05-2025,Snacks & Ready-to-Eat,Popcorn Seeds 250GM,14,45,40,5,1
01-05-2025,Snacks & Ready-to-Eat,MIGHTY PUFF,14,25,25,0,1
01-05-2025,"Grains, Flours & Dals",IDLY RAVA 1KG,4,60,50,10,1
01-05-2025,Spices & Seasonings,DURGA SALT CRYSTAL 1KG,15,25,25,0,1
01-05-2025,Snacks & Ready-to-Eat,MIGHTY PUFFS CHEDDAR CHEESE,14,25,25,0,1
01-05-2025,"Dry Fruits, Nuts & Seeds",SABJA SEEDS,2,70,70,0,1
01-05-2025,Snacks & Ready-to-Eat,SF COOKIES CHOCO RAGI,14,99,99,0,1
01-05-2025,Spices & Seasonings,Coriander seeds 200 gms,15,48,40,8,1
01-05-2025,Snacks & Ready-to-Eat,MIGHTY PUFFS TOMATO,14,25,25,0,1
01-05-2025,Snacks & Ready-to-Eat,BD RED RICE NOODLES 200G,14,70,70,0,1
01-05-2025,"Grains, Flours & Dals",BASMATHI RICE 1KG,4,150,135,15,1
01-05-2025,Spices & Seasonings,DRY MIECHI 200GM,15,80,60,20,1
01-05-2025,Spices & Seasonings,PN ORGANIC PINK SALT 1KG,15,248,248,0,2
01-05-2025,Snacks & Ready-to-Eat,MIGHTY PUFFS CHEESE AND HERBS,14,25,25,0,1
01-05-2025,Snacks & Ready-to-Eat,MIGHTY PUFFS KHATTA METTA,14,25,25,0,1
01-05-2025,Spices & Seasonings,TATA SALT 1KG,15,30,30,0,1
01-05-2025,"Grains, Flours & Dals",UDALU (Barnyard millet) 1 kg,4,140,115,25,1
01-05-2025,Snacks & Ready-to-Eat,SF COOKIES BANANA OATS,14,99,99,0,1
01-05-2025,Pooja & Spiritual Items,KASHI ASHTAGANDHA CHANDHANA,12,20,20,0,1
01-05-2025,"Grains, Flours & Dals",CHANA DAL 1KG,4,112,96,16,1
01-05-2025,Sweeteners,SUGAR 1KG,16,120,112,8,2
01-05-2025,Spices & Seasonings,AVALU 250grms,15,60,40,20,1
01-05-2025,"Grains, Flours & Dals",SABDANA 500GM,4,180,140,40,2
01-05-2025,"Grains, Flours & Dals",BOMBAY RAVA,4,70,55,15,1
01-05-2025,Spices & Seasonings,Tamarind 250GMS,15,80,65,15,1
01-05-2025,"Grains, Flours & Dals",Wheat Rava S 1KG,4,130,110,20,2
01-05-2025,"Grains, Flours & Dals",turdal 1kg,4,440,340,100,2
01-05-2025,"Dry Fruits, Nuts & Seeds",SALTED PISTA 250GM,2,400,350,50,1
01-05-2025,"Dry Fruits, Nuts & Seeds",SATHVI CHIA SEEDS 100GM,2,100,80,20,1
01-05-2025,Spices & Seasonings,LG 50GM,15,92,92,0,1
01-05-2025,Sweeteners,YB JAGGERY POWDER 500GMS,16,75,75,0,1
01-05-2025,Oils & Ghee,mustard oil,9,195,195,0,1
01-05-2025,Personal Care & Cosmetics,MADDI BATH POWDER 400GM,10,300,300,0,2
01-05-2025,"Dry Fruits, Nuts & Seeds",PUTNALU 500GMS,2,90,76,14,1
01-05-2025,"Grains, Flours & Dals",Red Wheat Flour 1 kg,4,140,130,10,1
01-05-2025,Spices & Seasonings,DURGA SALT CRYSTAL 1KG,15,25,25,0,1
01-05-2025,"Dry Fruits, Nuts & Seeds",Groundnuts 500 gms,2,95,85,10,1
01-05-2025,"Grains, Flours & Dals",RED TUDAL 1KG,4,150,140,10,1
01-05-2025,Spices & Seasonings,Tamarind 500GM,15,160,130,30,1
01-05-2025,"Grains, Flours & Dals",VGR rice 1 kg,4,210,195,15,3
01-05-2025,Pooja & Spiritual Items,GD SANDAL 150GM,12,110,110,0,1
01-05-2025,Household & Cleaning,ROOPERI PITAMBARI SILVER 50ML,6,110,110,0,1
01-05-2025,"Grains, Flours & Dals",DISANO ROLED OATS,4,197.5,197.5,0,0.5
01-05-2025,Sweeteners,ACHUBELLAM 500GM,16,50,40,10,1
01-05-2025,Oils & Ghee,groundnet oil,9,1600,"1,600.00",0,1
01-05-2025,Personal Care & Cosmetics,DWI ROSE WATER 120ML,10,90,90,0,1
01-05-2025,Oils & Ghee,sesame oil 1L,9,2950,"2,800.00",150,5
01-05-2025,Snacks & Ready-to-Eat,MIGHTY PUFFS KHATTA METTA,14,25,25,0,1
01-05-2025,Snacks & Ready-to-Eat,SF MIGHTY PUFFS,14,25,25,0,1
01-05-2025,Oils & Ghee,Coconut oil 500 ml,9,220,200,20,1
01-05-2025,"Grains, Flours & Dals",Multigrain 1 kg,4,200,170,30,2
01-05-2025,"Grains, Flours & Dals",PESARA PAPPU 500GMS,4,85,75,10,1
01-05-2025,"Grains, Flours & Dals",DH URAD GOTA 1KG,4,215,190,25,1
01-05-2025,"Grains, Flours & Dals",Wheat Flour 1 kg,4,140,120,20,2
01-05-2025,Sweeteners,organic jaggery powder,16,198,198,0,2
01-05-2025,"Grains, Flours & Dals",IDLY RAVA 1KG,4,60,50,10,1
01-05-2025,Sweeteners,SUGAR 1KG,16,60,56,4,1
01-05-2025,Pooja & Spiritual Items,GD Aiswarya Deepam 700ML,12,195,195,0,1
01-05-2025,Oils & Ghee,Safflower oil 5 L,9,2200,"1,950.00",250,1
01-05-2025,"Grains, Flours & Dals",Wheat Flour 1 kg,4,70,60,10,1
01-05-2025,"Grains, Flours & Dals",chana flour 500 gms,4,60,54,6,1
01-05-2025,"Health, Wellness & Ayurvedic Products",SAI DURGA MORINGA LEAVES 100GM,5,80,80,0,1
01-05-2025,Snacks & Ready-to-Eat,NGT CHATPATTA CHANA 90GM,14,25,25,0,1
01-05-2025,Snacks & Ready-to-Eat,VD MURUKU 175GM,14,120,120,0,2
01-05-2025,Household & Cleaning,HARPIC 200ML,6,46,46,0,1
01-05-2025,Milk & Dairy,SANGAM TONED MILK 500ML,7,124,124,0,4
01-05-2025,"Dry Fruits, Nuts & Seeds",Groundnuts 1 kg,2,190,165,25,1
01-05-2025,Snacks & Ready-to-Eat,VD Pappu Chekkalu 190gm,14,60,60,0,1
01-05-2025,Oils & Ghee,sesame oil 1L,9,590,560,30,1
01-05-2025,Spices & Seasonings,KOTHIMIRA KARAM 100GM,15,75,75,0,1
01-05-2025,Spices & Seasonings,AVALU 250grms,15,180,180,0,3
01-05-2025,Oils & Ghee,Groundnut oil 1 L,9,330,330,0,1
01-05-2025,Pickles & Cooking Pastes,DURGA BRAND TM PICKLES SPECIAL,11,56,56,0,2
01-05-2025,Spices & Seasonings,SD Curry Leaves Karam Powder 100GM,15,65,65,0,1
01-05-2025,Oils & Ghee,Groundnut oil 1 L,9,330,330,0,1
01-05-2025,Spices & Seasonings,AVALU 250grms,15,180,180,0,3
01-05-2025,Oils & Ghee,sesame oil 1L,9,590,560,30,1
01-05-2025,Spices & Seasonings,DURGA SALT CRYSTAL 1KG,15,56,56,0,2
01-05-2025,"Grains, Flours & Dals",AISHWARYA SP 25KG,4,1999,"1,690.00",309,1
01-05-2025,Oils & Ghee,Safflower oil 500 ml,9,220,200,20,1
01-05-2025,Oils & Ghee,mustard oil,9,195,195,0,1
01-05-2025,"Grains, Flours & Dals",SH RED POHA 500GM,4,85,85,0,1
01-05-2025,Sweeteners,MISHRI D,16,40,30,10,1
01-05-2025,"Grains, Flours & Dals",yellow jowar flour 1kg,4,100,92,8,1
01-05-2025,Oils & Ghee,sesame oil 1L,9,1180,"1,120.00",60,2
01-05-2025,Snacks & Ready-to-Eat,KURNOOL MARMURA,14,70,55,15,1
01-05-2025,Snacks & Ready-to-Eat,VD MURUKU 175GM,14,60,60,0,1
01-05-2025,Oils & Ghee,Groundnut oil 5 L,9,1800,"1,600.00",200,1
30-04-2025,"Dry Fruits, Nuts & Seeds",PUMPKIN SEEDS 250GM,2,200,160,40,1
30-04-2025,Oils & Ghee,Groundnut oil 1 L,9,330,330,0,1
30-04-2025,"Dry Fruits, Nuts & Seeds",SUNFLOWER SEEDS 250GRM,2,150,130,20,1
30-04-2025,"Grains, Flours & Dals",RAGI FLOUR 500GRMS,4,40,35,5,1
30-04-2025,Snacks & Ready-to-Eat,SD Vamu with palm jaggery 250gm,14,135,135,0,1
30-04-2025,"Grains, Flours & Dals",RAGULU 1 KG,4,35,30,5,0.5
30-04-2025,Oils & Ghee,Groundnut oil 1 L,9,990,990,0,3
30-04-2025,"Grains, Flours & Dals",White jowar.F 1 kg,4,100,80,20,1
30-04-2025,Snacks & Ready-to-Eat,VD Pappu Chekkalu 190gm,14,60,60,0,1
30-04-2025,Beverages,BISLERI 100ml,1,10,10,0,1
30-04-2025,Snacks & Ready-to-Eat,NGT CHATPATTA CHANA 90GM,14,25,25,0,1
30-04-2025,Milk & Dairy,HERITAGE BUTTERMILK,7,20,20,0,2
30-04-2025,Misc,VD0001,8,100,100,0,1
30-04-2025,Milk & Dairy,HRITAGE TOTAL CURD 130GM,7,10,10,0,1
30-04-2025,"Grains, Flours & Dals",Multigrain 1 kg,4,200,170,30,2
30-04-2025,"Grains, Flours & Dals",SL Idly Rava 1KG,4,65,55,10,1
30-04-2025,Snacks & Ready-to-Eat,VD NUVVULU LADDU,14,80,80,0,1
30-04-2025,Oils & Ghee,Groundnut oil 1 L,9,330,330,0,1
30-04-2025,Oils & Ghee,Sesame oil 1 L,9,560,560,0,1
30-04-2025,"Grains, Flours & Dals",Wheat Flour 1 kg,4,210,180,30,3
30-04-2025,Personal Care & Cosmetics,UVIS MULTANI MITTI 200GM,10,90,90,0,1
30-04-2025,Oils & Ghee,Coconut oil 500 ml,9,220,200,20,1
30-04-2025,Personal Care & Cosmetics,DWIBHASHI GULABA ARKA ROSA WATER,10,60,60,0,1
30-04-2025,Oils & Ghee,Black Sesame oil 500 ml,9,220,190,30,1
30-04-2025,Misc,C123,8,95,80,15,1
30-04-2025,Baking & Cooking Aids,GONDKATIRA Ag,0,85,75,10,1
30-04-2025,Spices & Seasonings,SONTI 50GM,15,30,20,10,1
30-04-2025,Spices & Seasonings,BLACK JEERA 50 GM,15,45,30,15,1
30-04-2025,"Dry Fruits, Nuts & Seeds",Groundnuts 500 gms,2,95,85,10,1
30-04-2025,Personal Care & Cosmetics,DWI ALOEVERA 100GM,10,125,125,0,1
30-04-2025,"Grains, Flours & Dals",SL Suji Rava 500GM,4,32,32,0,1
30-04-2025,Snacks & Ready-to-Eat,VD ARISELU,14,0,0,0,1
30-04-2025,"Dry Fruits, Nuts & Seeds",SUNFLOWER SEEDS 250GRM,2,150,130,20,1
30-04-2025,Snacks & Ready-to-Eat,SAGOPAPAD GREEN CHILLI VD,14,55,55,0,1
30-04-2025,Oils & Ghee,Groundnut oil 1 L,9,330,330,0,1
30-04-2025,Snacks & Ready-to-Eat,VD SAGOPAPAD 150GM,14,55,55,0,1
30-04-2025,Spices & Seasonings,TATA SALT 1KG,15,30,30,0,1
30-04-2025,Spices & Seasonings,DURGA SALT CRYSTAL 1KG,15,25,25,0,1
30-04-2025,Snacks & Ready-to-Eat,PEANUT CHILLI,14,5,5,0,1
30-04-2025,Snacks & Ready-to-Eat,TILLI CHIKKI,14,5,5,0,1
30-04-2025,Snacks & Ready-to-Eat,RAJGIRA PEANUT CHIKKI,14,5,5,0,1
30-04-2025,"Grains, Flours & Dals",Multigrain 1 kg,4,200,170,30,2
30-04-2025,"Grains, Flours & Dals",RICE FLOUR 1KG,4,70,55,15,1
30-04-2025,Household & Cleaning,vim small,6,30,30,0,2
30-04-2025,"Grains, Flours & Dals",Em Little idli R 500g,4,129,129,0,1
30-04-2025,Oils & Ghee,Groundnut oil 500ml,9,180,165,15,1
30-04-2025,Pooja & Spiritual Items,SWASTIK CAMPHOR 10GM,12,20,20,0,1
30-04-2025,Snacks & Ready-to-Eat,SF MIGHTY PUFFS,14,25,25,0,1
30-04-2025,Snacks & Ready-to-Eat,MIGHTY PUFFS CHEDDAR CHEESE,14,25,25,0,1
30-04-2025,"Grains, Flours & Dals",RED TUDAL 1KG,4,150,140,10,1
30-04-2025,Snacks & Ready-to-Eat,MIGHTY PUFFS KHATTA METTA,14,25,25,0,1
30-04-2025,Pooja & Spiritual Items,deep jyothi deepam oil 1000ml,12,198,190,8,1
30-04-2025,Oils & Ghee,Coconut oil 500 ml,9,220,200,20,1
30-04-2025,"Grains, Flours & Dals",HS RAGI IDLY R,4,70,70,0,1
30-04-2025,"Grains, Flours & Dals",PESARA PAPPU 500GMS,4,85,75,10,1
30-04-2025,Oils & Ghee,Coconut oil 500 ml,9,220,200,20,1
30-04-2025,Oils & Ghee,Groundnut oil 500ml,9,180,165,15,1
30-04-2025,"Dry Fruits, Nuts & Seeds",ALMONDS 250GM,2,280,260,20,1
30-04-2025,"Dry Fruits, Nuts & Seeds",KAJU HALF 250GM,2,310,290,20,1
30-04-2025,"Dry Fruits, Nuts & Seeds",Groundnuts 500 gms,2,95,85,10,1
30-04-2025,"Health, Wellness & Ayurvedic Products",RB Max Protein PERI PERI 60gm,5,45,45,0,1
30-04-2025,Oils & Ghee,Groundnut oil 1 L,9,330,330,0,1
30-04-2025,Oils & Ghee,Groundnut oil 1 L,9,330,330,0,1
30-04-2025,Oils & Ghee,Coconut oil 1 L,9,440,400,40,1
30-04-2025,"Grains, Flours & Dals",RAGI FLOUR 500GRMS,4,40,35,5,1
30-04-2025,Spices & Seasonings,SAJEERA,15,60,40,20,1
30-04-2025,Snacks & Ready-to-Eat,VD Pappu Chekkalu 190gm,14,60,60,0,1
30-04-2025,Snacks & Ready-to-Eat,VD Pappu Chekkalu 190gm,14,60,60,0,1
30-04-2025,"Grains, Flours & Dals",Wheat Flour 1 kg,4,70,60,10,1
30-04-2025,"Grains, Flours & Dals",PESARA PAPPU 500GMS,4,85,75,10,1
30-04-2025,"Grains, Flours & Dals",yellow jowar flour 1kg,4,100,92,8,1
30-04-2025,"Grains, Flours & Dals",Wheat Flour 1 kg,4,140,120,20,2
30-04-2025,Spices & Seasonings,MTR SAMBAR POW 100GM,15,76,76,0,1
30-04-2025,"Grains, Flours & Dals",Chana Flour 500 gms,4,140,110,30,1
30-04-2025,Oils & Ghee,Groundnut oil 1 L,9,330,330,0,1
30-04-2025,"Grains, Flours & Dals",Wheat Rava M 500GM,4,33,30,3,1
30-04-2025,Pooja & Spiritual Items,GD SANDAL 150GM,12,110,110,0,1
30-04-2025,Snacks & Ready-to-Eat,VD MIXTURE 175 GM,14,60,60,0,1
30-04-2025,Pickles & Cooking Pastes,SD MANGO PICKLE,11,110,110,0,1
30-04-2025,"Grains, Flours & Dals",RAGI FLOUR 1KG,4,80,70,10,1
30-04-2025,"Grains, Flours & Dals",Black uluvalu 250 gms,4,45,35,10,1
30-04-2025,Snacks & Ready-to-Eat,VD BOONDI 175GM,14,60,60,0,1
30-04-2025,Pickles & Cooking Pastes,SD TOMATO PICKLE,11,110,110,0,1
30-04-2025,"Grains, Flours & Dals",Red Chana 250GM,4,35,30,5,1
30-04-2025,General Household & Kitchenware,chalk piece 1b,3,15,10,5,1
30-04-2025,Snacks & Ready-to-Eat,ANNAPURNA APPALAM,14,35,35,0,1
30-04-2025,Spices & Seasonings,Tamarind 250GMS,15,80,65,15,1
30-04-2025,"Grains, Flours & Dals",Wheat Flour 1 kg,4,70,60,10,1
30-04-2025,"Dry Fruits, Nuts & Seeds",Putnalu 250GM,2,45,38,7,1
30-04-2025,Snacks & Ready-to-Eat,RAJGIRA PEANUT CHIKKI,14,30,30,0,6
30-04-2025,"Grains, Flours & Dals",RICE FLOUR 1KG,4,70,55,15,1
30-04-2025,Snacks & Ready-to-Eat,TILLI CHIKKI,14,5,5,0,1
30-04-2025,Snacks & Ready-to-Eat,SF COOKIES CHOCO RAGI,14,99,99,0,1
30-04-2025,"Grains, Flours & Dals",FLOUR CHARGE,4,30,30,0,2.5
30-04-2025,Snacks & Ready-to-Eat,SF COOKIES BANANA OATS,14,99,99,0,1
30-04-2025,"Grains, Flours & Dals",split black gram 1 kg,4,180,170,10,1
30-04-2025,"Dry Fruits, Nuts & Seeds",Groundnuts 1 kg,2,190,165,25,1
30-04-2025,General Household & Kitchenware,chalk piece 1b,3,15,10,5,1
30-04-2025,Sweeteners,MISHRI D,16,40,30,10,1
30-04-2025,Misc,VD0009,8,100,100,0,1
30-04-2025,"Health, Wellness & Ayurvedic Products",RB Max Protein Cheese&amp;,5,45,45,0,1
30-04-2025,Snacks & Ready-to-Eat,SOYA MURK,14,60,60,0,1
30-04-2025,Snacks & Ready-to-Eat,BD RED RICE NOODLES 200G,14,70,70,0,1
30-04-2025,Snacks & Ready-to-Eat,VD PALLI CHIKKI,14,80,80,0,1
30-04-2025,"Grains, Flours & Dals",White jowar.F 1 kg,4,100,80,20,1
30-04-2025,Pooja & Spiritual Items,PACHAKARPURAM,12,60,50,10,1
30-04-2025,Oils & Ghee,Groundnut oil 1 L,9,330,330,0,1
30-04-2025,"Grains, Flours & Dals",Wheat Flour 1 kg,4,140,120,20,2
30-04-2025,Oils & Ghee,Sesame oil 1 L,9,560,560,0,1
30-04-2025,"Grains, Flours & Dals",AISHWARYA SP 1KG,4,240,210,30,3
30-04-2025,"Health, Wellness & Ayurvedic Products",JAMBU SEED CHOORNAM 100GM,5,80,80,0,1
30-04-2025,Snacks & Ready-to-Eat,TILLI CHIKKI,14,5,5,0,1
30-04-2025,"Grains, Flours & Dals",chana flour 500 gms,4,60,54,6,1
30-04-2025,"Grains, Flours & Dals",UNPOLISHED TURDALL 1KG,4,480,420,60,2
30-04-2025,"Grains, Flours & Dals",THICK POHA 1KG,4,160,140,20,2
30-04-2025,"Grains, Flours & Dals",Multigrain 1 kg,4,300,255,45,3
30-04-2025,Oils & Ghee,Sesame oil 1 L,9,560,560,0,1
30-04-2025,Spices & Seasonings,Jeera 100GM,15,100,90,10,2
30-04-2025,Snacks & Ready-to-Eat,BLACK PEPPER RICEPAPAD VD,14,50,50,0,1
30-04-2025,"Grains, Flours & Dals",Wheat Flour 1 kg,4,140,120,20,2
30-04-2025,"Grains, Flours & Dals",PESARA PAPPU 500GMS,4,85,75,10,1
30-04-2025,Misc,ROLL D C,8,70,45,25,1
30-04-2025,Snacks & Ready-to-Eat,ONION RINGS,14,50,50,0,1
30-04-2025,Snacks & Ready-to-Eat,KURNOOL MARMURA,14,210,165,45,3
30-04-2025,"Grains, Flours & Dals",BASMATHI RICE 1KG,4,450,405,45,3
30-04-2025,Spices & Seasonings,DRY MIECHI 200GM,15,160,120,40,2
30-04-2025,Spices & Seasonings,Coriander seeds 200 gms,15,96,80,16,2
30-04-2025,"Grains, Flours & Dals",Urad dall 1 Kg,4,370,340,30,2
30-04-2025,"Dry Fruits, Nuts & Seeds",PUTNALU 500GMS,2,180,152,28,2
30-04-2025,"Grains, Flours & Dals",Chittimuthaylu rice 1 kg,4,160,140,20,1
30-04-2025,Spices & Seasonings,DURGA SALT CRYSTAL 1KG,15,50,50,0,2
30-04-2025,"Dry Fruits, Nuts & Seeds",Groundnuts 500 gms,2,285,255,30,3
30-04-2025,"Grains, Flours & Dals",PESARA PAPPU 1 KG,4,340,290,50,2
30-04-2025,Sweeteners,YB Brown Sugar 500GM,16,150,150,0,2
30-04-2025,"Grains, Flours & Dals",RAJMA 250GM,4,55,45,10,1
30-04-2025,Spices & Seasonings,AVALU 250grms,15,60,60,0,1
30-04-2025,Sweeteners,SUGAR 1KG,16,60,56,4,1
30-04-2025,Oils & Ghee,Groundnut oil 1 L,9,660,660,0,2
30-04-2025,Beverages,BISLERI SODA 750ML,1,20,20,0,1
30-04-2025,Beverages,REFRESH SHARBATH NORMAL,1,199,190,9,1
30-04-2025,Snacks & Ready-to-Eat,VD MIXTURE 175 GM,14,60,60,0,1
30-04-2025,Snacks & Ready-to-Eat,sannakarampusa,14,60,60,0,1
30-04-2025,"Grains, Flours & Dals",FLOUR CHARGE,4,60,60,0,5
30-04-2025,Oils & Ghee,Groundnut oil 500ml,9,180,165,15,1
30-04-2025,Oils & Ghee,Sesame oil 1 L,9,560,560,0,1
30-04-2025,Household & Cleaning,vim dish liquid,6,55,55,0,1
30-04-2025,"Grains, Flours & Dals",Wheat Flour 1 kg,4,70,60,10,1
30-04-2025,Oils & Ghee,Coconut oil 1 L,9,440,400,40,1
30-04-2025,"Grains, Flours & Dals",SL Idly Rava 1KG,4,65,55,10,1
30-04-2025,Oils & Ghee,Groundnut oil 1 L,9,330,330,0,1
30-04-2025,Oils & Ghee,Sesame oil 1 L,9,560,560,0,1
30-04-2025,Oils & Ghee,Coconut oil 1 L,9,440,400,40,1
30-04-2025,Oils & Ghee,Safflower oil 1 L,9,400,400,0,1
30-04-2025,Snacks & Ready-to-Eat,SATHVI REGIVADA 200GM,14,80,60,20,1
30-04-2025,Snacks & Ready-to-Eat,DOSA BATTER 1KG,14,60,60,0,1
30-04-2025,Milk & Dairy,HERITAGE TONED MILK 500ML,7,31,31,0,1
30-04-2025,Spices & Seasonings,SAJEERA,15,60,40,20,1
30-04-2025,"Dry Fruits, Nuts & Seeds",Groundnuts 1 kg,2,190,165,25,1
30-04-2025,"Grains, Flours & Dals",JOWAR UPMA RAVA,4,65,65,0,1
30-04-2025,"Grains, Flours & Dals",BARLEY SEEDS 250GMS,4,40,35,5,1
30-04-2025,"Grains, Flours & Dals",KORRALU (FOXTAIL M) 500GM,4,65,55,10,1
30-04-2025,Spices & Seasonings,Jeera 100GM,15,50,45,5,1
30-04-2025,"Dry Fruits, Nuts & Seeds",ALMONDS 250GM,2,280,260,20,1
30-04-2025,"Dry Fruits, Nuts & Seeds",DRYDATES YELLOW 250GM,2,135,120,15,1
30-04-2025,"Grains, Flours & Dals",Wheat Rava M 500GM,4,33,30,3,1
30-04-2025,Oils & Ghee,Black Sesame oil 500 ml,9,220,190,30,1
30-04-2025,Spices & Seasonings,DURGA SALT CRYSTAL 1KG,15,25,25,0,1
30-04-2025,"Grains, Flours & Dals",turdal 1kg,4,220,170,50,1
30-04-2025,"Grains, Flours & Dals",chana flour 500 gms,4,60,54,6,1
30-04-2025,"Grains, Flours & Dals",RICE FLOUR 1KG,4,70,55,15,1
30-04-2025,Spices & Seasonings,ROYAL SAFFRON 400GRMS,15,65,65,0,1
30-04-2025,Spices & Seasonings,DURGA SALT CRYSTAL 1KG,15,25,25,0,1
30-04-2025,Snacks & Ready-to-Eat,MIGHTY PUFFS TOMATO,14,25,25,0,1
30-04-2025,"Health, Wellness & Ayurvedic Products",MAX PROTEIN ALMOND BAR,5,80,80,0,1
30-04-2025,"Grains, Flours & Dals",Wheat Flour 1 kg,4,140,120,20,2
30-04-2025,Oils & Ghee,Groundnut oil 1 L,9,330,330,0,1
30-04-2025,"Grains, Flours & Dals",RAGI FLOUR 1KG,4,80,70,10,1
30-04-2025,Milk & Dairy,HERITAGE TONED MILK 500ML,7,62,62,0,2
30-04-2025,Snacks & Ready-to-Eat,VD PALLI LADDU,14,80,80,0,1
30-04-2025,"Grains, Flours & Dals",Wheat Flour 1 kg,4,140,120,20,2
30-04-2025,Oils & Ghee,Groundnut oil 1 L,9,990,990,0,3
30-04-2025,"Dry Fruits, Nuts & Seeds",YELLOW KISHMISH 250GM,2,130,110,20,1
30-04-2025,Spices & Seasonings,THOKA MIRYALU 50GM,15,100,80,20,1
30-04-2025,Snacks & Ready-to-Eat,DINNER PAPAD,14,80,80,0,1
30-04-2025,Milk & Dairy,HERITAGE TONED MILK 500ML,7,31,31,0,1
30-04-2025,Snacks & Ready-to-Eat,DOSA BATTER 1KG,14,60,60,0,1
30-04-2025,Spices & Seasonings,Elaichi 25GM,15,145,120,25,1
30-04-2025,Pooja & Spiritual Items,deep jyothi deepam oil 1000ml,12,198,180,18,1
30-04-2025,Oils & Ghee,Groundnut oil 500ml,9,180,165,15,1
30-04-2025,Milk & Dairy,HERITAGE BUTTERMILK,7,20,20,0,2
30-04-2025,"Grains, Flours & Dals",HS MULTI UPMA RAVA,4,65,65,0,1
30-04-2025,"Grains, Flours & Dals",Urad dall 1 Kg,4,185,170,15,1
30-04-2025,"Grains, Flours & Dals",SL Suji Rava 500GM,4,32,32,0,1
30-04-2025,"Dry Fruits, Nuts & Seeds",Groundnuts 1 kg,2,190,165,25,1
30-04-2025,"Grains, Flours & Dals",split black gram 1 kg,4,180,170,10,1
30-04-2025,"Grains, Flours & Dals",SPLIT URAD DHAL,4,80,80,0,1
30-04-2025,"Grains, Flours & Dals",split green gram 500 gms,4,75,70,5,1
30-04-2025,Spices & Seasonings,DRY MIECHI 200GM,15,80,60,20,1
30-04-2025,"Grains, Flours & Dals",Sathya Javva Wheat Rava 500GM,4,95,95,0,1
30-04-2025,Household & Cleaning,SURFEXCEL BAR 80G,6,20,20,0,2
30-04-2025,Milk & Dairy,SANGAM TONED MILK 500ML,7,31,31,0,1
30-04-2025,Household & Cleaning,vim pudina fresh,6,30,30,0,3
30-04-2025,Spices & Seasonings,DURGA SALT CRYSTAL 1KG,15,25,25,0,1
30-04-2025,"Grains, Flours & Dals",Brown RICE 1KG,4,700,650,50,10
30-04-2025,Sweeteners,NATURAL HONEY 250GM,16,150,130,20,1
30-04-2025,Spices & Seasonings,Tamarind 250GMS,15,80,65,15,1
30-04-2025,Snacks & Ready-to-Eat,BLACK PEPPER RICEPAPAD VD,14,50,50,0,1
30-04-2025,Oils & Ghee,Safflower oil 1 L,9,400,400,0,1
30-04-2025,"Grains, Flours & Dals",RAGI FLOUR 500GRMS,4,40,35,5,1
30-04-2025,Snacks & Ready-to-Eat,VD RICE MURUKU 150GM,14,50,50,0,1
30-04-2025,"Grains, Flours & Dals",Wheat Flour 1 kg,4,70,60,10,1
30-04-2025,Snacks & Ready-to-Eat,JONNA RIBAN,14,60,60,0,1
30-04-2025,"Grains, Flours & Dals",POORI ATTA 500GM,4,35,30,5,1
30-04-2025,General Household & Kitchenware,GOOD HOME,3,15,15,0,1
30-04-2025,"Grains, Flours & Dals",COW B rice 1 kg,4,72,69,3,1
30-04-2025,Personal Care & Cosmetics,SVE KADHI CONDITIONING MILK,10,220,220,0,1
30-04-2025,Oils & Ghee,Black Sesame oil 500 ml,9,220,190,30,1
30-04-2025,Personal Care & Cosmetics,GOW DURBAR NAVA 100GM SOAP,10,40,40,0,1
30-04-2025,General Household & Kitchenware,GOODHOME S,3,40,40,0,4
30-04-2025,"Grains, Flours & Dals",yellow jowar flour 1kg,4,100,92,8,1
30-04-2025,Snacks & Ready-to-Eat,SAGOPAPAD RED CHILLI VD,14,55,55,0,1
30-04-2025,Oils & Ghee,Groundnut oil 1 L,9,990,990,0,3
30-04-2025,Spices & Seasonings,AVALU 250grms,15,120,120,0,2
30-04-2025,Spices & Seasonings,JEERA 250 gms,15,125,105,20,1
30-04-2025,Spices & Seasonings,DURGA SALT CRYSTAL 1KG,15,25,25,0,1
30-04-2025,Sweeteners,GS Palm Jaggery Powder 400GM,16,180,180,0,1
30-04-2025,Milk & Dairy,HERTG FULL CREAM M,7,82,82,0,2
30-04-2025,"Dry Fruits, Nuts & Seeds",DIANUTS 500GM,2,240,240,0,2
30-04-2025,"Grains, Flours & Dals",SL Idly Rava 1KG,4,195,165,30,3
30-04-2025,Oils & Ghee,Groundnut oil 1 L,9,330,330,0,1
30-04-2025,Oils & Ghee,Safflower oil 1 L,9,400,400,0,1
30-04-2025,Oils & Ghee,Coconut oil 1 L,9,440,400,40,1
30-04-2025,"Grains, Flours & Dals",VGR RICE bag 1,4,1899,"1,650.00",249,1
30-04-2025,Spices & Seasonings,Masala Karam 250 gms,15,130,120,10,1
30-04-2025,Household & Cleaning,vim small,6,15,15,0,1
30-04-2025,Snacks & Ready-to-Eat,KB MILK JUNNU POW 100GM,14,160,160,0,2
30-04-2025,"Grains, Flours & Dals",Black uluvalu 250 gms,4,45,35,10,1
30-04-2025,Household & Cleaning,RIN FABRIC WHITENER 500ML,6,89,89,0,1
30-04-2025,"Grains, Flours & Dals",white Bobarlu 500 gms,4,80,75,5,1
30-04-2025,Sweeteners,YB JAGGERY POWDER 500GMS,16,75,75,0,1
30-04-2025,"Dry Fruits, Nuts & Seeds",SH GROUNDNUT 500GM,2,163,130,33,1
30-04-2025,Snacks & Ready-to-Eat,VD PAPPU CHEGODI 200GM,14,60,60,0,1
30-04-2025,"Grains, Flours & Dals",PRO ORG TUR DAL UNPOLISHED 500GM,4,352,352,0,2
30-04-2025,Snacks & Ready-to-Eat,VD KOBARI LADDU,14,80,80,0,1
30-04-2025,Sweeteners,SH JAGGERY POWDER 500GM,16,88,76,12,1
30-04-2025,"Grains, Flours & Dals",Urad dall 1 Kg,4,185,170,15,1
30-04-2025,"Grains, Flours & Dals",SH MOONG DAL 500GM,4,140,140,0,1
30-04-2025,Spices & Seasonings,Tamarind 500GM,15,320,260,60,2
30-04-2025,Snacks & Ready-to-Eat,SD FLAX SEED APPADALU,14,90,90,0,1
30-04-2025,"Grains, Flours & Dals",SABDANA,4,40,35,5,1
30-04-2025,"Health, Wellness & Ayurvedic Products",MXP CREAM ONION,5,90,90,0,2
30-04-2025,Spices & Seasonings,SAJEERA,15,60,40,20,1
30-04-2025,"Health, Wellness & Ayurvedic Products",RB Max Protein PERI PERI 60gm,5,45,45,0,1
30-04-2025,"Health, Wellness & Ayurvedic Products",RB Max Protein Choco Berry bar 50g,5,150,150,0,2
30-04-2025,Snacks & Ready-to-Eat,VD ATUKULU MIXTURE 175GM,14,60,60,0,1
30-04-2025,"Grains, Flours & Dals",Multigrain 1 kg,4,100,85,15,1
30-04-2025,"Health, Wellness & Ayurvedic Products",RB Max Protein DESI MASALA 60gm,5,45,45,0,1
30-04-2025,Oils & Ghee,Coconut oil 500 ml,9,220,200,20,1
30-04-2025,Oils & Ghee,Coconut oil 1 L,9,440,400,40,1
30-04-2025,"Health, Wellness & Ayurvedic Products",RB Max Protein Cheese&amp;,5,45,45,0,1
30-04-2025,Snacks & Ready-to-Eat,VD MIXTURE 175 GM,14,60,60,0,1
30-04-2025,Spices & Seasonings,lavangam,15,50,50,0,1
30-04-2025,"Dry Fruits, Nuts & Seeds",ALMONDS 250GM,2,280,260,20,1
30-04-2025,"Dry Fruits, Nuts & Seeds",cashew,2,340,310,30,1
30-04-2025,Sweeteners,SUGAR 1KG,16,60,56,4,1
30-04-2025,Spices & Seasonings,NUVVULU 250GM,15,100,85,15,1
30-04-2025,"Grains, Flours & Dals",BASMATHI RICE 1KG,4,300,270,30,2
30-04-2025,Oils & Ghee,Coconut oil 500 ml,9,220,200,20,1
30-04-2025,"Grains, Flours & Dals",Wheat Flour 1 kg,4,70,60,10,1
30-04-2025,Oils & Ghee,Coconut oil 1 L,9,440,400,40,1
30-04-2025,Oils & Ghee,Groundnut oil 1 L,9,330,330,0,1
30-04-2025,Snacks & Ready-to-Eat,PEANUT CHIKKI 450GM,14,250,250,0,2
29-04-2025,Snacks & Ready-to-Eat,PEANUT CHILLI,14,10,10,0,2
29-04-2025,"Grains, Flours & Dals",VGR rice 1 kg,4,350,325,25,5
29-04-2025,Snacks & Ready-to-Eat,VD BOONDI 175GM,14,60,60,0,1
29-04-2025,Snacks & Ready-to-Eat,VD Pappu Chekkalu 190gm,14,60,60,0,1
29-04-2025,"Grains, Flours & Dals",Wheat Flour 1 kg,4,140,120,20,2
29-04-2025,Oils & Ghee,Safflower oil 1 L,9,800,800,0,2
29-04-2025,"Grains, Flours & Dals",doctor rice 1kg,4,600,600,0,5
29-04-2025,"Health, Wellness & Ayurvedic Products",MH Millets Malt 1KG,5,800,760,40,2
29-04-2025,Personal Care & Cosmetics,APPLE BC POWDER,10,200,200,0,1
29-04-2025,Spices & Seasonings,SD Redgram Karam Powder 100GM,15,65,65,0,1
29-04-2025,"Grains, Flours & Dals",AISHWARYA SP 1KG,4,1200,"1,050.00",150,15
29-04-2025,Oils & Ghee,Sesame oil 500ml,9,295,280,15,1
29-04-2025,"Dry Fruits, Nuts & Seeds",PUTNALU 500GMS,2,180,152,28,2
29-04-2025,"Grains, Flours & Dals",RED TUDAL 1KG,4,150,140,10,1
29-04-2025,"Grains, Flours & Dals",PESARA PAPPU 1 KG,4,170,145,25,1
29-04-2025,"Dry Fruits, Nuts & Seeds",Groundnuts 1 kg,2,190,165,25,1
29-04-2025,"Grains, Flours & Dals",SL Suji Rava 500GM,4,32,32,0,1
29-04-2025,"Grains, Flours & Dals",Red Chana 500 GM,4,75,60,15,1
29-04-2025,Spices & Seasonings,DRY MIECHI 200GM,15,80,60,20,1
29-04-2025,"Grains, Flours & Dals",CHANADALL 250 GMS,4,28,24,4,1
29-04-2025,"Grains, Flours & Dals",AISHWARYA SP 5KG,4,400,375,25,1
29-04-2025,"Grains, Flours & Dals",chana flour 500 gms,4,60,54,6,1
29-04-2025,Snacks & Ready-to-Eat,VD PAPPU CHEGODI 200GM,14,60,60,0,1
29-04-2025,"Grains, Flours & Dals",SRILATHA RICE RAVVA 500GM,4,35,35,0,1
29-04-2025,"Grains, Flours & Dals",PESARA PAPPU 500GMS,4,85,75,10,1
29-04-2025,Oils & Ghee,cow ghee 500 ml,9,430,390,40,1
29-04-2025,"Grains, Flours & Dals",turdal 1kg,4,440,340,100,2
29-04-2025,Snacks & Ready-to-Eat,NGT CHATPATTA CHANA 90GM,14,25,25,0,1
29-04-2025,"Grains, Flours & Dals",Red Bobarlu 500 gms,4,95,85,10,1
29-04-2025,"Grains, Flours & Dals",Multigrain 1 kg,4,100,85,15,1
29-04-2025,"Grains, Flours & Dals",SL Idly Rava 1KG,4,65,55,10,1
29-04-2025,"Grains, Flours & Dals",CHANA DALL 250GM,4,28,24,4,1
29-04-2025,Snacks & Ready-to-Eat,BATANA NGT 70GMS,14,20,20,0,1
29-04-2025,Pooja & Spiritual Items,SWATHI POOJA VATHULU,12,38,38,0,1
29-04-2025,"Grains, Flours & Dals",Arikalu (kodo),4,70,65,5,1
29-04-2025,"Grains, Flours & Dals",KORRALU (FOXTAIL M) 500GM,4,65,55,10,1
29-04-2025,Sweeteners,GS Palm Jaggery Powder 400GM,16,180,180,0,1
29-04-2025,"Grains, Flours & Dals",SAMALU (Little millet) 500 gms,4,85,65,20,1
29-04-2025,"Grains, Flours & Dals",ANDU KORRALU (Brown top .mlt) 500,4,130,110,20,1
29-04-2025,"Grains, Flours & Dals",UDALU (Barnyard millet) 500 gms,4,70,60,10,1
29-04-2025,Oils & Ghee,Groundnut oil 5 L,9,1800,"1,600.00",200,1
29-04-2025,General Household & Kitchenware,SPOON 4,3,40,40,0,1
29-04-2025,"Grains, Flours & Dals",VGR rice 1 kg,4,70,65,5,1
29-04-2025,Snacks & Ready-to-Eat,GB SALT COOKIES,14,60,55,5,1
29-04-2025,Snacks & Ready-to-Eat,NGT CHATPATTA CHANA 90GM,14,25,25,0,1
29-04-2025,"Grains, Flours & Dals",AISHWARAYA IDLY RAVA 1KG,4,99,66,33,1
29-04-2025,Spices & Seasonings,ROYAL SAFFRON 400GRMS,15,130,130,0,2
29-04-2025,"Grains, Flours & Dals",BARLEY SEEDS 250GMS,4,40,35,5,1
29-04-2025,Snacks & Ready-to-Eat,VD MINAPA VADIYAM,14,65,65,0,1
29-04-2025,Snacks & Ready-to-Eat,VD PALLI LADDU,14,80,80,0,1
29-04-2025,"Dry Fruits, Nuts & Seeds",ALMONDS 250GM,2,280,260,20,1
29-04-2025,Oils & Ghee,Groundnut oil 1 L,9,330,330,0,1
29-04-2025,Household & Cleaning,VIM MAHA BAR,6,20,20,0,2
29-04-2025,Milk & Dairy,HERTG FULL CREAM M,7,41,41,0,1
29-04-2025,Household & Cleaning,VIM SOAP,6,10,10,0,2
29-04-2025,"Grains, Flours & Dals",JOWAR UPMA RAVA,4,65,65,0,1
29-04-2025,"Grains, Flours & Dals",Wheat Flour 1 kg,4,70,60,10,1
29-04-2025,"Grains, Flours & Dals",RAGI FLOUR 500GRMS,4,40,35,5,1
29-04-2025,"Grains, Flours & Dals",MAAGAANI LOW GI SP L 1KG,4,360,315,45,3
29-04-2025,Sweeteners,SD PALM JAGGERY 500GM,16,200,200,0,1
29-04-2025,Oils & Ghee,Safflower oil 500 ml,9,220,200,20,1
29-04-2025,Oils & Ghee,Groundnut oil 1 L,9,990,990,0,3
29-04-2025,"Grains, Flours & Dals",RAGI FLOUR 1KG,4,80,70,10,1
29-04-2025,"Grains, Flours & Dals",Wheat Flour 1 kg,4,70,60,10,1
29-04-2025,Snacks & Ready-to-Eat,VD KOBARI LADDU,14,80,80,0,1
29-04-2025,"Grains, Flours & Dals",Multigrain 1 kg,4,100,85,15,1
29-04-2025,Snacks & Ready-to-Eat,SATHVI REGIVADA 200GM,14,80,60,20,1
29-04-2025,Beverages,BISLERI 100ml,1,10,10,0,1
29-04-2025,Milk & Dairy,SANGAM TONED MILK 500ML,7,31,31,0,1
29-04-2025,"Grains, Flours & Dals",Wheat Flour 1 kg,4,70,60,10,1
29-04-2025,Snacks & Ready-to-Eat,VD PAPPU CHEGODI 200GM,14,60,60,0,1
29-04-2025,Personal Care & Cosmetics,YB Bath Powder 200GM,10,150,150,0,1
29-04-2025,Snacks & Ready-to-Eat,BB ROASTED VERMICELLY 500GM,14,70,70,0,1
29-04-2025,"Dry Fruits, Nuts & Seeds",DRYDATES 250GM,2,150,120,30,1
29-04-2025,Snacks & Ready-to-Eat,DINNER PAPAD,14,80,80,0,1
29-04-2025,"Health, Wellness & Ayurvedic Products",SAI DURGA MORINGA LEAVES 100GM,5,75,75,0,1
29-04-2025,"Grains, Flours & Dals",RAGI FLOUR 500GRMS,4,40,35,5,1
29-04-2025,"Grains, Flours & Dals",HEALTH JOWAR RAWA,4,99,99,0,1
29-04-2025,"Grains, Flours & Dals",KORRALU (FOXTAIL M) 500GM,4,130,110,20,2
29-04-2025,Oils & Ghee,Groundnut oil 1 L,9,660,660,0,2
29-04-2025,Pooja & Spiritual Items,SWATHI POOJA VATHULU,12,38,38,0,1
29-04-2025,"Grains, Flours & Dals",UDALU (Barnyard millet) 500 gms,4,70,60,10,1
29-04-2025,"Grains, Flours & Dals",SAMALU (Little millet) 500 gms,4,85,65,20,1
29-04-2025,"Grains, Flours & Dals",Green gram 500 gms,4,75,70,5,1
29-04-2025,"Grains, Flours & Dals",turdal 1kg,4,220,170,50,1
29-04-2025,"Grains, Flours & Dals",RAGI FLOUR 500GRMS,4,40,35,5,1
29-04-2025,"Grains, Flours & Dals",Wheat Flour 1 kg,4,140,120,20,2
29-04-2025,"Grains, Flours & Dals",White jowar.F 1 kg,4,100,80,20,1
29-04-2025,Milk & Dairy,HRITAGE TOTAL CURD 130GM,7,10,10,0,1
29-04-2025,Snacks & Ready-to-Eat,SS IDLY BATTER 1KG,14,60,60,0,1
29-04-2025,Milk & Dairy,HERITAGE BUTTERMILK,7,20,20,0,2
29-04-2025,"Grains, Flours & Dals",RAGI FLOUR 1KG,4,80,70,10,1
29-04-2025,"Grains, Flours & Dals",Wheat Rava M 500GM,4,33,30,3,1
29-04-2025,"Grains, Flours & Dals",JOWAR UPMA RAVA,4,75,75,0,1
29-04-2025,Snacks & Ready-to-Eat,ELITE ELAICHI RUSK 200GM,14,35,35,0,1
29-04-2025,"Grains, Flours & Dals",JOWAR UPMA RAVA,4,75,75,0,1
29-04-2025,"Grains, Flours & Dals",RAGI FLOUR 1KG,4,80,70,10,1
29-04-2025,"Grains, Flours & Dals",YELLOW JOWER 1KG,4,180,160,20,2
29-04-2025,"Grains, Flours & Dals",AISHWARYA SP 5KG,4,400,375,25,1
29-04-2025,"Grains, Flours & Dals",turdal 500 gms,4,110,85,25,1
29-04-2025,Snacks & Ready-to-Eat,PEANUT CHILLI,14,20,20,0,4
29-04-2025,Spices & Seasonings,ROYAL SAFFRON 400GRMS,15,65,65,0,1
29-04-2025,Household & Cleaning,vim small,6,30,30,0,2
29-04-2025,"Grains, Flours & Dals",RAGI FLOUR 500GRMS,4,40,35,5,1
29-04-2025,"Dry Fruits, Nuts & Seeds",SALTED PISTA 250GM,2,400,350,50,1
29-04-2025,Personal Care & Cosmetics,SVE PREMIUM PAPAYA SOAP 100GM,10,110,110,0,1
29-04-2025,"Grains, Flours & Dals",Multigrain 1 kg,4,200,170,30,2
29-04-2025,Oils & Ghee,Sesame oil 1 L,9,560,560,0,1
29-04-2025,Spices & Seasonings,SH CASSIA STICKS 50GM,15,75,75,0,1
29-04-2025,Spices & Seasonings,SAFE HARVEST FENNEL SANUF,15,110,110,0,1
29-04-2025,Snacks & Ready-to-Eat,RSC ORANGE 100GMS,14,20,20,0,1
29-04-2025,"Dry Fruits, Nuts & Seeds",Groundnuts 500 gms,2,95,85,10,1
29-04-2025,Snacks & Ready-to-Eat,RB Choco Delite Almonds Raisins 40g,14,45,45,0,1
29-04-2025,"Grains, Flours & Dals",SABDANA,4,40,35,5,1
29-04-2025,Spices & Seasonings,PN ORGANIC PINK SALT 1KG,15,124,124,0,1
29-04-2025,Snacks & Ready-to-Eat,SD Sesame laddu with dates250gm,14,125,125,0,1
29-04-2025,Snacks & Ready-to-Eat,FOXTAIL BIS,14,135,135,0,1
29-04-2025,"Dry Fruits, Nuts & Seeds",KAJU HALF 250GM,2,310,290,20,1
29-04-2025,Beverages,REFRESH SHARBATH NORMAL,1,199,190,9,1
29-04-2025,"Dry Fruits, Nuts & Seeds",ALMONDS 250GM,2,280,260,20,1
29-04-2025,Snacks & Ready-to-Eat,SD barnyard Millet with palm jaggery,14,135,135,0,1
29-04-2025,"Dry Fruits, Nuts & Seeds",PUTNALU 500GMS,2,90,76,14,1
29-04-2025,"Health, Wellness & Ayurvedic Products",RB Max Protein Choco Berry bar 50g,5,150,150,0,2
29-04-2025,Snacks & Ready-to-Eat,RITEBITE MELTING CHOCOLATE,14,50,50,0,1
29-04-2025,Spices & Seasonings,PALLI KARAM G,15,75,75,0,1
29-04-2025,Snacks & Ready-to-Eat,FOXTAIL BIS,14,135,135,0,1
29-04-2025,Snacks & Ready-to-Eat,VD DAHI MIRCHI(SALTED) 100GM,14,45,45,0,1
29-04-2025,Spices & Seasonings,Tamarind 500GM,15,160,130,30,1
29-04-2025,"Dry Fruits, Nuts & Seeds",SUNFLOWER SEEDS 250GRM,2,150,130,20,1
29-04-2025,"Dry Fruits, Nuts & Seeds",WATERMELON SEEDS 250GRM,2,320,280,40,1
29-04-2025,"Dry Fruits, Nuts & Seeds",PUMPKIN SEEDS 250GM,2,200,160,40,1
29-04-2025,Beverages,BISLERI SODA 750ML,1,20,20,0,1
29-04-2025,"Grains, Flours & Dals",YELLOW JOWER 1KG,4,180,160,20,2
29-04-2025,"Grains, Flours & Dals",FLOUR CHARGE,4,24,24,0,2
29-04-2025,Beverages,REFRESH SHARBATH SUGAR FREE,1,299,285,14,1
29-04-2025,"Grains, Flours & Dals",RAGULU 1 KG,4,140,120,20,2
29-04-2025,"Grains, Flours & Dals",Urad dall 500 gms,4,95,85,10,1
29-04-2025,Snacks & Ready-to-Eat,SF NOODLES CLKASSIC MASALA,14,129,129,0,1
29-04-2025,Spices & Seasonings,TATA SALT 1KG,15,30,30,0,1
29-04-2025,"Grains, Flours & Dals",Red Chana 250GM,4,35,30,5,1
29-04-2025,"Grains, Flours & Dals",Urad dall 1 Kg,4,370,340,30,2
29-04-2025,"Dry Fruits, Nuts & Seeds",Groundnuts 500 gms,2,95,85,10,1
29-04-2025,"Dry Fruits, Nuts & Seeds",Groundnuts 1 kg,2,190,165,25,1
29-04-2025,"Grains, Flours & Dals",SL Idly Rava 1KG,4,65,55,10,1
29-04-2025,Household & Cleaning,vim dish liquid,6,55,55,0,1
29-04-2025,Snacks & Ready-to-Eat,VD MURUKU 175GM,14,60,60,0,1
29-04-2025,Oils & Ghee,Coconut oil 500 ml,9,220,200,20,1
29-04-2025,Snacks & Ready-to-Eat,VD KOBARI LADDU,14,80,80,0,1
29-04-2025,Oils & Ghee,Sesame oil 1 L,9,560,560,0,1
29-04-2025,Snacks & Ready-to-Eat,ELITE ELAICHI RUSK 200GM,14,35,35,0,1
29-04-2025,Milk & Dairy,HRITAGE TOTAL CURD 130GM,7,10,10,0,1
29-04-2025,"Grains, Flours & Dals",White jowar.F 1 kg,4,100,80,20,1
29-04-2025,"Dry Fruits, Nuts & Seeds",KAJU HALF 250GM,2,310,290,20,1
29-04-2025,"Grains, Flours & Dals",SH WHITE POHA 500GM,4,75,75,0,1
29-04-2025,"Dry Fruits, Nuts & Seeds",Groundnuts 500 gms,2,95,85,10,1
29-04-2025,Snacks & Ready-to-Eat,RITEBITE MELTING CHOCOLATE,14,135,135,0,3
29-04-2025,Snacks & Ready-to-Eat,VD PAPPU CHEGODI 200GM,14,60,60,0,1
29-04-2025,Oils & Ghee,Coconut oil 500 ml,9,220,200,20,1
29-04-2025,"Grains, Flours & Dals",RAGULU 1 KG,4,70,60,10,1
29-04-2025,"Grains, Flours & Dals",Wheat Flour 1 kg,4,210,180,30,3
29-04-2025,Snacks & Ready-to-Eat,NGT CHATPATTA CHANA 90GM,14,25,25,0,1
29-04-2025,Snacks & Ready-to-Eat,VD KOBARI LADDU,14,80,80,0,1
29-04-2025,"Grains, Flours & Dals",Wheat Rava S 1KG,4,65,55,10,1
29-04-2025,"Grains, Flours & Dals",WHITE BATANI,4,40,30,10,1
29-04-2025,Snacks & Ready-to-Eat,3D PAPAD,14,40,40,0,1
29-04-2025,Snacks & Ready-to-Eat,ONION RINGS,14,50,50,0,1
29-04-2025,Spices & Seasonings,DURGA SALT CRYSTAL 1KG,15,25,25,0,1
29-04-2025,Spices & Seasonings,Masala Karam 250 gms,15,130,120,10,1
29-04-2025,"Grains, Flours & Dals",RICE FLOUR 500 GM,4,70,56,14,2
29-04-2025,Spices & Seasonings,coconut powder,15,90,70,20,1
29-04-2025,Sweeteners,GS Palm Jaggery Powder 400GM,16,180,180,0,1
29-04-2025,Spices & Seasonings,NUVVULU 500GM,15,160,130,30,1
29-04-2025,"Grains, Flours & Dals",Wheat Rava S 1KG,4,65,55,10,1
29-04-2025,Sweeteners,YB JAGGERY POWDER 500GMS,16,75,75,0,1
29-04-2025,"Dry Fruits, Nuts & Seeds",Groundnuts 1 kg,2,190,165,25,1
29-04-2025,"Grains, Flours & Dals",BARLEY SEEDS 250GMS,4,40,35,5,1
29-04-2025,"Grains, Flours & Dals",BAJRA 1 KG,4,15,12.5,2.5,0.25
29-04-2025,"Grains, Flours & Dals",SOYA BEANS 1KG,4,40,36,4,0.2
29-04-2025,"Grains, Flours & Dals",YELLOW JOWER 1KG,4,90,80,10,1
29-04-2025,"Grains, Flours & Dals",WHEAT 1 KG,4,300,250,50,5
29-04-2025,"Grains, Flours & Dals",RAGULU 1 KG,4,14,12,2,0.2
29-04-2025,"Grains, Flours & Dals",SAMALU (Little millet) 500 gms,4,85,65,20,1
29-04-2025,Spices & Seasonings,SD Garlic Karam Powder 100GM,15,70,70,0,1
29-04-2025,Snacks & Ready-to-Eat,VD MURUKU 175GM,14,60,60,0,1
29-04-2025,"Grains, Flours & Dals",ANDU KORRALU (Brown top .mlt) 500,4,130,110,20,1
29-04-2025,"Grains, Flours & Dals",UDALU (Barnyard millet) 500 gms,4,70,60,10,1
29-04-2025,Snacks & Ready-to-Eat,PASTALICIOUS DS,14,175,175,0,1
29-04-2025,Spices & Seasonings,PALLI KARAM G,15,75,75,0,1
29-04-2025,Snacks & Ready-to-Eat,BATANA NGT 70GMS,14,20,20,0,1
29-04-2025,"Grains, Flours & Dals",Wheat Rava M 500GM,4,33,30,3,1
29-04-2025,"Grains, Flours & Dals",chana flour 500 gms,4,60,55,5,1
29-04-2025,"Grains, Flours & Dals",RAGULU 1 KG,4,140,120,20,2
29-04-2025,"Grains, Flours & Dals",FLOUR CHARGE,4,27,27,0,2.25
29-04-2025,"Grains, Flours & Dals",SABDANA,4,10,8.75,1.25,0.25
29-04-2025,"Grains, Flours & Dals",MAATEJA rice 1 kg,4,108,103.5,4.5,1.5
29-04-2025,Household & Cleaning,HERBAL FLOOR CLEANER 500ML,6,116,116,0,1
29-04-2025,Snacks & Ready-to-Eat,SAGOPAPAD RED CHILLI VD,14,55,55,0,1
29-04-2025,Snacks & Ready-to-Eat,VD DAHI MIRCHI(SALTED) 100GM,14,45,45,0,1
29-04-2025,Oils & Ghee,Sesame oil 500ml,9,295,280,15,1
29-04-2025,Snacks & Ready-to-Eat,SD SESAME PAPAD,14,80,80,0,1
29-04-2025,"Grains, Flours & Dals",RAGI FLOUR 500GRMS,4,40,35,5,1
29-04-2025,"Grains, Flours & Dals",chana flour 500 gms,4,60,54,6,1
29-04-2025,Baking & Cooking Aids,GONDKATIRA Ag,0,85,75,10,1
29-04-2025,"Grains, Flours & Dals",RICE FLOUR 500 GM,4,35,28,7,1
29-04-2025,Personal Care & Cosmetics,HERBAL BATH POWDER 200GM,10,80,80,0,1
29-04-2025,Baking & Cooking Aids,GONDKATIRA Ag,0,85,75,10,1
29-04-2025,"Grains, Flours & Dals",chana flour 500 gms,4,60,54,6,1
29-04-2025,"Grains, Flours & Dals",RAGI FLOUR 500GRMS,4,40,35,5,1
29-04-2025,Spices & Seasonings,Menthulu 250 gms,15,50,45,5,1
29-04-2025,"Grains, Flours & Dals",RAGI FLOUR 1KG,4,80,70,10,1
29-04-2025,Snacks & Ready-to-Eat,SD FINGER Millet with palm Jaggery 250gm,14,135,135,0,1
29-04-2025,"Grains, Flours & Dals",SA Sprouted Ragi Flour 500GM,4,69,69,0,1
29-04-2025,"Grains, Flours & Dals",Multigrain 1 kg,4,100,85,15,1
29-04-2025,Snacks & Ready-to-Eat,ANNAPURNA APPALAM,14,35,35,0,1
29-04-2025,Snacks & Ready-to-Eat,VD DAHI MIRCHI(SALTED) 100GM,14,45,45,0,1
29-04-2025,"Grains, Flours & Dals",Chana Flour 500 gms,4,120,108,12,1
29-04-2025,"Grains, Flours & Dals",RICE FLOUR 500 GM,4,140,112,28,4
29-04-2025,Beverages,BISLERI 100ml,1,10,10,0,1
29-04-2025,"Dry Fruits, Nuts & Seeds",SATHVI CHIA SEEDS 100GM,2,100,80,20,1
29-04-2025,Sweeteners,YB JAGGERY POWDER 500GMS,16,75,75,0,1
29-04-2025,"Dry Fruits, Nuts & Seeds",ANJEER 250GM,2,400,360,40,1
29-04-2025,Baking & Cooking Aids,GONDKATIRA Ag,0,425,375,50,5
29-04-2025,"Grains, Flours & Dals",RICE FLOUR 500 GM,4,35,28,7,1
29-04-2025,Beverages,BRU GREEN LABEL 1.2G,1,22,22,0,11
29-04-2025,"Grains, Flours & Dals",VGR rice 1 kg,4,1050,975,75,15
29-04-2025,"Grains, Flours & Dals",THIN POHA 500GM,4,40,35,5,1
29-04-2025,Oils & Ghee,Sesame oil 1 L,9,2240,"2,240.00",0,4
29-04-2025,Oils & Ghee,cow ghee 500 ml,9,860,780,80,2
29-04-2025,"Grains, Flours & Dals",Wheat Flour 1 kg,4,210,180,30,3
29-04-2025,Beverages,BISLERI SODA 750ML,1,20,20,0,1
29-04-2025,"Grains, Flours & Dals",CHANA DALL 250GM,4,28,24,4,1
29-04-2025,Oils & Ghee,Groundnut oil 1 L,9,330,330,0,1
29-04-2025,"Grains, Flours & Dals",RAJMA 250GM,4,55,45,10,1
29-04-2025,Oils & Ghee,Sesame oil 500ml,9,295,280,15,1
29-04-2025,"Dry Fruits, Nuts & Seeds",WATERMELON SEEDS 250GRM,2,320,280,40,1
29-04-2025,Oils & Ghee,Groundnut oil 1 L,9,1320,"1,320.00",0,4
29-04-2025,"Dry Fruits, Nuts & Seeds",ALMONDS 250GM,2,280,260,20,1
29-04-2025,Sweeteners,Natural Honey 500 gms,16,280,240,40,1
29-04-2025,"Dry Fruits, Nuts & Seeds",cashew,2,340,310,30,1
29-04-2025,"Dry Fruits, Nuts & Seeds",PUMPKIN SEEDS 250GM,2,200,160,40,1
29-04-2025,Sweeteners,SUGAR 1KG,16,60,56,4,1
29-04-2025,"Grains, Flours & Dals",turdal 1kg,4,220,170,50,1
29-04-2025,Snacks & Ready-to-Eat,SATHVI REGIVADA 200GM,14,80,60,20,1
29-04-2025,"Health, Wellness & Ayurvedic Products",AMLA PACHAK,5,100,100,0,1
29-04-2025,Snacks & Ready-to-Eat,MIGHTY PUFFS CHEDDAR CHEESE,14,25,25,0,1
29-04-2025,Pooja & Spiritual Items,GD KASTHURI,12,60,60,0,1
29-04-2025,Pooja & Spiritual Items,GOW DURBAR GEETHA CAMPHOR,12,60,60,0,1
29-04-2025,Sweeteners,SUGAR 1KG,16,60,56,4,1
29-04-2025,"Grains, Flours & Dals",Multigrain 1 kg,4,500,425,75,5
29-04-2025,Oils & Ghee,Sesame oil 1 L,9,560,560,0,1
29-04-2025,Oils & Ghee,Groundnut oil 1 L,9,660,660,0,2
29-04-2025,"Grains, Flours & Dals",AISHWARYA SP 25KG,4,1999,"1,690.00",309,1
29-04-2025,Spices & Seasonings,3M.MIRCHI POWDER,15,360,320,40,1
29-04-2025,Spices & Seasonings,DURGA SALT CRYSTAL 1KG,15,56,56,0,2
29-04-2025,Spices & Seasonings,MUSTARD POWDR 500G,15,260,220,40,2
29-04-2025,Spices & Seasonings,MUSTARD POWDER 250G,15,65,55,10,1
29-04-2025,"Grains, Flours & Dals",RICE FLOUR 1KG,4,70,55,15,1
29-04-2025,"Grains, Flours & Dals",Chana Flour 500 gms,4,140,110,30,1
29-04-2025,Oils & Ghee,Groundnut oil 1 L,9,660,660,0,2
29-04-2025,Snacks & Ready-to-Eat,VD MULTI CHAKKA,14,110,110,0,1
29-04-2025,Milk & Dairy,HERITAGE BUTTERMILK,7,10,10,0,1
29-04-2025,Snacks & Ready-to-Eat,SATHVI REGIVADA 200GM,14,80,60,20,1
29-04-2025,Snacks & Ready-to-Eat,VD PAPPU CHEGODI 200GM,14,60,60,0,1
29-04-2025,Snacks & Ready-to-Eat,MILLET PANCAKE CHOCOLATE,14,199,199,0,1
29-04-2025,Snacks & Ready-to-Eat,JONNA RIBAN,14,60,60,0,1
29-04-2025,Snacks & Ready-to-Eat,BEETROOT MURK,14,60,60,0,1
29-04-2025,"Grains, Flours & Dals",SABDANA,4,40,35,5,1
29-04-2025,Spices & Seasonings,PICKLES CHILLIP 500 GMS,15,355,325,30,1
29-04-2025,"Grains, Flours & Dals",SRILATHA RICE RAVVA 500GM,4,35,35,0,1
29-04-2025,Oils & Ghee,Sesame oil 1 L,9,1120,"1,120.00",0,2
29-04-2025,"Grains, Flours & Dals",RAGI FLOUR 500GRMS,4,40,35,5,1
29-04-2025,Snacks & Ready-to-Eat,ELITE MILK RUSK 200GM,14,35,35,0,1
29-04-2025,Snacks & Ready-to-Eat,VD PAPPU CHEGODI 200GM,14,60,60,0,1
29-04-2025,Snacks & Ready-to-Eat,RAGI GAVVALU,14,60,60,0,1
29-04-2025,Snacks & Ready-to-Eat,VD Pappu Chekkalu 190gm,14,60,60,0,1
29-04-2025,Spices & Seasonings,WHITE SESAME,15,225,225,0,3
29-04-2025,Beverages,BRU GREEN LABEL 1.2G,1,48,48,0,24
29-04-2025,"Dry Fruits, Nuts & Seeds",SABJA SEEDS,2,70,70,0,1
29-04-2025,Spices & Seasonings,AVALU 250grms,15,60,60,0,1
29-04-2025,"Grains, Flours & Dals",yellow jowar flour 1kg,4,100,92,8,1
29-04-2025,Snacks & Ready-to-Eat,ELITE MILK RUSK 200GM,14,35,35,0,1
29-04-2025,Snacks & Ready-to-Eat,ELITE ELAICHI RUSK 200GM,14,35,35,0,1
29-04-2025,Oils & Ghee,Sesame oil 1 L,9,1680,"1,680.00",0,3
29-04-2025,Spices & Seasonings,3M.MIRCHI POWDER,15,1080,960,120,3
29-04-2025,Spices & Seasonings,PN ORGANIC PINK SALT 1KG,15,124,124,0,1
29-04-2025,Spices & Seasonings,DURGA SALT CRYSTAL 1KG,15,25,25,0,1
29-04-2025,"Dry Fruits, Nuts & Seeds",PUTNALU 500GMS,2,90,76,14,1
29-04-2025,"Grains, Flours & Dals",AISHWARYA SP 1KG,4,80,70,10,1
29-04-2025,Snacks & Ready-to-Eat,RSC ORANGE 100GMS,14,40,40,0,2
29-04-2025,"Grains, Flours & Dals",RAGI FLOUR 500GRMS,4,80,70,10,2
29-04-2025,Sweeteners,ACHU BELLAM 1KG,16,100,80,20,1
29-04-2025,"Grains, Flours & Dals",RAGI FLOUR 1KG,4,80,70,10,1
29-04-2025,"Grains, Flours & Dals",Wheat Flour 1 kg,4,210,180,30,3
29-04-2025,"Dry Fruits, Nuts & Seeds",SUNFLOWER SEEDS 250GRM,2,150,130,20,1
29-04-2025,"Grains, Flours & Dals",White jowar.F 1 kg,4,400,320,80,4
29-04-2025,"Grains, Flours & Dals",Chana Flour 500 gms,4,110,110,0,1
29-04-2025,"Dry Fruits, Nuts & Seeds",DRYDATES 250GM,2,300,240,60,2
29-04-2025,"Dry Fruits, Nuts & Seeds",PUMPKIN SEEDS 250GM,2,200,160,40,1
29-04-2025,"Dry Fruits, Nuts & Seeds",WATERMELON SEEDS 250GRM,2,320,280,40,1
29-04-2025,"Dry Fruits, Nuts & Seeds",DRYDATES 250GM,2,300,240,60,2
29-04-2025,Spices & Seasonings,KALONJI SEEDS,15,90,80,10,1
29-04-2025,Baking & Cooking Aids,GONDKATIRA Ag,0,170,150,20,2
29-04-2025,Spices & Seasonings,BLACK JEERA 50 GM,15,45,30,15,1
29-04-2025,"Grains, Flours & Dals",IDLY RAVA 1KG,4,120,100,20,2
29-04-2025,"Grains, Flours & Dals",AISHWARYA SP 1KG,4,80,70,10,1
29-04-2025,"Grains, Flours & Dals",yellow jowar flour 1kg,4,100,92,8,1
29-04-2025,"Grains, Flours & Dals",BARLEY SEEDS 500 GM,4,90,70,20,1
29-04-2025,"Grains, Flours & Dals",KORRALU (FOXTAIL M) 1KG,4,150,110,40,1
29-04-2025,Household & Cleaning,ROOPERI PITAMBARI SILVER 50ML,6,110,110,0,1
29-04-2025,"Grains, Flours & Dals",RAGULU 1 KG,4,70,60,10,1
29-04-2025,"Grains, Flours & Dals",Wheat Flour 1 kg,4,70,60,10,1
29-04-2025,"Grains, Flours & Dals",Wheat Rava S 1KG,4,65,55,10,1
29-04-2025,"Grains, Flours & Dals",chana flour 500 gms,4,60,54,6,1
29-04-2025,"Grains, Flours & Dals",RAGULU 1 KG,4,70,60,10,1
29-04-2025,"Grains, Flours & Dals",turdal 1kg,4,220,170,50,1
29-04-2025,Milk & Dairy,HERITAGE TONED MILK 500ML,7,62,62,0,2
29-04-2025,Snacks & Ready-to-Eat,DINNER PAPAD,14,80,80,0,1
29-04-2025,Spices & Seasonings,menthulu,15,90,90,0,1
29-04-2025,Oils & Ghee,Groundnut oil 1 L,9,660,660,0,2
29-04-2025,Spices & Seasonings,3M.MIRCHI POWDER,15,1080,960,120,3
29-04-2025,"Grains, Flours & Dals",White jowar.F 1 kg,4,400,320,80,4
29-04-2025,"Dry Fruits, Nuts & Seeds",SUNFLOWER SEEDS 250GRM,2,150,130,20,1
29-04-2025,"Dry Fruits, Nuts & Seeds",WATERMELON SEEDS 250GRM,2,320,280,40,1
29-04-2025,"Grains, Flours & Dals",Chana Flour 500 gms,4,140,110,30,1
29-04-2025,"Dry Fruits, Nuts & Seeds",PUMPKIN SEEDS 250GM,2,200,160,40,1
29-04-2025,"Dry Fruits, Nuts & Seeds",DRYDATES 250GM,2,150,120,30,1
29-04-2025,Snacks & Ready-to-Eat,NGT CHATPATTA CHANA 90GM,14,25,25,0,1
29-04-2025,Snacks & Ready-to-Eat,VD NUVULLU CHIKKI,14,80,80,0,1
29-04-2025,Snacks & Ready-to-Eat,VD NUVULLU CHIKKI,14,80,80,0,1
29-04-2025,Snacks & Ready-to-Eat,VD MURMURA LADDU,14,50,50,0,1
29-04-2025,"Grains, Flours & Dals",KORRALU (FOXTAIL M) 1KG,4,150,110,40,1
29-04-2025,"Grains, Flours & Dals",RAGI FLOUR 1KG,4,80,70,10,1
29-04-2025,"Grains, Flours & Dals",Kandulu 250GM,4,40,35,5,1
29-04-2025,"Grains, Flours & Dals",Red Chana 250GM,4,35,30,5,1
29-04-2025,"Grains, Flours & Dals",White Chana 250 GM,4,60,50,10,1
29-04-2025,"Grains, Flours & Dals",Green gram 500 gms,4,75,70,5,1
29-04-2025,Snacks & Ready-to-Eat,SD black sesme laddu with dates 175gm,14,135,135,0,1
29-04-2025,Oils & Ghee,Groundnut oil 1 L,9,1320,"1,320.00",0,4
29-04-2025,"Dry Fruits, Nuts & Seeds",Groundnuts 1 kg,2,190,165,25,1
29-04-2025,"Dry Fruits, Nuts & Seeds",Groundnuts 1 kg,2,190,165,25,1
29-04-2025,Oils & Ghee,Sesame oil 1 L,9,2240,"2,240.00",0,4
29-04-2025,Snacks & Ready-to-Eat,VD KOBARI LADDU,14,80,80,0,1
29-04-2025,"Dry Fruits, Nuts & Seeds",YB GRANMA NUTS,2,180,180,0,2
29-04-2025,Snacks & Ready-to-Eat,VD MURMURA LADDU,14,50,50,0,1
29-04-2025,"Dry Fruits, Nuts & Seeds",FLAX SEEDS 250GM,2,180,150,30,3
29-04-2025,"Grains, Flours & Dals",doctor rice 1kg,4,240,240,0,2
29-04-2025,Snacks & Ready-to-Eat,RSC ORANGE 100GMS,14,20,20,0,1
29-04-2025,Beverages,BISLERI 100ml,1,10,10,0,1
29-04-2025,General Household & Kitchenware,chalk piece 1b,3,30,20,10,2
29-04-2025,"Dry Fruits, Nuts & Seeds",SATHVI CHIA SEEDS 100GM,2,100,80,20,1
29-04-2025,Milk & Dairy,HERTG FULL CREAM M,7,41,41,0,1
29-04-2025,Snacks & Ready-to-Eat,VD KOBARI LADDU,14,80,80,0,1
29-04-2025,Snacks & Ready-to-Eat,VD NUVULLU CHIKKI,14,80,80,0,1
29-04-2025,Snacks & Ready-to-Eat,SATHVI REGIVADA 200GM,14,160,120,40,2
29-04-2025,Snacks & Ready-to-Eat,VD MURUKU 175GM,14,60,60,0,1
29-04-2025,Spices & Seasonings,KALONJI SEEDS,15,90,80,10,1
29-04-2025,"Grains, Flours & Dals",turdal 1kg,4,220,170,50,1
29-04-2025,Oils & Ghee,Coconut oil 1 L,9,880,800,80,2
29-04-2025,Sweeteners,YB JAGGERY POWDER 500GMS,16,75,75,0,1
29-04-2025,"Grains, Flours & Dals",Quinova 1 kg,4,220,195,25,1
29-04-2025,Oils & Ghee,Groundnut oil 5 L,9,1800,"1,600.00",200,1
29-04-2025,Milk & Dairy,SANGAM TONED MILK 500ML,7,124,124,0,4
28-04-2025,Snacks & Ready-to-Eat,ONION RINGS,14,100,100,0,2
28-04-2025,"Grains, Flours & Dals",IDLY RAVA 1KG,4,60,50,10,1
28-04-2025,Snacks & Ready-to-Eat,MIX MILLET NOODLES,14,150,150,0,2
28-04-2025,General Household & Kitchenware,GOOD HOME,3,30,30,0,2
28-04-2025,"Grains, Flours & Dals",SL Suji Rava 500GM,4,96,96,0,3
28-04-2025,Snacks & Ready-to-Eat,SD Moringa with plam jaggery 250gm,14,270,270,0,2
28-04-2025,"Grains, Flours & Dals",RAGI FLOUR 500GRMS,4,40,35,5,1
28-04-2025,Household & Cleaning,comfort morning fresh,6,58,58,0,1
28-04-2025,"Grains, Flours & Dals",turdal 1kg,4,220,170,50,1
28-04-2025,"Grains, Flours & Dals",Wheat Rava M 500GM,4,66,60,6,2
28-04-2025,General Household & Kitchenware,GOODHOME S,3,30,30,0,3
28-04-2025,Oils & Ghee,Sesame oil 1 L,9,560,560,0,1
28-04-2025,Oils & Ghee,Safflower oil 1 L,9,400,400,0,1
28-04-2025,"Grains, Flours & Dals",Wheat Flour 1 kg,4,70,60,10,1
28-04-2025,"Grains, Flours & Dals",SL Suji Rava 500GM,4,32,32,0,1
28-04-2025,Snacks & Ready-to-Eat,GB SALT COOKIES,14,60,55,5,1
28-04-2025,Snacks & Ready-to-Eat,DINNER PAPAD,14,80,80,0,1
28-04-2025,Pooja & Spiritual Items,rudraksha malla,12,50,50,0,2
28-04-2025,Sweeteners,PN ORGANIC JAGGERY POWDER 400GM,16,86,86,0,1
28-04-2025,Oils & Ghee,Groundnut oil 1 L,9,660,660,0,2
28-04-2025,Sweeteners,SUGAR 1KG,16,60,56,4,1
28-04-2025,"Grains, Flours & Dals",EM Ragi upma R 500g,4,75,75,0,1
28-04-2025,Oils & Ghee,Black Sesame oil 1 L,9,440,380,60,1
28-04-2025,Pooja & Spiritual Items,BALAJI KASTURI DHOOP STICKS,12,70,70,0,1
28-04-2025,Pooja & Spiritual Items,SWASTIK SAMBRANI 25 GRMS,12,20,0,20,1
28-04-2025,Snacks & Ready-to-Eat,RAJGIRA PEANUT CHIKKI,14,15,15,0,3
28-04-2025,"Grains, Flours & Dals",MAAGAANI LOW GI SP L 1KG,4,600,525,75,5
28-04-2025,Beverages,REFRESH SHARBATH NORMAL,1,199,190,9,1
28-04-2025,"Grains, Flours & Dals",RAGI FLOUR 500GRMS,4,40,35,5,1
28-04-2025,"Grains, Flours & Dals",Wheat Flour 1 kg,4,70,60,10,1
28-04-2025,"Grains, Flours & Dals",Sathya Javva Wheat Rava 500GM,4,95,95,0,1
28-04-2025,Snacks & Ready-to-Eat,SD Moringa with plam jaggery 250gm,14,135,135,0,1
28-04-2025,Oils & Ghee,Safflower oil 1 L,9,400,400,0,1
28-04-2025,"Dry Fruits, Nuts & Seeds",SUNFLOWER SEEDS 250GRM,2,150,130,20,1
28-04-2025,"Grains, Flours & Dals",HS JOWAR FLAKES 250GM 1+1,4,119,59.5,59.5,1
28-04-2025,"Grains, Flours & Dals",MAAGAANI LOW GI SP L 1KG,4,240,210,30,2
28-04-2025,Oils & Ghee,Groundnut oil 1 L,9,330,330,0,1
28-04-2025,"Grains, Flours & Dals",RAGI FLOUR 500GRMS,4,80,70,10,2
28-04-2025,Oils & Ghee,Safflower oil 1 L,9,400,400,0,1
28-04-2025,"Dry Fruits, Nuts & Seeds",Putnalu 250GM,2,45,38,7,1
28-04-2025,"Grains, Flours & Dals",turdal 500 gms,4,110,85,25,1
28-04-2025,"Dry Fruits, Nuts & Seeds",Groundnuts 500 gms,2,95,85,10,1
28-04-2025,Sweeteners,SH JAGGERY POWDER 500GM,16,80,68,12,1
28-04-2025,"Grains, Flours & Dals",AISHWARYA SP 5KG,4,400,375,25,1
28-04-2025,"Grains, Flours & Dals",AISHWARYA SP 5KG,4,400,375,25,1
28-04-2025,"Grains, Flours & Dals",Sathya Javva Wheat Rava 500GM,4,95,95,0,1
28-04-2025,"Health, Wellness & Ayurvedic Products",MH Baby Food 400GM,5,200,200,0,1
28-04-2025,Oils & Ghee,Groundnut oil 1 L,9,330,330,0,1
28-04-2025,Spices & Seasonings,AVALU 250grms,15,60,60,0,1
28-04-2025,"Grains, Flours & Dals",Urad dall 1 Kg,4,185,170,15,1
28-04-2025,"Dry Fruits, Nuts & Seeds",Groundnuts 1 kg,2,190,165,25,1
28-04-2025,"Grains, Flours & Dals",CHANA DAL 500GM,4,56,48,8,1
28-04-2025,"Grains, Flours & Dals",yellow jowar flour 1kg,4,100,92,8,1
28-04-2025,"Grains, Flours & Dals",chana flour 500 gms,4,60,54,6,1
28-04-2025,Snacks & Ready-to-Eat,VD KOBARI LADDU,14,80,80,0,1
28-04-2025,Spices & Seasonings,Tamarind 250GMS,15,80,65,15,1
28-04-2025,"Grains, Flours & Dals",SAMALU (Little millet) 500 gms,4,85,65,20,1
28-04-2025,Snacks & Ready-to-Eat,SATHVI REGIVADA 200GM,14,80,60,20,1
28-04-2025,"Grains, Flours & Dals",Wheat Rava S 1KG,4,65,55,10,1
28-04-2025,Pickles & Cooking Pastes,SD TOMATO PICKLE,11,110,110,0,1
28-04-2025,"Grains, Flours & Dals",Arikalu (kodo),4,70,65,5,1
28-04-2025,Personal Care & Cosmetics,DWIBHASHI GULABA ARKA ROSA WATER,10,60,60,0,1
28-04-2025,"Grains, Flours & Dals",Quinova 500 gms,4,110,100,10,1
28-04-2025,"Grains, Flours & Dals",KORRALU (FOXTAIL M) 500GM,4,65,55,10,1
28-04-2025,Snacks & Ready-to-Eat,SD Aswagandha with palm Jaggery250Gm,14,135,135,0,1
28-04-2025,Oils & Ghee,Black Sesame oil 500 ml,9,440,380,60,2
28-04-2025,Pickles & Cooking Pastes,SD MANGO PICKLE,11,110,110,0,1
28-04-2025,Spices & Seasonings,Chilli powder 500 gms,15,580,420,160,2
28-04-2025,Household & Cleaning,vim,6,60,60,0,1
28-04-2025,Spices & Seasonings,sf jeera,15,120,120,0,1
28-04-2025,Sweeteners,sugar 500 gms,16,30,28,2,1
28-04-2025,"Grains, Flours & Dals",Wheat Rava M 500GM,4,33,30,3,1
28-04-2025,Sweeteners,YB Brown Sugar 500GM,16,75,75,0,1
28-04-2025,"Grains, Flours & Dals",IDLY RAVA 1KG,4,60,50,10,1
28-04-2025,"Grains, Flours & Dals",Urad dall 1 Kg,4,185,170,15,1
28-04-2025,"Grains, Flours & Dals",Wheat Flour 1 kg,4,70,60,10,1
28-04-2025,"Grains, Flours & Dals",Chana Flour 500 gms,4,140,110,30,1
28-04-2025,Oils & Ghee,Groundnut oil 500ml,9,180,165,15,1
28-04-2025,"Grains, Flours & Dals",FLOUR CHARGE,4,44.4,44.4,0,3.7
28-04-2025,Snacks & Ready-to-Eat,GREEN FRIED BATANA,14,20,20,0,1
28-04-2025,Snacks & Ready-to-Eat,NGT CHATPATTA CHANA 90GM,14,25,25,0,1
28-04-2025,"Grains, Flours & Dals",SL Idly Rava 1KG,4,65,55,10,1
28-04-2025,Oils & Ghee,rice bran oil f,9,194,169,25,1
28-04-2025,"Grains, Flours & Dals",SABDANA,4,40,35,5,1
28-04-2025,"Grains, Flours & Dals",SL Suji Rava 500GM,4,32,32,0,1
28-04-2025,"Grains, Flours & Dals",HS JOWAR IDLY RAWA,4,65,65,0,1
28-04-2025,Oils & Ghee,Groundnut oil 1 L,9,330,330,0,1
28-04-2025,Oils & Ghee,Groundnut oil 1 L,9,660,660,0,2
28-04-2025,"Grains, Flours & Dals",RAJMA 250GM,4,55,45,10,1
28-04-2025,"Grains, Flours & Dals",CHANA DAL 500GM,4,56,48,8,1
28-04-2025,"Dry Fruits, Nuts & Seeds",PULMAKHANA 100 GM,2,180,170,10,1
28-04-2025,Milk & Dairy,SANGAM FULL CREAM MILK 500ML,7,38,38,0,1
28-04-2025,Misc,VD00014,8,100,90,10,1
28-04-2025,Snacks & Ready-to-Eat,VD PALLI LADDU,14,80,80,0,1
28-04-2025,"Dry Fruits, Nuts & Seeds",SABJA SEEDS,2,70,70,0,1
28-04-2025,Snacks & Ready-to-Eat,RSC ORANGE 100GMS,14,20,20,0,1
28-04-2025,Snacks & Ready-to-Eat,3D PAPAD,14,40,40,0,1
28-04-2025,Beverages,BRU GREEN LABEL 1.2G,1,14,14,0,7
28-04-2025,"Dry Fruits, Nuts & Seeds",DRYDATES YELLOW 250GM,2,135,120,15,1
28-04-2025,Sweeteners,SD PALM JAGGERY 500GM,16,200,200,0,1
28-04-2025,Snacks & Ready-to-Eat,CHOCO BROWINE,14,20,20,0,1
28-04-2025,"Dry Fruits, Nuts & Seeds",ANJEER 250GM,2,400,360,40,1
28-04-2025,Spices & Seasonings,Telaga Pindi 250 GM,15,40,35,5,1
28-04-2025,Oils & Ghee,Sesame oil 1 L,9,560,560,0,1
28-04-2025,"Grains, Flours & Dals",AISHWARYA SP 1KG,4,120,105,15,1.5
28-04-2025,"Dry Fruits, Nuts & Seeds",Groundnuts 1 kg,2,190,165,25,1
28-04-2025,Pooja & Spiritual Items,SWASTIK CAMPHORE,12,90,90,0,1
28-04-2025,"Grains, Flours & Dals",AISHWARYA SP 25KG,4,1999,"1,690.00",309,1
28-04-2025,Spices & Seasonings,FLAXSEED KARAM,15,75,75,0,1
28-04-2025,Oils & Ghee,Groundnut oil 1 L,9,330,330,0,1
28-04-2025,Oils & Ghee,Groundnut oil 5 L,9,1800,"1,600.00",200,1
28-04-2025,"Dry Fruits, Nuts & Seeds",SUNFLOWER SEEDS 250GRM,2,150,130,20,1
28-04-2025,"Grains, Flours & Dals",Wheat Flour 1 kg,4,140,120,20,2
28-04-2025,"Grains, Flours & Dals",Red Bobarlu 1 kg,4,190,170,20,1
28-04-2025,Oils & Ghee,Coconut oil 1 L,9,440,400,40,1
28-04-2025,Oils & Ghee,Sesame oil 1 L,9,2750,"2,750.00",0,5
28-04-2025,Oils & Ghee,Sesame oil 5 L,9,2950,"2,750.00",200,1
28-04-2025,Sweeteners,MISHRI 250 GM,16,35,30,5,1
28-04-2025,Sweeteners,MISHRI D,16,40,30,10,1
28-04-2025,Pooja & Spiritual Items,s karpuram,12,180,180,0,1
28-04-2025,"Dry Fruits, Nuts & Seeds",MAHA BEERA SEEDS 100GM,2,60,60,0,1
28-04-2025,Oils & Ghee,Groundnut oil 1 L,9,990,990,0,3
28-04-2025,Snacks & Ready-to-Eat,SATHVI REGIVADA 200GM,14,80,60,20,1
28-04-2025,"Dry Fruits, Nuts & Seeds",Groundnuts 500 gms,2,95,85,10,1
28-04-2025,Snacks & Ready-to-Eat,GB SALT COOKIES,14,60,55,5,1
28-04-2025,Snacks & Ready-to-Eat,VD PALLI CHIKKI,14,80,80,0,1
28-04-2025,Snacks & Ready-to-Eat,GREEN FRIED batana,14,20,20,0,1
28-04-2025,Beverages,TAJ MAHAL 250GM,1,235,235,0,1
28-04-2025,Snacks & Ready-to-Eat,NGT CHATPATTA CHANA 90GM,14,50,50,0,2
28-04-2025,"Grains, Flours & Dals",RAGI FLOUR 500GRMS,4,40,35,5,1
28-04-2025,"Grains, Flours & Dals",turdal 1kg,4,220,170,50,1
28-04-2025,Oils & Ghee,cow ghee 500 ml,9,430,390,40,1
28-04-2025,"Dry Fruits, Nuts & Seeds",Groundnuts 1 kg,2,380,330,50,2
28-04-2025,"Grains, Flours & Dals",AISHWARYA SP 1KG,4,800,700,100,10
28-04-2025,Oils & Ghee,Groundnut oil 1 L,9,660,660,0,2
28-04-2025,Oils & Ghee,Groundnut oil 1 L,9,330,330,0,1
28-04-2025,Oils & Ghee,Sesame oil 1 L,9,560,560,0,1
28-04-2025,Spices & Seasonings,YB PINK ROCK SALT 1KG,15,120,120,0,1
28-04-2025,Snacks & Ready-to-Eat,NGT CHATPATTA CHANA 90GM,14,50,50,0,2
28-04-2025,"Grains, Flours & Dals",THIN POHA 500GM,4,40,35,5,1
28-04-2025,"Grains, Flours & Dals",AISHWARYA SP 5KG,4,400,375,25,1
28-04-2025,"Grains, Flours & Dals",Green gram 1 kg,4,150,130,20,1
28-04-2025,Spices & Seasonings,JEERA 250 gms,15,125,105,20,1
28-04-2025,"Grains, Flours & Dals",PESARA PAPPU 1 KG,4,170,145,25,1
28-04-2025,"Grains, Flours & Dals",FLOUR CHARGE,4,36,36,0,3
28-04-2025,"Dry Fruits, Nuts & Seeds",PULMAKHANA 100 GM,2,180,170,10,1
28-04-2025,"Grains, Flours & Dals",BARLEY SEEDS 1KG,4,32,28,4,0.2
28-04-2025,"Grains, Flours & Dals",SOYA BEANS 1KG,4,40,36,4,0.2
28-04-2025,Spices & Seasonings,Tamarind 250GMS,15,80,65,15,1
28-04-2025,"Grains, Flours & Dals",Green gram 500 gms,4,75,70,5,1
28-04-2025,"Grains, Flours & Dals",RED WHEAT 1 KG,4,325,300,25,2.5
28-04-2025,"Grains, Flours & Dals",SA Sprouted Ragi Flour 500GM,4,69,69,0,1
28-04-2025,Spices & Seasonings,MUSTARD POWDER 250G,15,65,55,10,1
28-04-2025,Snacks & Ready-to-Eat,ANNAPURNA APPALAM,14,35,35,0,1
28-04-2025,Spices & Seasonings,Menthulu 250 gms,15,50,45,5,1
28-04-2025,"Grains, Flours & Dals",Wheat Rava M 500GM,4,33,30,3,1
28-04-2025,Spices & Seasonings,MUSTARD POWDR 500G,15,650,550,100,5
28-04-2025,Spices & Seasonings,3M.MIRCHI POWDER,15,360,320,40,1
28-04-2025,Spices & Seasonings,DURGA SALT CRYSTAL 1KG,15,140,140,0,5
28-04-2025,"Health, Wellness & Ayurvedic Products",RB Max Protein PERI PERI 60gm,5,45,45,0,1
28-04-2025,"Grains, Flours & Dals",MELMEKER 250GMS,4,60,45,15,1
28-04-2025,Snacks & Ready-to-Eat,SF NOODLES CLKASSIC MASALA,14,129,129,0,1
28-04-2025,Sweeteners,mishri 500g,16,140,120,20,2
28-04-2025,Snacks & Ready-to-Eat,VD PALLI LADDU,14,80,80,0,1
28-04-2025,Snacks & Ready-to-Eat,VD KOBARI LADDU,14,80,80,0,1
28-04-2025,Misc,VD00014,8,200,180,20,2
28-04-2025,Snacks & Ready-to-Eat,PUMPKIN CHIKKI 200GM,14,140,120,20,1
28-04-2025,"Health, Wellness & Ayurvedic Products",RB Max Protein Cheese&amp;,5,45,45,0,1
28-04-2025,Snacks & Ready-to-Eat,VD MULTI CHAKKA,14,110,110,0,1
28-04-2025,Snacks & Ready-to-Eat,SF COOKIES BANANA OATS,14,99,99,0,1
28-04-2025,"Health, Wellness & Ayurvedic Products",MH Millets Malt 1KG,5,400,380,20,1
28-04-2025,"Health, Wellness & Ayurvedic Products",RB Max Protein Spanish Tomato,5,45,45,0,1
28-04-2025,Sweeteners,PN ORGANIC JAGGERY POWDER 400GM,16,172,172,0,2
28-04-2025,Snacks & Ready-to-Eat,VD DRY FRUIT PUTHAREKULU,14,300,300,0,2
28-04-2025,"Dry Fruits, Nuts & Seeds",WATERMELON SEEDS 250GRM,2,320,280,40,1
28-04-2025,"Dry Fruits, Nuts & Seeds",PUMPKIN SEEDS 250GM,2,200,160,40,1
28-04-2025,"Dry Fruits, Nuts & Seeds",SUNFLOWER SEEDS 250GRM,2,150,130,20,1
28-04-2025,Beverages,REFRESH SHARBATH SUGAR FREE,1,299,285,14,1
28-04-2025,"Grains, Flours & Dals",Multigrain 1 kg,4,100,85,15,1
28-04-2025,"Grains, Flours & Dals",samalu,4,130,130,0,1
28-04-2025,Snacks & Ready-to-Eat,FOXTAIL BIS,14,135,135,0,1
28-04-2025,"Grains, Flours & Dals",KORRALU (FOXTAIL M) 1KG,4,150,110,40,1
28-04-2025,"Grains, Flours & Dals",Wheat Flour 1 kg,4,140,120,20,2
28-04-2025,Oils & Ghee,Coconut oil 500 ml,9,220,200,20,1
28-04-2025,Spices & Seasonings,Tamarind 500GM,15,160,130,30,1
28-04-2025,Spices & Seasonings,Menthulu 250 gms,15,50,45,5,1
28-04-2025,Spices & Seasonings,JEERA 250 gms,15,250,210,40,2
28-04-2025,"Grains, Flours & Dals",RAGI FLOUR 1KG,4,80,70,10,1
28-04-2025,Snacks & Ready-to-Eat,VD CORNFLAKES MIXTURE 175GM,14,60,60,0,1
28-04-2025,Snacks & Ready-to-Eat,SATHVI REGIVADA 200GM,14,80,60,20,1
28-04-2025,"Grains, Flours & Dals",chana flour 500 gms,4,60,54,6,1
28-04-2025,"Grains, Flours & Dals",FLOUR CHARGE,4,52.8,52.8,0,4.4
28-04-2025,"Health, Wellness & Ayurvedic Products",MH Millets Malt 500GM,5,200,190,10,1
28-04-2025,"Grains, Flours & Dals",IG BROWN RICE,4,152,137,15,1
28-04-2025,"Grains, Flours & Dals",white Bobarlu 500 gms,4,80,75,5,1
28-04-2025,"Grains, Flours & Dals",Green gram 1 kg,4,150,130,20,1
28-04-2025,Beverages,BRU GREEN LABEL 1.2G,1,4,4,0,2
28-04-2025,"Grains, Flours & Dals",MELMEKER 250GMS,4,60,45,15,1
28-04-2025,Snacks & Ready-to-Eat,MILLET PANCAKE CHOCOLATE,14,199,199,0,1
28-04-2025,"Grains, Flours & Dals",HS JOWAR IDLY RAWA,4,65,65,0,1
28-04-2025,"Grains, Flours & Dals",Arikadu ( kodo),4,140,130,10,1
28-04-2025,"Grains, Flours & Dals",UDALU (Barnyard millet) 1 kg,4,140,115,25,1
28-04-2025,"Grains, Flours & Dals",KORRALU (FOXTAIL M) 1KG,4,150,110,40,1
28-04-2025,"Grains, Flours & Dals",White Chana 500GM,4,240,200,40,2
28-04-2025,Milk & Dairy,HERITAGE TOTAL CURD 500GM,7,50,50,0,1
28-04-2025,"Grains, Flours & Dals",Em Little idli R 500g,4,129,129,0,1
28-04-2025,"Grains, Flours & Dals",HS MULTI UPMA RAVA,4,65,65,0,1
28-04-2025,"Grains, Flours & Dals",SL Idly Rava 1KG,4,65,55,10,1
28-04-2025,"Grains, Flours & Dals",yellow jowar flour 1kg,4,100,92,8,1
28-04-2025,Spices & Seasonings,coriander,15,190,190,0,2
28-04-2025,Sweeteners,sugar 500 gms,16,30,28,2,1
28-04-2025,Spices & Seasonings,ROYAL SAFFRON,15,125,125,0,1
28-04-2025,"Grains, Flours & Dals",White jowar.F 1 kg,4,100,80,20,1
28-04-2025,"Grains, Flours & Dals",Urad dall 1 Kg,4,185,170,15,1
28-04-2025,Spices & Seasonings,Menthulu 250 gms,15,50,45,5,1
28-04-2025,Spices & Seasonings,JEERA 250 gms,15,125,105,20,1
28-04-2025,"Grains, Flours & Dals",turdal 1kg,4,220,170,50,1
28-04-2025,"Grains, Flours & Dals",Sathya Javva Wheat Rava 500GM,4,95,95,0,1
28-04-2025,"Grains, Flours & Dals",Wheat Flour 1 kg,4,70,60,10,1
28-04-2025,Spices & Seasonings,LG 50GM,15,92,92,0,1
28-04-2025,"Grains, Flours & Dals",Wheat Flour 1 kg,4,280,240,40,4
28-04-2025,"Grains, Flours & Dals",RAGI FLOUR 500GRMS,4,80,70,10,2
28-04-2025,Spices & Seasonings,Elaichi 25GM,15,145,120,25,1
28-04-2025,Spices & Seasonings,Jeera 100GM,15,50,45,5,1
28-04-2025,"Grains, Flours & Dals",KORRALU (FOXTAIL M) 1KG,4,150,110,40,1
28-04-2025,"Grains, Flours & Dals",CHANA DALL 250GM,4,28,24,4,1
28-04-2025,Spices & Seasonings,SATHVI ANASAPUVUU 25GM,15,90,65,25,1
28-04-2025,"Grains, Flours & Dals",CHANA DAL 500GM,4,56,48,8,1
28-04-2025,"Grains, Flours & Dals",Urad dall 1 Kg,4,277.5,255,22.5,1.5
28-04-2025,Spices & Seasonings,DURGA SALT CRYSTAL 1KG,15,50,50,0,2
28-04-2025,Spices & Seasonings,JEERA 250 gms,15,125,105,20,1
28-04-2025,"Grains, Flours & Dals",Green gram 1 kg,4,150,130,20,1
28-04-2025,Snacks & Ready-to-Eat,SATHVI REGIVADA 200GM,14,80,60,20,1
28-04-2025,Snacks & Ready-to-Eat,VD MURUKU 175GM,14,60,60,0,1
28-04-2025,Snacks & Ready-to-Eat,BELLAM MINAPA SUNADULLU,14,180,180,0,1
28-04-2025,Sweeteners,SUGAR 1KG,16,60,56,4,1
28-04-2025,Beverages,BRU GREEN LABEL 1.2G,1,8,8,0,4
28-04-2025,"Grains, Flours & Dals",turdal 500 gms,4,110,85,25,1
28-04-2025,Snacks & Ready-to-Eat,SD SESAME PAPAD,14,80,80,0,1
28-04-2025,Snacks & Ready-to-Eat,SAGOPAPAD GREEN CHILLI VD,14,55,55,0,1
28-04-2025,Oils & Ghee,Sesame oil 1 L,9,560,560,0,1
28-04-2025,Oils & Ghee,Coconut oil 500 ml,9,220,200,20,1
28-04-2025,Beverages,REFRESH SHARBATH SUGAR FREE,1,299,285,14,1
28-04-2025,Snacks & Ready-to-Eat,VD SAGOPAPAD 150GM,14,55,55,0,1
28-04-2025,Snacks & Ready-to-Eat,VD GUMMADI VADIYAM,14,75,75,0,1
28-04-2025,Snacks & Ready-to-Eat,3D PAPAD,14,40,40,0,1
28-04-2025,Snacks & Ready-to-Eat,SAGUPAPAD GREEN CHILLI,14,55,55,0,1
28-04-2025,Snacks & Ready-to-Eat,VD MULTI CHAKKA,14,220,220,0,2
28-04-2025,"Grains, Flours & Dals",RICE FLOUR 1KG,4,70,55,15,1
28-04-2025,"Dry Fruits, Nuts & Seeds",DRYDATES 250GM,2,150,120,30,1
28-04-2025,"Dry Fruits, Nuts & Seeds",ALMONDS 250GM,2,280,260,20,1
28-04-2025,"Dry Fruits, Nuts & Seeds",ALMONDS 250GM,2,280,260,20,1
28-04-2025,"Grains, Flours & Dals",HS JOWAR IDLY RAWA,4,65,65,0,1
28-04-2025,Snacks & Ready-to-Eat,VD NUVULLU CHIKKI,14,80,80,0,1
28-04-2025,Oils & Ghee,Sesame oil 1 L,9,560,560,0,1
28-04-2025,Snacks & Ready-to-Eat,VD PALLI CHIKKI,14,80,80,0,1
28-04-2025,"Grains, Flours & Dals",IDLY RAVA 1KG,4,60,50,10,1
28-04-2025,"Grains, Flours & Dals",Urad dall 1 Kg,4,185,170,15,1
28-04-2025,"Grains, Flours & Dals",split black gram 1 kg,4,180,170,10,1
28-04-2025,Snacks & Ready-to-Eat,BB VERMICELLI 1KG,14,95,90,5,1
28-04-2025,Oils & Ghee,Groundnut oil 1 L,9,330,330,0,1
28-04-2025,"Grains, Flours & Dals",chana flour 500 gms,4,60,54,6,1
28-04-2025,"Grains, Flours & Dals",Wheat Rava S 1KG,4,65,55,10,1
28-04-2025,Beverages,REFRESH SHARBATH SUGAR FREE,1,299,285,14,1
28-04-2025,Personal Care & Cosmetics,DETTOL AL 125 ML,10,80,80,0,1
28-04-2025,"Health, Wellness & Ayurvedic Products",RB Max Protein Spanish Tomato,5,45,45,0,1
28-04-2025,Snacks & Ready-to-Eat,SD High Protein Laddu 175gm,14,190,190,0,1
28-04-2025,Misc,VD0009,8,100,100,0,1
28-04-2025,Personal Care & Cosmetics,SVE KADHI CONDITIONING MILK,10,220,220,0,1
28-04-2025,"Grains, Flours & Dals",turdal 1kg,4,220,170,50,1
28-04-2025,"Grains, Flours & Dals",PESARA PAPPU 1 KG,4,170,145,25,1
28-04-2025,"Grains, Flours & Dals",KORRALU (FOXTAIL M) 500GM,4,65,55,10,1
28-04-2025,"Grains, Flours & Dals",SAMALU (Little millet) 500 gms,4,85,65,20,1
28-04-2025,"Grains, Flours & Dals",UDALU (Barnyard millet) 500 gms,4,70,60,10,1
28-04-2025,Oils & Ghee,Sesame oil 1 L,9,1680,"1,680.00",0,3
28-04-2025,"Grains, Flours & Dals",THICK POHA 500GM,4,40,35,5,1
28-04-2025,Oils & Ghee,Groundnut oil 1 L,9,660,660,0,2
28-04-2025,"Grains, Flours & Dals",THIN POHA 500GM,4,40,35,5,1
28-04-2025,Spices & Seasonings,Menthulu 250 gms,15,50,45,5,1
28-04-2025,Spices & Seasonings,DURGA SALT CRYSTAL 1KG,15,25,25,0,1
28-04-2025,Spices & Seasonings,MUSTARD POWDER 250G,15,195,165,30,3
28-04-2025,Snacks & Ready-to-Eat,RAJGIRA PEANUT CHIKKI 450GM,14,125,125,0,1
28-04-2025,Oils & Ghee,Sesame oil 1 L,9,560,560,0,1
28-04-2025,Spices & Seasonings,3M.MIRCHI POWDER,15,1440,"1,280.00",160,4
28-04-2025,"Dry Fruits, Nuts & Seeds",Groundnuts 1 kg,2,190,165,25,1
28-04-2025,"Grains, Flours & Dals",Red Wheat Flour 1 kg,4,140,130,10,1
28-04-2025,"Grains, Flours & Dals",turdal 1kg,4,220,170,50,1
28-04-2025,Oils & Ghee,Safflower oil 1 L,9,400,400,0,1
28-04-2025,Oils & Ghee,Groundnut oil 1 L,9,330,330,0,1
28-04-2025,"Dry Fruits, Nuts & Seeds",FLAX SEEDS 250GM,2,60,50,10,1
28-04-2025,"Dry Fruits, Nuts & Seeds",WATERMELON SEEDS 250GRM,2,320,280,40,1
28-04-2025,"Dry Fruits, Nuts & Seeds",ALMONDS 250GM,2,280,260,20,1
28-04-2025,"Dry Fruits, Nuts & Seeds",PUMPKIN SEEDS 250GM,2,200,160,40,1
28-04-2025,Oils & Ghee,Groundnut oil 1 L,9,660,660,0,2
28-04-2025,Misc,VD0001,8,100,100,0,1
28-04-2025,"Dry Fruits, Nuts & Seeds",SUNFLOWER SEEDS 250GRM,2,150,130,20,1
28-04-2025,Spices & Seasonings,Jeera 100GM,15,50,45,5,1
28-04-2025,Spices & Seasonings,NUVVULU 250GM,15,80,65,15,1
27-04-2025,Oils & Ghee,Coconut oil 500 ml,9,220,200,20,1
27-04-2025,"Dry Fruits, Nuts & Seeds",SUNFLOWER SEEDS 250GRM,2,150,130,20,1
27-04-2025,"Dry Fruits, Nuts & Seeds",ALMONDS 250GM,2,280,260,20,1
27-04-2025,"Dry Fruits, Nuts & Seeds",PUMPKIN SEEDS 250GM,2,200,160,40,1
27-04-2025,"Grains, Flours & Dals",KORRALU (FOXTAIL M) 1KG,4,150,110,40,1
27-04-2025,Snacks & Ready-to-Eat,VD MURMURA LADDU,14,50,50,0,1
27-04-2025,Oils & Ghee,Groundnut oil 1 L,9,990,990,0,3
27-04-2025,"Grains, Flours & Dals",ANDU KORRALU (Browntop.m) 1 kg,4,260,220,40,1
27-04-2025,"Grains, Flours & Dals",Black uluvalu 500 gms,4,90,70,20,1
27-04-2025,Oils & Ghee,Coconut oil 500 ml,9,220,200,20,1
27-04-2025,"Grains, Flours & Dals",Red Bobarlu 1 kg,4,190,170,20,1
27-04-2025,Spices & Seasonings,KALONJI SEEDS,15,90,80,10,1
27-04-2025,"Grains, Flours & Dals",Green gram 500 gms,4,75,70,5,1
27-04-2025,Pooja & Spiritual Items,VRP APOORVA JAVADHU POW,12,35,30,5,1
27-04-2025,Snacks & Ready-to-Eat,VD MURMURA LADDU,14,50,50,0,1
27-04-2025,Snacks & Ready-to-Eat,VD GUMMADI VADIYAM,14,75,75,0,1
27-04-2025,Oils & Ghee,Sesame oil 500ml,9,295,280,15,1
27-04-2025,Spices & Seasonings,MUSTARD POWDER 250G,15,130,110,20,2
27-04-2025,Oils & Ghee,Sesame oil 1 L,9,560,560,0,1
27-04-2025,Spices & Seasonings,AVALU 250grms,15,60,60,0,1
27-04-2025,Spices & Seasonings,THOKA MIRYALU 50GM,15,210,180,30,1
27-04-2025,"Grains, Flours & Dals",Urad dall 1 Kg,4,185,170,15,1
27-04-2025,"Grains, Flours & Dals",PESARA PAPPU 1 KG,4,170,145,25,1
27-04-2025,"Grains, Flours & Dals",IDLY RAVA 1KG,4,60,50,10,1
27-04-2025,Spices & Seasonings,PN ORGANIC PINK SALT 1KG,15,124,124,0,1
27-04-2025,"Dry Fruits, Nuts & Seeds",Groundnuts 1 kg,2,380,330,50,2
27-04-2025,Spices & Seasonings,DRY MIECHI 200GM,15,80,60,20,1
27-04-2025,Oils & Ghee,Sesame oil 1 L,9,560,560,0,1
27-04-2025,"Dry Fruits, Nuts & Seeds",SATHVI CHIA SEEDS 100GM,2,100,80,20,1
27-04-2025,Oils & Ghee,Groundnut oil 1 L,9,660,660,0,2
27-04-2025,"Grains, Flours & Dals",MAATEJA rice 1 kg,4,144,138,6,2
27-04-2025,"Grains, Flours & Dals",MELMEKER 250GMS,4,60,45,15,1
27-04-2025,Spices & Seasonings,3M.MIRCHI POWDER,15,720,640,80,2
27-04-2025,Oils & Ghee,Sesame oil 1 L,9,560,560,0,1
27-04-2025,Spices & Seasonings,THREE MANGO RAI 200G,15,84,84,0,2
27-04-2025,Oils & Ghee,Groundnut oil 1 L,9,330,330,0,1
27-04-2025,"Grains, Flours & Dals",Wheat Rava M 500GM,4,33,30,3,1
27-04-2025,"Grains, Flours & Dals",CHANA DAL 500GM,4,56,48,8,1
27-04-2025,"Grains, Flours & Dals",AISHWARAYA IDLY RAVA 1KG,4,99,66,33,1
27-04-2025,"Dry Fruits, Nuts & Seeds",ANJEER 250GM,2,400,360,40,1
27-04-2025,Oils & Ghee,Sesame oil 1 L,9,560,560,0,1
27-04-2025,"Grains, Flours & Dals",SRILATHA RICE RAVVA 500GM,4,35,35,0,1
27-04-2025,"Grains, Flours & Dals",chana flour 500 gms,4,60,54,6,1
27-04-2025,"Grains, Flours & Dals",Wheat Flour 1 kg,4,350,300,50,5
27-04-2025,"Grains, Flours & Dals",RAGI FLOUR 500GRMS,4,40,35,5,1
27-04-2025,Pooja & Spiritual Items,SHANKARS SWARNA YUG 60GM,12,60,60,0,1
27-04-2025,"Grains, Flours & Dals",RICE FLOUR 500 GM,4,35,28,7,1
27-04-2025,"Grains, Flours & Dals",MAIDA 1KG,4,70,60,10,1
27-04-2025,Pooja & Spiritual Items,GD TULASI 75GM,12,60,60,0,1
27-04-2025,Snacks & Ready-to-Eat,MILK BREAD,14,55,55,0,1
27-04-2025,Snacks & Ready-to-Eat,TILLI CHIKKI,14,20,20,0,4
27-04-2025,Snacks & Ready-to-Eat,SOYA MURK,14,60,60,0,1
27-04-2025,"Grains, Flours & Dals",BAJRA 1 KG,4,60,50,10,1
27-04-2025,Pickles & Cooking Pastes,SD MANGO TOKKU,11,110,110,0,1
27-04-2025,"Grains, Flours & Dals",Sathya Javva Wheat Rava 500GM,4,190,190,0,2
27-04-2025,Snacks & Ready-to-Eat,RAJGIRA PEANUT CHIKKI,14,25,25,0,5
27-04-2025,"Grains, Flours & Dals",RAGULU 1 KG,4,70,60,10,1
27-04-2025,Pickles & Cooking Pastes,SD AMALA PICKLE,11,110,110,0,1
27-04-2025,Oils & Ghee,Coconut oil 1 L,9,440,400,40,1
27-04-2025,Sweeteners,NATURAL HONEY 1KG,16,560,480,80,1
27-04-2025,Spices & Seasonings,ROYAL SAFFRON,15,125,125,0,1
27-04-2025,"Grains, Flours & Dals",YELLOW JOWER 1KG,4,90,80,10,1
27-04-2025,Spices & Seasonings,coconut powder,15,90,70,20,1
27-04-2025,"Grains, Flours & Dals",CHANA DAL 1KG,4,112,96,16,1
27-04-2025,Oils & Ghee,Groundnut oil 1 L,9,660,660,0,2
27-04-2025,"Dry Fruits, Nuts & Seeds",Groundnuts 1 kg,2,190,165,25,1
27-04-2025,"Grains, Flours & Dals",IDLY RAVA 1KG,4,120,100,20,2
27-04-2025,Snacks & Ready-to-Eat,RINGS 200GM,14,30,30,0,1
27-04-2025,"Grains, Flours & Dals",PESARA PAPPU 1 KG,4,170,145,25,1
27-04-2025,Oils & Ghee,rice bran oil f,9,388,338,50,2
27-04-2025,Spices & Seasonings,DRY MIECHI 200GM,15,80,60,20,1
27-04-2025,Snacks & Ready-to-Eat,3D PAPAD,14,40,40,0,1
27-04-2025,Snacks & Ready-to-Eat,VD SAGOPAPAD 150GM,14,55,55,0,1
27-04-2025,"Dry Fruits, Nuts & Seeds",KAJU HALF 250GM,2,310,290,20,1
27-04-2025,"Grains, Flours & Dals",Wheat Flour 1 kg,4,70,60,10,1
27-04-2025,"Grains, Flours & Dals",turdal 1kg,4,220,170,50,1
27-04-2025,Snacks & Ready-to-Eat,VD RICE MURUKU 150GM,14,50,50,0,1
27-04-2025,"Dry Fruits, Nuts & Seeds",Groundnuts 1 kg,2,190,165,25,1
27-04-2025,"Grains, Flours & Dals",IDLY RAVA 1KG,4,120,100,20,2
27-04-2025,"Grains, Flours & Dals",unpolished turdall500grms,4,120,110,10,1
27-04-2025,Spices & Seasonings,SAMBAR POWDER 200GM,15,130,110,20,1
27-04-2025,"Grains, Flours & Dals",turdal 1kg,4,220,170,50,1
27-04-2025,"Grains, Flours & Dals",Multigrain 1 kg,4,100,85,15,1
27-04-2025,"Grains, Flours & Dals",BAJRA 1 KG,4,30,25,5,0.5
27-04-2025,"Grains, Flours & Dals",KORRALU (FOXTAIL M) 500GM,4,65,55,10,1
27-04-2025,Snacks & Ready-to-Eat,PEANUT CHILLI,14,10,10,0,2
27-04-2025,Snacks & Ready-to-Eat,TILLI CHIKKI,14,10,10,0,2
27-04-2025,Snacks & Ready-to-Eat,VD MINAPA VADIYAM,14,65,65,0,1
27-04-2025,Beverages,BRU GREEN LABEL 1.2G,1,10,10,0,5
27-04-2025,"Dry Fruits, Nuts & Seeds",Putnalu 250GM,2,45,38,7,1
27-04-2025,"Grains, Flours & Dals",Wheat Flour 1 kg,4,210,180,30,3
27-04-2025,Snacks & Ready-to-Eat,VD NUVVULU LADDU,14,80,80,0,1
27-04-2025,"Grains, Flours & Dals",RICE FLOUR 1KG,4,70,55,15,1
27-04-2025,Snacks & Ready-to-Eat,VD PALLI LADDU,14,80,80,0,1
27-04-2025,"Grains, Flours & Dals",RED TURDAL 500GM,4,75,70,5,1
27-04-2025,"Grains, Flours & Dals",split green gram 500 gms,4,75,70,5,1
27-04-2025,Snacks & Ready-to-Eat,ONION RINGS,14,100,100,0,2
27-04-2025,Snacks & Ready-to-Eat,VD Minapa papad 200gm,14,60,60,0,1
27-04-2025,Snacks & Ready-to-Eat,VD MINAPA VADIYAM,14,65,65,0,1
27-04-2025,Snacks & Ready-to-Eat,VD GUMMADI VADIYAM,14,75,75,0,1
27-04-2025,"Dry Fruits, Nuts & Seeds",Groundnuts 500 gms,2,95,85,10,1
27-04-2025,Spices & Seasonings,pickle chili powder,15,180,165,15,1
27-04-2025,Oils & Ghee,Groundnut oil 1 L,9,330,330,0,1
27-04-2025,Snacks & Ready-to-Eat,SAGOPAPAD GREEN CHILLI VD,14,55,55,0,1
27-04-2025,Beverages,3ROSES,1,90,90,0,1
27-04-2025,"Grains, Flours & Dals",SL Idly Rava 1KG,4,130,110,20,2
27-04-2025,Snacks & Ready-to-Eat,BELLAM MINAPA SUNADULLU,14,180,180,0,1
27-04-2025,"Grains, Flours & Dals",Wheat Rava M 500GM,4,33,30,3,1
27-04-2025,Snacks & Ready-to-Eat,SD FINGER Millet with palm Jaggery 250gm,14,270,270,0,2
27-04-2025,Spices & Seasonings,NUVVULU 250GM,15,80,65,15,1
27-04-2025,"Grains, Flours & Dals",SH TUR DAL 500GM,4,165,165,0,1
27-04-2025,Sweeteners,YB JAGGERY POWDER 500GMS,16,75,75,0,1
27-04-2025,Sweeteners,YB Brown Sugar 500GM,16,150,130,20,2
27-04-2025,Spices & Seasonings,TATA SALT 1KG,15,30,30,0,1
27-04-2025,"Grains, Flours & Dals",AISHWARYA SP 1KG,4,640,560,80,8
27-04-2025,Snacks & Ready-to-Eat,DINNER PAPAD,14,80,80,0,1
27-04-2025,"Grains, Flours & Dals",MELMEKER 250GMS,4,60,45,15,1
27-04-2025,"Grains, Flours & Dals",chana flour 500 gms,4,60,54,6,1
27-04-2025,"Grains, Flours & Dals",RAGI FLOUR 500GRMS,4,40,35,5,1
27-04-2025,"Grains, Flours & Dals",THICK POHA 500GM,4,40,35,5,1
27-04-2025,Snacks & Ready-to-Eat,MILLET NOODLES CURRY MASALA,14,129,129,0,1
27-04-2025,Sweeteners,Natural Honey 500 gms,16,280,240,40,1
27-04-2025,Oils & Ghee,Groundnut oil 500ml,9,180,165,15,1
27-04-2025,Snacks & Ready-to-Eat,SF NOODLES CLKASSIC MASALA,14,129,129,0,1
27-04-2025,"Grains, Flours & Dals",samalu,4,130,130,0,1
27-04-2025,"Grains, Flours & Dals",JOWAR UPMA RAVA,4,65,65,0,1
27-04-2025,Spices & Seasonings,Menthulu 250 gms,15,50,45,5,1
27-04-2025,Spices & Seasonings,MUSTARD POWDER 250G,15,260,220,40,4
27-04-2025,Spices & Seasonings,3M.MIRCHI POWDER,15,720,640,80,2
27-04-2025,Spices & Seasonings,DURGA SALT CRYSTAL 1KG,15,56,56,0,2
27-04-2025,Oils & Ghee,Groundnut oil 1 L,9,990,990,0,3
27-04-2025,Oils & Ghee,Groundnut oil 5 L,9,1800,"1,600.00",200,1
27-04-2025,Baking & Cooking Aids,GONDKATIRA Ag,0,170,150,20,2
27-04-2025,"Dry Fruits, Nuts & Seeds",MAHA BEERA SEEDS 100GM,2,160,160,0,2
27-04-2025,Oils & Ghee,Sesame oil 5 L,9,2950,"2,750.00",200,1
27-04-2025,"Grains, Flours & Dals",HEALTH JOWAR RAWA,4,99,99,0,1
27-04-2025,Snacks & Ready-to-Eat,VD DAHI MIRCHI(SALTED) 100GM,14,45,45,0,1
27-04-2025,"Grains, Flours & Dals",split green gram 500 gms,4,75,70,5,1
27-04-2025,Beverages,BISLERI 100ml,1,10,10,0,1
27-04-2025,Spices & Seasonings,DRY MIECHI 200GM,15,80,60,20,1
27-04-2025,"Grains, Flours & Dals",SPLIT BLACK GRAM 500 GM,4,90,85,5,1
27-04-2025,Personal Care & Cosmetics,HERBAL BATH POWDER 200GM,10,80,80,0,1
27-04-2025,Spices & Seasonings,AVALU 250grms,15,60,60,0,1
27-04-2025,Spices & Seasonings,Tamalapaku Karam Powder 100GM,15,80,80,0,1
27-04-2025,Spices & Seasonings,Chilli powder 500 gms,15,290,210,80,1
27-04-2025,Spices & Seasonings,Tamarind 250GMS,15,80,65,15,1
27-04-2025,Spices & Seasonings,Jeera 100GM,15,50,45,5,1
27-04-2025,"Dry Fruits, Nuts & Seeds",PULMAKHANA 100 GM,2,180,170,10,1
27-04-2025,"Grains, Flours & Dals",Arikalu (kodo),4,70,65,5,1
27-04-2025,"Grains, Flours & Dals",AISHWARYA SP 1KG,4,80,70,10,1
27-04-2025,"Grains, Flours & Dals",KORRALU (FOXTAIL M) 500GM,4,65,55,10,1
27-04-2025,Snacks & Ready-to-Eat,VD SAGOPAPAD 150GM,14,55,55,0,1
27-04-2025,Snacks & Ready-to-Eat,PEANUT CHIKKI 450GM,14,125,125,0,1
27-04-2025,"Grains, Flours & Dals",VGR rice 1 kg,4,280,260,20,4
27-04-2025,"Dry Fruits, Nuts & Seeds",FLAX SEEDS 250GM,2,60,50,10,1
27-04-2025,Personal Care & Cosmetics,SVE TURMERIC SOAP 100GM,10,90,90,0,1
27-04-2025,Snacks & Ready-to-Eat,SD JOWAR WITH PALM JAGGERY 250GM,14,135,135,0,1
27-04-2025,"Dry Fruits, Nuts & Seeds",SABJA SEEDS,2,70,70,0,1
27-04-2025,"Dry Fruits, Nuts & Seeds",SD Mango cubes 100gm,2,45,45,0,1
27-04-2025,Oils & Ghee,Groundnut oil 1 L,9,1320,"1,320.00",0,4
27-04-2025,Sweeteners,YB FOREST H 250 GMS,16,180,180,0,1
27-04-2025,Sweeteners,NATURAL HONEY 250GM,16,150,130,20,1
27-04-2025,Personal Care & Cosmetics,OVAL BODY LOOFAH,10,55,55,0,1
27-04-2025,Snacks & Ready-to-Eat,GB SALT COOKIES,14,60,55,5,1
27-04-2025,Snacks & Ready-to-Eat,TILLI CHIKKI,14,125,125,0,1
27-04-2025,Sweeteners,MISHRI 250 GM,16,35,30,5,1
27-04-2025,Snacks & Ready-to-Eat,VD MURMURA LADDU,14,50,50,0,1
27-04-2025,Spices & Seasonings,ROYAL SAFFRON,15,125,125,0,1
27-04-2025,"Dry Fruits, Nuts & Seeds",FLAX SEEDS 250GM,2,60,50,10,1
27-04-2025,Oils & Ghee,Coconut oil 500 ml,9,220,200,20,1
27-04-2025,Snacks & Ready-to-Eat,NGT CHATPATTA CHANA 90GM,14,50,50,0,2
27-04-2025,Personal Care & Cosmetics,Soapnut 250GM,10,120,90,30,2
27-04-2025,Personal Care & Cosmetics,Soapnut 500GM,10,120,90,30,1
27-04-2025,Personal Care & Cosmetics,Soapnut 500GM,10,120,90,30,1
27-04-2025,"Grains, Flours & Dals",Wheat Flour 1 kg,4,140,120,20,2
27-04-2025,Sweeteners,YB Brown Sugar 500GM,16,75,75,0,1
27-04-2025,Oils & Ghee,Groundnut oil 5 L,9,1800,"1,600.00",200,1
27-04-2025,"Dry Fruits, Nuts & Seeds",WATERMELON SEEDS 250GRM,2,320,280,40,1
27-04-2025,"Dry Fruits, Nuts & Seeds",PUMPKIN SEEDS 250GM,2,200,160,40,1
27-04-2025,"Dry Fruits, Nuts & Seeds",DRYDATES 250GM,2,300,240,60,2
27-04-2025,Snacks & Ready-to-Eat,BATANA NGT 70GMS,14,20,20,0,1
27-04-2025,Sweeteners,YB FOREST H 250 GMS,16,180,180,0,1
27-04-2025,"Dry Fruits, Nuts & Seeds",PULMAKHANA 100 GM,2,180,170,10,1
27-04-2025,"Dry Fruits, Nuts & Seeds",ANJEER 250GM,2,800,720,80,2
27-04-2025,Oils & Ghee,Sesame oil 1 L,9,1120,"1,120.00",0,2
27-04-2025,"Grains, Flours & Dals",Brown RICE 1KG,4,140,130,10,2
27-04-2025,"Dry Fruits, Nuts & Seeds",PULMAKHANA 100 GM,2,180,170,10,1
27-04-2025,Sweeteners,organic jaggery powder,16,198,198,0,2
27-04-2025,Snacks & Ready-to-Eat,SF COOKIES CHOCO RAGI,14,99,99,0,1
27-04-2025,Sweeteners,YB JAGGERY POWDER 1KG,16,140,140,0,1
27-04-2025,"Grains, Flours & Dals",SH RED POHA 500GM,4,85,85,0,1
27-04-2025,"Grains, Flours & Dals",HS RAGI FLAKES 250GM 1+1,4,119,119,0,1
27-04-2025,"Grains, Flours & Dals",Wheat Flour 1 kg,4,140,120,20,2
27-04-2025,"Health, Wellness & Ayurvedic Products",RB Max Protein DESI MASALA 60gm,5,45,45,0,1
27-04-2025,Oils & Ghee,Safflower oil 1 L,9,800,800,0,2
27-04-2025,"Grains, Flours & Dals",turdal 500 gms,4,110,85,25,1
27-04-2025,Spices & Seasonings,Chilli powder 250 gms,15,145,110,35,1
27-04-2025,"Grains, Flours & Dals",VGR rice 1 kg,4,350,325,25,5
27-04-2025,"Dry Fruits, Nuts & Seeds",Groundnuts 500 gms,2,95,85,10,1
27-04-2025,"Grains, Flours & Dals",Em Multimillet idli r 500g,4,129,129,0,1
27-04-2025,Oils & Ghee,Groundnut oil 1 L,9,330,330,0,1
27-04-2025,"Grains, Flours & Dals",RAGI FLOUR 1KG,4,80,70,10,1
27-04-2025,"Grains, Flours & Dals",PESARA PAPPU 500GMS,4,85,75,10,1
27-04-2025,Snacks & Ready-to-Eat,RI SPORTS BAR 40G,14,45,45,0,1
27-04-2025,"Grains, Flours & Dals",Wheat Flour 1 kg,4,70,60,10,1
27-04-2025,"Dry Fruits, Nuts & Seeds",Groundnuts 1 kg,2,190,165,25,1
27-04-2025,Spices & Seasonings,Menthulu 250 gms,15,50,45,5,1
27-04-2025,Oils & Ghee,Coconut oil 500 ml,9,220,200,20,1
27-04-2025,"Health, Wellness & Ayurvedic Products",RB Max Protein Cheese&amp;,5,45,45,0,1
27-04-2025,Oils & Ghee,Sesame oil 1 L,9,2240,"2,240.00",0,4
27-04-2025,"Grains, Flours & Dals",VGR RICE bag 1,4,1899,"1,650.00",249,1
27-04-2025,Spices & Seasonings,NUVVULU 500GM,15,200,170,30,1
27-04-2025,Snacks & Ready-to-Eat,VD PALLI LADDU,14,80,80,0,1
27-04-2025,"Grains, Flours & Dals",PN BROWN RICE,4,126,126,0,1
27-04-2025,"Dry Fruits, Nuts & Seeds",Groundnuts 1 kg,2,190,165,25,1
27-04-2025,"Grains, Flours & Dals",KORRALU (FOXTAIL M) 500GM,4,65,55,10,1
27-04-2025,"Grains, Flours & Dals",Arikalu (kodo),4,70,65,5,1
27-04-2025,"Grains, Flours & Dals",White jowar.F 1 kg,4,100,80,20,1
27-04-2025,"Grains, Flours & Dals",PESARA PAPPU 500GMS,4,85,75,10,1
27-04-2025,"Dry Fruits, Nuts & Seeds",SALTED PISTA 250GM,2,400,350,50,1
27-04-2025,"Grains, Flours & Dals",RAGI FLOUR 500GRMS,4,40,35,5,1
27-04-2025,Snacks & Ready-to-Eat,GREEN FRIED BATANA,14,40,40,0,2
27-04-2025,"Grains, Flours & Dals",turdal 500 gms,4,220,170,50,2
27-04-2025,"Grains, Flours & Dals",chana flour 500 gms,4,60,54,6,1
27-04-2025,"Grains, Flours & Dals",Wheat Rava S 1KG,4,65,55,10,1
27-04-2025,Household & Cleaning,SURFEXCEL BAR 80G,6,20,20,0,2
27-04-2025,Baking & Cooking Aids,GONDKATIRA Ag,0,85,75,10,1
27-04-2025,Snacks & Ready-to-Eat,NGT CHATPATTA CHANA 90GM,14,25,25,0,1
27-04-2025,Spices & Seasonings,Jeera 100GM,15,50,45,5,1
27-04-2025,Snacks & Ready-to-Eat,Corn Chips 250GM,14,40,35,5,1
27-04-2025,"Grains, Flours & Dals",SL Suji Rava 500GM,4,32,32,0,1
27-04-2025,Oils & Ghee,Sesame oil 500ml,9,295,280,15,1
27-04-2025,"Grains, Flours & Dals",AISHWARAYA IDLY RAVA 1KG,4,99,66,33,1
27-04-2025,"Grains, Flours & Dals",BASMATHI RICE 1KG,4,150,135,15,1
27-04-2025,Snacks & Ready-to-Eat,VD SAGOPAPAD 150GM,14,55,55,0,1
27-04-2025,Oils & Ghee,Safflower oil 500 ml,9,220,200,20,1
27-04-2025,Snacks & Ready-to-Eat,ANNAPURNA APPALAM,14,35,35,0,1
27-04-2025,Snacks & Ready-to-Eat,RAJGIRA PEANUT CHIKKI 450GM,14,125,125,0,1
27-04-2025,Snacks & Ready-to-Eat,Popcorn Seeds 250GM,14,45,40,5,1
27-04-2025,Spices & Seasonings,DURGA SALT CRYSTAL 1KG,15,25,25,0,1
27-04-2025,"Grains, Flours & Dals",split black gram 1 kg,4,180,170,10,1
27-04-2025,"Grains, Flours & Dals",RED TURDAL 500GM,4,75,70,5,1
27-04-2025,"Grains, Flours & Dals",Green gram 1 kg,4,150,130,20,1
27-04-2025,"Dry Fruits, Nuts & Seeds",PULMAKHANA 100 GM,2,180,170,10,1
27-04-2025,"Dry Fruits, Nuts & Seeds",PUMPKIN SEEDS 250GM,2,200,160,40,1
27-04-2025,"Dry Fruits, Nuts & Seeds",FLAX SEEDS 250GM,2,60,50,10,1
27-04-2025,"Dry Fruits, Nuts & Seeds",ALMONDS 250GM,2,280,260,20,1
27-04-2025,"Grains, Flours & Dals",CHANA DALL 250GM,4,28,24,4,1
27-04-2025,"Dry Fruits, Nuts & Seeds",cashew,2,340,310,30,1
27-04-2025,Oils & Ghee,Groundnut oil 1 L,9,330,330,0,1
27-04-2025,Pooja & Spiritual Items,VRP APOORVA JAVADHU POW,12,420,420,0,12
27-04-2025,Oils & Ghee,Coconut oil 500 ml,9,220,200,20,1
27-04-2025,"Grains, Flours & Dals",Wheat Flour 1 kg,4,70,60,10,1
27-04-2025,"Grains, Flours & Dals",SRILATHA RICE RAVVA 500GM,4,35,35,0,1
27-04-2025,Snacks & Ready-to-Eat,VD NUVULLU CHIKKI,14,80,80,0,1
27-04-2025,Spices & Seasonings,DURGA SALT CRYSTAL 1KG,15,25,25,0,1
27-04-2025,"Grains, Flours & Dals",WHITE BATANI,4,40,30,10,1
27-04-2025,Snacks & Ready-to-Eat,BD LITTLE MILLET NOODLES 200G,14,75,75,0,1
27-04-2025,"Dry Fruits, Nuts & Seeds",SABJA SEEDS,2,70,70,0,1
27-04-2025,"Grains, Flours & Dals",Red Chana 500 GM,4,75,60,15,1
27-04-2025,"Dry Fruits, Nuts & Seeds",Groundnuts 500 gms,2,95,85,10,1
27-04-2025,Snacks & Ready-to-Eat,PEANUT CHIKKI,14,88,88,0,4
27-04-2025,Snacks & Ready-to-Eat,RAJGIRA PEANUT CHIKKI,14,5,5,0,1
27-04-2025,"Dry Fruits, Nuts & Seeds",SATHVI CHIA SEEDS 100GM,2,100,80,20,1
27-04-2025,Snacks & Ready-to-Eat,SATHVI REGIVADA 200GM,14,80,60,20,1
27-04-2025,Oils & Ghee,Safflower oil 1 L,9,400,400,0,1
27-04-2025,Snacks & Ready-to-Eat,ID CHAPATI,14,79,79,0,1
27-04-2025,Snacks & Ready-to-Eat,VD NUVULLU CHIKKI,14,80,80,0,1
27-04-2025,"Grains, Flours & Dals",KORRALU (FOXTAIL M) 1KG,4,150,110,40,1
27-04-2025,"Grains, Flours & Dals",RAGI FLOUR 1KG,4,160,140,20,2
27-04-2025,"Grains, Flours & Dals",COW B rice 1 kg,4,360,345,15,5
27-04-2025,Snacks & Ready-to-Eat,VD NUVULLU CHIKKI,14,80,80,0,1
27-04-2025,Spices & Seasonings,PICKLES CHILLIP 500 GMS,15,355,325,30,1
27-04-2025,Beverages,BRU GREEN LABEL 1.2G,1,20,20,0,10
27-04-2025,Snacks & Ready-to-Eat,SD Aswagandha with palm Jaggery250Gm,14,135,135,0,1
27-04-2025,"Grains, Flours & Dals",AISHWARYA SP 1KG,4,240,210,30,3
27-04-2025,"Grains, Flours & Dals",BOBBARA PAPPU 500GM,4,85,80,5,1
27-04-2025,Oils & Ghee,rice bran oil f,9,388,338,50,2
27-04-2025,"Grains, Flours & Dals",AISHWARYA SP 25KG,4,1999,"1,690.00",309,1
27-04-2025,"Grains, Flours & Dals",SPLIT BLACK GRAM 500 GM,4,90,85,5,1
27-04-2025,Spices & Seasonings,DURGA SALT CRYSTAL 1KG,15,28,28,0,1
27-04-2025,"Grains, Flours & Dals",Urad dall 1 Kg,4,185,170,15,1
27-04-2025,"Dry Fruits, Nuts & Seeds",SABJA SEEDS,2,140,140,0,2
27-04-2025,"Grains, Flours & Dals",IDLY RAVA 1KG,4,180,150,30,3
27-04-2025,"Grains, Flours & Dals",JOWAR UPMA RAVA,4,65,65,0,1
27-04-2025,"Grains, Flours & Dals",split greengram,4,140,140,0,1
27-04-2025,Snacks & Ready-to-Eat,VD CORNFLAKES MIXTURE 175GM,14,60,60,0,1
27-04-2025,"Grains, Flours & Dals",UNPOLISHED TURDALL 1KG,4,240,210,30,1
27-04-2025,"Grains, Flours & Dals",PESARA PAPPU 500GMS,4,85,75,10,1
27-04-2025,Sweeteners,sugar 500 gms,16,30,28,2,1
27-04-2025,Snacks & Ready-to-Eat,KB MILK JUNNU POW 100GM,14,80,80,0,1
27-04-2025,Snacks & Ready-to-Eat,DOSA BATTER 1KG,14,60,60,0,1
27-04-2025,Snacks & Ready-to-Eat,ID PAROTA,14,99,99,0,1
27-04-2025,"Dry Fruits, Nuts & Seeds",PUMPKIN SEEDS 250GM,2,200,160,40,1
27-04-2025,"Dry Fruits, Nuts & Seeds",ALMONDS 250GM,2,280,260,20,1
27-04-2025,"Dry Fruits, Nuts & Seeds",BLACK KISMIS 250GM,2,175,140,35,1
27-04-2025,"Dry Fruits, Nuts & Seeds",Groundnuts 1 kg,2,190,165,25,1
27-04-2025,"Grains, Flours & Dals",samalu,4,130,130,0,1
27-04-2025,"Grains, Flours & Dals",MELMEKER 250GMS,4,60,45,15,1
27-04-2025,"Grains, Flours & Dals",ANDU KORRALU (Browntop.m) 1 kg,4,260,220,40,1
27-04-2025,"Grains, Flours & Dals",Arikadu ( kodo),4,140,130,10,1
27-04-2025,"Grains, Flours & Dals",UDALU (Barnyard millet) 1 kg,4,140,115,25,1
27-04-2025,"Grains, Flours & Dals",KORRALU (FOXTAIL M) 1KG,4,150,110,40,1
27-04-2025,Snacks & Ready-to-Eat,KB MILK JUNNU POW 100GM,14,150,150,0,1
27-04-2025,"Grains, Flours & Dals",CORN FLOUR,4,80,70,10,1
27-04-2025,"Grains, Flours & Dals",SL Suji Rava 500GM,4,32,32,0,1
27-04-2025,Spices & Seasonings,Masala Karam 250 gms,15,260,240,20,2
27-04-2025,"Grains, Flours & Dals",SRILALITHA MAIDA FLOUR 500G,4,32,32,0,1
27-04-2025,Snacks & Ready-to-Eat,ONION RINGS,14,55,55,0,1
27-04-2025,Snacks & Ready-to-Eat,RSC ORANGE 100GMS,14,20,20,0,1
27-04-2025,Snacks & Ready-to-Eat,3D PAPAD,14,40,40,0,1
27-04-2025,Pooja & Spiritual Items,SWASTIK CAMPHOR 25GM,12,45,45,0,1
27-04-2025,Oils & Ghee,Groundnut oil 1 L,9,1320,"1,320.00",0,4
27-04-2025,"Dry Fruits, Nuts & Seeds",SATHVI CHIA SEEDS 100GM,2,100,80,20,1
27-04-2025,Spices & Seasonings,SAFE HARVEST FENNEL SANUF,15,110,110,0,1
27-04-2025,Oils & Ghee,Coconut oil 500 ml,9,220,200,20,1
27-04-2025,"Grains, Flours & Dals",VL Sabdana 500GM,4,77,77,0,1
27-04-2025,Snacks & Ready-to-Eat,VD KOBARI LADDU,14,80,80,0,1
27-04-2025,"Grains, Flours & Dals",turdal 1kg,4,220,170,50,1
27-04-2025,"Grains, Flours & Dals",CHANA DAL 1KG,4,112,96,16,1
27-04-2025,"Grains, Flours & Dals",RAGI FLOUR 1KG,4,80,70,10,1
27-04-2025,Sweeteners,Natural Honey 500 gms,16,280,240,40,1
27-04-2025,Oils & Ghee,Groundnut oil 1 L,9,330,330,0,1
27-04-2025,"Dry Fruits, Nuts & Seeds",FLAX SEEDS 250GM,2,60,50,10,1
27-04-2025,Oils & Ghee,Safflower oil 1 L,9,400,400,0,1
27-04-2025,Oils & Ghee,Coconut oil 500 ml,9,220,200,20,1
27-04-2025,Spices & Seasonings,Telaga Pindi 250 GM,15,40,35,5,1
27-04-2025,"Grains, Flours & Dals",BLACKGRAM,4,70,70,0,1
27-04-2025,Oils & Ghee,Sesame oil 1 L,9,560,560,0,1
27-04-2025,"Grains, Flours & Dals",ANDU KORRALU (Brown top .mlt) 500,4,130,110,20,1
27-04-2025,Spices & Seasonings,Elaichi 25GM,15,290,240,50,2
27-04-2025,Snacks & Ready-to-Eat,SATHVI REGIVADA 200GM,14,160,120,40,2
27-04-2025,"Grains, Flours & Dals",SAMALU (Little millet) 500 gms,4,85,65,20,1
27-04-2025,"Grains, Flours & Dals",UDALU (Barnyard millet) 500 gms,4,70,60,10,1
27-04-2025,Spices & Seasonings,DURGA SALT CRYSTAL 1KG,15,84,84,0,3
27-04-2025,"Grains, Flours & Dals",Red Wheat Flour 1 kg,4,140,130,10,1
27-04-2025,"Grains, Flours & Dals",IDLY RAVA 1KG,4,180,150,30,3
27-04-2025,"Grains, Flours & Dals",Arikalu (kodo),4,70,65,5,1
27-04-2025,"Grains, Flours & Dals",KORRALU (FOXTAIL M) 500GM,4,65,55,10,1
27-04-2025,"Grains, Flours & Dals",YELLOW JOWER 1KG,4,90,80,10,1
27-04-2025,Beverages,BISLERI 100ml,1,20,20,0,2
27-04-2025,"Grains, Flours & Dals",KORRALU (FOXTAIL M) 1KG,4,150,110,40,1
27-04-2025,"Grains, Flours & Dals",UDALU (Barnyard millet) 1 kg,4,140,115,25,1
27-04-2025,"Grains, Flours & Dals",Arikadu ( kodo),4,140,130,10,1
27-04-2025,"Grains, Flours & Dals",samalu,4,260,260,0,2
27-04-2025,"Grains, Flours & Dals",JOWAR UPMA RAVA,4,65,65,0,1
27-04-2025,"Grains, Flours & Dals",yellow jowar flour 1kg,4,100,92,8,1
27-04-2025,Milk & Dairy,BROWN EGGS TRAY 30P,7,360,330,30,1
27-04-2025,Sweeteners,ACHU BELLAM 1KG,16,200,160,40,2
27-04-2025,"Grains, Flours & Dals",RICE FLOUR 500 GM,4,35,28,7,1
27-04-2025,Snacks & Ready-to-Eat,VD PALLI LADDU,14,80,80,0,1
27-04-2025,"Grains, Flours & Dals",maida 500grms,4,35,30,5,1
27-04-2025,"Grains, Flours & Dals",Wheat Flour 1 kg,4,70,60,10,1
27-04-2025,Oils & Ghee,Sesame oil 1 L,9,560,560,0,1
27-04-2025,Snacks & Ready-to-Eat,A biscuits,14,0,0,0,1
27-04-2025,"Dry Fruits, Nuts & Seeds",PULMAKHANA 100 GM,2,180,170,10,1
27-04-2025,Snacks & Ready-to-Eat,VD PALLI LADDU,14,80,80,0,1
27-04-2025,Beverages,REFRESH SHARBATH NORMAL,1,199,190,9,1
27-04-2025,"Grains, Flours & Dals",VGR RICE bag 1,4,1899,"1,650.00",249,1
27-04-2025,Personal Care & Cosmetics,UVIS COW GHEE SOAP 100GM,10,340,340,0,4
27-04-2025,Oils & Ghee,Groundnut oil 1 L,9,330,330,0,1
27-04-2025,"Grains, Flours & Dals",RICE FLOUR 500 GM,4,35,28,7,1
27-04-2025,Personal Care & Cosmetics,UVIS CHARCOAL SOAP 100GM,10,170,170,0,2
27-04-2025,Snacks & Ready-to-Eat,BD BARELY NOODLES 200G,14,140,140,0,2
27-04-2025,Oils & Ghee,cow ghee 500 ml,9,430,390,40,1
27-04-2025,Oils & Ghee,Safflower oil 1 L,9,400,400,0,1
27-04-2025,"Grains, Flours & Dals",chana flour 500 gms,4,120,108,12,2
27-04-2025,Milk & Dairy,BROWN EGGS 1P,7,140,120,20,10
27-04-2025,"Grains, Flours & Dals",RICE FLOUR 1KG,4,140,110,30,2
27-04-2025,Sweeteners,ACHUBELLAM 500GM,16,50,40,10,1
27-04-2025,Oils & Ghee,Groundnut oil 1 L,9,660,660,0,2
27-04-2025,"Grains, Flours & Dals",AISHWARYA SP 1KG,4,160,140,20,2
27-04-2025,"Dry Fruits, Nuts & Seeds",Groundnuts 1 kg,2,190,165,25,1
27-04-2025,Snacks & Ready-to-Eat,NAVARATNA MIX,14,60,60,0,1
27-04-2025,Snacks & Ready-to-Eat,RSC ORANGE 100GMS,14,20,20,0,1
27-04-2025,"Grains, Flours & Dals",PESARA PAPPU 1 KG,4,170,145,25,1
27-04-2025,"Dry Fruits, Nuts & Seeds",SD Mango cubes 100gm,2,50,50,0,1
27-04-2025,Sweeteners,PN ORGANIC BROWN SUGAR 500GM,16,78,78,0,1
27-04-2025,Spices & Seasonings,ROYAL SAFFRON 400GRMS,15,130,130,0,2
27-04-2025,"Grains, Flours & Dals",RAGI FLOUR 500GRMS,4,40,35,5,1
27-04-2025,Personal Care & Cosmetics,MYSORE SANDAL BABY SOAP,10,90,90,0,2
27-04-2025,Oils & Ghee,Coconut oil 1 L,9,440,400,40,1
27-04-2025,Snacks & Ready-to-Eat,NGT CHATPATTA CHANA 90GM,14,25,25,0,1
27-04-2025,"Grains, Flours & Dals",Wheat Flour 1 kg,4,140,120,20,2
27-04-2025,Spices & Seasonings,Elaichi 25GM,15,145,120,25,1
27-04-2025,"Grains, Flours & Dals",UNPOLISHED TURDALL 1KG,4,240,210,30,1
27-04-2025,Misc,C123,8,95,80,15,1
27-04-2025,Household & Cleaning,comfort,6,58,58,0,1
27-04-2025,General Household & Kitchenware,SABEENA,3,15,15,0,1
27-04-2025,Snacks & Ready-to-Eat,VD MIXTURE 175 GM,14,60,60,0,1
27-04-2025,Spices & Seasonings,BIRYANI LEAF 10GM,15,30,20,10,1
27-04-2025,Snacks & Ready-to-Eat,BB ROASTED VERMICELLY 500GM,14,70,70,0,1
27-04-2025,"Grains, Flours & Dals",PRO ORG IDLY RAVA 1KG,4,145,145,0,1
27-04-2025,"Grains, Flours & Dals",SH WHITE POHA 500GM,4,56,56,0,1
27-04-2025,"Grains, Flours & Dals",VGR rice 1 kg,4,350,325,25,5
27-04-2025,"Grains, Flours & Dals",BASMATHI RICE 1KG,4,150,135,15,1
27-04-2025,"Dry Fruits, Nuts & Seeds",PULMAKHANA 100 GM,2,180,170,10,1
27-04-2025,Snacks & Ready-to-Eat,VD MURMURA LADDU,14,50,50,0,1
27-04-2025,Sweeteners,ACHUBELLAM 500GM,16,50,40,10,1
27-04-2025,Snacks & Ready-to-Eat,VD MURUKU 175GM,14,60,60,0,1
27-04-2025,Misc,VD00014,8,100,90,10,1
27-04-2025,Oils & Ghee,Sesame oil 1 L,9,560,560,0,1
27-04-2025,"Grains, Flours & Dals",turdal 1kg,4,220,170,50,1
27-04-2025,"Grains, Flours & Dals",turdal 500 gms,4,220,170,50,2
27-04-2025,Milk & Dairy,BROWN EGGS TRAY 30P,7,360,330,30,1
27-04-2025,"Grains, Flours & Dals",CHANA DALL 250GM,4,28,24,4,1
27-04-2025,Milk & Dairy,ID PANEER,7,135,135,0,1
27-04-2025,Milk & Dairy,HERITAGE BUTTERMILK,7,50,50,0,5
27-04-2025,"Grains, Flours & Dals",Green gram 500 gms,4,75,70,5,1
27-04-2025,Milk & Dairy,SANGAM TONED MILK 500ML,7,30,30,0,1
27-04-2025,"Dry Fruits, Nuts & Seeds",Groundnuts 500 gms,2,95,85,10,1
27-04-2025,"Grains, Flours & Dals",white Bobarlu 500 gms,4,40,38,2,1
27-04-2025,"Grains, Flours & Dals",KORRALU (FOXTAIL M) 500GM,4,65,55,10,1
27-04-2025,Snacks & Ready-to-Eat,PEANUT CHILLI,14,60,60,0,12
27-04-2025,Sweeteners,organic jaggery powder,16,198,198,0,2
27-04-2025,"Health, Wellness & Ayurvedic Products",MH Millets Malt 500GM,5,200,190,10,1
27-04-2025,"Grains, Flours & Dals",ANDU KORRALU (Brown top .mlt) 500,4,130,110,20,1
27-04-2025,"Grains, Flours & Dals",turdal 1kg,4,220,170,50,1
27-04-2025,Oils & Ghee,Groundnut oil 1 L,9,330,330,0,1
27-04-2025,"Grains, Flours & Dals",BARLEY SEEDS 250GMS,4,40,35,5,1
27-04-2025,"Grains, Flours & Dals",Arikalu (kodo),4,70,65,5,1
27-04-2025,"Grains, Flours & Dals",SAMALU (Little millet) 500 gms,4,85,65,20,1
27-04-2025,"Grains, Flours & Dals",UNPOLISHED TURDALL 1KG,4,240,210,30,1
27-04-2025,"Grains, Flours & Dals",ANDU KORRALU (Brown top .mlt) 500,4,130,110,20,1
27-04-2025,"Grains, Flours & Dals",SL Idly Rava 1KG,4,65,55,10,1
27-04-2025,Sweeteners,ACHU BELLAM 1KG,16,100,80,20,1
27-04-2025,Sweeteners,SD PALM JAGGERY 500GM,16,200,200,0,1
27-04-2025,"Dry Fruits, Nuts & Seeds",Groundnuts 500 gms,2,190,170,20,2
27-04-2025,"Grains, Flours & Dals",Quinova 500 gms,4,110,100,10,1
27-04-2025,Oils & Ghee,GANTASALA A2 COW GHEE 500ML,9,1100,"1,100.00",0,2
27-04-2025,Personal Care & Cosmetics,APPLE BC POWDER,10,200,200,0,1
27-04-2025,Oils & Ghee,Sesame oil 5 L,9,5900,"5,500.00",400,2
27-04-2025,Milk & Dairy,HERITAGE TONED MILK 500ML,7,31,31,0,1
27-04-2025,Spices & Seasonings,asafoetida,15,85,85,0,1
27-04-2025,Oils & Ghee,Groundnut oil 1 L,9,660,660,0,2
27-04-2025,Oils & Ghee,Sesame oil 5 L,9,2950,"2,750.00",200,1
27-04-2025,Oils & Ghee,Sesame oil 500ml,9,295,280,15,1
27-04-2025,Beverages,BRU GREEN LABEL 1.2G,1,144,144,0,72
27-04-2025,Oils & Ghee,Sesame oil 1 L,9,560,560,0,1
27-04-2025,Snacks & Ready-to-Eat,VD NUVULLU CHIKKI,14,80,80,0,1
27-04-2025,Oils & Ghee,Groundnut oil 1 L,9,330,330,0,1
27-04-2025,"Grains, Flours & Dals",Brown rice 5 kgs,4,350,325,25,1
27-04-2025,Misc,VD0001,8,100,100,0,1
27-04-2025,Oils & Ghee,Groundnut oil 1 L,9,330,330,0,1
27-04-2025,Snacks & Ready-to-Eat,BROWN BREAD,14,55,55,0,1
27-04-2025,"Grains, Flours & Dals",yellow jowar flour 1kg,4,100,92,8,1
27-04-2025,Pooja & Spiritual Items,GOW DURBAR GEETHA CAMPHOR,12,60,60,0,1
27-04-2025,Household & Cleaning,pour home,6,169,169,0,1
27-04-2025,Household & Cleaning,VIM SOAP,6,5,5,0,1
27-04-2025,Spices & Seasonings,JEERA 250 gms,15,125,105,20,1
27-04-2025,Snacks & Ready-to-Eat,GB SALT COOKIES,14,60,55,5,1
27-04-2025,"Dry Fruits, Nuts & Seeds",PULMAKHANA 100 GM,2,180,170,10,1
27-04-2025,Snacks & Ready-to-Eat,JONNA RIBAN,14,60,60,0,1
27-04-2025,"Grains, Flours & Dals",Wheat Flour 1 kg,4,70,60,10,1
27-04-2025,Oils & Ghee,Sesame oil 1 L,9,560,560,0,1
27-04-2025,Oils & Ghee,Safflower oil 1 L,9,400,400,0,1
27-04-2025,"Grains, Flours & Dals",Wheat Flour 1 kg,4,70,60,10,1
27-04-2025,"Dry Fruits, Nuts & Seeds",DRYDATES 250GM,2,150,120,30,1
27-04-2025,Oils & Ghee,Groundnut oil 1 L,9,330,330,0,1
27-04-2025,"Health, Wellness & Ayurvedic Products",j s pnature,5,136,136,0,1
27-04-2025,"Grains, Flours & Dals",AISHWARYA SP 1KG,4,800,700,100,10
27-04-2025,Snacks & Ready-to-Eat,RSC ORANGE 100GMS,14,20,20,0,1
27-04-2025,"Grains, Flours & Dals",Urad dall 1 Kg,4,185,170,15,1
27-04-2025,Snacks & Ready-to-Eat,BB VERMICELLY 500GM,14,53,53,0,1
27-04-2025,"Grains, Flours & Dals",IDLY RAVA 1KG,4,60,50,10,1
27-04-2025,Oils & Ghee,rice bran oil f,9,194,169,25,1
27-04-2025,"Grains, Flours & Dals",MAATEJA rice 1 kg,4,216,207,9,3
27-04-2025,"Dry Fruits, Nuts & Seeds",YB GRANMA NUTS,2,180,180,0,2
27-04-2025,"Grains, Flours & Dals",turdal 1kg,4,220,170,50,1
27-04-2025,"Grains, Flours & Dals",Multigrain 1 kg,4,500,425,75,5
27-04-2025,Oils & Ghee,Sesame oil 1 L,9,560,560,0,1
27-04-2025,Spices & Seasonings,Chilli powder 250 gms,15,145,110,35,1
27-04-2025,Oils & Ghee,Sesame oil 500ml,9,295,280,15,1
27-04-2025,Spices & Seasonings,AVALU 100GM,15,25,20,5,1
27-04-2025,"Grains, Flours & Dals",MULTIMILLET IDLY RAVVA,4,195,195,0,3
27-04-2025,Spices & Seasonings,NUVVULU 500GM,15,200,170,30,1
27-04-2025,"Dry Fruits, Nuts & Seeds",FLAX SEEDS 250GM,2,120,100,20,2
27-04-2025,"Grains, Flours & Dals",DISANO OATS 1KG,4,285,285,0,1
27-04-2025,Oils & Ghee,Coconut oil 500 ml,9,220,200,20,1
27-04-2025,Snacks & Ready-to-Eat,Sprouted Ragi Biscuits 450GM,14,150,150,0,1
27-04-2025,"Grains, Flours & Dals",Green gram 500 gms,4,75,70,5,1
27-04-2025,"Grains, Flours & Dals",AISHWARYA SP 1KG,4,320,280,40,4
27-04-2025,"Grains, Flours & Dals",SL Idly Rava 1KG,4,65,55,10,1
27-04-2025,"Dry Fruits, Nuts & Seeds",SALTED PISTA 250GM,2,400,350,50,1
27-04-2025,Household & Cleaning,SURFEXCEL BAR 80G,6,20,20,0,2
27-04-2025,Oils & Ghee,Safflower oil 500 ml,9,220,200,20,1
27-04-2025,Snacks & Ready-to-Eat,BD RAGI NOODLES,14,75,75,0,1
27-04-2025,Snacks & Ready-to-Eat,VD NUVULU CHEGODI 175GM,14,60,60,0,1
27-04-2025,Snacks & Ready-to-Eat,VD MURMURA LADDU,14,50,50,0,1
27-04-2025,Snacks & Ready-to-Eat,VD PAPPU CHEGODI 200GM,14,60,60,0,1
27-04-2025,Milk & Dairy,BROWN EGGS 1P,7,140,120,20,10
27-04-2025,Oils & Ghee,Sesame oil 1 L,9,560,560,0,1
27-04-2025,Snacks & Ready-to-Eat,NGT CHATPATTA CHANA 90GM,14,50,50,0,2
27-04-2025,Oils & Ghee,Sesame oil 1 L,9,2240,"2,240.00",0,4
27-04-2025,"Grains, Flours & Dals",SA Sprouted Ragi Flour 500GM,4,69,69,0,1
27-04-2025,"Grains, Flours & Dals",RAGI FLOUR 500GRMS,4,40,35,5,1
27-04-2025,Sweeteners,GS Palm Jaggery Powder 400GM,16,180,180,0,1
27-04-2025,Snacks & Ready-to-Eat,GRA IDLY PRE POW 450G,14,95,95,0,1
27-04-2025,"Grains, Flours & Dals",Red Wheat Flour 1 kg,4,140,130,10,1
27-04-2025,Snacks & Ready-to-Eat,VD MINAPA VADIYAM,14,65,65,0,1
27-04-2025,"Grains, Flours & Dals",RAGI FLOUR 1KG,4,80,70,10,1
27-04-2025,"Grains, Flours & Dals",SB Javva Wheat Ravva 500GM,4,95,95,0,1
27-04-2025,"Grains, Flours & Dals",SL Idly Rava 1KG,4,65,55,10,1
27-04-2025,Oils & Ghee,Sesame oil 1 L,9,560,560,0,1
27-04-2025,"Grains, Flours & Dals",RAGI FLOUR 500GRMS,4,40,35,5,1
27-04-2025,Milk & Dairy,BROWN EGGS 1P,7,140,120,20,10
27-04-2025,"Dry Fruits, Nuts & Seeds",Groundnuts 500 gms,2,95,85,10,1
27-04-2025,"Dry Fruits, Nuts & Seeds",BLACK KISMIS 250GM,2,175,140,35,1
27-04-2025,"Dry Fruits, Nuts & Seeds",cashew,2,340,310,30,1
27-04-2025,"Dry Fruits, Nuts & Seeds",DRYDATES 250GM,2,150,120,30,1
27-04-2025,Snacks & Ready-to-Eat,VD KOBARI LADDU,14,80,80,0,1
27-04-2025,"Dry Fruits, Nuts & Seeds",SALTED PISTA 250GM,2,400,350,50,1
27-04-2025,"Grains, Flours & Dals",Multigrain 1 kg,4,100,85,15,1
27-04-2025,"Grains, Flours & Dals",SAMALU (Little millet) 500 gms,4,85,65,20,1
27-04-2025,"Grains, Flours & Dals",UDALU (Barnyard millet) 500 gms,4,70,60,10,1
27-04-2025,"Grains, Flours & Dals",Arikalu (kodo),4,70,65,5,1
27-04-2025,"Grains, Flours & Dals",KORRALU (FOXTAIL M) 500GM,4,65,55,10,1
27-04-2025,Oils & Ghee,BUFFALLO GHEE 500ML,9,410,370,40,1
27-04-2025,Snacks & Ready-to-Eat,RSC ORANGE 100GMS,14,20,20,0,1
27-04-2025,Snacks & Ready-to-Eat,GB SALT COOKIES,14,120,110,10,2
27-04-2025,Snacks & Ready-to-Eat,SATHVI REGIVADA 200GM,14,320,240,80,4
27-04-2025,Spices & Seasonings,Jeera 100GM,15,50,45,5,1
27-04-2025,Personal Care & Cosmetics,MADDI BATH POWDER 400GM,10,150,150,0,1
27-04-2025,Snacks & Ready-to-Eat,GB SALT COOKIES,14,60,55,5,1
27-04-2025,Oils & Ghee,Groundnut oil 5 L,9,1800,"1,600.00",200,1
27-04-2025,Beverages,REFRESH SHARBATH NORMAL,1,199,190,9,1
27-04-2025,Milk & Dairy,BROWN EGGS TRAY 30P,7,360,330,30,1
27-04-2025,Snacks & Ready-to-Eat,VD MURMURA LADDU,14,50,50,0,1
27-04-2025,Oils & Ghee,Coconut oil 500 ml,9,220,200,20,1
27-04-2025,Snacks & Ready-to-Eat,RSC ORANGE 100GMS,14,40,40,0,2
27-04-2025,Snacks & Ready-to-Eat,ANNAPURNA APPALAM,14,70,70,0,2
27-04-2025,Snacks & Ready-to-Eat,VD GUMMADI VADIYAM,14,75,75,0,1
27-04-2025,Spices & Seasonings,Menthulu 250 gms,15,50,45,5,1
27-04-2025,"Grains, Flours & Dals",WHEAT 1 KG,4,120,100,20,2
27-04-2025,Spices & Seasonings,Jeera 100GM,15,50,45,5,1
27-04-2025,"Grains, Flours & Dals",RAGULU 1 KG,4,70,60,10,1
27-04-2025,Milk & Dairy,BROWN EGGS 1P,7,210,180,30,15
27-04-2025,Oils & Ghee,Coconut oil 500 ml,9,220,200,20,1
27-04-2025,Spices & Seasonings,KALONJI SEEDS,15,90,80,10,1
27-04-2025,Milk & Dairy,SANGAM CURD 450GM,7,38,38,0,1
27-04-2025,Milk & Dairy,SANGAM FULL CREAM MILK 500ML,7,38,38,0,1
27-04-2025,"Health, Wellness & Ayurvedic Products",MAX PROTEIN ALMOND BAR,5,80,80,0,1
27-04-2025,"Dry Fruits, Nuts & Seeds",SABJA SEEDS,2,70,70,0,1
27-04-2025,"Health, Wellness & Ayurvedic Products",MXP CHOCO CLASSIC BAR,5,80,80,0,1
27-04-2025,Oils & Ghee,Groundnut oil 1 L,9,330,330,0,1
27-04-2025,Spices & Seasonings,NUVVULU 250GM,15,100,85,15,1
27-04-2025,Spices & Seasonings,pickle chili powder,15,360,330,30,2
27-04-2025,Oils & Ghee,Safflower oil 1 L,9,400,400,0,1
27-04-2025,Oils & Ghee,Sesame oil 1 L,9,1120,"1,120.00",0,2
27-04-2025,"Grains, Flours & Dals",SRILATHA RICE RAVVA 500GM,4,35,35,0,1
27-04-2025,"Grains, Flours & Dals",Multigrain 1 kg,4,100,85,15,1
27-04-2025,"Grains, Flours & Dals",PESARA PAPPU 500GMS,4,85,75,10,1
27-04-2025,Snacks & Ready-to-Eat,NGT CHATPATTA CHANA 90GM,14,25,25,0,1
27-04-2025,"Grains, Flours & Dals",turdal 1kg,4,220,170,50,1
27-04-2025,"Grains, Flours & Dals",Green gram 500 gms,4,75,70,5,1
27-04-2025,"Grains, Flours & Dals",RED RICE 1KG,4,150,120,30,1
27-04-2025,General Household & Kitchenware,SABEENA,3,15,15,0,1
27-04-2025,"Dry Fruits, Nuts & Seeds",SD Mango cubes 100gm,2,50,50,0,1
27-04-2025,Beverages,3ROSES,1,90,90,0,1
27-04-2025,"Grains, Flours & Dals",SL Idly Rava 1KG,4,130,110,20,2
27-04-2025,"Grains, Flours & Dals",Wheat Rava M 500GM,4,33,30,3,1
27-04-2025,Household & Cleaning,VIM SOAP,6,25,25,0,5
27-04-2025,"Grains, Flours & Dals",split black gram 1 kg,4,180,170,10,1
27-04-2025,Snacks & Ready-to-Eat,DINNER PAPAD,14,80,80,0,1
27-04-2025,Spices & Seasonings,DURGA SALT CRYSTAL 1KG,15,25,25,0,1
27-04-2025,Snacks & Ready-to-Eat,PEANUT CHILLI,14,10,10,0,2
27-04-2025,Beverages,BRU GREEN LABEL 1.2G,1,24,24,0,12
27-04-2025,"Dry Fruits, Nuts & Seeds",Groundnuts 1 kg,2,190,165,25,1
27-04-2025,Oils & Ghee,Sesame oil 500ml,9,295,280,15,1
27-04-2025,"Grains, Flours & Dals",maagaani low gi white rice 1kg,4,229,115,114,1
27-04-2025,Spices & Seasonings,SONTI 50GM,15,30,20,10,1
27-04-2025,"Grains, Flours & Dals",RAGULU 1 KG,4,140,120,20,2
27-04-2025,Oils & Ghee,mustard oil 1l,9,440,390,50,1
27-04-2025,Snacks & Ready-to-Eat,VD DAHI MIRCHI(SALTED) 100GM,14,45,45,0,1
27-04-2025,Snacks & Ready-to-Eat,VD GUMMADI VADIYAM,14,150,150,0,2
27-04-2025,Snacks & Ready-to-Eat,VD PALLI LADDU,14,80,80,0,1
27-04-2025,Snacks & Ready-to-Eat,VD MURMURA LADDU,14,50,50,0,1
27-04-2025,Snacks & Ready-to-Eat,VD MULTI CHAKKA,14,110,110,0,1
27-04-2025,Oils & Ghee,Groundnut oil 1 L,9,330,330,0,1
27-04-2025,Snacks & Ready-to-Eat,VD MIXTURE 175 GM,14,60,60,0,1
27-04-2025,"Grains, Flours & Dals",Green gram 500 gms,4,75,70,5,1
27-04-2025,Snacks & Ready-to-Eat,VD VAMUPUSA 175GM,14,60,60,0,1
27-04-2025,"Grains, Flours & Dals",Wheat Flour 1 kg,4,140,120,20,2
27-04-2025,Spices & Seasonings,NUVVULU 250GM,15,80,65,15,1
27-04-2025,Snacks & Ready-to-Eat,VD PAPPU CHEGODI 200GM,14,60,60,0,1
27-04-2025,Snacks & Ready-to-Eat,VD MURUKU 175GM,14,60,60,0,1
27-04-2025,Snacks & Ready-to-Eat,3D PAPAD,14,40,40,0,1
27-04-2025,Snacks & Ready-to-Eat,BB VERMICELLI 1KG,14,95,90,5,1
27-04-2025,Snacks & Ready-to-Eat,ONION MURK,14,60,60,0,1
27-04-2025,"Grains, Flours & Dals",Urad dall 1 Kg,4,185,170,15,1
27-04-2025,"Grains, Flours & Dals",IDLY RAVA 1KG,4,120,100,20,2
27-04-2025,"Grains, Flours & Dals",SABDANA,4,40,35,5,1
27-04-2025,Snacks & Ready-to-Eat,VD PALLI CHIKKI,14,80,80,0,1
27-04-2025,"Dry Fruits, Nuts & Seeds",Groundnuts 1 kg,2,190,165,25,1
27-04-2025,Snacks & Ready-to-Eat,SOYA MURK,14,60,60,0,1
27-04-2025,"Grains, Flours & Dals",SL Suji Rava 500GM,4,32,32,0,1
27-04-2025,"Grains, Flours & Dals",Red Wheat Flour 1 kg,4,140,130,10,1
27-04-2025,"Dry Fruits, Nuts & Seeds",Groundnuts 500 gms,2,95,85,10,1
27-04-2025,Household & Cleaning,vim 500ml,6,125,125,0,1
27-04-2025,Snacks & Ready-to-Eat,SF MILLET VERMICELLII FOXTAIL,14,139,139,0,1
27-04-2025,"Grains, Flours & Dals",MAIDA 1KG,4,70,60,10,1
27-04-2025,"Grains, Flours & Dals",SL Idly Rava 1KG,4,195,165,30,3
27-04-2025,"Grains, Flours & Dals",Green gram 500 gms,4,75,70,5,1
27-04-2025,"Grains, Flours & Dals",RAGI FLOUR 500GRMS,4,40,35,5,1
27-04-2025,"Grains, Flours & Dals",chana flour 500 gms,4,60,54,6,1
27-04-2025,"Grains, Flours & Dals",Wheat Flour 1 kg,4,140,120,20,2
27-04-2025,"Grains, Flours & Dals",RAGI FLOUR 500GRMS,4,80,70,10,2
27-04-2025,Beverages,BISLERI 100ml,1,10,10,0,1
27-04-2025,Snacks & Ready-to-Eat,VD MURMURA LADDU,14,50,50,0,1
27-04-2025,"Grains, Flours & Dals",KORRALU (FOXTAIL M) 1KG,4,150,110,40,1
27-04-2025,"Grains, Flours & Dals",yellow jowar flour 1kg,4,100,92,8,1
27-04-2025,"Grains, Flours & Dals",samalu,4,260,260,0,2
27-04-2025,Spices & Seasonings,THOKA MIRYALU 50GM,15,210,180,30,1
27-04-2025,"Grains, Flours & Dals",Arikadu ( kodo),4,140,130,10,1
27-04-2025,Spices & Seasonings,AVALU 250grms,15,120,80,40,2
27-04-2025,Oils & Ghee,Groundnut oil 1 L,9,330,330,0,1
27-04-2025,Oils & Ghee,mustard oil,9,195,195,0,1
27-04-2025,Milk & Dairy,BROWN EGGS TRAY 30P,7,360,330,30,1
27-04-2025,Snacks & Ready-to-Eat,VD BOONDI 175GM,14,60,60,0,1
26-04-2025,Beverages,REFRESH SHARBATH SUGAR FREE,1,299,285,14,1
26-04-2025,"Health, Wellness & Ayurvedic Products",RB Max Protein Choco Almond bar 50g,5,150,150,0,2
26-04-2025,Snacks & Ready-to-Eat,SATHVI REGIVADA 200GM,14,160,120,40,2
26-04-2025,Snacks & Ready-to-Eat,ELITE ELAICHI RUSK 200GM,14,70,70,0,2
26-04-2025,Snacks & Ready-to-Eat,PEANUT CHIKKI 450GM,14,125,125,0,1
26-04-2025,Snacks & Ready-to-Eat,RAJGIRA PEANUT CHIKKI 450GM,14,125,125,0,1
26-04-2025,"Grains, Flours & Dals",SA YELLOW JOWAR RAVA 500GM,4,95,95,0,1
26-04-2025,General Household & Kitchenware,SPOON 4,3,40,40,0,2
26-04-2025,Snacks & Ready-to-Eat,Popcorn Seeds 250GM,14,45,40,5,1
26-04-2025,Beverages,BRU GREEN LABEL 1.2G,1,10,10,0,5
26-04-2025,Personal Care & Cosmetics,Soapnut 250GM,10,60,45,15,1
26-04-2025,"Grains, Flours & Dals",KORRALU (FOXTAIL M) 500GM,4,65,55,10,1
26-04-2025,Snacks & Ready-to-Eat,VD RICE MURUKU 150GM,14,50,50,0,1
26-04-2025,Spices & Seasonings,PRO ORG TURMERIC POWDER 100G,15,70,70,0,1
26-04-2025,"Grains, Flours & Dals",RED RICE 1KG,4,150,120,30,1
26-04-2025,"Grains, Flours & Dals",SAMALU (Little millet) 500 gms,4,85,65,20,1
26-04-2025,Snacks & Ready-to-Eat,GREEN FRIED BATANA,14,20,20,0,1
26-04-2025,"Grains, Flours & Dals",Sathya Javva Wheat Rava 500GM,4,95,95,0,1
26-04-2025,"Grains, Flours & Dals",HS JOWAR IDLY RAWA,4,65,65,0,1
26-04-2025,"Grains, Flours & Dals",MAAGANI SP LOW GI RICE 1KG,4,249,249,0,1
26-04-2025,"Grains, Flours & Dals",UDALU (Barnyard millet) 1 kg,4,140,115,25,1
26-04-2025,"Grains, Flours & Dals",KORRALU (FOXTAIL M) 1KG,4,150,110,40,1
26-04-2025,"Grains, Flours & Dals",Arikadu ( kodo),4,140,130,10,1
26-04-2025,"Grains, Flours & Dals",Quinova 1 kg,4,220,195,25,1
26-04-2025,Snacks & Ready-to-Eat,VD GUMMADI VADIYAM,14,75,75,0,1
26-04-2025,Snacks & Ready-to-Eat,SOYA MURK,14,60,60,0,1
26-04-2025,Snacks & Ready-to-Eat,VD MIXTURE 175 GM,14,60,60,0,1
26-04-2025,"Dry Fruits, Nuts & Seeds",PUMPKIN SEEDS 250GM,2,200,160,40,1
26-04-2025,Snacks & Ready-to-Eat,VD KOBARI LADDU,14,160,160,0,2
26-04-2025,Oils & Ghee,GANTASALA A2 COW GHEE 500ML,9,550,550,0,1
26-04-2025,"Grains, Flours & Dals",turdal 1kg,4,220,170,50,1
26-04-2025,"Dry Fruits, Nuts & Seeds",Groundnuts 500 gms,2,95,85,10,1
26-04-2025,Snacks & Ready-to-Eat,ANNAPURNA APPALAM,14,70,70,0,2
26-04-2025,Snacks & Ready-to-Eat,SOYA MURK,14,60,60,0,1
26-04-2025,Baking & Cooking Aids,MTR GULAB JAMUN MIX 190GM,0,80,80,0,1
26-04-2025,"Grains, Flours & Dals",HS RAGI IDLY R,4,140,140,0,2
26-04-2025,Personal Care & Cosmetics,COW DURBAR 7 HERBS SHAMPOO,10,125,125,0,1
26-04-2025,"Grains, Flours & Dals",SA WHITE JOWAR RAVA 500GM,4,69,69,0,1
26-04-2025,"Grains, Flours & Dals",Wheat Flour 1 kg,4,140,120,20,2
26-04-2025,"Health, Wellness & Ayurvedic Products",RB Max Protein Fruit &amp;Nut 50g,5,80,80,0,1
26-04-2025,Spices & Seasonings,Jeera 100GM,15,50,45,5,1
26-04-2025,"Grains, Flours & Dals",Wheat Rava S 1KG,4,65,55,10,1
26-04-2025,Spices & Seasonings,DRY MIECHI 200GM,15,80,60,20,1
26-04-2025,"Grains, Flours & Dals",SL Suji Rava 500GM,4,32,32,0,1
26-04-2025,"Grains, Flours & Dals",IDLY RAVA 1KG,4,60,50,10,1
26-04-2025,"Grains, Flours & Dals",FLOUR CHARGE,4,24,24,0,2
26-04-2025,"Grains, Flours & Dals",RED WHEAT 1 KG,4,130,120,10,1
26-04-2025,"Grains, Flours & Dals",BARLEY SEEDS 1KG,4,16,14,2,0.1
26-04-2025,Snacks & Ready-to-Eat,VD Pappu Chekkalu 190gm,14,120,120,0,2
26-04-2025,Snacks & Ready-to-Eat,VD PALLI LADDU,14,80,80,0,1
26-04-2025,Snacks & Ready-to-Eat,SALTED PHALLI,14,65,65,0,1
26-04-2025,Snacks & Ready-to-Eat,VD PAPPU CHEGODI 200GM,14,60,60,0,1
26-04-2025,Misc,VD00014,8,100,90,10,1
26-04-2025,Snacks & Ready-to-Eat,VD MURUKU 175GM,14,60,60,0,1
26-04-2025,Pooja & Spiritual Items,VRP APOORVA JAVADHU POW,12,180,180,0,6
26-04-2025,Snacks & Ready-to-Eat,SS IDLY BATTER 1KG,14,60,60,0,1
26-04-2025,Spices & Seasonings,SD Redgram Karam Powder 100GM,15,65,65,0,1
26-04-2025,Snacks & Ready-to-Eat,DOSA BATTER 1KG,14,60,60,0,1
26-04-2025,Spices & Seasonings,GS KARVEPAKU KARAM,15,75,75,0,1
26-04-2025,Snacks & Ready-to-Eat,RAJGIRA PEANUT CHIKKI 450GM,14,125,125,0,1
26-04-2025,"Grains, Flours & Dals",KORRALU (FOXTAIL M) 1KG,4,300,220,80,2
26-04-2025,Snacks & Ready-to-Eat,VD MURMURA LADDU,14,50,50,0,1
26-04-2025,"Grains, Flours & Dals",Sathya Javva Wheat Rava 500GM,4,95,95,0,1
26-04-2025,"Grains, Flours & Dals",UNPOLISHED TURDALL 1KG,4,240,210,30,1
26-04-2025,"Grains, Flours & Dals",Wheat Rava S 1KG,4,65,55,10,1
26-04-2025,Sweeteners,YB N FOREST HONEY 700 GM,16,400,400,0,1
26-04-2025,Snacks & Ready-to-Eat,SD Moringa with plam jaggery 250gm,14,135,135,0,1
26-04-2025,Snacks & Ready-to-Eat,RAJGIRA PEANUT CHIKKI 450GM,14,125,125,0,1
26-04-2025,"Grains, Flours & Dals",White jowar.F 1 kg,4,200,160,40,2
26-04-2025,Snacks & Ready-to-Eat,VD GUMMADI VADIYAM,14,75,75,0,1
26-04-2025,"Dry Fruits, Nuts & Seeds",cashew,2,340,310,30,1
26-04-2025,Milk & Dairy,ID PANEER,7,270,270,0,2
26-04-2025,"Grains, Flours & Dals",SRILATHA RICE RAVVA 500GM,4,35,35,0,1
26-04-2025,"Dry Fruits, Nuts & Seeds",Putnalu 250GM,2,45,38,7,1
26-04-2025,"Grains, Flours & Dals",FLOUR CHARGE,4,31.2,31.2,0,2.6
26-04-2025,Baking & Cooking Aids,MTR GULAB JAMUN MIX 190GM,0,80,80,0,1
26-04-2025,Spices & Seasonings,Coriander seeds 200 gms,15,48,40,8,1
26-04-2025,General Household & Kitchenware,SPOON 4,3,16,16,0,1
26-04-2025,Snacks & Ready-to-Eat,MIGHTY PUFFS TOMATO,14,50,50,0,2
26-04-2025,"Dry Fruits, Nuts & Seeds",SABJA SEEDS,2,70,70,0,1
26-04-2025,Spices & Seasonings,JEERA 250 gms,15,125,105,20,1
26-04-2025,"Health, Wellness & Ayurvedic Products",KONDAPINDI CHOORNAM,5,100,100,0,1
26-04-2025,Spices & Seasonings,menthulu,15,90,90,0,1
26-04-2025,"Health, Wellness & Ayurvedic Products",MD Bringaraj Choornam 100GM,5,80,80,0,1
26-04-2025,"Grains, Flours & Dals",PRO ORG MEDIUM POHA 500G,4,78,78,0,1
26-04-2025,Oils & Ghee,Coconut oil 1 L,9,440,400,40,1
26-04-2025,Oils & Ghee,Safflower oil 1 L,9,400,400,0,1
26-04-2025,Spices & Seasonings,KALONJI SEEDS,15,90,80,10,1
26-04-2025,Snacks & Ready-to-Eat,NGT CHATPATTA CHANA 90GM,14,60,60,0,3
26-04-2025,Snacks & Ready-to-Eat,NGT CHATPATTA CHANA 90GM,14,25,25,0,1
26-04-2025,Snacks & Ready-to-Eat,VD MURUKU 175GM,14,60,60,0,1
26-04-2025,Snacks & Ready-to-Eat,RAGI GAVVALU,14,60,60,0,1
26-04-2025,Snacks & Ready-to-Eat,VD MIXTURE 175 GM,14,120,120,0,2
26-04-2025,Oils & Ghee,Groundnut oil 1 L,9,330,330,0,1
26-04-2025,"Dry Fruits, Nuts & Seeds",Groundnuts 1 kg,2,190,165,25,1
26-04-2025,"Grains, Flours & Dals",IDLY RAVA 1KG,4,60,50,10,1
26-04-2025,"Grains, Flours & Dals",White jowar.F 1 kg,4,100,80,20,1
26-04-2025,Sweeteners,MISHRI 250 GM,16,35,30,5,1
26-04-2025,"Grains, Flours & Dals",FLOUR CHARGE,4,39.6,39.6,0,3.3
26-04-2025,"Health, Wellness & Ayurvedic Products",SHIKAKAI CHOORNAM,5,80,80,0,1
26-04-2025,"Grains, Flours & Dals",MELMEKER 250GMS,4,60,45,15,1
26-04-2025,"Grains, Flours & Dals",VGR RICE 5 KGS,4,350,325,25,1
26-04-2025,"Grains, Flours & Dals",RICE FLOUR 1KG,4,70,55,15,1
26-04-2025,"Grains, Flours & Dals",Green gram 500 gms,4,75,70,5,1
26-04-2025,"Grains, Flours & Dals",Wheat Flour 1 kg,4,70,60,10,1
26-04-2025,"Grains, Flours & Dals",RED TURDAL 500GM,4,75,70,5,1
26-04-2025,"Grains, Flours & Dals",MELMEKER 250GMS,4,60,45,15,1
26-04-2025,"Grains, Flours & Dals",SPLIT BLACK GRAM 500 GM,4,90,85,5,1
26-04-2025,Snacks & Ready-to-Eat,3D PAPAD,14,40,40,0,1
26-04-2025,Oils & Ghee,Groundnut oil 1 L,9,330,330,0,1
26-04-2025,"Dry Fruits, Nuts & Seeds",SATHVI CHIA SEEDS 100GM,2,100,80,20,1
26-04-2025,"Grains, Flours & Dals",Multigrain 1 kg,4,100,85,15,1
26-04-2025,"Grains, Flours & Dals",UDALU (Barnyard millet) 500 gms,4,70,60,10,1
26-04-2025,"Grains, Flours & Dals",SAMALU (Little millet) 500 gms,4,85,65,20,1
26-04-2025,"Grains, Flours & Dals",Arikalu (kodo),4,70,65,5,1
26-04-2025,"Grains, Flours & Dals",KORRALU (FOXTAIL M) 500GM,4,65,55,10,1
26-04-2025,Sweeteners,COCONUT SUGAR,16,299,284,15,1
26-04-2025,Personal Care & Cosmetics,GOW DURBAR NAVA 100GM SOAP,10,80,80,0,2
26-04-2025,Oils & Ghee,Groundnut oil 1 L,9,330,330,0,1
26-04-2025,Oils & Ghee,Sesame oil 1 L,9,560,560,0,1
26-04-2025,"Grains, Flours & Dals",Wheat Flour 1 kg,4,140,120,20,2
26-04-2025,Snacks & Ready-to-Eat,Corn Chips 250GM,14,40,35,5,1
26-04-2025,"Dry Fruits, Nuts & Seeds",FLAX SEEDS 250GM,2,60,50,10,1
26-04-2025,"Dry Fruits, Nuts & Seeds",PUMPKIN SEEDS 250GM,2,200,160,40,1
26-04-2025,"Grains, Flours & Dals",Wheat Flour 1 kg,4,210,180,30,3
26-04-2025,"Grains, Flours & Dals",Multigrain 1 kg,4,100,85,15,1
26-04-2025,Sweeteners,YB N FOREST HONEY 700 GM,16,400,400,0,1
26-04-2025,Oils & Ghee,Coconut oil 1 L,9,440,400,40,1
26-04-2025,Oils & Ghee,Groundnut oil 1 L,9,330,330,0,1
26-04-2025,"Grains, Flours & Dals",MAAGAANI LOW GI SP L 1KG,4,600,525,75,5
26-04-2025,"Grains, Flours & Dals",VGR RICE 5 KGS,4,350,325,25,1
26-04-2025,"Grains, Flours & Dals",Chittimuthaylu rice 1 kg,4,160,140,20,1
26-04-2025,"Grains, Flours & Dals",BASMATHI RICE 1KG,4,150,135,15,1
26-04-2025,"Grains, Flours & Dals",maida 500grms,4,35,30,5,1
26-04-2025,"Grains, Flours & Dals",IDLY RAVA 1KG,4,60,50,10,1
26-04-2025,Snacks & Ready-to-Eat,BD RED RICE NOODLES 200G,14,70,70,0,1
26-04-2025,"Grains, Flours & Dals",BOMBAY RAVA,4,70,55,15,1
26-04-2025,"Grains, Flours & Dals",Multigrain 1 kg,4,100,85,15,1
26-04-2025,Snacks & Ready-to-Eat,VD DRY FRUIT PUTHAREKULU,14,150,150,0,1
26-04-2025,"Grains, Flours & Dals",Wheat Rava M 500GM,4,33,30,3,1
26-04-2025,"Grains, Flours & Dals",SH RED POHA 500GM,4,85,85,0,1
26-04-2025,"Grains, Flours & Dals",RAGI FLOUR 1KG,4,80,70,10,1
26-04-2025,"Grains, Flours & Dals",KORRALU (FOXTAIL M) 1KG,4,600,440,160,4
26-04-2025,"Grains, Flours & Dals",RAJMA 250GM,4,55,45,10,1
26-04-2025,Misc,C123,8,95,80,15,1
26-04-2025,"Grains, Flours & Dals",Green Batani 250GM,4,55,45,10,1
26-04-2025,"Grains, Flours & Dals",Red Chana 250GM,4,35,30,5,1
26-04-2025,"Grains, Flours & Dals",white Bobarlu 500 gms,4,80,75,5,1
26-04-2025,"Grains, Flours & Dals",JOWAR UPMA RAVA,4,75,75,0,1
26-04-2025,Oils & Ghee,Sesame oil 1 L,9,560,560,0,1
26-04-2025,Oils & Ghee,GANTASALA A2 COW GHEE 250ML,9,299,299,0,1
26-04-2025,Snacks & Ready-to-Eat,VD NUVULLU CHIKKI,14,80,80,0,1
26-04-2025,"Grains, Flours & Dals",Wheat Flour 1 kg,4,70,60,10,1
26-04-2025,"Grains, Flours & Dals",Bajra Flour 1 kg,4,70,60,10,1
26-04-2025,"Grains, Flours & Dals",HS JOWAR FLAKES 250GM 1+1,4,119,59.5,59.5,1
26-04-2025,Spices & Seasonings,pickle chili powder,15,180,165,15,1
26-04-2025,"Grains, Flours & Dals",Wheat Flour 1 kg,4,140,120,20,2
26-04-2025,Snacks & Ready-to-Eat,PEANUT CHILLI,14,100,100,0,20
26-04-2025,Snacks & Ready-to-Eat,VD MURMURA LADDU,14,50,50,0,1
26-04-2025,Snacks & Ready-to-Eat,VD CORNFLAKES MIXTURE 175GM,14,60,60,0,1
26-04-2025,Snacks & Ready-to-Eat,VD MURUKU 175GM,14,60,60,0,1
26-04-2025,Oils & Ghee,cow ghee 500 ml,9,430,390,40,1
26-04-2025,"Grains, Flours & Dals",HS JOWAR IDLY RAWA,4,65,65,0,1
26-04-2025,"Grains, Flours & Dals",Urad dall 500 gms,4,95,85,10,1
26-04-2025,"Grains, Flours & Dals",HS JOWAR FLAKES 250GM 1+1,4,119,119,0,1
26-04-2025,Sweeteners,organic jaggery powder,16,99,99,0,1
26-04-2025,"Grains, Flours & Dals",MELMEKER 250GMS,4,60,45,15,1
26-04-2025,Spices & Seasonings,Tamarind 500GM,15,160,130,30,1
26-04-2025,"Dry Fruits, Nuts & Seeds",Groundnuts 500 gms,2,95,85,10,1
26-04-2025,"Dry Fruits, Nuts & Seeds",PULMAKHANA 100 GM,2,180,170,10,1
26-04-2025,Spices & Seasonings,Masala Karam 250 gms,15,130,120,10,1
26-04-2025,Spices & Seasonings,Menthulu 250 gms,15,50,45,5,1
26-04-2025,"Grains, Flours & Dals",BOMBAY RAVA,4,70,55,15,1
26-04-2025,"Grains, Flours & Dals",CHANA DALL 250GM,4,28,24,4,1
26-04-2025,"Dry Fruits, Nuts & Seeds",cashew,2,340,310,30,1
26-04-2025,Snacks & Ready-to-Eat,SAGOPAPAD RED CHILLI VD,14,55,55,0,1
26-04-2025,Oils & Ghee,Groundnut oil 1 L,9,660,660,0,2
26-04-2025,"Grains, Flours & Dals",Arikalu (kodo),4,70,65,5,1
26-04-2025,"Grains, Flours & Dals",KORRALU (FOXTAIL M) 500GM,4,65,55,10,1
26-04-2025,"Grains, Flours & Dals",Multigrain 1 kg,4,100,85,15,1
26-04-2025,"Grains, Flours & Dals",ANDU KORRALU (Brown top .mlt) 500,4,130,110,20,1
26-04-2025,"Grains, Flours & Dals",SAMALU (Little millet) 500 gms,4,85,65,20,1
26-04-2025,"Grains, Flours & Dals",Wheat Flour 1 kg,4,70,60,10,1
26-04-2025,"Grains, Flours & Dals",ANDU KORRALU (Brown top .mlt) 500,4,130,110,20,1
26-04-2025,"Grains, Flours & Dals",SAMALU (Little millet) 500 gms,4,85,65,20,1
26-04-2025,"Grains, Flours & Dals",Multigrain 1 kg,4,100,85,15,1
26-04-2025,"Grains, Flours & Dals",Wheat Flour 1 kg,4,70,60,10,1
26-04-2025,Oils & Ghee,Groundnut oil 1 L,9,660,660,0,2
26-04-2025,"Grains, Flours & Dals",Arikalu (kodo),4,70,65,5,1
26-04-2025,"Grains, Flours & Dals",KORRALU (FOXTAIL M) 500GM,4,7085,"5,995.00","1,090.00",109
26-04-2025,Spices & Seasonings,Menthulu 250 gms,15,50,45,5,1
26-04-2025,"Grains, Flours & Dals",CHANA DAL 500GM,4,56,48,8,1
26-04-2025,Spices & Seasonings,Coriander seeds 200 gms,15,48,40,8,1
26-04-2025,"Grains, Flours & Dals",Urad dall 1 Kg,4,370,340,30,2
26-04-2025,Spices & Seasonings,MIRYALU 50 GRMS,15,100,80,20,1
26-04-2025,"Grains, Flours & Dals",Wheat Flour 1 kg,4,140,120,20,2
26-04-2025,Snacks & Ready-to-Eat,sannakarampusa,14,120,120,0,2
26-04-2025,"Grains, Flours & Dals",RAGULU 1 KG,4,140,120,20,2
26-04-2025,Spices & Seasonings,DURGA SALT CRYSTAL 1KG,15,275,275,0,11
26-04-2025,Snacks & Ready-to-Eat,VD BOONDI 175GM,14,180,180,0,3
26-04-2025,"Grains, Flours & Dals",AISHWARYA SP 1KG,4,400,350,50,5
26-04-2025,Oils & Ghee,Groundnut oil 1 L,9,1320,"1,320.00",0,4
26-04-2025,"Grains, Flours & Dals",RAGULU 1 KG,4,70,60,10,1
26-04-2025,"Grains, Flours & Dals",Wheat Flour 1 kg,4,140,120,20,2
26-04-2025,Oils & Ghee,Coconut oil 500 ml,9,220,200,20,1
26-04-2025,Misc,8906020581302,8,70,70,0,1
26-04-2025,"Grains, Flours & Dals",CHANA DALL 250GM,4,28,24,4,1
26-04-2025,"Grains, Flours & Dals",YELLOW JOWER 1KG,4,90,80,10,1
26-04-2025,Pooja & Spiritual Items,GB Bharatha Woods 75GM,12,120,120,0,2
26-04-2025,Sweeteners,GS Palm Jaggery Powder 400GM,16,180,180,0,1
26-04-2025,Spices & Seasonings,Jeera 100GM,15,50,45,5,1
26-04-2025,Spices & Seasonings,PRO ORG CORIANDER WHOLE 100G,15,70,70,0,1
26-04-2025,Oils & Ghee,Safflower oil 5 L,9,2200,"1,950.00",250,1
26-04-2025,Milk & Dairy,BROWN EGGS TRAY 30P,7,720,660,60,2
26-04-2025,Oils & Ghee,Groundnut oil 1 L,9,660,660,0,2
26-04-2025,Milk & Dairy,BROWN EGGS TRAY 30P,7,360,330,30,1
26-04-2025,"Grains, Flours & Dals",JOWAR UPMA RAVA,4,260,260,0,4
26-04-2025,"Grains, Flours & Dals",HS JOWAR IDLY RAWA,4,260,260,0,4
26-04-2025,"Grains, Flours & Dals",Multigrain 1 kg,4,100,85,15,1
26-04-2025,Snacks & Ready-to-Eat,SD Vamu with palm jaggery 250gm,14,135,135,0,1
26-04-2025,Sweeteners,SD PALM JAGGERY 500GM,16,200,200,0,1
26-04-2025,"Grains, Flours & Dals",UDALU (Barnyard millet) 1 kg,4,280,230,50,2
26-04-2025,Milk & Dairy,BROWN EGGS TRAY 30P,7,360,330,30,1
26-04-2025,Snacks & Ready-to-Eat,SD Aswagandha with palm Jaggery250Gm,14,135,135,0,1
26-04-2025,Sweeteners,YB JAGGERY POWDER 1KG,16,140,140,0,1
26-04-2025,"Grains, Flours & Dals",MAAGAANI SP RICE 20 KGS,4,2300,"1,960.00",340,1
26-04-2025,"Grains, Flours & Dals",samalu,4,260,260,0,2
26-04-2025,"Grains, Flours & Dals",DOCTOR RICE DIABETIC SFR 1KG,4,1200,"1,200.00",0,10
26-04-2025,Snacks & Ready-to-Eat,BB ROASTED VERMICELLY 500GM,14,70,70,0,1
26-04-2025,"Grains, Flours & Dals",EM Ragi upma R 500g,4,75,75,0,1
26-04-2025,"Grains, Flours & Dals",AISHWARAYA IDLY RAVA 1KG,4,198,132,66,2
26-04-2025,"Grains, Flours & Dals",AISHWARYA SP 1KG,4,800,700,100,10
26-04-2025,"Grains, Flours & Dals",Multigrain 1 kg,4,200,170,30,2
26-04-2025,"Grains, Flours & Dals",Wheat Flour 1 kg,4,210,180,30,3
26-04-2025,Snacks & Ready-to-Eat,VD MURUKU 175GM,14,60,60,0,1
26-04-2025,Snacks & Ready-to-Eat,SOYA MURK,14,60,60,0,1
26-04-2025,Snacks & Ready-to-Eat,ONION MURK,14,60,60,0,1
26-04-2025,Spices & Seasonings,Tamalapaku Karam Powder 100GM,15,80,80,0,1
26-04-2025,Snacks & Ready-to-Eat,GANTASALA FLAX SEEDS SPICY,14,80,80,0,1
26-04-2025,Snacks & Ready-to-Eat,SAGOPAPAD GREEN CHILLI VD,14,55,55,0,1
26-04-2025,"Health, Wellness & Ayurvedic Products",MD Triphala Chorrnam 100GM,5,80,80,0,1
26-04-2025,Sweeteners,MISHRI 250 GM,16,35,30,5,1
26-04-2025,"Grains, Flours & Dals",THIN POHA 500GM,4,40,35,5,1
26-04-2025,"Grains, Flours & Dals",Quinova 500 gms,4,110,100,10,1
26-04-2025,Snacks & Ready-to-Eat,VD MINAPA VADIYAM,14,65,65,0,1
26-04-2025,Snacks & Ready-to-Eat,RITEBITE MELTING CHOCOLATE,14,50,50,0,1
26-04-2025,Milk & Dairy,BROWN EGGS 1P,7,84,72,12,6
26-04-2025,Milk & Dairy,SANGAM FULL CREAM MILK 500ML,7,39,39,0,1
26-04-2025,"Grains, Flours & Dals",THICK POHA 500GM,4,40,35,5,1
26-04-2025,Milk & Dairy,SANGAM CURD 450GM,7,40,40,0,1
26-04-2025,"Grains, Flours & Dals",VGR rice 1 kg,4,210,195,15,3
26-04-2025,"Grains, Flours & Dals",maagaani low gi white rice 1kg,4,458,230,228,2
26-04-2025,Milk & Dairy,SANGAM TONED MILK 500ML,7,62,62,0,2
26-04-2025,Spices & Seasonings,AVALU 100GM,15,25,20,5,1
26-04-2025,Milk & Dairy,SANGAM FULL CREAM MILK 500ML,7,39,39,0,1
26-04-2025,"Grains, Flours & Dals",SPLIT URAD DAL,4,45,40,5,1
26-04-2025,Spices & Seasonings,NUVVULU 250GM,15,80,65,15,1
26-04-2025,"Grains, Flours & Dals",Brown RICE 1KG,4,70,65,5,1
26-04-2025,Snacks & Ready-to-Eat,ONION MURK,14,60,60,0,1
26-04-2025,Snacks & Ready-to-Eat,VD BELLAM GAVVALU 200GM,14,60,60,0,1
26-04-2025,Snacks & Ready-to-Eat,VD KOBARI LADDU,14,80,80,0,1
26-04-2025,General Household & Kitchenware,LASER STAINLESS 50N,3,120,120,0,1
26-04-2025,Snacks & Ready-to-Eat,BELLAM MINAPA SUNADULLU,14,180,180,0,1
26-04-2025,Snacks & Ready-to-Eat,VD MURUKU 175GM,14,60,60,0,1
26-04-2025,"Grains, Flours & Dals",SRILATHA RICE RAVVA 500GM,4,35,35,0,1
26-04-2025,"Grains, Flours & Dals",BOMBAY RAVA,4,70,55,15,1
26-04-2025,"Grains, Flours & Dals",JOWAR UPMA RAVA,4,75,75,0,1
26-04-2025,"Grains, Flours & Dals",AISHWARYA SP 1KG,4,800,700,100,10
25-04-2025,"Grains, Flours & Dals",BAJRA 1 KG,4,30,25,5,0.5
25-04-2025,"Grains, Flours & Dals",Green Batani 250GM,4,55,45,10,1
25-04-2025,"Grains, Flours & Dals",SL Suji Rava 500GM,4,32,32,0,1
25-04-2025,"Grains, Flours & Dals",KORRALU (FOXTAIL M) 500GM,4,65,55,10,1
25-04-2025,"Grains, Flours & Dals",Arikalu (kodo),4,70,65,5,1
25-04-2025,"Grains, Flours & Dals",ANDU KORRALU (Brown top .mlt) 500,4,130,110,20,1
25-04-2025,"Grains, Flours & Dals",RAGULU 1 KG,4,140,120,20,2
25-04-2025,"Grains, Flours & Dals",Wheat Flour 1 kg,4,70,60,10,1
25-04-2025,"Grains, Flours & Dals",SAMALU (Little millet) 500 gms,4,85,65,20,1
25-04-2025,"Grains, Flours & Dals",PESARA PAPPU 500GMS,4,85,75,10,1
25-04-2025,Sweeteners,sugar 500 gms,16,30,28,2,1
25-04-2025,"Grains, Flours & Dals",SOYA BEANS 1KG,4,50,45,5,0.25
25-04-2025,"Dry Fruits, Nuts & Seeds",SD Mango cubes 100gm,2,45,45,0,1
25-04-2025,"Grains, Flours & Dals",Sathya Javva Wheat Rava 500GM,4,95,95,0,1
25-04-2025,Snacks & Ready-to-Eat,VD MURUKU 175GM,14,120,120,0,2
25-04-2025,Sweeteners,YB N FOREST HONEY 700 GM,16,400,400,0,1
25-04-2025,Snacks & Ready-to-Eat,VD VAMUPUSA 175GM,14,60,60,0,1
25-04-2025,Oils & Ghee,Coconut oil 1 L,9,440,400,40,1
25-04-2025,"Grains, Flours & Dals",split greengram,4,140,140,0,1
25-04-2025,Oils & Ghee,Groundnut oil 1 L,9,660,660,0,2
25-04-2025,Spices & Seasonings,MUSTARD POWDR 500G,15,260,220,40,2
25-04-2025,Spices & Seasonings,TATA SALT 1KG,15,30,30,0,1
25-04-2025,Spices & Seasonings,pickles chilli powder 500GM,15,0,0,0,2
25-04-2025,Snacks & Ready-to-Eat,MIGHTY PUFF,14,25,25,0,1
25-04-2025,Beverages,BRU GREEN LABEL 1.2G,1,48,48,0,24
25-04-2025,Spices & Seasonings,SONTI 50GM,15,30,20,10,1
25-04-2025,"Dry Fruits, Nuts & Seeds",SABJA SEEDS,2,70,70,0,1
25-04-2025,General Household & Kitchenware,B3 BOWL,3,310,294.5,15.5,1
25-04-2025,Spices & Seasonings,AVALU 100GM,15,25,20,5,1
25-04-2025,General Household & Kitchenware,VERMI COMPOST MIX,3,30,30,0,1
25-04-2025,Snacks & Ready-to-Eat,VD PALLI CHIKKI,14,80,80,0,1
25-04-2025,Sweeteners,mishri 500g,16,70,60,10,1
25-04-2025,Pooja & Spiritual Items,JAGI KAYA 25GM,12,80,60,20,1
25-04-2025,"Grains, Flours & Dals",VGR rice 1 kg,4,140,130,10,2
25-04-2025,Spices & Seasonings,Turmeric powder 250 gms,15,100,75,25,1
25-04-2025,"Grains, Flours & Dals",Wheat Flour 1 kg,4,70,60,10,1
25-04-2025,Snacks & Ready-to-Eat,VD MURUKU 175GM,14,60,60,0,1
25-04-2025,Spices & Seasonings,NUVVULU 250GM,15,80,65,15,1
25-04-2025,Oils & Ghee,Coconut oil 1 L,9,440,400,40,1
25-04-2025,Oils & Ghee,Groundnut oil 1 L,9,330,330,0,1
25-04-2025,Sweeteners,ACHUBELLAM 500GM,16,50,40,10,1
25-04-2025,Sweeteners,SD PALM JAGGERY 500GM,16,200,200,0,1
25-04-2025,Spices & Seasonings,Masala Karam 250 gms,15,130,120,10,1
25-04-2025,Spices & Seasonings,Chilli powder 250 gms,15,145,110,35,1
25-04-2025,Oils & Ghee,Coconut oil 1 L,9,440,400,40,1
25-04-2025,"Grains, Flours & Dals",chana flour 500 gms,4,60,54,6,1
25-04-2025,"Grains, Flours & Dals",Wheat Flour 1 kg,4,140,120,20,2
25-04-2025,"Dry Fruits, Nuts & Seeds",KAJU HALF 250GM,2,310,290,20,1
25-04-2025,"Dry Fruits, Nuts & Seeds",Groundnuts 1 kg,2,190,165,25,1
25-04-2025,Snacks & Ready-to-Eat,BATANA NGT 70GMS,14,20,20,0,1
25-04-2025,Snacks & Ready-to-Eat,GREEN FRIED BATANA,14,20,20,0,1
25-04-2025,"Grains, Flours & Dals",RAGI FLOUR 500GRMS,4,40,35,5,1
25-04-2025,Snacks & Ready-to-Eat,CHOCO BROWINE,14,20,20,0,1
25-04-2025,"Grains, Flours & Dals",unpolished turdall500grms,4,120,110,10,1
25-04-2025,Spices & Seasonings,Black Till 250GM,15,90,75,15,1
25-04-2025,Oils & Ghee,Sesame oil 500ml,9,295,280,15,1
25-04-2025,Misc,C123,8,95,80,15,1
25-04-2025,Snacks & Ready-to-Eat,MIGHTY PUFF,14,25,25,0,1
25-04-2025,Spices & Seasonings,Black Till 250GM,15,90,75,15,1
25-04-2025,"Grains, Flours & Dals",Red Chana 500 GM,4,75,60,15,1
25-04-2025,"Grains, Flours & Dals",PRO ORG MEDIUM POHA 500G,4,78,78,0,1
25-04-2025,"Dry Fruits, Nuts & Seeds",PUMPKIN SEEDS 250GM,2,200,160,40,1
25-04-2025,Pooja & Spiritual Items,VRP APOORVA JAVADHU POW,12,35,35,0,1
25-04-2025,Sweeteners,YB JAGGERY POWDER 500GMS,16,75,75,0,1
25-04-2025,"Grains, Flours & Dals",RAGI FLOUR 1KG,4,160,140,20,2
25-04-2025,"Grains, Flours & Dals",White jowar.F 1 kg,4,100,80,20,1
25-04-2025,Milk & Dairy,BROWN EGGS 1P,7,210,180,30,15
25-04-2025,Pooja & Spiritual Items,SWASTIK CAMPHOR 25GM,12,45,45,0,1
25-04-2025,Pooja & Spiritual Items,PACHAKARPURAM,12,60,50,10,1
25-04-2025,"Grains, Flours & Dals",VGR rice 1 kg,4,210,195,15,3
25-04-2025,"Grains, Flours & Dals",IDLY RAVA 1KG,4,60,50,10,1
25-04-2025,Milk & Dairy,HERITAGE TONED MILK 500ML,7,31,31,0,1
25-04-2025,Snacks & Ready-to-Eat,DOSA BATTER 1KG,14,60,60,0,1
25-04-2025,Snacks & Ready-to-Eat,SF MILLET NOODLES MILD MASALA 192GM,14,129,129,0,1
25-04-2025,Milk & Dairy,BROWN EGGS 1P,7,14,12,2,1
25-04-2025,Milk & Dairy,BROWN EGGS TRAY 30P,7,360,330,30,1
25-04-2025,"Grains, Flours & Dals",KORRALU (FOXTAIL M) 1KG,4,150,110,40,1
25-04-2025,"Grains, Flours & Dals",samalu,4,130,130,0,1
25-04-2025,"Grains, Flours & Dals",White jowar.F 1 kg,4,300,240,60,3
25-04-2025,Milk & Dairy,SANGAM TONED MILK 500ML,7,30,30,0,1
25-04-2025,Snacks & Ready-to-Eat,VD MURMURA LADDU,14,50,50,0,1
25-04-2025,Personal Care & Cosmetics,KHADI ALOEVERA SHAMPOO,10,199,199,0,1
25-04-2025,Beverages,BISLERI 100ml,1,10,10,0,1
25-04-2025,Snacks & Ready-to-Eat,SALTED PHALLI,14,65,65,0,1
25-04-2025,"Grains, Flours & Dals",Urad dall 500 gms,4,95,85,10,1
25-04-2025,Snacks & Ready-to-Eat,JONNA RIBAN,14,60,60,0,1
25-04-2025,"Dry Fruits, Nuts & Seeds",Groundnuts 500 gms,2,95,85,10,1
25-04-2025,Snacks & Ready-to-Eat,VD PALLI CHIKKI,14,80,80,0,1
25-04-2025,Snacks & Ready-to-Eat,VD MIXTURE 175 GM,14,60,60,0,1
25-04-2025,Oils & Ghee,Groundnut oil 1 L,9,660,660,0,2
25-04-2025,Oils & Ghee,Groundnut oil 5 L,9,1800,"1,600.00",200,1
25-04-2025,Oils & Ghee,Groundnut oil 500ml,9,180,165,15,1
25-04-2025,"Health, Wellness & Ayurvedic Products",VAMU WATER,5,99,99,0,1
25-04-2025,"Grains, Flours & Dals",MAATEJA rice 10 kgs,4,720,690,30,1
25-04-2025,Snacks & Ready-to-Eat,VD SAGOPAPAD 150GM,14,55,55,0,1
25-04-2025,"Grains, Flours & Dals",Wheat Flour 1 kg,4,70,60,10,1
25-04-2025,Spices & Seasonings,Tamarind 250GMS,15,80,65,15,1
25-04-2025,"Grains, Flours & Dals",Wheat Rava M 500GM,4,33,30,3,1
25-04-2025,Oils & Ghee,Groundnut oil 1 L,9,330,330,0,1
25-04-2025,Spices & Seasonings,DURGA SALT CRYSTAL 1KG,15,25,25,0,1
25-04-2025,"Grains, Flours & Dals",Wheat Flour 1 kg,4,140,120,20,2
25-04-2025,Sweeteners,YB JAGGERY POWDER 500GMS,16,75,75,0,1
25-04-2025,Snacks & Ready-to-Eat,VD DRY FRUIT PUTHAREKULU,14,120,120,0,1
25-04-2025,Oils & Ghee,Groundnut oil 1 L,9,660,660,0,2
25-04-2025,Oils & Ghee,GANTASALA A2 COW GHEE 250ML,9,299,299,0,1
25-04-2025,Spices & Seasonings,Chilli powder 250 gms,15,145,110,35,1
25-04-2025,"Grains, Flours & Dals",BOMBAY RAVA,4,35,27.5,7.5,0.5
25-04-2025,Snacks & Ready-to-Eat,CHOCO BROWINE,14,40,40,0,2
25-04-2025,"Grains, Flours & Dals",turdal 500 gms,4,110,85,25,1
25-04-2025,Spices & Seasonings,Masala Karam 250 gms,15,130,120,10,1
25-04-2025,Sweeteners,SUGAR 1KG,16,60,56,4,1
25-04-2025,"Grains, Flours & Dals",Chana Flour 500 gms,4,140,110,30,1
25-04-2025,Snacks & Ready-to-Eat,SAGOPAPAD GREEN CHILLI VD,14,55,55,0,1
25-04-2025,"Dry Fruits, Nuts & Seeds",RB FIGS DATES,2,0,0,0,1
25-04-2025,"Grains, Flours & Dals",chana flour 500 gms,4,120,108,12,2
25-04-2025,Oils & Ghee,Sesame oil 1 L,9,560,560,0,1
25-04-2025,"Grains, Flours & Dals",HS JOWAR IDLY RAWA,4,65,65,0,1
25-04-2025,Sweeteners,MISHRI 250 GM,16,70,60,10,2
25-04-2025,"Grains, Flours & Dals",SL Idly Rava 1KG,4,65,55,10,1
25-04-2025,"Grains, Flours & Dals",RAGI FLOUR 500GRMS,4,40,35,5,1
25-04-2025,"Grains, Flours & Dals",chana flour 500 gms,4,60,54,6,1
25-04-2025,Snacks & Ready-to-Eat,GB SALT COOKIES,14,60,55,5,1
25-04-2025,"Grains, Flours & Dals",White jowar.F 1 kg,4,100,80,20,1
25-04-2025,Misc,C123,8,190,160,30,2
25-04-2025,Oils & Ghee,Coconut oil 500 ml,9,440,400,40,2
25-04-2025,"Grains, Flours & Dals",RED RICE 1KG,4,150,120,30,1
25-04-2025,"Grains, Flours & Dals",Quinova 500 gms,4,110,100,10,1
25-04-2025,"Grains, Flours & Dals",KORRALU (FOXTAIL M) 500GM,4,65,55,10,1
25-04-2025,"Dry Fruits, Nuts & Seeds",PULMAKHANA 100 GM,2,180,170,10,1
25-04-2025,"Grains, Flours & Dals",Brown RICE 1KG,4,140,130,10,2
25-04-2025,"Grains, Flours & Dals",yellow jowar .f 500g,4,50,50,0,1
25-04-2025,"Grains, Flours & Dals",Urad dall 1 Kg,4,185,170,15,1
25-04-2025,"Grains, Flours & Dals",KORRALU (FOXTAIL M) 500GM,4,65,55,10,1
25-04-2025,"Grains, Flours & Dals",SAMALU (Little millet) 500 gms,4,85,65,20,1
25-04-2025,"Grains, Flours & Dals",Multigrain 1 kg,4,100,85,15,1
25-04-2025,"Grains, Flours & Dals",RAGI FLOUR 500GRMS,4,40,35,5,1
25-04-2025,Snacks & Ready-to-Eat,VD MURUKU 175GM,14,60,60,0,1
25-04-2025,Oils & Ghee,Sesame oil 1 L,9,560,560,0,1
25-04-2025,Spices & Seasonings,Tamarind 250GMS,15,80,65,15,1
25-04-2025,Spices & Seasonings,MUSTARD POWDR 500G,15,130,110,20,1
25-04-2025,Oils & Ghee,Sesame oil 1 L,9,1120,"1,120.00",0,2
25-04-2025,Snacks & Ready-to-Eat,VD KOBARI LADDU,14,80,80,0,1
25-04-2025,Baking & Cooking Aids,GONDKATIRA Ag,0,85,75,10,1
25-04-2025,"Grains, Flours & Dals",Wheat Flour 1 kg,4,70,60,10,1
25-04-2025,"Grains, Flours & Dals",HS RAGI IDLY R,4,70,70,0,1
25-04-2025,"Grains, Flours & Dals",SRILATHA RICE RAVVA 500GM,4,70,70,0,2
25-04-2025,Oils & Ghee,Safflower oil 1 L,9,800,800,0,2
25-04-2025,"Health, Wellness & Ayurvedic Products",SAI DURGA MORINGA LEAVES 100GM,5,75,75,0,1
25-04-2025,"Dry Fruits, Nuts & Seeds",PULMAKHANA 100 GM,2,540,510,30,3
25-04-2025,Beverages,REFRESH SHARBATH NORMAL,1,398,380,18,2
25-04-2025,Spices & Seasonings,CORIANDER K P SD,15,65,65,0,1
25-04-2025,Spices & Seasonings,ROYAL SAFFRON,15,125,125,0,1
25-04-2025,"Grains, Flours & Dals",SL Idly Rava 1KG,4,585,495,90,9
25-04-2025,Personal Care & Cosmetics,GOW DURBAR NAVA 100GM SOAP,10,120,120,0,3
25-04-2025,"Grains, Flours & Dals",Wheat Flour 1 kg,4,70,60,10,1
25-04-2025,"Grains, Flours & Dals",turdal 1kg,4,440,340,100,2
25-04-2025,"Dry Fruits, Nuts & Seeds",Groundnuts 1 kg,2,760,660,100,4
25-04-2025,Snacks & Ready-to-Eat,DINNER PAPAD,14,80,80,0,1
25-04-2025,Oils & Ghee,Sesame oil 500ml,9,295,280,15,1
25-04-2025,Oils & Ghee,Groundnut oil 1 L,9,330,330,0,1
25-04-2025,"Grains, Flours & Dals",chana flour 500 gms,4,60,54,6,1
25-04-2025,Sweeteners,organic jaggery powder,16,99,99,0,1
25-04-2025,Oils & Ghee,Sesame oil 500ml,9,295,280,15,1
25-04-2025,Oils & Ghee,Sesame oil 5 L,9,5900,"5,500.00",400,2
25-04-2025,"Grains, Flours & Dals",SABDANA,4,40,35,5,1
25-04-2025,"Grains, Flours & Dals",BOMBAY RAVA,4,70,55,15,1
25-04-2025,Milk & Dairy,SANGAM CURD 450GM,7,40,40,0,1
25-04-2025,"Grains, Flours & Dals",VGR RICE bag 1,4,1899,"1,650.00",249,1
25-04-2025,Oils & Ghee,Groundnut oil 1 L,9,330,330,0,1
25-04-2025,Snacks & Ready-to-Eat,SD JOWAR WITH PALM JAGGERY 250GM,14,135,135,0,1
25-04-2025,"Grains, Flours & Dals",BAJRA 1 KG,4,30,25,5,0.5
25-04-2025,"Grains, Flours & Dals",KORRALU (FOXTAIL M) 500GM,4,65,55,10,1
25-04-2025,"Grains, Flours & Dals",RAGULU 1 KG,4,35,30,5,0.5
25-04-2025,Oils & Ghee,Groundnut oil 5 L,9,1800,"1,600.00",200,1
25-04-2025,Oils & Ghee,Groundnut oil 1 L,9,330,330,0,1
25-04-2025,Snacks & Ready-to-Eat,SD FINGER Millet with palm Jaggery 250gm,14,135,135,0,1
25-04-2025,Oils & Ghee,Sesame oil 1 L,9,1120,"1,120.00",0,2
25-04-2025,Snacks & Ready-to-Eat,FOXTAIL BIS,14,135,135,0,1
25-04-2025,"Dry Fruits, Nuts & Seeds",SABJA SEEDS,2,70,70,0,1
25-04-2025,"Grains, Flours & Dals",Arikalu (kodo),4,70,65,5,1
25-04-2025,Oils & Ghee,Groundnut oil 1 L,9,330,330,0,1
25-04-2025,"Grains, Flours & Dals",RAGI FLOUR 1KG,4,80,70,10,1
25-04-2025,"Grains, Flours & Dals",SAMALU (Little millet) 500 gms,4,85,65,20,1
25-04-2025,Oils & Ghee,Coconut oil 1 L,9,440,400,40,1
25-04-2025,"Grains, Flours & Dals",ANDU KORRALU (Brown top .mlt) 500,4,130,110,20,1
25-04-2025,"Grains, Flours & Dals",Multigrain 1 kg,4,100,85,15,1
25-04-2025,Oils & Ghee,Groundnut oil 1 L,9,660,660,0,2
25-04-2025,Spices & Seasonings,AVALU 250grms,15,160,160,0,4
25-04-2025,Spices & Seasonings,menthulu,15,90,90,0,1
25-04-2025,"Grains, Flours & Dals",SB Javva Wheat Ravva 500GM,4,190,190,0,2
25-04-2025,Beverages,BISLERI 100ml,1,10,10,0,1
25-04-2025,Personal Care & Cosmetics,Soapnut 250GM,10,60,45,15,1
25-04-2025,"Grains, Flours & Dals",Multigrain 1 kg,4,200,170,30,2
25-04-2025,"Grains, Flours & Dals",HS JOWAR IDLY RAWA,4,65,65,0,1
25-04-2025,Oils & Ghee,Groundnut oil 5 L,9,1800,"1,600.00",200,1
25-04-2025,Oils & Ghee,BUFFALLO GHEE 500ML,9,410,370,40,1
25-04-2025,"Grains, Flours & Dals",SAMALU (Little millet) 500 gms,4,85,65,20,1
25-04-2025,"Grains, Flours & Dals",HS JOWAR IDLY RAWA,4,65,65,0,1
25-04-2025,Sweeteners,YB JAGGERY POWDER 500GMS,16,75,75,0,1
25-04-2025,"Grains, Flours & Dals",VGR RICE bag 1,4,1899,"1,650.00",249,1
25-04-2025,Oils & Ghee,Groundnut oil 1 L,9,330,330,0,1
25-04-2025,"Grains, Flours & Dals",Brown RICE 1KG,4,350,325,25,5
25-04-2025,Snacks & Ready-to-Eat,VD GUMMADI CHAKKA,14,130,130,0,1
25-04-2025,"Grains, Flours & Dals",AISWARYA SP RICE 1KG,4,375,350,25,5
25-04-2025,"Grains, Flours & Dals",RAGULU 1 KG,4,70,60,10,1
25-04-2025,"Grains, Flours & Dals",C DALL 250G,4,28,24,4,1
25-04-2025,"Grains, Flours & Dals",SPLIT BLACK GRAM 500 GM,4,90,85,5,1
25-04-2025,"Grains, Flours & Dals",RED TURDAL 500GM,4,75,70,5,1
25-04-2025,"Grains, Flours & Dals",Wheat Flour 1 kg,4,70,60,10,1
25-04-2025,"Grains, Flours & Dals",rice aiswarya sp rice 5 kgs,4,375,350,25,1
25-04-2025,Oils & Ghee,Sesame oil 1 L,9,1120,"1,120.00",0,2
25-04-2025,Spices & Seasonings,NUVVULU 250GM,15,100,85,15,1
25-04-2025,"Grains, Flours & Dals",RICE FLOUR 500 GM,4,70,56,14,2
24-04-2025,Oils & Ghee,Groundnut oil 1 L,9,660,660,0,2
24-04-2025,Oils & Ghee,Coconut oil 500 ml,9,220,200,20,1
24-04-2025,Oils & Ghee,Sesame oil 1 L,9,1120,"1,120.00",0,2
24-04-2025,"Grains, Flours & Dals",Wheat Flour 1 kg,4,70,60,10,1
24-04-2025,Snacks & Ready-to-Eat,PEANUT CHILLI,14,25,25,0,5
24-04-2025,"Grains, Flours & Dals",IDLY RAVA 1KG,4,120,100,20,2
24-04-2025,"Health, Wellness & Ayurvedic Products",MH Millets Malt 500GM,5,200,190,10,1
24-04-2025,"Grains, Flours & Dals",BARLEY SEEDS 250GMS,4,80,70,10,2
24-04-2025,Sweeteners,mishri 500g,16,70,60,10,1
24-04-2025,Sweeteners,SUGAR 1KG,16,120,112,8,2
24-04-2025,"Grains, Flours & Dals",DISANO ROLED OATS,4,395,197.5,197.5,1
24-04-2025,"Grains, Flours & Dals",RICE FLOUR 500 GM,4,70,56,14,2
24-04-2025,Snacks & Ready-to-Eat,BATANA NGT 70GMS,14,40,40,0,2
24-04-2025,Oils & Ghee,Coconut oil 500 ml,9,220,200,20,1
24-04-2025,"Grains, Flours & Dals",Wheat Flour 1 kg,4,70,60,10,1
24-04-2025,"Grains, Flours & Dals",RAGI FLOUR 500GRMS,4,80,70,10,2
24-04-2025,Snacks & Ready-to-Eat,RAJGIRA PEANUT CHIKKI 450GM,14,125,125,0,1
24-04-2025,"Grains, Flours & Dals",White jowar.F 1 kg,4,100,80,20,1
24-04-2025,"Grains, Flours & Dals",MELMEKER 250GMS,4,60,45,15,1
24-04-2025,Snacks & Ready-to-Eat,SS IDLY BATTER 1KG,14,60,60,0,1
24-04-2025,"Grains, Flours & Dals",HS RAGI IDLY R,4,70,70,0,1
24-04-2025,Snacks & Ready-to-Eat,RI SPORTS BAR 40G,14,45,45,0,1
24-04-2025,"Grains, Flours & Dals",RAGI FLOUR 500GRMS,4,40,35,5,1
24-04-2025,"Grains, Flours & Dals",AISHWARYA SP 1KG,4,160,140,20,2
24-04-2025,Oils & Ghee,Groundnut oil 1 L,9,330,330,0,1
24-04-2025,Milk & Dairy,HERITAGE BUTTERMILK,7,30,30,0,3
24-04-2025,Spices & Seasonings,ROYAL SAFFRON,15,125,125,0,1
24-04-2025,"Grains, Flours & Dals",Chittimuthaylu rice 1 kg,4,160,140,20,1
24-04-2025,"Grains, Flours & Dals",Wheat Flour 1 kg,4,560,480,80,8
24-04-2025,"Grains, Flours & Dals",Wheat Flour 1 kg,4,210,180,30,3
24-04-2025,"Grains, Flours & Dals",THICK POHA 1KG,4,160,140,20,2
24-04-2025,"Grains, Flours & Dals",SL Suji Rava 500GM,4,32,32,0,1
24-04-2025,Spices & Seasonings,TATA SALT 1KG,15,30,30,0,1
24-04-2025,Milk & Dairy,SANGAM TONED MILK 500ML,7,30,30,0,1
24-04-2025,Snacks & Ready-to-Eat,VD CORNFLAKES MIXTURE 175GM,14,60,60,0,1
24-04-2025,"Grains, Flours & Dals",RAGI FLOUR 500GRMS,4,40,35,5,1
24-04-2025,Oils & Ghee,Safflower oil 1 L,9,400,400,0,1
24-04-2025,"Grains, Flours & Dals",HEALTH JOWAR RAWA,4,99,99,0,1
24-04-2025,"Grains, Flours & Dals",yellow jowar flour 1kg,4,100,92,8,1
24-04-2025,"Grains, Flours & Dals",Multigrain 1 kg,4,200,170,30,2
24-04-2025,Spices & Seasonings,Masala Karam 250 gms,15,130,120,10,1
24-04-2025,"Grains, Flours & Dals",BASMATHI RICE 1KG,4,300,270,30,2
24-04-2025,"Dry Fruits, Nuts & Seeds",BLACK KISMIS 250GM,2,175,140,35,1
24-04-2025,"Grains, Flours & Dals",CHANA DAL 500GM,4,112,96,16,2
24-04-2025,"Dry Fruits, Nuts & Seeds",PUMPKIN SEEDS 250GM,2,200,160,40,1
24-04-2025,"Dry Fruits, Nuts & Seeds",DRYDATES 250GM,2,150,120,30,1
24-04-2025,Oils & Ghee,Coconut oil 1 L,9,440,400,40,1
24-04-2025,Snacks & Ready-to-Eat,SATHVI REGIVADA 200GM,14,160,120,40,2
24-04-2025,Oils & Ghee,Groundnut oil 1 L,9,330,330,0,1
24-04-2025,Snacks & Ready-to-Eat,VD MULTI CHAKKA,14,110,110,0,1
24-04-2025,Sweeteners,mishri 500g,16,70,60,10,1
24-04-2025,Snacks & Ready-to-Eat,VD SAGOPAPAD 150GM,14,55,55,0,1
24-04-2025,"Grains, Flours & Dals",KORRALU (FOXTAIL M) 1KG,4,150,110,40,1
24-04-2025,Oils & Ghee,Groundnut oil 1 L,9,330,330,0,1
24-04-2025,Oils & Ghee,Groundnut oil 500ml,9,180,165,15,1
24-04-2025,"Grains, Flours & Dals",KORRALU (FOXTAIL M) 500GM,4,65,55,10,1
24-04-2025,"Grains, Flours & Dals",Green gram 1 kg,4,150,130,20,1
24-04-2025,"Grains, Flours & Dals",HS JOWAR IDLY RAWA,4,65,65,0,1
24-04-2025,"Grains, Flours & Dals",Wheat Rava S 1KG,4,65,55,10,1
24-04-2025,Pooja & Spiritual Items,GOMATHA AGARBATHI,12,45,45,0,1
24-04-2025,General Household & Kitchenware,MATCH BOX,3,20,20,0,1
24-04-2025,"Grains, Flours & Dals",MAATEJA rice 1 kg,4,144,138,6,2
24-04-2025,"Grains, Flours & Dals",SL Idly Rava 1KG,4,65,55,10,1
24-04-2025,"Grains, Flours & Dals",AISHWARYA SP 1KG,4,20,17.5,2.5,0.25
24-04-2025,"Grains, Flours & Dals",RED TURDAL 500GM,4,75,70,5,1
24-04-2025,Snacks & Ready-to-Eat,RSC ORANGE 100GMS,14,20,20,0,1
24-04-2025,"Grains, Flours & Dals",AISHWARYA SP 1KG,4,160,140,20,2
24-04-2025,Beverages,REFRESH SHARBATH NORMAL,1,199,190,9,1
24-04-2025,Snacks & Ready-to-Eat,Sprouted Ragi Biscuits 450GM,14,150,150,0,1
24-04-2025,Snacks & Ready-to-Eat,JONNA RIBAN,14,60,60,0,1
24-04-2025,"Grains, Flours & Dals",unpolished turdall500grms,4,120,110,10,1
24-04-2025,"Grains, Flours & Dals",SL Idly Rava 1KG,4,32.5,27.5,5,0.5
24-04-2025,"Health, Wellness & Ayurvedic Products",MAX PROTEIN PEANUT,5,175,175,0,1
24-04-2025,Snacks & Ready-to-Eat,DOSA BATTER 1KG,14,60,60,0,1
24-04-2025,Milk & Dairy,SANGAM TONED MILK 500ML,7,30,30,0,1
24-04-2025,Snacks & Ready-to-Eat,RSC ORANGE 100GMS,14,20,20,0,1
24-04-2025,Milk & Dairy,SANGAM FULL CREAM MILK 500ML,7,38,38,0,1
24-04-2025,Snacks & Ready-to-Eat,NGT CHATPATTA CHANA 90GM,14,50,50,0,2
24-04-2025,Snacks & Ready-to-Eat,BATANA NGT 70GMS,14,20,20,0,1
24-04-2025,Spices & Seasonings,AVALU 250grms,15,60,60,0,1
24-04-2025,"Dry Fruits, Nuts & Seeds",Groundnuts 1 kg,2,190,165,25,1
24-04-2025,Spices & Seasonings,PN ORGANIC PINK SALT 1KG,15,68,68,0,1
24-04-2025,Spices & Seasonings,Coriander seeds 200 gms,15,48,40,8,1
24-04-2025,"Grains, Flours & Dals",Green gram 1 kg,4,150,130,20,1
24-04-2025,"Grains, Flours & Dals",URAD DALL,4,95,85,10,1
24-04-2025,"Grains, Flours & Dals",SL Idly Rava 1KG,4,65,55,10,1
24-04-2025,Oils & Ghee,Groundnut oil 1 L,9,330,330,0,1
24-04-2025,"Dry Fruits, Nuts & Seeds",YB GRANMA NUTS,2,90,90,0,1
24-04-2025,Snacks & Ready-to-Eat,MIGHTY PUFFS CHEDDAR CHEESE,14,25,25,0,1
24-04-2025,Snacks & Ready-to-Eat,SF MIGHTY PUFFS,14,25,25,0,1
24-04-2025,"Dry Fruits, Nuts & Seeds",PULMAKHANA 100 GM,2,180,170,10,1
24-04-2025,"Grains, Flours & Dals",Green gram 1 kg,4,150,130,20,1
24-04-2025,"Grains, Flours & Dals",MELMEKER 250GMS,4,60,45,15,1
24-04-2025,"Grains, Flours & Dals",Chana Flour 500 gms,4,120,108,12,1
24-04-2025,Oils & Ghee,Safflower oil 1 L,9,400,400,0,1
24-04-2025,Oils & Ghee,Groundnut oil 1 L,9,330,330,0,1
24-04-2025,Oils & Ghee,BUFFALLO GHEE 500ML,9,820,740,80,2
24-04-2025,Snacks & Ready-to-Eat,VD GUMMADI VADIYAM,14,75,75,0,1
24-04-2025,Milk & Dairy,HERITAGE TONED MILK 500ML,7,31,31,0,1
24-04-2025,"Grains, Flours & Dals",split black gram 1 kg,4,180,170,10,1
24-04-2025,Snacks & Ready-to-Eat,VD CORNFLAKES MIXTURE 175GM,14,60,60,0,1
24-04-2025,Snacks & Ready-to-Eat,NGT CHATPATTA CHANA 90GM,14,25,25,0,1
24-04-2025,Snacks & Ready-to-Eat,SATHVI REGIVADA 200GM,14,80,60,20,1
24-04-2025,Snacks & Ready-to-Eat,ragi apadalu,14,180,180,0,2
24-04-2025,Snacks & Ready-to-Eat,BLACK PEPPER RICEPAPAD VD,14,50,50,0,1
24-04-2025,Snacks & Ready-to-Eat,ONION RINGS,14,50,50,0,1
24-04-2025,Snacks & Ready-to-Eat,SAGOPAPAD GREEN CHILLI VD,14,110,110,0,2
24-04-2025,Spices & Seasonings,FLAXSEED KARAM,15,75,75,0,1
24-04-2025,"Health, Wellness & Ayurvedic Products",SAI DURGA MORINGA LEAVES 100GM,5,75,75,0,1
24-04-2025,"Dry Fruits, Nuts & Seeds",PULMAKHANA 100 GM,2,180,170,10,1
24-04-2025,Snacks & Ready-to-Eat,JONNA RIBAN,14,60,60,0,1
24-04-2025,Snacks & Ready-to-Eat,SOYA MURK,14,60,60,0,1
24-04-2025,"Grains, Flours & Dals",turdal 500 gms,4,110,85,25,1
24-04-2025,"Grains, Flours & Dals",AISHWARYA SP 1KG,4,160,140,20,2
24-04-2025,Oils & Ghee,Sesame oil 1 L,9,560,560,0,1
24-04-2025,Beverages,REFRESH SHARBATH SUGAR FREE,1,299,285,14,1
24-04-2025,Sweeteners,GS Palm Jaggery Powder 400GM,16,180,180,0,1
24-04-2025,Snacks & Ready-to-Eat,VD NUVULLU CHIKKI,14,80,80,0,1
24-04-2025,"Grains, Flours & Dals",RAGI FLOUR 1KG,4,80,70,10,1
24-04-2025,"Grains, Flours & Dals",RICE FLOUR 1KG,4,70,55,15,1
24-04-2025,Spices & Seasonings,AVALU 250grms,15,40,40,0,1
24-04-2025,Spices & Seasonings,menthulu,15,90,90,0,1
24-04-2025,Oils & Ghee,Groundnut oil 1 L,9,660,660,0,2
24-04-2025,"Grains, Flours & Dals",SL Idly Rava 1KG,4,65,55,10,1
24-04-2025,"Dry Fruits, Nuts & Seeds",Putnalu 250GM,2,45,38,7,1
24-04-2025,Spices & Seasonings,Jeera 100GM,15,50,45,5,1
24-04-2025,Spices & Seasonings,Tamarind 250GMS,15,80,65,15,1
24-04-2025,Spices & Seasonings,pickles chilli powder 500GM,15,325,325,0,1
24-04-2025,Snacks & Ready-to-Eat,MIGHTY PUFF,14,25,25,0,1
24-04-2025,"Dry Fruits, Nuts & Seeds",Groundnuts 500 gms,2,95,85,10,1
24-04-2025,Snacks & Ready-to-Eat,BATANA NGT 70GMS,14,20,20,0,1
24-04-2025,Snacks & Ready-to-Eat,SD Moringa with plam jaggery 250gm,14,135,135,0,1
24-04-2025,Snacks & Ready-to-Eat,SD black sesme laddu with dates 175gm,14,135,135,0,1
24-04-2025,Sweeteners,YB JAGGERY POWDER 500GMS,16,75,75,0,1
24-04-2025,"Dry Fruits, Nuts & Seeds",Groundnuts 500 gms,2,95,85,10,1
24-04-2025,Oils & Ghee,Coconut oil 500 ml,9,220,200,20,1
24-04-2025,Spices & Seasonings,Chilli powder 500 gms,15,580,420,160,2
24-04-2025,Oils & Ghee,Groundnut oil 5 L,9,3600,"3,200.00",400,2
24-04-2025,Spices & Seasonings,GARAM MASALA 200GM,15,120,95,25,1
24-04-2025,Oils & Ghee,Groundnut oil 1 L,9,660,660,0,2
24-04-2025,Oils & Ghee,Sesame oil 1 L,9,1120,"1,120.00",0,2
24-04-2025,Oils & Ghee,Coconut oil 500 ml,9,220,200,20,1
24-04-2025,Spices & Seasonings,Chilli powder 500 gms,15,290,210,80,1
24-04-2025,"Health, Wellness & Ayurvedic Products",SAI DURGA MORINGA LEAVES 100GM,5,75,75,0,1
24-04-2025,Milk & Dairy,SANGAM FULL CREAM MILK 500ML,7,39,39,0,1
24-04-2025,"Dry Fruits, Nuts & Seeds",Groundnuts 500 gms,2,95,85,10,1
24-04-2025,"Grains, Flours & Dals",turdal 500 gms,4,110,85,25,1
24-04-2025,Spices & Seasonings,TATA SALT 1KG,15,60,60,0,2
24-04-2025,"Grains, Flours & Dals",yellow jowar flour 1kg,4,100,92,8,1
24-04-2025,Oils & Ghee,Sesame oil 1 L,9,560,560,0,1
24-04-2025,Snacks & Ready-to-Eat,VD PALLI LADDU,14,160,160,0,2
24-04-2025,Spices & Seasonings,AVALU 100GM,15,25,20,5,1
24-04-2025,Snacks & Ready-to-Eat,RINGS 200GM,14,90,90,0,3
24-04-2025,"Dry Fruits, Nuts & Seeds",Groundnuts 1 kg,2,190,165,25,1
24-04-2025,Spices & Seasonings,Masala Karam 250 gms,15,130,120,10,1
24-04-2025,Oils & Ghee,Groundnut oil 5 L,9,3600,"3,200.00",400,2
24-04-2025,Spices & Seasonings,Chilli powder 500 gms,15,580,420,160,2
24-04-2025,Spices & Seasonings,Chilli powder 500 gms,15,580,420,160,2
24-04-2025,Spices & Seasonings,Masala Karam 250 gms,15,130,120,10,1
24-04-2025,Oils & Ghee,Groundnut oil 1 L,9,660,660,0,2
24-04-2025,Oils & Ghee,BUFFALLO GHEE 500ML,9,1230,"1,110.00",120,3
24-04-2025,"Grains, Flours & Dals",ANDU KORRALU (Browntop.m) 1 kg,4,1040,880,160,4
24-04-2025,"Grains, Flours & Dals",samalu,4,260,260,0,2
24-04-2025,"Grains, Flours & Dals",Arikadu ( kodo),4,280,260,20,2
24-04-2025,"Grains, Flours & Dals",KORRALU (FOXTAIL M) 1KG,4,300,220,80,2
24-04-2025,"Grains, Flours & Dals",UDALU (Barnyard millet) 1 kg,4,280,230,50,2
24-04-2025,Oils & Ghee,Groundnut oil 500ml,9,180,165,15,1
24-04-2025,Pooja & Spiritual Items,GD Dhoop Sticks 26GM,12,20,20,0,1
24-04-2025,"Grains, Flours & Dals",white Bobarlu 500 gms,4,80,75,5,1
24-04-2025,"Grains, Flours & Dals",samalu,4,130,130,0,1
24-04-2025,"Health, Wellness & Ayurvedic Products",MH Millets Malt 500GM,5,200,190,10,1
24-04-2025,"Grains, Flours & Dals",Green gram 1 kg,4,150,130,20,1
24-04-2025,Snacks & Ready-to-Eat,MIX MILLET NOODLES,14,75,75,0,1
24-04-2025,"Grains, Flours & Dals",KORRALU (FOXTAIL M) 1KG,4,150,110,40,1
24-04-2025,Oils & Ghee,Groundnut oil 5 L,9,1800,"1,600.00",200,1
24-04-2025,"Grains, Flours & Dals",Wheat Flour 1 kg,4,70,60,10,1
24-04-2025,Oils & Ghee,Sesame oil 1 L,9,560,560,0,1
24-04-2025,"Grains, Flours & Dals",RAGI FLOUR 500GRMS,4,40,35,5,1
24-04-2025,"Grains, Flours & Dals",Multigrain 1 kg,4,300,255,45,3
24-04-2025,"Grains, Flours & Dals",BOBBARA PAPPU 1KG,4,180,160,20,1
24-04-2025,Snacks & Ready-to-Eat,VD CORNFLAKES MIXTURE 175GM,14,240,240,0,4
24-04-2025,"Grains, Flours & Dals",JOWAR UPMA RAVA,4,75,75,0,1
24-04-2025,"Grains, Flours & Dals",split greengram,4,140,140,0,1
24-04-2025,Misc,VD00014,8,100,90,10,1
24-04-2025,Snacks & Ready-to-Eat,SATHVI REGIVADA 200GM,14,80,60,20,1
24-04-2025,"Grains, Flours & Dals",KORRALU (FOXTAIL M) 1KG,4,150,110,40,1
24-04-2025,"Dry Fruits, Nuts & Seeds",Groundnuts 1 kg,2,190,165,25,1
24-04-2025,"Grains, Flours & Dals",MULTIMILLET IDLY RAVVA,4,65,65,0,1
24-04-2025,"Health, Wellness & Ayurvedic Products",HARITHAKI CHOORNAM,5,80,80,0,1
24-04-2025,"Health, Wellness & Ayurvedic Products",SONAMUKHI,5,80,80,0,1
24-04-2025,"Dry Fruits, Nuts & Seeds",PUMPKIN SEEDS 250GM,2,200,160,40,1
24-04-2025,Oils & Ghee,Groundnut oil 1 L,9,330,330,0,1
24-04-2025,Spices & Seasonings,AVALU 100GM,15,25,20,5,1
24-04-2025,Spices & Seasonings,Masala Karam 250 gms,15,130,120,10,1
24-04-2025,"Grains, Flours & Dals",Multigrain 1 kg,4,100,85,15,1
24-04-2025,Oils & Ghee,GANTASALA A2 COW GHEE 250ML,9,299,299,0,1
24-04-2025,"Dry Fruits, Nuts & Seeds",SATHVI CHIA SEEDS 100GM,2,400,320,80,4
24-04-2025,"Grains, Flours & Dals",Quinova 1 kg,4,220,195,25,1
24-04-2025,Sweeteners,MISHRI D,16,80,60,20,2
24-04-2025,"Grains, Flours & Dals",AISHWARYA SP 1KG,4,800,700,100,10
24-04-2025,"Grains, Flours & Dals",AISHWARYA SP 1KG,4,1200,"1,050.00",150,15
24-04-2025,"Grains, Flours & Dals",VGR rice 1 kg,4,140,130,10,2
24-04-2025,Beverages,REFRESH SHARBATH SUGAR FREE,1,299,285,14,1
24-04-2025,Snacks & Ready-to-Eat,VD DASA DINUSULU,14,398,398,0,2
24-04-2025,Oils & Ghee,Groundnut oil 1 L,9,330,330,0,1
24-04-2025,"Dry Fruits, Nuts & Seeds",PUMPKIN SEEDS 250GM,2,200,160,40,1
24-04-2025,Snacks & Ready-to-Eat,VD MULTI CHAKKA,14,220,220,0,2
24-04-2025,"Dry Fruits, Nuts & Seeds",cashew,2,340,310,30,1
24-04-2025,Sweeteners,SUGAR 1KG,16,120,112,8,2
24-04-2025,"Dry Fruits, Nuts & Seeds",WATERMELON SEEDS 250GRM,2,320,280,40,1
24-04-2025,Beverages,REFRESH SHARBATH NORMAL,1,199,190,9,1
24-04-2025,Oils & Ghee,Safflower oil 500 ml,9,220,200,20,1
24-04-2025,Snacks & Ready-to-Eat,VD PALLI LADDU,14,160,160,0,2
24-04-2025,"Grains, Flours & Dals",VGR rice 1 kg,4,350,325,25,5
24-04-2025,Sweeteners,mishri 500g,16,70,60,10,1
24-04-2025,Snacks & Ready-to-Eat,BEETROOT MURK,14,60,60,0,1
24-04-2025,"Dry Fruits, Nuts & Seeds",Groundnuts 1 kg,2,190,165,25,1
24-04-2025,"Grains, Flours & Dals",turdal 1kg,4,220,170,50,1
24-04-2025,Beverages,REFRESH SHARBATH SUGAR FREE,1,299,285,14,1
24-04-2025,Oils & Ghee,Sesame oil 1 L,9,1120,"1,120.00",0,2
24-04-2025,"Grains, Flours & Dals",MAATEJA rice 26 kg,4,1690,"1,690.00",0,1
24-04-2025,Oils & Ghee,Sesame oil 1 L,9,1120,"1,120.00",0,2
24-04-2025,"Grains, Flours & Dals",Wheat Flour 1 kg,4,140,120,20,2
24-04-2025,Spices & Seasonings,LG 50GM,15,92,92,0,1
24-04-2025,"Grains, Flours & Dals",turdal 1kg,4,220,170,50,1
24-04-2025,Oils & Ghee,Groundnut oil 1 L,9,330,330,0,1
24-04-2025,"Grains, Flours & Dals",Red Chana 250GM,4,70,60,10,2
24-04-2025,"Grains, Flours & Dals",SPLIT BLACK GRAM 500 GM,4,90,85,5,1
24-04-2025,Spices & Seasonings,JEERA 250 gms,15,125,105,20,1
24-04-2025,"Grains, Flours & Dals",UNPOLISHED TURDALL 1KG,4,240,210,30,1
24-04-2025,"Grains, Flours & Dals",Wheat Flour 1 kg,4,70,60,10,1
24-04-2025,Milk & Dairy,BROWN EGGS 1P,7,168,144,24,12
24-04-2025,Snacks & Ready-to-Eat,VD PALLI CHIKKI,14,80,80,0,1
24-04-2025,Snacks & Ready-to-Eat,SD FINGER Millet with palm Jaggery 250gm,14,135,135,0,1
24-04-2025,Oils & Ghee,Coconut oil 1 L,9,440,400,40,1
24-04-2025,"Grains, Flours & Dals",DOCTOR RICE DIABETIC SFR 1KG,4,600,600,0,5
24-04-2025,"Grains, Flours & Dals",Wheat Flour 1 kg,4,140,120,20,2
24-04-2025,Sweeteners,YB JAGGERY POWDER 1KG,16,280,280,0,2
24-04-2025,Snacks & Ready-to-Eat,VD Pappu Chekkalu 190gm,14,120,120,0,2
24-04-2025,Snacks & Ready-to-Eat,RAGI GAVVALU,14,60,60,0,1
24-04-2025,Snacks & Ready-to-Eat,NAVARATNA MIX,14,60,60,0,1
24-04-2025,Snacks & Ready-to-Eat,VD PALLI LADDU,14,80,80,0,1
24-04-2025,Snacks & Ready-to-Eat,VD MURUKU 175GM,14,60,60,0,1
24-04-2025,Oils & Ghee,Sesame oil 1 L,9,1120,"1,120.00",0,2
24-04-2025,Misc,VD0009,8,100,100,0,1
24-04-2025,"Grains, Flours & Dals",RAGI FLOUR 1KG,4,80,70,10,1
24-04-2025,Beverages,BRU GREEN LABEL 1.2G,1,24,24,0,12
24-04-2025,"Grains, Flours & Dals",UDALU (Barnyard millet) 1 kg,4,280,230,50,2
24-04-2025,Beverages,REFRESH SHARBATH SUGAR FREE,1,299,285,14,1
24-04-2025,Milk & Dairy,BROWN EGGS 1P,7,140,120,20,10
23-04-2025,"Dry Fruits, Nuts & Seeds",PUMPKIN SEEDS 250GM,2,200,160,40,1
23-04-2025,"Dry Fruits, Nuts & Seeds",ALMONDS 250GM,2,280,260,20,1
23-04-2025,"Grains, Flours & Dals",MELMEKER 250GMS,4,60,45,15,1
23-04-2025,"Grains, Flours & Dals",unpolished turdall500grms,4,120,110,10,1
23-04-2025,"Grains, Flours & Dals",Red Chana 500 GM,4,50,50,0,1
23-04-2025,Sweeteners,YB Brown Sugar 500GM,16,75,75,0,1
23-04-2025,"Dry Fruits, Nuts & Seeds",Groundnuts 500 gms,2,95,85,10,1
23-04-2025,Spices & Seasonings,PN ORGANIC PINK SALT 1KG,15,124,124,0,1
23-04-2025,"Grains, Flours & Dals",chana flour 500 gms,4,60,54,6,1
23-04-2025,Milk & Dairy,BROWN EGGS 1P,7,140,120,20,10
23-04-2025,"Grains, Flours & Dals",Wheat Flour 1 kg,4,280,240,40,4
23-04-2025,"Grains, Flours & Dals",BOMBAY RAVA,4,140,110,30,2
23-04-2025,Snacks & Ready-to-Eat,RAJGIRA PEANUT CHIKKI 450GM,14,125,125,0,1
23-04-2025,"Grains, Flours & Dals",maida 500grms,4,35,30,5,1
23-04-2025,"Grains, Flours & Dals",Chana Flour 500 gms,4,140,110,30,1
23-04-2025,"Grains, Flours & Dals",Wheat Rava M 500GM,4,33,30,3,1
23-04-2025,"Grains, Flours & Dals",RAGI FLOUR 1KG,4,80,70,10,1
23-04-2025,"Grains, Flours & Dals",yellow jowar flour 1kg,4,100,92,8,1
23-04-2025,"Grains, Flours & Dals",Wheat Flour 1 kg,4,140,120,20,2
23-04-2025,"Grains, Flours & Dals",Red Wheat Flour 1 kg,4,140,130,10,1
23-04-2025,"Grains, Flours & Dals",VGR RICE bag 1,4,1899,"1,650.00",249,1
23-04-2025,Snacks & Ready-to-Eat,SD DrybFruit LADDU WITH DATES 175GM,14,135,135,0,1
23-04-2025,"Grains, Flours & Dals",MAAGAANI LOW GI SP 1KG,4,149,125,24,1
23-04-2025,"Grains, Flours & Dals",Multigrain 1 kg,4,300,255,45,3
23-04-2025,"Grains, Flours & Dals",DOCTOR RICE DIABETIC SFR 1KG,4,120,120,0,1
23-04-2025,Oils & Ghee,Groundnut oil 1 L,9,330,330,0,1
23-04-2025,"Dry Fruits, Nuts & Seeds",Groundnuts 500 gms,2,95,85,10,1
23-04-2025,"Dry Fruits, Nuts & Seeds",PUTNALU 500GMS,2,90,76,14,1
23-04-2025,"Grains, Flours & Dals",SL Suji Rava 500GM,4,32,32,0,1
23-04-2025,"Grains, Flours & Dals",MELMEKER 250GMS,4,60,45,15,1
23-04-2025,"Grains, Flours & Dals",Em Multimillet idli r 500g,4,129,129,0,1
23-04-2025,"Dry Fruits, Nuts & Seeds",PULMAKHANA 100 GM,2,180,170,10,1
23-04-2025,"Grains, Flours & Dals",HS MULTI UPMA RAVA,4,65,65,0,1
23-04-2025,Sweeteners,MISHRI D,16,40,30,10,1
23-04-2025,Oils & Ghee,Groundnut oil 1 L,9,660,660,0,2
23-04-2025,"Grains, Flours & Dals",Sathya Javva Wheat Rava 500GM,4,190,190,0,2
23-04-2025,"Grains, Flours & Dals",SRILATHA RICE RAVVA 500GM,4,70,70,0,2
23-04-2025,"Grains, Flours & Dals",split greengram,4,140,140,0,1
23-04-2025,Oils & Ghee,Sesame oil 1 L,9,1120,"1,120.00",0,2
23-04-2025,Oils & Ghee,Coconut oil 500 ml,9,220,200,20,1
23-04-2025,"Dry Fruits, Nuts & Seeds",SH GROUNDNUT 500GM,2,163,130,33,1
23-04-2025,Oils & Ghee,Groundnut oil 1 L,9,660,660,0,2
23-04-2025,Oils & Ghee,Groundnut oil 1 L,9,660,660,0,2
23-04-2025,Spices & Seasonings,AVALU 100GM,15,50,40,10,2
23-04-2025,Spices & Seasonings,Menthulu 250 gms,15,50,45,5,1
23-04-2025,Spices & Seasonings,DURGA SALT CRYSTAL 1KG,15,56,56,0,2
23-04-2025,Oils & Ghee,Groundnut oil 1 L,9,330,330,0,1
23-04-2025,Oils & Ghee,Black Sesame oil 500 ml,9,440,380,60,2
23-04-2025,Milk & Dairy,BROWN EGGS TRAY 30P,7,360,330,30,1
23-04-2025,"Grains, Flours & Dals",Brown RICE 1KG,4,140,130,10,2
23-04-2025,Snacks & Ready-to-Eat,PASTALICIOUS,14,175,175,0,1
23-04-2025,Spices & Seasonings,ROYAL SAFFRON,15,250,250,0,2
23-04-2025,"Grains, Flours & Dals",BLACK GRAM 1KG,4,150,140,10,1
23-04-2025,"Grains, Flours & Dals",URAD DALL,4,190,170,20,2
23-04-2025,"Dry Fruits, Nuts & Seeds",Groundnuts 500 gms,2,95,85,10,1
23-04-2025,"Dry Fruits, Nuts & Seeds",cashew,2,340,310,30,1
23-04-2025,"Dry Fruits, Nuts & Seeds",ALMONDS 250GM,2,280,260,20,1
23-04-2025,Sweeteners,sugar 500 gms,16,30,28,2,1
23-04-2025,Oils & Ghee,Groundnut oil 1 L,9,330,330,0,1
23-04-2025,"Grains, Flours & Dals",AISHWARYA SP 5KG,4,400,375,25,1
23-04-2025,Snacks & Ready-to-Eat,VD SAGOPAPAD 150GM,14,55,55,0,1
23-04-2025,"Dry Fruits, Nuts & Seeds",Groundnuts 500 gms,2,95,85,10,1
23-04-2025,"Grains, Flours & Dals",MELMEKER 250GMS,4,60,45,15,1
23-04-2025,"Grains, Flours & Dals",Multigrain 1 kg,4,100,85,15,1
23-04-2025,Oils & Ghee,GANTASALA A2 COW GHEE 250ML,9,299,299,0,1
23-04-2025,"Grains, Flours & Dals",Wheat Flour 1 kg,4,70,60,10,1
23-04-2025,Oils & Ghee,groundnet oil,9,1600,"1,600.00",0,1
23-04-2025,Sweeteners,ACHU BELLAM 1KG,16,200,160,40,2
23-04-2025,Snacks & Ready-to-Eat,VD DRY FRUIT PUTHAREKULU,14,120,120,0,1
23-04-2025,"Dry Fruits, Nuts & Seeds",SD Mango cubes 100gm,2,95,95,0,1
23-04-2025,Snacks & Ready-to-Eat,RSC ORANGE 100GMS,14,20,20,0,1
23-04-2025,Personal Care & Cosmetics,harbal shampoo,10,175,175,0,1
23-04-2025,Snacks & Ready-to-Eat,PEANUT CHILLI,14,10,10,0,2
23-04-2025,"Grains, Flours & Dals",Multigrain 1 kg,4,200,170,30,2
23-04-2025,"Grains, Flours & Dals",Red Bobarlu 1 kg,4,190,170,20,1
23-04-2025,"Grains, Flours & Dals",Red Bobarlu 500 gms,4,95,85,10,1
23-04-2025,Snacks & Ready-to-Eat,SATHVI REGIVADA 200GM,14,80,60,20,1
23-04-2025,Oils & Ghee,Groundnut oil 1 L,9,330,330,0,1
23-04-2025,Snacks & Ready-to-Eat,SS IDLY BATTER 1KG,14,120,120,0,2
23-04-2025,Spices & Seasonings,MTR SAMBAR POW 100GM,15,76,76,0,1
23-04-2025,Beverages,BISLERI 100ml,1,10,10,0,1
23-04-2025,Spices & Seasonings,asafoetida,15,85,85,0,1
23-04-2025,"Health, Wellness & Ayurvedic Products",MH Millets Malt 500GM,5,200,190,10,1
23-04-2025,"Grains, Flours & Dals",Multigrain 1 kg,4,100,85,15,1
23-04-2025,"Grains, Flours & Dals",MAAGAANI W RICE 5KGS,4,899,535,364,1
23-04-2025,Snacks & Ready-to-Eat,NGT CHATPATTA CHANA 90GM,14,50,50,0,2
23-04-2025,General Household & Kitchenware,SABEENA,3,15,15,0,1
23-04-2025,"Grains, Flours & Dals",Wheat Flour 1 kg,4,140,120,20,2
23-04-2025,Sweeteners,MISHRI 250 GM,16,35,30,5,1
23-04-2025,Pooja & Spiritual Items,SWASTIK SAMBRANI 25 GRMS,12,20,20,0,1
23-04-2025,"Grains, Flours & Dals",Arikalu (kodo),4,70,65,5,1
23-04-2025,"Grains, Flours & Dals",KORRALU (FOXTAIL M) 500GM,4,65,55,10,1
23-04-2025,"Grains, Flours & Dals",UDALU (Barnyard millet) 500 gms,4,70,60,10,1
23-04-2025,"Grains, Flours & Dals",SAMALU (Little millet) 500 gms,4,85,65,20,1
23-04-2025,Sweeteners,NATURAL HONEY 250GM,16,150,130,20,1
23-04-2025,Snacks & Ready-to-Eat,NGT CHATPATTA CHANA 90GM,14,50,50,0,2
23-04-2025,Oils & Ghee,Coconut oil 1 L,9,440,400,40,1
23-04-2025,Oils & Ghee,Safflower oil 1 L,9,400,400,0,1
23-04-2025,Snacks & Ready-to-Eat,SD Aswagandha with palm Jaggery250Gm,14,135,135,0,1
23-04-2025,Sweeteners,YB FOREST H 250 GMS,16,180,180,0,1
23-04-2025,Oils & Ghee,Groundnut oil 1 L,9,330,330,0,1
23-04-2025,Beverages,REFRESH SHARBATH SUGAR FREE,1,299,285,14,1
23-04-2025,Oils & Ghee,Safflower oil 1 L,9,400,400,0,1
23-04-2025,Oils & Ghee,Groundnut oil 1 L,9,330,330,0,1
23-04-2025,Oils & Ghee,Groundnut oil 1 L,9,330,330,0,1
23-04-2025,"Grains, Flours & Dals",URAD DALL,4,95,85,10,1
23-04-2025,"Grains, Flours & Dals",samalu,4,260,260,0,2
23-04-2025,"Dry Fruits, Nuts & Seeds",Groundnuts 1 kg,2,190,165,25,1
23-04-2025,Sweeteners,YB Brown Sugar 500GM,16,75,75,0,1
23-04-2025,"Grains, Flours & Dals",FLOUR CHARGE,4,70.8,70.8,0,5.9
23-04-2025,"Grains, Flours & Dals",MELMEKER 250GMS,4,60,45,15,1
23-04-2025,Snacks & Ready-to-Eat,BROWN BREAD,14,55,55,0,1
23-04-2025,Milk & Dairy,BROWN EGGS 1P,7,84,72,12,6
23-04-2025,Snacks & Ready-to-Eat,VD PALLI LADDU,14,80,80,0,1
23-04-2025,"Grains, Flours & Dals",unpolished turdall500grms,4,120,110,10,1
23-04-2025,"Grains, Flours & Dals",MAAGAANI LOW GI SP L 1KG,4,240,210,30,2
23-04-2025,Snacks & Ready-to-Eat,BROWN BREAD,14,55,55,0,1
23-04-2025,Snacks & Ready-to-Eat,SF COOKIES BANANA OATS,14,99,99,0,1
23-04-2025,"Grains, Flours & Dals",SB Javva Wheat Ravva 500GM,4,95,95,0,1
23-04-2025,"Dry Fruits, Nuts & Seeds",WATERMELON SEEDS 250GRM,2,320,280,40,1
23-04-2025,Oils & Ghee,Groundnut oil 5 L,9,1800,"1,600.00",200,1
23-04-2025,"Grains, Flours & Dals",ANDU KORRALU (Brown top .mlt) 500,4,130,110,20,1
23-04-2025,"Grains, Flours & Dals",Multigrain 1 kg,4,200,170,30,2
23-04-2025,"Grains, Flours & Dals",SAMALU (Little millet) 500 gms,4,85,65,20,1
23-04-2025,Spices & Seasonings,NUVVULU 250GM,15,80,65,15,1
23-04-2025,"Grains, Flours & Dals",AISHWARYA SP 1KG,4,240,210,30,3
23-04-2025,Spices & Seasonings,SONTI 50GM,15,30,20,10,1
23-04-2025,"Grains, Flours & Dals",KORRALU (FOXTAIL M) 500GM,4,65,55,10,1
23-04-2025,Snacks & Ready-to-Eat,ragi chegodi,14,60,60,0,1
23-04-2025,"Grains, Flours & Dals",Arikalu (kodo),4,70,65,5,1
23-04-2025,Milk & Dairy,SANGAM TONED MILK 500ML,7,62,62,0,2
23-04-2025,Snacks & Ready-to-Eat,MIGHTY PUFFS TOMATO,14,25,25,0,1
23-04-2025,Snacks & Ready-to-Eat,RITEBITE MELTING CHOCOLATE,14,50,50,0,1
23-04-2025,Snacks & Ready-to-Eat,RSC ORANGE 100GMS,14,20,20,0,1
23-04-2025,Snacks & Ready-to-Eat,VD DRY FRUIT PUTHAREKULU,14,120,120,0,1
23-04-2025,"Grains, Flours & Dals",HS JOWAR FLAKES 250GM 1+1,4,476,476,0,4
23-04-2025,"Health, Wellness & Ayurvedic Products",RB Max Protein Choco chips 55gm,5,50,50,0,1
23-04-2025,Snacks & Ready-to-Eat,CHOCO BROWINE,14,40,40,0,2
23-04-2025,"Grains, Flours & Dals",Wheat Flour 1 kg,4,70,60,10,1
23-04-2025,"Dry Fruits, Nuts & Seeds",Groundnuts 1 kg,2,380,330,50,2
23-04-2025,Spices & Seasonings,SAMBAR POWDER 200GM,15,130,110,20,1
23-04-2025,"Grains, Flours & Dals",CHANA DAL 1KG,4,112,96,16,1
23-04-2025,Spices & Seasonings,ROYAL SAFFRON,15,250,250,0,2
23-04-2025,Sweeteners,SUGAR 1KG,16,60,56,4,1
23-04-2025,Milk & Dairy,BUTTER MILK,7,20,20,0,2
23-04-2025,Beverages,BRU GREEN LABEL 1.2G,1,4,4,0,2
23-04-2025,Spices & Seasonings,DHANIYA POWDER 200GM,15,100,85,15,1
23-04-2025,"Grains, Flours & Dals",Chittimuthaylu rice 1 kg,4,320,280,40,2
23-04-2025,Oils & Ghee,Groundnut oil 500ml,9,180,165,15,1
23-04-2025,Oils & Ghee,Sesame oil 1 L,9,560,560,0,1
23-04-2025,Oils & Ghee,Sesame oil 1 L,9,560,560,0,1
23-04-2025,Spices & Seasonings,Chilli powder 500 gms,15,580,420,160,2
23-04-2025,"Grains, Flours & Dals",Wheat Flour 1 kg,4,140,120,20,2
23-04-2025,Milk & Dairy,BROWN EGGS TRAY 30P,7,360,330,30,1
23-04-2025,Oils & Ghee,Black Sesame oil 500 ml,9,440,380,60,2
23-04-2025,Spices & Seasonings,ROYAL SAFFRON,15,125,125,0,1
23-04-2025,"Grains, Flours & Dals",turdal 1kg,4,220,170,50,1
23-04-2025,Snacks & Ready-to-Eat,RAJGIRA PEANUT CHIKKI,14,5,5,0,1
23-04-2025,Sweeteners,organic jaggery powder,16,198,198,0,2
23-04-2025,Household & Cleaning,scrubber steel,6,15,15,0,1
23-04-2025,Oils & Ghee,Groundnut oil 1 L,9,330,330,0,1
23-04-2025,Oils & Ghee,Groundnut oil 1 L,9,330,330,0,1
23-04-2025,Oils & Ghee,Safflower oil 1 L,9,400,400,0,1
23-04-2025,Snacks & Ready-to-Eat,VD NUVULLU CHIKKI,14,80,80,0,1
23-04-2025,Snacks & Ready-to-Eat,VD GUMMADI CHAKKA,14,260,260,0,2
23-04-2025,Snacks & Ready-to-Eat,SUNNUNDALU,14,120,120,0,1
23-04-2025,Milk & Dairy,BROWN EGGS TRAY 30P,7,360,330,30,1
23-04-2025,Oils & Ghee,Groundnut oil 5 L,9,1800,"1,600.00",200,1
23-04-2025,"Grains, Flours & Dals",SRILATHA RICE RAVVA 500GM,4,70,70,0,2
23-04-2025,"Grains, Flours & Dals",turdal 1kg,4,660,510,150,3
23-04-2025,"Grains, Flours & Dals",AISHWARYA SP 1KG,4,800,700,100,10
23-04-2025,Sweeteners,organic jaggery powder,16,99,99,0,1
23-04-2025,"Grains, Flours & Dals",PESARA PAPPU 1 KG,4,170,145,25,1
23-04-2025,Spices & Seasonings,AVALU 250grms,15,60,40,20,1
23-04-2025,Spices & Seasonings,RED COPRA 500GM,15,170,148,22,1
23-04-2025,"Grains, Flours & Dals",CHANA DAL 1KG,4,112,96,16,1
23-04-2025,"Dry Fruits, Nuts & Seeds",DRYDATES YELLOW 250GM,2,135,120,15,1
23-04-2025,Spices & Seasonings,Jeera 100GM,15,50,45,5,1
23-04-2025,"Grains, Flours & Dals",URAD DALL,4,190,170,20,2
23-04-2025,"Grains, Flours & Dals",SAMALU (Little millet) 500 gms,4,85,65,20,1
23-04-2025,Spices & Seasonings,Tamarind 250GMS,15,160,130,30,2
23-04-2025,"Grains, Flours & Dals",chana flour 500 gms,4,60,54,6,1
23-04-2025,"Grains, Flours & Dals",UDALU (Barnyard millet) 500 gms,4,70,60,10,1
23-04-2025,"Dry Fruits, Nuts & Seeds",Groundnuts 1 kg,2,380,330,50,2
23-04-2025,"Grains, Flours & Dals",AISHWARYA SP 25KG,4,1999,"1,690.00",309,1
23-04-2025,"Grains, Flours & Dals",split black gram 1 kg,4,180,170,10,1
23-04-2025,"Grains, Flours & Dals",IDLY RAVA 1KG,4,120,100,20,2
23-04-2025,"Grains, Flours & Dals",IDLY RAVA 1KG,4,120,100,20,2
23-04-2025,"Dry Fruits, Nuts & Seeds",Groundnuts 1 kg,2,380,330,50,2
23-04-2025,"Grains, Flours & Dals",AISHWARYA SP 25KG,4,1999,"1,690.00",309,1
23-04-2025,"Grains, Flours & Dals",UDALU (Barnyard millet) 500 gms,4,70,60,10,1
23-04-2025,"Grains, Flours & Dals",chana flour 500 gms,4,60,54,6,1
23-04-2025,"Grains, Flours & Dals",URAD DALL,4,190,170,20,2
23-04-2025,"Grains, Flours & Dals",BLACK GRAM 1KG,4,150,140,10,1
23-04-2025,Spices & Seasonings,Tamarind 250GMS,15,160,130,30,2
23-04-2025,"Grains, Flours & Dals",SAMALU (Little millet) 500 gms,4,85,65,20,1
23-04-2025,"Grains, Flours & Dals",RAGULU 1 KG,4,140,120,20,2
23-04-2025,"Grains, Flours & Dals",MELMEKER 250GMS,4,60,45,15,1
23-04-2025,Spices & Seasonings,ROYAL SAFFRON 400GRMS,15,130,130,0,2
23-04-2025,"Grains, Flours & Dals",IDLY RAVA 1KG,4,60,50,10,1
23-04-2025,Pickles & Cooking Pastes,SD MANGO TOKKU,11,110,110,0,1
23-04-2025,"Grains, Flours & Dals",BOMBAY RAVA,4,70,55,15,1
23-04-2025,"Grains, Flours & Dals",Wheat Flour 1 kg,4,140,120,20,2
23-04-2025,"Grains, Flours & Dals",Brown RICE 1KG,4,700,650,50,10
23-04-2025,"Grains, Flours & Dals",AISHWARYA SP 25KG,4,1999,"1,690.00",309,1
23-04-2025,Snacks & Ready-to-Eat,SD DrybFruit LADDU WITH DATES 175GM,14,340,340,0,2
23-04-2025,"Grains, Flours & Dals",Multigrain 1 kg,4,100,85,15,1
23-04-2025,Spices & Seasonings,NUVVULU 250GM,15,100,85,15,1
23-04-2025,"Dry Fruits, Nuts & Seeds",Groundnuts 1 kg,2,380,330,50,2
23-04-2025,"Grains, Flours & Dals",AISHWARYA SP 25KG,4,1999,"1,690.00",309,1
23-04-2025,"Grains, Flours & Dals",IDLY RAVA 1KG,4,120,100,20,2
23-04-2025,"Grains, Flours & Dals",UNPOLISHED TURDALL 1KG,4,240,210,30,1
23-04-2025,Spices & Seasonings,Tamarind 250GMS,15,160,130,30,2
23-04-2025,"Grains, Flours & Dals",chana flour 500 gms,4,60,54,6,1
23-04-2025,"Grains, Flours & Dals",UDALU (Barnyard millet) 500 gms,4,70,60,10,1
23-04-2025,"Grains, Flours & Dals",turdal 1kg,4,220,170,50,1
23-04-2025,"Grains, Flours & Dals",SAMALU (Little millet) 500 gms,4,85,65,20,1
23-04-2025,Oils & Ghee,Safflower oil 1 L,9,400,400,0,1
23-04-2025,Oils & Ghee,Sesame oil 1 L,9,1120,"1,120.00",0,2
23-04-2025,"Grains, Flours & Dals",RAGI FLOUR 500GRMS,4,40,35,5,1
23-04-2025,Oils & Ghee,Groundnut oil 1 L,9,330,330,0,1
23-04-2025,"Grains, Flours & Dals",Wheat Rava M 500GM,4,33,30,3,1
23-04-2025,Snacks & Ready-to-Eat,SD FINGER Millet with palm Jaggery 250gm,14,135,135,0,1
23-04-2025,Oils & Ghee,Groundnut oil 500ml,9,180,165,15,1
23-04-2025,"Grains, Flours & Dals",SF OATS JUMBO ROLLED 500GM,4,249,249,0,1
23-04-2025,"Grains, Flours & Dals",Wheat Rava S 1KG,4,65,55,10,1
23-04-2025,Snacks & Ready-to-Eat,SD Groundnut with palm jaggery 250gm,14,135,135,0,1
23-04-2025,Spices & Seasonings,idli karam powdwer,15,65,65,0,1
23-04-2025,"Grains, Flours & Dals",BARLEY SEEDS 500 GM,4,90,70,20,1
23-04-2025,Snacks & Ready-to-Eat,VD MULTI CHAKKA,14,110,110,0,1
23-04-2025,"Grains, Flours & Dals",SL Idly Rava 1KG,4,65,55,10,1
23-04-2025,Oils & Ghee,Safflower oil 1 L,9,800,800,0,2
22-04-2025,General Household & Kitchenware,VERMI COMPOST MIX,3,60,60,0,2
22-04-2025,"Grains, Flours & Dals",unpolished turdall500grms,4,120,110,10,1
22-04-2025,Milk & Dairy,BROWN EGGS TRAY 30P,7,360,330,30,1
22-04-2025,Spices & Seasonings,coconut powder,15,90,70,20,1
22-04-2025,Milk & Dairy,BROWN EGGS 1P,7,84,72,12,6
22-04-2025,Snacks & Ready-to-Eat,TILLI CHIKKI,14,30,30,0,6
22-04-2025,"Grains, Flours & Dals",PESARA PAPPU 1 KG,4,170,145,25,1
22-04-2025,"Grains, Flours & Dals",AISHWARYA SP 5KG,4,400,375,25,1
22-04-2025,"Grains, Flours & Dals",PESARA PAPPU 1 KG,4,170,145,25,1
22-04-2025,"Dry Fruits, Nuts & Seeds",cashew,2,340,310,30,1
22-04-2025,"Grains, Flours & Dals",turdal 1kg,4,220,170,50,1
22-04-2025,"Grains, Flours & Dals",Wheat Flour 1 kg,4,70,60,10,1
22-04-2025,"Grains, Flours & Dals",THICK POHA 1KG,4,80,70,10,1
22-04-2025,"Grains, Flours & Dals",Green gram 500 gms,4,75,70,5,1
22-04-2025,Oils & Ghee,Sesame oil 500ml,9,295,280,15,1
22-04-2025,Oils & Ghee,Sesame oil 500ml,9,295,280,15,1
22-04-2025,Baking & Cooking Aids,GONDKATIRA Ag,0,85,75,10,1
22-04-2025,Snacks & Ready-to-Eat,SATHVI REGIVADA 200GM,14,80,60,20,1
22-04-2025,Oils & Ghee,Coconut oil 500 ml,9,220,200,20,1
22-04-2025,Oils & Ghee,Safflower oil 1 L,9,1200,"1,200.00",0,3
22-04-2025,"Grains, Flours & Dals",Wheat Flour 1 kg,4,140,120,20,2
22-04-2025,"Dry Fruits, Nuts & Seeds",SABJA SEEDS,2,140,140,0,2
22-04-2025,"Grains, Flours & Dals",Chana Flour 500 gms,4,280,220,60,2
22-04-2025,"Grains, Flours & Dals",Wheat Rava M 500GM,4,33,30,3,1
22-04-2025,"Grains, Flours & Dals",YB BLACK RICE 500GM,4,150,150,0,1
22-04-2025,"Grains, Flours & Dals",YB Red RICE 1 KG,4,150,120,30,1
22-04-2025,Oils & Ghee,Groundnut oil 1 L,9,330,330,0,1
22-04-2025,Spices & Seasonings,Menthulu 250 gms,15,50,45,5,1
22-04-2025,Spices & Seasonings,SONTI 50GM,15,30,20,10,1
22-04-2025,"Grains, Flours & Dals",YB CHITTIMUTYALU RICE 1KG,4,200,200,0,1
22-04-2025,General Household & Kitchenware,VERMI COMPOST MIX,3,60,60,0,2
22-04-2025,"Grains, Flours & Dals",Green Batani 250GM,4,55,45,10,1
22-04-2025,"Grains, Flours & Dals",Wheat Flour 1 kg,4,70,60,10,1
22-04-2025,Oils & Ghee,Sesame oil 1 L,9,560,560,0,1
22-04-2025,"Grains, Flours & Dals",Multigrain 1 kg,4,200,170,30,2
22-04-2025,Oils & Ghee,Groundnut oil 1 L,9,330,330,0,1
22-04-2025,"Grains, Flours & Dals",RAGI FLOUR 1KG,4,80,70,10,1
22-04-2025,"Health, Wellness & Ayurvedic Products",MH Millets Malt 500GM,5,200,190,10,1
22-04-2025,"Grains, Flours & Dals",Arikalu (kodo),4,70,65,5,1
22-04-2025,"Grains, Flours & Dals",KORRALU (FOXTAIL M) 500GM,4,65,55,10,1
22-04-2025,"Grains, Flours & Dals",SAMALU (Little millet) 500 gms,4,85,65,20,1
22-04-2025,"Grains, Flours & Dals",ANDU KORRALU (Brown top .mlt) 500,4,130,110,20,1
22-04-2025,"Grains, Flours & Dals",SAMALU (Little millet) 500 gms,4,85,65,20,1
22-04-2025,"Grains, Flours & Dals",Wheat Flour 1 kg,4,280,240,40,4
22-04-2025,"Grains, Flours & Dals",UDALU (Barnyard millet) 500 gms,4,70,60,10,1
22-04-2025,Snacks & Ready-to-Eat,PEANUT CHIKKI,14,44,44,0,2
22-04-2025,"Grains, Flours & Dals",Arikalu (kodo),4,70,65,5,1
22-04-2025,"Grains, Flours & Dals",KORRALU (FOXTAIL M) 500GM,4,65,55,10,1
22-04-2025,"Grains, Flours & Dals",White jowar.F 1 kg,4,200,160,40,2
22-04-2025,"Dry Fruits, Nuts & Seeds",RAW FLAXSEEDS SH,2,115,115,0,1
22-04-2025,Spices & Seasonings,Elaichi 25GM,15,145,120,25,1
22-04-2025,Oils & Ghee,mustard oil,9,195,195,0,1
22-04-2025,"Dry Fruits, Nuts & Seeds",SUNFLOWER SEEDS 250GRM,2,150,130,20,1
22-04-2025,"Dry Fruits, Nuts & Seeds",ANJEER 250GM,2,400,360,40,1
22-04-2025,"Dry Fruits, Nuts & Seeds",PUMPKIN SEEDS 250GM,2,200,160,40,1
22-04-2025,Milk & Dairy,HERITAGE BUTTERMILK,7,20,20,0,2
22-04-2025,"Dry Fruits, Nuts & Seeds",FLAX SEEDS 250GM,2,60,50,10,1
22-04-2025,"Grains, Flours & Dals",White jowar.F 1 kg,4,200,160,40,2
22-04-2025,Oils & Ghee,Coconut oil 500 ml,9,220,200,20,1
22-04-2025,"Grains, Flours & Dals",Wheat Flour 1 kg,4,140,120,20,2
22-04-2025,"Dry Fruits, Nuts & Seeds",SUNFLOWER SEEDS 250GRM,2,150,130,20,1
22-04-2025,Snacks & Ready-to-Eat,VD VAMUPUSA 175GM,14,60,60,0,1
22-04-2025,Snacks & Ready-to-Eat,VD MIXTURE 175 GM,14,60,60,0,1
22-04-2025,"Dry Fruits, Nuts & Seeds",WATERMELON SEEDS 250GRM,2,320,280,40,1
22-04-2025,Oils & Ghee,Groundnut oil 1 L,9,330,330,0,1
22-04-2025,"Dry Fruits, Nuts & Seeds",PUMPKIN SEEDS 250GM,2,200,160,40,1
22-04-2025,Spices & Seasonings,NUVVULU 250GM,15,100,85,15,1
22-04-2025,"Dry Fruits, Nuts & Seeds",FLAX SEEDS 250GM,2,60,50,10,1
22-04-2025,Snacks & Ready-to-Eat,VD PALLI LADDU,14,80,80,0,1
22-04-2025,Spices & Seasonings,RED COPRA 250GMS,15,85,74,11,1
22-04-2025,Spices & Seasonings,DRY MIECHI 200GM,15,80,60,20,1
22-04-2025,Spices & Seasonings,SATHVI ANASAPUVUU 25GM,15,90,65,25,1
22-04-2025,"Grains, Flours & Dals",AISHWARYA SP 1KG,4,800,700,100,10
22-04-2025,Spices & Seasonings,Black Till 250GM,15,90,75,15,1
22-04-2025,"Health, Wellness & Ayurvedic Products",MD Bringaraj Choornam 100GM,5,80,80,0,1
22-04-2025,Snacks & Ready-to-Eat,VD MULTI CHAKKA,14,110,110,0,1
22-04-2025,Snacks & Ready-to-Eat,VD NUVULLU CHIKKI,14,80,80,0,1
22-04-2025,Snacks & Ready-to-Eat,VD DAHI MIRCHI(SALTED) 100GM,14,45,45,0,1
22-04-2025,"Dry Fruits, Nuts & Seeds",Groundnuts 500 gms,2,95,85,10,1
22-04-2025,"Grains, Flours & Dals",CHANA DAL 500GM,4,56,48,8,1
22-04-2025,"Grains, Flours & Dals",Green gram 1 kg,4,150,130,20,1
22-04-2025,Oils & Ghee,Black Sesame oil 500 ml,9,220,190,30,1
22-04-2025,"Grains, Flours & Dals",chana flour 500 gms,4,60,54,6,1
22-04-2025,Oils & Ghee,Coconut oil 500 ml,9,220,200,20,1
22-04-2025,Spices & Seasonings,LG 50GM,15,92,92,0,1
22-04-2025,Spices & Seasonings,NUVVULU 250GM,15,80,65,15,1
22-04-2025,"Grains, Flours & Dals",RAGI FLOUR 500GRMS,4,40,35,5,1
22-04-2025,"Grains, Flours & Dals",RAGULU 1 KG,4,35,30,5,0.5
22-04-2025,"Grains, Flours & Dals",White jowar.F 1 kg,4,25,20,5,0.25
22-04-2025,"Grains, Flours & Dals",BAJRA 1 KG,4,15,12.5,2.5,0.25
22-04-2025,"Grains, Flours & Dals",FLOUR CHARGE,4,12,12,0,1
22-04-2025,Personal Care & Cosmetics,UVIS HENNA 100GM,10,120,120,0,2
22-04-2025,Personal Care & Cosmetics,DABUR RED PASTE 50GM,10,20,20,0,1
22-04-2025,Snacks & Ready-to-Eat,PEANUT CHIKKI,14,22,22,0,1
22-04-2025,Sweeteners,YB FOREST H 250 GMS,16,180,180,0,1
22-04-2025,Oils & Ghee,Groundnut oil 1 L,9,330,330,0,1
22-04-2025,Sweeteners,Natural Honey 500 gms,16,280,240,40,1
22-04-2025,"Grains, Flours & Dals",KORRALU (FOXTAIL M) 1KG,4,150,110,40,1
22-04-2025,Sweeteners,YB JAGGERY POWDER 1KG,16,140,140,0,1
22-04-2025,Spices & Seasonings,PN ORGANIC PINK SALT 1KG,15,124,124,0,1
22-04-2025,Snacks & Ready-to-Eat,BB VERMICELLY 500GM,14,53,53,0,1
22-04-2025,"Grains, Flours & Dals",Arikalu (kodo),4,70,65,5,1
22-04-2025,Milk & Dairy,HERITAGE TONED MILK 500ML,7,31,31,0,1
22-04-2025,"Grains, Flours & Dals",UDALU (Barnyard millet) 500 gms,4,70,60,10,1
22-04-2025,Milk & Dairy,BROWN EGGS 1P,7,140,120,20,10
22-04-2025,"Grains, Flours & Dals",RAGULU 1 KG,4,70,60,10,1
22-04-2025,Spices & Seasonings,Tamarind 250GMS,15,80,65,15,1
22-04-2025,"Grains, Flours & Dals",ANDU KORRALU (Brown top .mlt) 500,4,130,110,20,1
22-04-2025,"Health, Wellness & Ayurvedic Products",RB Max Protein Fruit &amp;Nut 50g,5,160,160,0,2
22-04-2025,Sweeteners,YB N FOREST HONEY 700 GM,16,400,400,0,1
22-04-2025,General Household & Kitchenware,IRN WDN HDL KADAI 9,3,240,240,0,1
22-04-2025,"Dry Fruits, Nuts & Seeds",PULMAKHANA 100 GM,2,360,340,20,2
22-04-2025,Snacks & Ready-to-Eat,VD Minapa papad 200gm,14,60,60,0,1
22-04-2025,Oils & Ghee,Groundnut oil 1 L,9,330,330,0,1
22-04-2025,Pooja & Spiritual Items,SWASTIK CAMPHOR 25GM,12,45,45,0,1
22-04-2025,Pooja & Spiritual Items,GOW DURBAR GEETHA CAMPHOR,12,60,60,0,1
22-04-2025,Personal Care & Cosmetics,KHADI ALMOND SOAP 125GM,10,180,140,40,2
22-04-2025,Personal Care & Cosmetics,KHADI COCONUT,10,180,140,40,2
22-04-2025,"Grains, Flours & Dals",PESARA PAPPU 1 KG,4,170,145,25,1
22-04-2025,Spices & Seasonings,AVALU 100GM,15,25,20,5,1
22-04-2025,"Grains, Flours & Dals",IDLY RAVA 1KG,4,60,50,10,1
22-04-2025,Spices & Seasonings,Tamarind 500GM,15,160,130,30,1
22-04-2025,"Grains, Flours & Dals",VGR RICE bag 1,4,1899,"1,650.00",249,1
22-04-2025,Sweeteners,SUGAR 1KG,16,120,112,8,2
22-04-2025,Spices & Seasonings,Tamarind 250GMS,15,160,130,30,2
22-04-2025,"Grains, Flours & Dals",URAD DALL,4,190,170,20,2
22-04-2025,"Grains, Flours & Dals",turdal 1kg,4,220,170,50,1
22-04-2025,Spices & Seasonings,Jeera 100GM,15,50,45,5,1
22-04-2025,"Grains, Flours & Dals",Arikadu ( kodo),4,280,260,20,2
22-04-2025,Beverages,BISLERI 100ml,1,10,10,0,1
22-04-2025,"Grains, Flours & Dals",samalu,4,260,260,0,2
22-04-2025,"Grains, Flours & Dals",BAJRA 1 KG,4,120,100,20,2
22-04-2025,"Grains, Flours & Dals",ANDU KORRALU (Browntop.m) 1 kg,4,1040,880,160,4
22-04-2025,"Grains, Flours & Dals",KORRALU (FOXTAIL M) 1KG,4,300,220,80,2
22-04-2025,Oils & Ghee,Groundnut oil 1 L,9,660,660,0,2
22-04-2025,Snacks & Ready-to-Eat,MB FOXTAIL MILLET NOODLES 180GM,14,95,95,0,1
22-04-2025,Oils & Ghee,Coconut oil 500 ml,9,220,200,20,1
22-04-2025,Oils & Ghee,Safflower oil 1 L,9,400,400,0,1
22-04-2025,Snacks & Ready-to-Eat,NGT CHATPATTA CHANA 90GM,14,50,50,0,2
22-04-2025,Oils & Ghee,Sesame oil 500ml,9,295,280,15,1
22-04-2025,"Grains, Flours & Dals",JOWAR UPMA RAVA,4,65,65,0,1
22-04-2025,Spices & Seasonings,3M.MIRCHI POWDER,15,145,115,30,1
22-04-2025,Spices & Seasonings,white miryalu,15,60,50,10,1
22-04-2025,Oils & Ghee,Groundnut oil 1 L,9,330,330,0,1
22-04-2025,Sweeteners,MISHRI 250 GM,16,35,30,5,1
22-04-2025,Snacks & Ready-to-Eat,SF MIGHTY PUFFS,14,25,25,0,1
22-04-2025,"Grains, Flours & Dals",AISHWARYA SP 1KG,4,400,350,50,5
22-04-2025,Snacks & Ready-to-Eat,SATHVI REGIVADA 200GM,14,320,240,80,4
22-04-2025,Spices & Seasonings,3M.MIRCHI POWDER,15,725,575,150,5
22-04-2025,"Grains, Flours & Dals",PESARA PAPPU 500GMS,4,85,75,10,1
22-04-2025,Spices & Seasonings,THREE MANGO RAI 200G,15,42,42,0,1
22-04-2025,Snacks & Ready-to-Eat,MNL IDLI MIX MILLET JOWAR,14,189,189,0,1
22-04-2025,Oils & Ghee,Groundnut oil 1 L,9,330,330,0,1
22-04-2025,Oils & Ghee,Sesame oil 1 L,9,560,560,0,1
22-04-2025,"Grains, Flours & Dals",RAGI FLOUR 500GRMS,4,40,35,5,1
22-04-2025,"Grains, Flours & Dals",Multigrain 1 kg,4,100,85,15,1
22-04-2025,"Grains, Flours & Dals",Wheat Flour 1 kg,4,70,60,10,1
22-04-2025,Spices & Seasonings,pickles chilli powder 500GM,15,325,325,0,1
22-04-2025,Oils & Ghee,Groundnut oil 1 L,9,660,660,0,2
22-04-2025,Oils & Ghee,Groundnut oil 1 L,9,330,330,0,1
22-04-2025,Snacks & Ready-to-Eat,VD CORNFLAKES MIXTURE 175GM,14,120,120,0,2
22-04-2025,"Grains, Flours & Dals",Wheat Flour 1 kg,4,70,60,10,1
22-04-2025,Snacks & Ready-to-Eat,sannakarampusa,14,60,60,0,1
22-04-2025,"Health, Wellness & Ayurvedic Products",RB Max Protein PERI PERI 60gm,5,90,90,0,2
22-04-2025,Snacks & Ready-to-Eat,NAVARATNA MIX,14,60,60,0,1
22-04-2025,Spices & Seasonings,PN ORGANIC PINK SALT 1KG,15,124,124,0,1
22-04-2025,"Grains, Flours & Dals",Green Batani 500GM,4,110,90,20,1
22-04-2025,"Grains, Flours & Dals",maida 500grms,4,35,30,5,1
22-04-2025,"Grains, Flours & Dals",turdal 500 gms,4,110,85,25,1
22-04-2025,"Grains, Flours & Dals",BASMATHI RICE 1KG,4,150,135,15,1
22-04-2025,"Grains, Flours & Dals",PESARA PAPPU 1 KG,4,170,145,25,1
22-04-2025,Snacks & Ready-to-Eat,KURNOOL MARMURA,14,70,55,15,1
22-04-2025,Spices & Seasonings,AVALU 100GM,15,25,20,5,1
22-04-2025,Sweeteners,mishri 500g,16,70,60,10,1
22-04-2025,Oils & Ghee,Groundnut oil 1 L,9,330,330,0,1
22-04-2025,Snacks & Ready-to-Eat,NGT CHATPATTA CHANA 90GM,14,25,25,0,1
22-04-2025,Snacks & Ready-to-Eat,VD MURUKU 175GM,14,120,120,0,2
22-04-2025,"Dry Fruits, Nuts & Seeds",SUNFLOWER SEEDS 250GRM,2,150,130,20,1
22-04-2025,Snacks & Ready-to-Eat,GB SALT COOKIES,14,60,55,5,1
22-04-2025,"Grains, Flours & Dals",Red Chana 250GM,4,35,30,5,1
22-04-2025,Snacks & Ready-to-Eat,SOYA MURK,14,60,60,0,1
22-04-2025,"Dry Fruits, Nuts & Seeds",WATERMELON SEEDS 250GRM,2,320,280,40,1
22-04-2025,"Dry Fruits, Nuts & Seeds",PUMPKIN SEEDS 250GM,2,200,160,40,1
22-04-2025,Snacks & Ready-to-Eat,BATANA NGT 70GMS,14,20,20,0,1
22-04-2025,"Dry Fruits, Nuts & Seeds",PUMPKIN SEEDS 250GM,2,200,160,40,1
22-04-2025,"Grains, Flours & Dals",BOBBARA PAPPU 1KG,4,180,160,20,1
22-04-2025,"Dry Fruits, Nuts & Seeds",SUNFLOWER SEEDS 250GRM,2,150,130,20,1
22-04-2025,Snacks & Ready-to-Eat,NGT CHATPATTA CHANA 90GM,14,20,20,0,1
22-04-2025,"Dry Fruits, Nuts & Seeds",Putnalu 250GM,2,45,38,7,1
22-04-2025,"Grains, Flours & Dals",Wheat Flour 1 kg,4,70,60,10,1
22-04-2025,Oils & Ghee,Safflower oil 1 L,9,400,400,0,1
22-04-2025,Oils & Ghee,Groundnut oil 1 L,9,660,660,0,2
22-04-2025,Snacks & Ready-to-Eat,VD RICE SAGO PAPAD 150GM,14,55,55,0,1
22-04-2025,Spices & Seasonings,DURGA SALT CRYSTAL 1KG,15,25,25,0,1
22-04-2025,Snacks & Ready-to-Eat,Pani Poori Chips 250GM,14,50,40,10,1
22-04-2025,Snacks & Ready-to-Eat,VD Pappu Chekkalu 190gm,14,60,60,0,1
22-04-2025,"Grains, Flours & Dals",unpolished turdall500grms,4,240,220,20,2
22-04-2025,Snacks & Ready-to-Eat,BB VERMICELLI 1KG,14,95,90,5,1
22-04-2025,Snacks & Ready-to-Eat,SD FLAX SEED APPADALU,14,90,90,0,1
22-04-2025,Spices & Seasonings,TATA SALT 1KG,15,30,30,0,1
22-04-2025,Snacks & Ready-to-Eat,VD Pappu Chekkalu 190gm,14,60,60,0,1
22-04-2025,"Grains, Flours & Dals",HS JOWAR IDLY RAWA,4,195,195,0,3
22-04-2025,Snacks & Ready-to-Eat,VD Pappu Chekkalu 190gm,14,60,60,0,1
22-04-2025,Snacks & Ready-to-Eat,PEANUT CHIKKI,14,44,44,0,2
22-04-2025,Oils & Ghee,Groundnut oil 1 L,9,330,330,0,1
22-04-2025,"Grains, Flours & Dals",BOMBAY RAVA,4,70,55,15,1
22-04-2025,Sweeteners,YB JAGGERY POWDER 500GMS,16,75,75,0,1
22-04-2025,Spices & Seasonings,Tamarind 250GMS,15,160,130,30,2
22-04-2025,"Grains, Flours & Dals",turdal 1kg,4,220,170,50,1
22-04-2025,"Grains, Flours & Dals",THICK POHA 1KG,4,80,70,10,1
22-04-2025,Snacks & Ready-to-Eat,VD PALLI CHIKKI,14,80,80,0,1
22-04-2025,"Dry Fruits, Nuts & Seeds",Groundnuts 1 kg,2,190,165,25,1
22-04-2025,"Grains, Flours & Dals",IDLY RAVA 1KG,4,180,150,30,3
22-04-2025,Snacks & Ready-to-Eat,GB SALT COOKIES,14,60,55,5,1
22-04-2025,"Grains, Flours & Dals",AISHWARYA SP 1KG,4,400,350,50,5
22-04-2025,"Grains, Flours & Dals",SL Idly Rava 1KG,4,65,55,10,1
22-04-2025,"Dry Fruits, Nuts & Seeds",FLAX SEEDS 250GM,2,60,50,10,1
22-04-2025,Misc,VD0009,8,100,100,0,1
22-04-2025,Sweeteners,YB JAGGERY POWDER 1KG,16,140,140,0,1
22-04-2025,"Dry Fruits, Nuts & Seeds",CASHEW,2,2040,"1,770.00",270,3
22-04-2025,"Grains, Flours & Dals",Brown RICE 1KG,4,350,325,25,5
22-04-2025,"Dry Fruits, Nuts & Seeds",BLACK KISMIS 250GM,2,175,140,35,1
22-04-2025,"Dry Fruits, Nuts & Seeds",PULMAKHANA 100 GM,2,180,170,10,1
22-04-2025,"Dry Fruits, Nuts & Seeds",DRYDATES 250GM,2,150,120,30,1
22-04-2025,"Dry Fruits, Nuts & Seeds",ALMONDS 250GM,2,560,520,40,2
22-04-2025,"Dry Fruits, Nuts & Seeds",FLAX SEEDS 250GM,2,60,50,10,1
22-04-2025,"Dry Fruits, Nuts & Seeds",DRYDATES YELLOW 250GM,2,135,120,15,1
22-04-2025,"Dry Fruits, Nuts & Seeds",PUMPKIN SEEDS 250GM,2,200,160,40,1
22-04-2025,"Grains, Flours & Dals",BARLEY SEEDS 500 GM,4,90,70,20,1
22-04-2025,"Dry Fruits, Nuts & Seeds",ANJEER 250GM,2,800,720,80,2
22-04-2025,"Dry Fruits, Nuts & Seeds",SUNFLOWER SEEDS 250GRM,2,150,130,20,1
22-04-2025,"Grains, Flours & Dals",Arikadu ( kodo),4,140,130,10,1
22-04-2025,Milk & Dairy,BROWN EGGS 1P,7,168,144,24,12
22-04-2025,Misc,VD00014,8,100,90,10,1
22-04-2025,Oils & Ghee,Coconut oil 500 ml,9,220,200,20,1
22-04-2025,Snacks & Ready-to-Eat,RSC ORANGE 100GMS,14,20,20,0,1
22-04-2025,"Grains, Flours & Dals",KORRALU (FOXTAIL M) 1KG,4,150,110,40,1
22-04-2025,"Grains, Flours & Dals",RAGI FLOUR 1KG,4,80,70,10,1
22-04-2025,Oils & Ghee,Groundnut oil 1 L,9,330,330,0,1
22-04-2025,Oils & Ghee,Sesame oil 1 L,9,560,560,0,1
22-04-2025,Spices & Seasonings,Avalu small 250 gms,15,60,40,20,1
22-04-2025,"Grains, Flours & Dals",Wheat Flour 1 kg,4,70,60,10,1
22-04-2025,"Grains, Flours & Dals",PESARA PAPPU 500GMS,4,85,75,10,1
22-04-2025,Spices & Seasonings,LG 50GM,15,92,92,0,1
22-04-2025,"Grains, Flours & Dals",turdal 500 gms,4,110,85,25,1
22-04-2025,"Dry Fruits, Nuts & Seeds",Groundnuts 1 kg,2,190,165,25,1
22-04-2025,"Grains, Flours & Dals",Red Chana 500 GM,4,150,120,30,2
22-04-2025,Spices & Seasonings,Coriander seeds 200 gms,15,48,40,8,1
22-04-2025,Spices & Seasonings,DURGA SALT CRYSTAL 1KG,15,25,25,0,1
22-04-2025,Spices & Seasonings,3M.MIRCHI POWDER,15,360,360,0,1
22-04-2025,Spices & Seasonings,DURGA SALT CRYSTAL 1KG,15,25,25,0,1
22-04-2025,Spices & Seasonings,Coriander seeds 200 gms,15,48,40,8,1
22-04-2025,"Dry Fruits, Nuts & Seeds",Groundnuts 1 kg,2,190,165,25,1
22-04-2025,Spices & Seasonings,3M.MIRCHI POWDER,15,360,227,133,1
22-04-2025,"Grains, Flours & Dals",turdal 500 gms,4,110,85,25,1
22-04-2025,Oils & Ghee,Groundnut oil 1 L,9,330,330,0,1
22-04-2025,"Grains, Flours & Dals",PESARA PAPPU 500GMS,4,85,75,10,1
22-04-2025,Oils & Ghee,Sesame oil 1 L,9,560,560,0,1
22-04-2025,Spices & Seasonings,LG 50GM,15,92,92,0,1
22-04-2025,"Grains, Flours & Dals",Wheat Flour 1 kg,4,70,60,10,1
22-04-2025,Household & Cleaning,VIM MAHA BAR,6,20,20,0,2
22-04-2025,"Grains, Flours & Dals",AISHWARYA SP 25KG,4,1999,"1,690.00",309,1
22-04-2025,Spices & Seasonings,DRY MIECHI 200GM,15,80,60,20,1
22-04-2025,Snacks & Ready-to-Eat,KURNOOL MARMURA,14,160,110,50,2
22-04-2025,Snacks & Ready-to-Eat,NGT CHATPATTA CHANA 90GM,14,50,50,0,2
22-04-2025,Snacks & Ready-to-Eat,VD NUVULLU CHIKKI,14,80,80,0,1
22-04-2025,"Dry Fruits, Nuts & Seeds",SATHVI CHIA SEEDS 100GM,2,100,80,20,1
22-04-2025,"Grains, Flours & Dals",THICK POHA 1KG,4,80,70,10,1
22-04-2025,Spices & Seasonings,LG 50GM,15,92,92,0,1
22-04-2025,Baking & Cooking Aids,GONDKATIRA Ag,0,85,75,10,1
22-04-2025,Spices & Seasonings,BLACK JEERA 50 GM,15,45,30,15,1
22-04-2025,"Grains, Flours & Dals",IDLY RAVA 1KG,4,60,50,10,1
22-04-2025,"Grains, Flours & Dals",White jowar.F 1 kg,4,100,80,20,1
22-04-2025,"Grains, Flours & Dals",VGR RICE bag 1,4,1899,"1,650.00",249,1
22-04-2025,Spices & Seasonings,NUVVULU 500GM,15,200,170,30,1
22-04-2025,Oils & Ghee,Groundnut oil 500ml,9,180,165,15,1
22-04-2025,Oils & Ghee,Sesame oil 500ml,9,295,280,15,1
22-04-2025,Snacks & Ready-to-Eat,RI Yogurt Berry Oats 35g,14,45,45,0,1
22-04-2025,"Health, Wellness & Ayurvedic Products",MAX PROTEIN,5,50,50,0,1
22-04-2025,Misc,VD00014,8,100,90,10,1
22-04-2025,"Dry Fruits, Nuts & Seeds",YB GRANMA NUTS,2,90,90,0,1
22-04-2025,"Grains, Flours & Dals",BARLEY SEEDS 500 GM,4,90,70,20,1
22-04-2025,"Grains, Flours & Dals",unpolished turdall500grms,4,120,110,10,1
22-04-2025,"Grains, Flours & Dals",Green gram 1 kg,4,150,130,20,1
22-04-2025,Spices & Seasonings,Gasagasalu 50GM,15,130,110,20,1
22-04-2025,"Dry Fruits, Nuts & Seeds",SABJA SEEDS,2,70,70,0,1
22-04-2025,"Dry Fruits, Nuts & Seeds",Groundnuts 1 kg,2,190,165,25,1
22-04-2025,"Health, Wellness & Ayurvedic Products",RB Max Protein PERI PERI 60gm,5,45,45,0,1
22-04-2025,"Grains, Flours & Dals",CHANA DAL 500GM,4,56,48,8,1
22-04-2025,"Grains, Flours & Dals",Urad dall 1 Kg,4,185,170,15,1
22-04-2025,Spices & Seasonings,AVALU 100GM,15,25,20,5,1
22-04-2025,Oils & Ghee,Coconut oil 500 ml,9,220,200,20,1
22-04-2025,Spices & Seasonings,Jeera 100GM,15,50,45,5,1
22-04-2025,Snacks & Ready-to-Eat,VD NUVULLU CHIKKI,14,80,80,0,1
22-04-2025,Spices & Seasonings,MIRYALU 50 GRMS,15,100,80,20,1
22-04-2025,Snacks & Ready-to-Eat,VD GUMMADI CHAKKA,14,130,130,0,1
22-04-2025,"Grains, Flours & Dals",Multigrain 1 kg,4,100,85,15,1
22-04-2025,Spices & Seasonings,RED COPRA 500GM,15,170,148,22,1
22-04-2025,"Grains, Flours & Dals",BARLEY SEEDS 250GMS,4,40,35,5,1
22-04-2025,"Grains, Flours & Dals",IDLY RAVA 1KG,4,120,100,20,2
22-04-2025,"Dry Fruits, Nuts & Seeds",Groundnuts 1 kg,2,380,330,50,2
22-04-2025,"Grains, Flours & Dals",BOMBAY RAVA,4,70,55,15,1
22-04-2025,"Grains, Flours & Dals",SH PANCHARATNA DALL,4,128,128,0,1
22-04-2025,"Grains, Flours & Dals",Arikadu ( kodo),4,140,130,10,1
22-04-2025,"Grains, Flours & Dals",UDALU (Barnyard millet) 1 kg,4,140,115,25,1
22-04-2025,"Grains, Flours & Dals",KORRALU (FOXTAIL M) 1KG,4,150,110,40,1
22-04-2025,"Grains, Flours & Dals",ANDU KORRALU (Browntop.m) 1 kg,4,260,220,40,1
22-04-2025,"Grains, Flours & Dals",samalu,4,130,130,0,1
21-04-2025,"Grains, Flours & Dals",IDLY RAVA 1KG,4,60,50,10,1
21-04-2025,Oils & Ghee,rice bran oil f,9,194,169,25,1
21-04-2025,"Dry Fruits, Nuts & Seeds",Groundnuts 1 kg,2,190,165,25,1
21-04-2025,Sweeteners,YB N FOREST HONEY 700 GM,16,550,550,0,1
21-04-2025,Oils & Ghee,Safflower oil 1 L,9,440,400,40,1
21-04-2025,"Grains, Flours & Dals",JOWAR UPMA RAVA,4,150,150,0,2
21-04-2025,"Grains, Flours & Dals",Quinova 1 kg,4,220,195,25,1
21-04-2025,Snacks & Ready-to-Eat,VD RICE SAGO PAPAD 150GM,14,55,55,0,1
21-04-2025,"Dry Fruits, Nuts & Seeds",PUMPKIN SEEDS 250GM,2,200,160,40,1
21-04-2025,"Grains, Flours & Dals",VGR rice 1 kg,4,350,325,25,5
21-04-2025,Milk & Dairy,BROWN EGGS 1P,7,280,240,40,20
21-04-2025,"Dry Fruits, Nuts & Seeds",SATHVI CHIA SEEDS 100GM,2,100,80,20,1
21-04-2025,Snacks & Ready-to-Eat,NGT CHATPATTA CHANA 90GM,14,75,75,0,3
21-04-2025,Oils & Ghee,Sesame oil 1 L,9,560,560,0,1
21-04-2025,Oils & Ghee,Coconut oil 1 L,9,440,400,40,1
21-04-2025,"Dry Fruits, Nuts & Seeds",PLAIN PISTA 250GM,2,660,550,110,1
21-04-2025,"Grains, Flours & Dals",Red Bobarlu 500 gms,4,95,85,10,1
21-04-2025,Oils & Ghee,Groundnut oil 1 L,9,330,330,0,1
21-04-2025,"Dry Fruits, Nuts & Seeds",ALMONDS 250GM,2,280,260,20,1
21-04-2025,Spices & Seasonings,NUVVULU 500GM,15,200,170,30,1
21-04-2025,"Dry Fruits, Nuts & Seeds",FLAX SEEDS 250GM,2,60,50,10,1
21-04-2025,"Dry Fruits, Nuts & Seeds",PUMPKIN SEEDS 250GM,2,200,160,40,1
21-04-2025,"Dry Fruits, Nuts & Seeds",BLACK KISMIS 250GM,2,175,140,35,1
21-04-2025,Spices & Seasonings,PN ORGANIC PINK SALT 1KG,15,124,124,0,1
21-04-2025,"Grains, Flours & Dals",Red Chana 500 GM,4,75,60,15,1
21-04-2025,"Dry Fruits, Nuts & Seeds",KAJU HALF 250GM,2,310,290,20,1
21-04-2025,"Dry Fruits, Nuts & Seeds",Groundnuts 1 kg,2,190,165,25,1
21-04-2025,"Dry Fruits, Nuts & Seeds",PULMAKHANA 100 GM,2,360,340,20,2
21-04-2025,"Grains, Flours & Dals",HS JOWAR IDLY RAWA,4,65,65,0,1
21-04-2025,"Grains, Flours & Dals",Multigrain 1 kg,4,100,85,15,1
21-04-2025,"Dry Fruits, Nuts & Seeds",SATHVI CHIA SEEDS 100GM,2,100,80,20,1
21-04-2025,Household & Cleaning,GOODKNIGHT,6,85,85,0,1
21-04-2025,"Grains, Flours & Dals",chana flour 500 gms,4,60,54,6,1
21-04-2025,Snacks & Ready-to-Eat,NGT CHATPATTA CHANA 90GM,14,25,25,0,1
21-04-2025,Spices & Seasonings,SF CASSIA,15,75,75,0,1
21-04-2025,Oils & Ghee,Groundnut oil 1 L,9,330,330,0,1
21-04-2025,"Grains, Flours & Dals",RICE FLOUR 1KG,4,70,55,15,1
21-04-2025,"Grains, Flours & Dals",White jowar.F 1 kg,4,100,80,20,1
21-04-2025,"Grains, Flours & Dals",MELMEKER 250GMS,4,60,45,15,1
21-04-2025,Snacks & Ready-to-Eat,MIGHTY PUFFS KHATTA METTA,14,50,50,0,2
21-04-2025,"Grains, Flours & Dals",Wheat Flour 1 kg,4,70,60,10,1
21-04-2025,"Grains, Flours & Dals",THICK POHA 500GM,4,40,35,5,1
21-04-2025,Household & Cleaning,VIM MAHA BAR,6,20,20,0,2
21-04-2025,Oils & Ghee,Groundnut oil 1 L,9,330,330,0,1
21-04-2025,"Grains, Flours & Dals",white Bobarlu 500 gms,4,80,75,5,1
21-04-2025,Sweeteners,mishri 500g,16,70,60,10,1
21-04-2025,"Dry Fruits, Nuts & Seeds",Groundnuts 1 kg,2,190,165,25,1
21-04-2025,"Grains, Flours & Dals",Sathya Javva Wheat Rava 500GM,4,95,95,0,1
21-04-2025,"Grains, Flours & Dals",HS BARLEY FLAKES 250GM 1+1,4,119,119,0,1
21-04-2025,Oils & Ghee,Sesame oil 5 L,9,2950,"2,750.00",200,1
21-04-2025,Oils & Ghee,Sesame oil 500ml,9,295,280,15,1
21-04-2025,Oils & Ghee,Groundnut oil 5 L,9,1800,"1,600.00",200,1
21-04-2025,"Grains, Flours & Dals",UDALU (Barnyard millet) 1 kg,4,140,115,25,1
21-04-2025,"Grains, Flours & Dals",KORRALU (FOXTAIL M) 1KG,4,150,110,40,1
21-04-2025,"Grains, Flours & Dals",ANDU KORRALU (Browntop.m) 1 kg,4,260,220,40,1
21-04-2025,"Grains, Flours & Dals",MULTIMILLET IDLY RAVVA,4,65,65,0,1
21-04-2025,"Grains, Flours & Dals",samalu,4,130,130,0,1
21-04-2025,"Grains, Flours & Dals",Arikadu ( kodo),4,140,130,10,1
21-04-2025,"Grains, Flours & Dals",SAMALU (Little millet) 500 gms,4,85,65,20,1
21-04-2025,"Grains, Flours & Dals",UDALU (Barnyard millet) 500 gms,4,70,60,10,1
21-04-2025,"Grains, Flours & Dals",KORRALU (FOXTAIL M) 500GM,4,65,55,10,1
21-04-2025,"Grains, Flours & Dals",Arikalu (kodo),4,70,65,5,1
21-04-2025,"Grains, Flours & Dals",White jowar.F 1 kg,4,100,80,20,1
21-04-2025,"Grains, Flours & Dals",SL Idly Rava 1KG,4,65,55,10,1
21-04-2025,"Grains, Flours & Dals",RAGI FLOUR 1KG,4,80,70,10,1
21-04-2025,Oils & Ghee,Safflower oil 1 L,9,440,400,40,1
21-04-2025,"Grains, Flours & Dals",BOMBAY RAVA,4,70,55,15,1
21-04-2025,Snacks & Ready-to-Eat,VD PALLI LADDU,14,160,160,0,2
21-04-2025,Snacks & Ready-to-Eat,GREEN FRIED batana,14,40,40,0,2
21-04-2025,Oils & Ghee,Groundnut oil 1 L,9,360,330,30,1
21-04-2025,Beverages,BISLERI 100ml,1,10,10,0,1
21-04-2025,Milk & Dairy,HERITAGE TOTAL CURD 500GM,7,50,50,0,1
21-04-2025,Spices & Seasonings,beetroot powder,15,149,149,0,1
21-04-2025,Personal Care & Cosmetics,GOW DURBAR NAVA 100GM SOAP,10,80,80,0,2
21-04-2025,Snacks & Ready-to-Eat,MB FOXTAIL MILLET NOODLES 180GM,14,95,95,0,1
21-04-2025,Spices & Seasonings,Vamu 100GM,15,60,50,10,1
21-04-2025,"Grains, Flours & Dals",unpolished turdall500grms,4,120,110,10,1
21-04-2025,Personal Care & Cosmetics,UVIS SANDALWOOD POWDR 100gm,10,149,149,0,1
21-04-2025,Spices & Seasonings,AVALU 100GM,15,25,20,5,1
21-04-2025,Oils & Ghee,Sesame oil 500ml,9,295,280,15,1
21-04-2025,Milk & Dairy,SANGAM CURD 450GM,7,38,38,0,1
21-04-2025,Spices & Seasonings,SAFE HARVEST FENNEL SANUF,15,110,110,0,1
21-04-2025,"Grains, Flours & Dals",chana flour 500 gms,4,60,54,6,1
21-04-2025,"Grains, Flours & Dals",Multigrain 1 kg,4,200,170,30,2
21-04-2025,Oils & Ghee,Coconut oil 500 ml,9,220,200,20,1
21-04-2025,"Dry Fruits, Nuts & Seeds",PUMPKIN SEEDS 250GM,2,200,160,40,1
21-04-2025,"Grains, Flours & Dals",SL Idly Rava 1KG,4,65,55,10,1
21-04-2025,Sweeteners,MISHRI 250 GM,16,35,30,5,1
21-04-2025,Snacks & Ready-to-Eat,VD SAGOPAPAD 150GM,14,55,55,0,1
21-04-2025,Snacks & Ready-to-Eat,SUNNUNDALU,14,120,120,0,1
21-04-2025,Oils & Ghee,Black Sesame oil 500 ml,9,440,380,60,2
21-04-2025,"Grains, Flours & Dals",Wheat Flour 1 kg,4,140,120,20,2
21-04-2025,"Grains, Flours & Dals",White jowar.F 1 kg,4,100,80,20,1
21-04-2025,"Dry Fruits, Nuts & Seeds",YB GRANMA NUTS,2,90,90,0,1
21-04-2025,Misc,VD0009,8,100,100,0,1
21-04-2025,Beverages,REFRESH SHARBATH SUGAR FREE,1,299,285,14,1
21-04-2025,Baking & Cooking Aids,GONDKATIRA Ag,0,170,150,20,2
21-04-2025,Oils & Ghee,Sesame oil 1 L,9,560,560,0,1
21-04-2025,"Dry Fruits, Nuts & Seeds",SABJA SEEDS,2,70,70,0,1
21-04-2025,"Grains, Flours & Dals",Green gram 1 kg,4,150,130,20,1
21-04-2025,"Grains, Flours & Dals",KORRALU (FOXTAIL M) 1KG,4,150,110,40,1
21-04-2025,Oils & Ghee,Groundnut oil 5 L,9,1800,"1,600.00",200,1
21-04-2025,"Grains, Flours & Dals",Wheat Flour 1 kg,4,70,60,10,1
21-04-2025,"Grains, Flours & Dals",Wheat Rava S 1KG,4,65,55,10,1
21-04-2025,"Dry Fruits, Nuts & Seeds",Groundnuts 1 kg,2,190,165,25,1
21-04-2025,"Grains, Flours & Dals",Urad dall 1 Kg,4,370,340,30,2
21-04-2025,"Grains, Flours & Dals",IDLY RAVA 1KG,4,120,100,20,2
21-04-2025,Sweeteners,sugar 500 gms,16,30,28,2,1
21-04-2025,"Grains, Flours & Dals",yellow jowar flour 1kg,4,200,184,16,2
21-04-2025,"Grains, Flours & Dals",BOMBAY RAVA,4,70,55,15,1
21-04-2025,Snacks & Ready-to-Eat,SATHVI REGIVADA 200GM,14,160,120,40,2
21-04-2025,"Grains, Flours & Dals",Wheat Flour 1 kg,4,210,180,30,3
21-04-2025,Spices & Seasonings,Chilli powder 500 gms,15,290,210,80,1
21-04-2025,Spices & Seasonings,Turmeric powder 250 gms,15,100,75,25,1
21-04-2025,Oils & Ghee,Sesame oil 1 L,9,560,560,0,1
21-04-2025,Spices & Seasonings,Vamu 100GM,15,60,50,10,1
21-04-2025,Spices & Seasonings,SONTI 50GM,15,60,40,20,2
21-04-2025,Spices & Seasonings,BLACK JEERA 50 GM,15,45,30,15,1
21-04-2025,"Grains, Flours & Dals",White jowar.F 1 kg,4,100,80,20,1
21-04-2025,Oils & Ghee,Groundnut oil 1 L,9,1080,990,90,3
21-04-2025,Sweeteners,MISHRI D,16,40,30,10,1
21-04-2025,Sweeteners,sugar 500 gms,16,30,28,2,1
21-04-2025,"Grains, Flours & Dals",Wheat Flour 1 kg,4,140,120,20,2
21-04-2025,Oils & Ghee,cow ghee 500 ml,9,430,390,40,1
21-04-2025,"Grains, Flours & Dals",SABDANA 500GM,4,90,70,20,1
21-04-2025,Spices & Seasonings,JEERA 250 gms,15,125,105,20,1
21-04-2025,"Grains, Flours & Dals",THIN POHA 500GM,4,40,35,5,1
21-04-2025,"Dry Fruits, Nuts & Seeds",Groundnuts 500 gms,2,95,85,10,1
21-04-2025,Oils & Ghee,Sesame oil 500ml,9,590,560,30,2
21-04-2025,"Grains, Flours & Dals",AISHWARYA SP 1KG,4,800,700,100,10
21-04-2025,"Grains, Flours & Dals",RICE FLOUR 1KG,4,70,55,15,1
21-04-2025,"Grains, Flours & Dals",RAGI FLOUR 1KG,4,80,70,10,1
21-04-2025,"Grains, Flours & Dals",SABDANA,4,40,35,5,1
21-04-2025,"Dry Fruits, Nuts & Seeds",PULMAKHANA 100 GM,2,180,170,10,1
21-04-2025,"Grains, Flours & Dals",THICK POHA 500GM,4,40,35,5,1
21-04-2025,Spices & Seasonings,NUVVULU 250GM,15,80,65,15,1
21-04-2025,"Dry Fruits, Nuts & Seeds",FLAX SEEDS 250GM,2,60,50,10,1
21-04-2025,Milk & Dairy,SANGAM TONED MILK 500ML,7,30,30,0,1
21-04-2025,Spices & Seasonings,AVALU 100GM,15,25,20,5,1
21-04-2025,"Grains, Flours & Dals",Urad dall 1 Kg,4,370,340,30,2
21-04-2025,"Grains, Flours & Dals",IDLY RAVA 1KG,4,60,50,10,1
21-04-2025,"Dry Fruits, Nuts & Seeds",SABJA SEEDS,2,70,70,0,1
21-04-2025,"Grains, Flours & Dals",PESARA PAPPU 500GMS,4,85,75,10,1
21-04-2025,Spices & Seasonings,Jeera 100GM,15,50,45,5,1
21-04-2025,Oils & Ghee,Sesame oil 1 L,9,560,560,0,1
21-04-2025,"Grains, Flours & Dals",chana flour 500 gms,4,60,54,6,1
21-04-2025,Milk & Dairy,BROWN EGGS 1P,7,84,72,12,6
21-04-2025,"Grains, Flours & Dals",turdal 1kg,4,220,170,50,1
21-04-2025,"Grains, Flours & Dals",Wheat Flour 1 kg,4,140,120,20,2
21-04-2025,"Grains, Flours & Dals",DH URAD GOTA 1KG,4,215,190,25,1
21-04-2025,Baking & Cooking Aids,Baking Soda 50GM,0,20,15,5,1
21-04-2025,Snacks & Ready-to-Eat,Corn Chips 250GM,14,40,35,5,1
21-04-2025,Oils & Ghee,Sesame oil 1 L,9,560,560,0,1
21-04-2025,Spices & Seasonings,THOKA MIRYALU 50GM,15,100,80,20,1
21-04-2025,"Grains, Flours & Dals",Arikalu (kodo),4,70,65,5,1
21-04-2025,"Grains, Flours & Dals",MULTIMILLET IDLY RAVVA,4,65,65,0,1
21-04-2025,"Grains, Flours & Dals",KORRALU (FOXTAIL M) 500GM,4,65,55,10,1
21-04-2025,"Dry Fruits, Nuts & Seeds",PULMAKHANA 100 GM,2,180,170,10,1
21-04-2025,"Grains, Flours & Dals",SPLIT BLACK GRAM 500 GM,4,90,85,5,1
21-04-2025,"Dry Fruits, Nuts & Seeds",Groundnuts 500 gms,2,95,85,10,1
21-04-2025,Sweeteners,YB JAGGERY POWDER 1KG,16,140,140,0,1
21-04-2025,"Grains, Flours & Dals",SL Idly Rava 1KG,4,65,55,10,1
21-04-2025,Pooja & Spiritual Items,VRP APOORVA JAVADHU POW,12,30,30,0,1
21-04-2025,"Grains, Flours & Dals",Wheat Flour 1 kg,4,280,240,40,4
21-04-2025,"Grains, Flours & Dals",multi mllit umpa ravva,4,129,129,0,1
21-04-2025,"Grains, Flours & Dals",URAD DALL,4,95,85,10,1
21-04-2025,Spices & Seasonings,SD Redgram Karam Powder 100GM,15,65,65,0,1
21-04-2025,"Grains, Flours & Dals",turdal 1kg,4,220,170,50,1
21-04-2025,Snacks & Ready-to-Eat,GB SALT COOKIES,14,60,55,5,1
21-04-2025,Personal Care & Cosmetics,MADDI BATH POWDER 400GM,10,150,150,0,1
21-04-2025,"Grains, Flours & Dals",KORRALU (FOXTAIL M) 500GM,4,65,55,10,1
21-04-2025,Oils & Ghee,Groundnut oil 1 L,9,360,330,30,1
21-04-2025,"Grains, Flours & Dals",UNPOLISHED TURDALL 1KG,4,240,210,30,1
21-04-2025,"Grains, Flours & Dals",UDALU (Barnyard millet) 500 gms,4,70,60,10,1
21-04-2025,Spices & Seasonings,Chilli powder 250 gms,15,145,110,35,1
21-04-2025,"Grains, Flours & Dals",SL Idly Rava 1KG,4,195,165,30,3
21-04-2025,"Grains, Flours & Dals",RAGI FLOUR 1KG,4,80,70,10,1
21-04-2025,"Grains, Flours & Dals",POORI ATTA 1KG,4,70,60,10,1
21-04-2025,"Grains, Flours & Dals",SRILATHA RICE RAVVA 500GM,4,70,70,0,2
21-04-2025,"Grains, Flours & Dals",Multigrain 1 kg,4,200,170,30,2
21-04-2025,"Grains, Flours & Dals",Wheat Flour 1 kg,4,140,120,20,2
21-04-2025,Spices & Seasonings,SH CASSIA STICKS 50GM,15,75,75,0,1
21-04-2025,Oils & Ghee,Sesame oil 1 L,9,1120,"1,120.00",0,2
21-04-2025,"Dry Fruits, Nuts & Seeds",ANJEER 250GM,2,400,360,40,1
21-04-2025,"Grains, Flours & Dals",Green gram 500 gms,4,150,140,10,2
21-04-2025,Oils & Ghee,Sesame oil 1 L,9,560,560,0,1
21-04-2025,"Dry Fruits, Nuts & Seeds",SUNFLOWER SEEDS 250GRM,2,150,130,20,1
21-04-2025,"Grains, Flours & Dals",SAMALU (Little millet) 500 gms,4,85,65,20,1
21-04-2025,"Grains, Flours & Dals",HS JOWAR IDLY RAWA,4,65,65,0,1
21-04-2025,"Dry Fruits, Nuts & Seeds",WATERMELON SEEDS 250GRM,2,320,280,40,1
21-04-2025,"Dry Fruits, Nuts & Seeds",PUMPKIN SEEDS 250GM,2,200,160,40,1
21-04-2025,"Grains, Flours & Dals",unpolished turdall500grms,4,120,110,10,1
21-04-2025,"Grains, Flours & Dals",turdal 500 gms,4,110,85,25,1
21-04-2025,"Dry Fruits, Nuts & Seeds",PULMAKHANA 100 GM,2,180,170,10,1
21-04-2025,Sweeteners,YB JAGGERY POWDER 1KG,16,140,140,0,1
21-04-2025,Oils & Ghee,Sesame oil 1 L,9,1120,"1,120.00",0,2
21-04-2025,Oils & Ghee,Groundnut oil 1 L,9,720,660,60,2
21-04-2025,"Grains, Flours & Dals",SA Multi Grain Mix 500GM,4,159,159,0,1
21-04-2025,Snacks & Ready-to-Eat,FOXTAIL NOODLES,14,75,75,0,1
21-04-2025,"Dry Fruits, Nuts & Seeds",ALBUKARA 250GM,2,145,120,25,1
21-04-2025,Snacks & Ready-to-Eat,GREEN FRIED batana,14,20,20,0,1
21-04-2025,"Grains, Flours & Dals",MELMEKER 250GMS,4,60,45,15,1
21-04-2025,Snacks & Ready-to-Eat,NGT CHATPATTA CHANA 90GM,14,25,25,0,1
21-04-2025,"Grains, Flours & Dals",DH URAD GOTA 1KG,4,645,570,75,3
21-04-2025,"Grains, Flours & Dals",SRILATHA RICE RAVVA 500GM,4,70,70,0,2
21-04-2025,"Grains, Flours & Dals",Chana Flour 500 gms,4,140,110,30,1
21-04-2025,"Grains, Flours & Dals",RICE FLOUR 1KG,4,70,55,15,1
21-04-2025,Spices & Seasonings,Tamarind 500GM,15,320,260,60,2
21-04-2025,Spices & Seasonings,DRY MIECHI 200GM,15,160,120,40,2
21-04-2025,"Grains, Flours & Dals",AISHWARYA SP 1KG,4,1200,"1,050.00",150,15
21-04-2025,"Dry Fruits, Nuts & Seeds",Groundnuts 500 gms,2,190,170,20,2
21-04-2025,Spices & Seasonings,Chilli powder 500 gms,15,580,420,160,2
21-04-2025,"Grains, Flours & Dals",SRILATHA RICE RAVVA 500GM,4,70,70,0,2
21-04-2025,"Grains, Flours & Dals",POORI ATTA 500GM,4,35,30,5,1
21-04-2025,"Grains, Flours & Dals",BARLEY SEEDS 250GMS,4,40,35,5,1
21-04-2025,Sweeteners,YB JAGGERY POWDER 1KG,16,140,140,0,1
21-04-2025,"Grains, Flours & Dals",Urad dall 1 Kg,4,185,170,15,1
21-04-2025,Milk & Dairy,ID PANEER,7,135,135,0,1
21-04-2025,"Grains, Flours & Dals",SB Javva Wheat Ravva 500GM,4,190,190,0,2
21-04-2025,"Dry Fruits, Nuts & Seeds",FLAX SEEDS 250GM,2,60,50,10,1
21-04-2025,Spices & Seasonings,NUVVULU 250GM,15,100,85,15,1
21-04-2025,Misc,C123,8,95,80,15,1
21-04-2025,"Grains, Flours & Dals",AISHWARYA SP 1KG,4,80,70,10,1
21-04-2025,"Dry Fruits, Nuts & Seeds",SUNFLOWER SEEDS 250GRM,2,150,130,20,1
21-04-2025,"Dry Fruits, Nuts & Seeds",WATERMELON SEEDS 250GRM,2,320,280,40,1
21-04-2025,"Dry Fruits, Nuts & Seeds",PUMPKIN SEEDS 250GM,2,200,160,40,1
21-04-2025,Oils & Ghee,Groundnut oil 1 L,9,360,330,30,1
21-04-2025,Snacks & Ready-to-Eat,KURNOOL MARMURA,14,70,55,15,1
21-04-2025,"Grains, Flours & Dals",chana flour 500 gms,4,60,54,6,1
21-04-2025,Snacks & Ready-to-Eat,VD NUVULLU CHIKKI,14,80,80,0,1
21-04-2025,"Grains, Flours & Dals",Wheat Flour 1 kg,4,70,60,10,1
21-04-2025,"Grains, Flours & Dals",Multigrain 1 kg,4,100,85,15,1
21-04-2025,Oils & Ghee,Safflower oil 500 ml,9,220,200,20,1
21-04-2025,Baking & Cooking Aids,MTR GULAB JAMUN MIX 190GM,0,80,80,0,1
21-04-2025,"Grains, Flours & Dals",RAGI FLOUR 1KG,4,160,140,20,2
21-04-2025,Beverages,BISLERI 100ml,1,10,10,0,1
21-04-2025,Oils & Ghee,Coconut oil 1 L,9,880,800,80,2
21-04-2025,Oils & Ghee,Sesame oil 1 L,9,1120,"1,120.00",0,2
21-04-2025,"Grains, Flours & Dals",RAGULU 1 KG,4,70,60,10,1
21-04-2025,Sweeteners,ACHU BELLAM 1KG,16,100,80,20,1
21-04-2025,Sweeteners,ACHUBELLAM 500GM,16,50,40,10,1
21-04-2025,Oils & Ghee,Groundnut oil 1 L,9,720,660,60,2
21-04-2025,Spices & Seasonings,AVALU 100GM,15,25,20,5,1
21-04-2025,"Grains, Flours & Dals",Urad dall 1 Kg,4,185,170,15,1
21-04-2025,"Dry Fruits, Nuts & Seeds",Groundnuts 1 kg,2,190,165,25,1
21-04-2025,"Grains, Flours & Dals",BARLY POWDER,4,80,80,0,2
21-04-2025,Oils & Ghee,Safflower oil 1 L,9,880,800,80,2
21-04-2025,"Grains, Flours & Dals",BOMBAY RAVA,4,70,55,15,1
21-04-2025,"Grains, Flours & Dals",Wheat Flour 1 kg,4,140,120,20,2
21-04-2025,"Grains, Flours & Dals",Wheat Flour 1 kg,4,700,600,100,10
21-04-2025,Oils & Ghee,Groundnut oil 1 L,9,360,330,30,1
21-04-2025,Snacks & Ready-to-Eat,PEANUT CHIKKI,14,22,22,0,1
21-04-2025,Snacks & Ready-to-Eat,FOXTAIL NOODLES,14,75,75,0,1
21-04-2025,Snacks & Ready-to-Eat,TILLI CHIKKI,14,5,5,0,1
21-04-2025,Spices & Seasonings,SAJEERA,15,60,40,20,1
21-04-2025,Snacks & Ready-to-Eat,PEANUT CHILLI,14,10,10,0,2
21-04-2025,Oils & Ghee,Sesame oil 1 L,9,560,560,0,1
21-04-2025,Oils & Ghee,Groundnut oil 1 L,9,360,330,30,1
21-04-2025,"Grains, Flours & Dals",SB Javva Wheat Ravva 500GM,4,190,190,0,2
21-04-2025,Snacks & Ready-to-Eat,VD PALLI LADDU,14,80,80,0,1
21-04-2025,Snacks & Ready-to-Eat,VD MURUKU 175GM,14,60,60,0,1
21-04-2025,Snacks & Ready-to-Eat,VD BELLAM GAVVALU 200GM,14,60,60,0,1
21-04-2025,"Grains, Flours & Dals",BLACK GRAM 1KG,4,150,140,10,1
21-04-2025,"Grains, Flours & Dals",Wheat Flour 1 kg,4,70,60,10,1
21-04-2025,"Dry Fruits, Nuts & Seeds",SUNFLOWER SEEDS 250GRM,2,150,130,20,1
21-04-2025,Baking & Cooking Aids,GONDKATIRA Ag,0,85,75,10,1
21-04-2025,Sweeteners,GS Palm Jaggery Powder 400GM,16,180,180,0,1
21-04-2025,"Grains, Flours & Dals",KORRALU (FOXTAIL M) 1KG,4,150,110,40,1
21-04-2025,Personal Care & Cosmetics,GOW DURBAR NAVA 100GM SOAP,10,40,40,0,1
21-04-2025,Pooja & Spiritual Items,GOW DURBAR GEETHA CAMPHOR,12,60,60,0,1
21-04-2025,"Grains, Flours & Dals",Urad dall 1 Kg,4,185,170,15,1
21-04-2025,Pooja & Spiritual Items,GD KASTHURI,12,60,60,0,1
21-04-2025,Pooja & Spiritual Items,bilwa patra,12,60,60,0,1
21-04-2025,Spices & Seasonings,SONTI 50GM,15,30,20,10,1
21-04-2025,"Dry Fruits, Nuts & Seeds",Groundnuts 1 kg,2,380,330,50,2
21-04-2025,"Grains, Flours & Dals",Green gram 1 kg,4,150,130,20,1
21-04-2025,General Household & Kitchenware,NYLON WIRE,3,48,48,0,1
21-04-2025,"Dry Fruits, Nuts & Seeds",YB GRANMA NUTS,2,90,90,0,1
21-04-2025,Misc,VD0009,8,100,100,0,1
21-04-2025,"Grains, Flours & Dals",BARLEY SEEDS 500 GM,4,90,70,20,1
21-04-2025,Spices & Seasonings,lavangam,15,100,100,0,2
21-04-2025,Spices & Seasonings,AVALU 250grms,15,60,60,0,1
21-04-2025,Spices & Seasonings,Vamu 100GM,15,60,50,10,1
21-04-2025,Spices & Seasonings,Elaichi 25GM,15,290,240,50,2
21-04-2025,Spices & Seasonings,Jeera 100GM,15,100,90,10,2
21-04-2025,Misc,ROLL D C,8,140,90,50,2
21-04-2025,"Grains, Flours & Dals",PESARA PAPPU 500GMS,4,85,75,10,1
21-04-2025,"Grains, Flours & Dals",URAD DALL,4,95,85,10,1
21-04-2025,Spices & Seasonings,Coriander seeds 200 gms,15,48,40,8,1
21-04-2025,"Dry Fruits, Nuts & Seeds",Groundnuts 1 kg,2,190,165,25,1
21-04-2025,Spices & Seasonings,DURGA SALT CRYSTAL 1KG,15,25,25,0,1
21-04-2025,Spices & Seasonings,Tamarind 500GM,15,160,130,30,1
21-04-2025,"Grains, Flours & Dals",turdal 500 gms,4,110,85,25,1
21-04-2025,Spices & Seasonings,RED COPRA 250GMS,15,85,74,11,1
21-04-2025,"Grains, Flours & Dals",CHANA DAL 500GM,4,56,48,8,1
21-04-2025,"Grains, Flours & Dals",White jowar.F 1 kg,4,200,160,40,2
21-04-2025,"Grains, Flours & Dals",Wheat Flour 1 kg,4,70,60,10,1
21-04-2025,Oils & Ghee,Sesame oil 1 L,9,1120,"1,120.00",0,2
21-04-2025,Spices & Seasonings,pickle chili powder,15,180,165,15,1
21-04-2025,Spices & Seasonings,NUVVULU 500GM,15,400,340,60,2
21-04-2025,Milk & Dairy,HERITAGE TOTAL CURD 500GM,7,50,50,0,1
21-04-2025,"Grains, Flours & Dals",RAGI FLOUR 1KG,4,80,70,10,1
21-04-2025,"Grains, Flours & Dals",Wheat Flour 1 kg,4,280,240,40,4
21-04-2025,"Grains, Flours & Dals",White jowar.F 1 kg,4,100,80,20,1
21-04-2025,Oils & Ghee,cow ghee 500 ml,9,430,390,40,1
21-04-2025,"Grains, Flours & Dals",THICK POHA 500GM,4,40,35,5,1
21-04-2025,Oils & Ghee,Safflower oil 1 L,9,440,400,40,1
21-04-2025,"Grains, Flours & Dals",THICK POHA 1KG,4,80,70,10,1
21-04-2025,"Dry Fruits, Nuts & Seeds",SUNFLOWER SEEDS 250GRM,2,150,130,20,1
21-04-2025,"Dry Fruits, Nuts & Seeds",WATERMELON SEEDS 250GRM,2,320,280,40,1
21-04-2025,"Dry Fruits, Nuts & Seeds",PUMPKIN SEEDS 250GM,2,200,160,40,1
21-04-2025,"Dry Fruits, Nuts & Seeds",BLACK KISMIS 250GM,2,175,140,35,1
21-04-2025,Snacks & Ready-to-Eat,VD PALLI LADDU,14,80,80,0,1
21-04-2025,Oils & Ghee,Safflower oil 500 ml,9,220,200,20,1
21-04-2025,"Dry Fruits, Nuts & Seeds",YB GRANMA NUTS,2,90,90,0,1
21-04-2025,Oils & Ghee,Groundnut oil 1 L,9,720,660,60,2
21-04-2025,"Grains, Flours & Dals",RAGI FLOUR 500GRMS,4,40,35,5,1
21-04-2025,Spices & Seasonings,Tamarind 250GMS,15,80,65,15,1
21-04-2025,Spices & Seasonings,PN ORGANIC PINK SALT 1KG,15,124,124,0,1
21-04-2025,Spices & Seasonings,Turmeric powder 250 gms,15,100,75,25,1
21-04-2025,"Dry Fruits, Nuts & Seeds",PULMAKHANA 100 GM,2,180,170,10,1
21-04-2025,"Grains, Flours & Dals",MELMEKER 250GMS,4,60,45,15,1
21-04-2025,Oils & Ghee,Groundnut oil 1 L,9,360,330,30,1
21-04-2025,Snacks & Ready-to-Eat,RAJGIRA PEANUT CHIKKI,14,5,5,0,1
20-04-2025,"Grains, Flours & Dals",Wheat Flour 1 kg,4,140,120,20,2
20-04-2025,"Grains, Flours & Dals",Green gram 500 gms,4,75,70,5,1
20-04-2025,"Grains, Flours & Dals",RAGI FLOUR 500GRMS,4,40,35,5,1
20-04-2025,Oils & Ghee,cow ghee 500 ml,9,860,780,80,2
20-04-2025,"Grains, Flours & Dals",turdal 1kg,4,220,170,50,1
20-04-2025,"Grains, Flours & Dals",RICE RAVVA,4,35,35,0,1
20-04-2025,"Grains, Flours & Dals",Em Multimillet idli r 500g,4,129,129,0,1
20-04-2025,"Grains, Flours & Dals",White jowar.F 1 kg,4,200,160,40,2
20-04-2025,"Dry Fruits, Nuts & Seeds",Groundnuts 1 kg,2,190,165,25,1
20-04-2025,"Dry Fruits, Nuts & Seeds",PULMAKHANA 100 GM,2,180,170,10,1
20-04-2025,Snacks & Ready-to-Eat,DOSA BATTER 1KG,14,60,60,0,1
20-04-2025,Oils & Ghee,Sesame oil 5 L,9,2950,"2,750.00",200,1
20-04-2025,Oils & Ghee,Groundnut oil 1 L,9,720,660,60,2
20-04-2025,Spices & Seasonings,ROYAL SAFFRON,15,125,125,0,1
20-04-2025,Oils & Ghee,Coconut oil 500 ml,9,440,400,40,2
20-04-2025,"Grains, Flours & Dals",Urad dall 1 Kg,4,370,340,30,2
20-04-2025,Oils & Ghee,Sesame oil 500ml,9,295,280,15,1
20-04-2025,Snacks & Ready-to-Eat,PEANUT CHILLI,14,15,15,0,3
20-04-2025,Oils & Ghee,Groundnut oil 500ml,9,180,165,15,1
20-04-2025,Spices & Seasonings,3M.MIRCHI POWDER,15,145,115,30,1
20-04-2025,Baking & Cooking Aids,GONDKATIRA Ag,0,85,75,10,1
20-04-2025,Spices & Seasonings,3M.MIRCHI POWDER,15,145,115,30,1
20-04-2025,"Health, Wellness & Ayurvedic Products",AMLA PACHAK,5,100,100,0,1
20-04-2025,Oils & Ghee,Groundnut oil 500ml,9,180,165,15,1
20-04-2025,"Grains, Flours & Dals",Wheat Flour 1 kg,4,140,120,20,2
20-04-2025,"Grains, Flours & Dals",split black gram 1 kg,4,180,170,10,1
20-04-2025,Spices & Seasonings,Turmeric powder 250 gms,15,100,75,25,1
20-04-2025,Snacks & Ready-to-Eat,RSC ORANGE 100GMS,14,20,20,0,1
20-04-2025,Snacks & Ready-to-Eat,GB SALT COOKIES,14,60,55,5,1
20-04-2025,Snacks & Ready-to-Eat,PEANUT CHILLI,14,10,10,0,2
20-04-2025,"Grains, Flours & Dals",unpolished turdall500grms,4,120,110,10,1
20-04-2025,Snacks & Ready-to-Eat,VD PALLI CHIKKI,14,80,80,0,1
20-04-2025,Sweeteners,sugar 500 gms,16,30,28,2,1
20-04-2025,"Grains, Flours & Dals",SL Idly Rava 1KG,4,65,55,10,1
20-04-2025,Spices & Seasonings,lavangam,15,50,50,0,1
20-04-2025,Oils & Ghee,Coconut oil 500 ml,9,220,200,20,1
20-04-2025,"Grains, Flours & Dals",chana flour 500 gms,4,60,54,6,1
20-04-2025,Misc,VD00014,8,100,90,10,1
20-04-2025,"Grains, Flours & Dals",Wheat Flour 1 kg,4,140,120,20,2
20-04-2025,"Grains, Flours & Dals",UNPOLISHED TURDALL 1KG,4,240,210,30,1
20-04-2025,"Grains, Flours & Dals",split black gram 1 kg,4,540,510,30,3
20-04-2025,"Grains, Flours & Dals",IDLY RAVA 1KG,4,60,50,10,1
20-04-2025,Oils & Ghee,rice bran oil f,9,194,169,25,1
20-04-2025,"Grains, Flours & Dals",CHANA DAL 500GM,4,56,48,8,1
20-04-2025,"Dry Fruits, Nuts & Seeds",Groundnuts 1 kg,2,380,330,50,2
20-04-2025,"Dry Fruits, Nuts & Seeds",PUTNALU 500GMS,2,180,152,28,2
20-04-2025,Spices & Seasonings,AVALU 100GM,15,25,20,5,1
20-04-2025,Personal Care & Cosmetics,MYSORE SANDAL SOAP 75G,10,168,168,0,4
20-04-2025,Spices & Seasonings,RED COPRA 250GMS,15,170,148,22,2
20-04-2025,Personal Care & Cosmetics,herbal antitan,10,50,50,0,1
20-04-2025,Household & Cleaning,vim small,6,30,30,0,2
20-04-2025,Household & Cleaning,harpic 500ml,6,110,110,0,1
20-04-2025,Oils & Ghee,Groundnut oil 1 L,9,360,330,30,1
20-04-2025,Spices & Seasonings,SD Redgram Karam Powder 100GM,15,130,130,0,2
20-04-2025,Snacks & Ready-to-Eat,RAJGIRA PEANUT CHIKKI,14,60,60,0,12
20-04-2025,"Grains, Flours & Dals",THICK POHA 500GM,4,40,35,5,1
20-04-2025,Pickles & Cooking Pastes,BITTER G KARAM SD,11,65,65,0,1
20-04-2025,"Grains, Flours & Dals",turdal 500 gms,4,110,85,25,1
20-04-2025,Spices & Seasonings,DURGA SALT CRYSTAL 1KG,15,25,25,0,1
20-04-2025,"Health, Wellness & Ayurvedic Products",MORINGA LEAF POWDER M,5,80,75,5,1
20-04-2025,Snacks & Ready-to-Eat,NAVARATNA MIX,14,60,60,0,1
20-04-2025,Beverages,REFRESH SHARBATH NORMAL,1,398,380,18,2
20-04-2025,Oils & Ghee,Safflower oil 1 L,9,880,800,80,2
20-04-2025,Oils & Ghee,Coconut oil 1 L,9,880,800,80,2
20-04-2025,Snacks & Ready-to-Eat,NGT CHATPATTA CHANA 90GM,14,65,65,0,1
20-04-2025,"Grains, Flours & Dals",MAAGAANI W RICE 5KGS,4,899,535,364,1
20-04-2025,"Grains, Flours & Dals",Wheat Flour 1 kg,4,70,60,10,1
20-04-2025,Oils & Ghee,Sesame oil 1 L,9,560,560,0,1
20-04-2025,"Grains, Flours & Dals",MAGGANI RICE 5KG,4,525,525,0,1
20-04-2025,Oils & Ghee,Groundnut oil 1 L,9,360,330,30,1
20-04-2025,"Grains, Flours & Dals",RICE FLOUR 500 GM,4,35,28,7,1
20-04-2025,"Dry Fruits, Nuts & Seeds",DRYDATES YELLOW 250GM,2,135,120,15,1
20-04-2025,"Grains, Flours & Dals",SL Idly Rava 1KG,4,65,55,10,1
20-04-2025,"Grains, Flours & Dals",Wheat Flour 1 kg,4,70,60,10,1
20-04-2025,Spices & Seasonings,Coriander seeds 200 gms,15,48,40,8,1
20-04-2025,"Dry Fruits, Nuts & Seeds",Groundnuts 1 kg,2,190,165,25,1
20-04-2025,"Dry Fruits, Nuts & Seeds",Groundnuts 500 gms,2,95,85,10,1
20-04-2025,"Grains, Flours & Dals",DISANO ROLED OATS,4,198,198,0,1
20-04-2025,Oils & Ghee,Groundnut oil 1 L,9,360,330,30,1
20-04-2025,"Grains, Flours & Dals",Wheat Flour 1 kg,4,70,60,10,1
20-04-2025,"Health, Wellness & Ayurvedic Products",AMLA PACHAK,5,100,100,0,1
20-04-2025,Sweeteners,YB FOREST H 250 GMS,16,180,180,0,1
20-04-2025,Snacks & Ready-to-Eat,SS IDLY BATTER 1KG,14,60,60,0,1
20-04-2025,Oils & Ghee,Groundnut oil 1 L,9,360,330,30,1
20-04-2025,"Grains, Flours & Dals",CHANA DAL 1KG,4,112,96,16,1
20-04-2025,Snacks & Ready-to-Eat,BB ROASTED VERMICELLY 850GM,14,117,117,0,1
20-04-2025,Oils & Ghee,Black Sesame oil 500 ml,9,440,380,60,2
20-04-2025,Spices & Seasonings,GREEN SOUNF,15,60,40,20,1
20-04-2025,"Grains, Flours & Dals",Wheat Flour 1 kg,4,210,180,30,3
20-04-2025,"Grains, Flours & Dals",Wheat Rava S 1KG,4,130,110,20,2
20-04-2025,"Grains, Flours & Dals",UNPOLISHED TURDALL 1KG,4,480,420,60,2
20-04-2025,"Grains, Flours & Dals",Urad dall 1 Kg,4,185,170,15,1
20-04-2025,Misc,VDOOO2,8,100,100,0,1
20-04-2025,"Grains, Flours & Dals",RAGI FLOUR 500GRMS,4,40,35,5,1
20-04-2025,"Grains, Flours & Dals",VL Sabdana 500GM,4,77,77,0,1
20-04-2025,"Grains, Flours & Dals",Wheat Flour 1 kg,4,70,60,10,1
20-04-2025,Oils & Ghee,Safflower oil 1 L,9,440,400,40,1
20-04-2025,Snacks & Ready-to-Eat,NGT CHATPATTA CHANA 90GM,14,100,100,0,5
20-04-2025,Oils & Ghee,Groundnut oil 1 L,9,360,330,30,1
20-04-2025,"Grains, Flours & Dals",SL Idly Rava 1KG,4,65,55,10,1
20-04-2025,"Grains, Flours & Dals",Wheat Flour 1 kg,4,70,60,10,1
20-04-2025,"Grains, Flours & Dals",White jowar.F 1 kg,4,100,80,20,1
20-04-2025,Spices & Seasonings,TATA SALT 1KG,15,30,30,0,1
20-04-2025,"Grains, Flours & Dals",POORI ATTA 1KG,4,70,60,10,1
20-04-2025,"Grains, Flours & Dals",FLOUR CHARGE,4,60,60,0,5
20-04-2025,Oils & Ghee,Groundnut oil 1 L,9,360,330,30,1
20-04-2025,"Grains, Flours & Dals",RAGI FLOUR 1KG,4,80,70,10,1
20-04-2025,Oils & Ghee,Sesame oil 1 L,9,560,560,0,1
20-04-2025,Snacks & Ready-to-Eat,VD GUMMADI CHAKKA,14,130,130,0,1
20-04-2025,General Household & Kitchenware,SPOON 4,3,16,16,0,1
20-04-2025,"Grains, Flours & Dals",SH WHITE POHA 500GM,4,75,75,0,1
20-04-2025,"Grains, Flours & Dals",White jowar.F 1 kg,4,100,80,20,1
20-04-2025,Spices & Seasonings,pickles chilli powder 500GM,15,813,813,0,1
20-04-2025,Snacks & Ready-to-Eat,RICE PATALA S,14,26,26,0,1
20-04-2025,Sweeteners,Natural Honey 500 gms,16,280,240,40,1
20-04-2025,Oils & Ghee,Groundnut oil 1 L,9,720,660,60,2
20-04-2025,Sweeteners,YB JAGGERY POWDER 500GMS,16,75,75,0,1
20-04-2025,"Grains, Flours & Dals",Wheat Flour 1 kg,4,140,120,20,2
20-04-2025,"Grains, Flours & Dals",IDLY RAVA 1KG,4,60,50,10,1
20-04-2025,Sweeteners,mishri 500g,16,70,60,10,1
20-04-2025,Oils & Ghee,Groundnut oil 5 L,9,1800,"1,600.00",200,1
20-04-2025,Oils & Ghee,Groundnut oil 1 L,9,360,330,30,1
20-04-2025,"Grains, Flours & Dals",RICE FLOUR 1KG,4,70,55,15,1
20-04-2025,Oils & Ghee,Groundnut oil 500ml,9,180,165,15,1
20-04-2025,Sweeteners,SUGAR 1KG,16,120,112,8,2
20-04-2025,Snacks & Ready-to-Eat,MILLET PANCAKE CHOCOLATE,14,199,199,0,1
20-04-2025,Spices & Seasonings,TATA SALT 1KG,15,30,30,0,1
20-04-2025,Snacks & Ready-to-Eat,BB VERMICELLY 500GM,14,53,53,0,1
20-04-2025,"Grains, Flours & Dals",RICE FLOUR 500 GM,4,35,28,7,1
20-04-2025,"Grains, Flours & Dals",THICK POHA 500GM,4,40,35,5,1
20-04-2025,"Grains, Flours & Dals",SRILATHA RICE RAVVA 500GM,4,35,35,0,1
20-04-2025,"Grains, Flours & Dals",Wheat Flour 1 kg,4,140,120,20,2
20-04-2025,Snacks & Ready-to-Eat,JUNNU POWDER 100GM,14,70,70,0,1
20-04-2025,"Grains, Flours & Dals",turdal 1kg,4,220,170,50,1
20-04-2025,Oils & Ghee,Safflower oil 1 L,9,440,400,40,1
20-04-2025,Oils & Ghee,Sesame oil 1 L,9,590,560,30,1
20-04-2025,Spices & Seasonings,Chilli powder 250 gms,15,1450000,"1,100,000.00","350,000.00",10000
20-04-2025,Spices & Seasonings,SAJEERA,15,60,40,20,1
20-04-2025,Snacks & Ready-to-Eat,VD PALLI CHIKKI,14,80,80,0,1
20-04-2025,Spices & Seasonings,Masala Karam 250 gms,15,130,120,10,1
20-04-2025,Sweeteners,ACHUBELLAM 500GM,16,50,40,10,1
20-04-2025,Milk & Dairy,HERITAGE BUTTERMILK,7,10,10,0,1
20-04-2025,"Grains, Flours & Dals",RICE FLOUR 500 GM,4,35,28,7,1
20-04-2025,Snacks & Ready-to-Eat,PEANUT CHIKKI,14,22,22,0,1
20-04-2025,Misc,ROLL D C,8,70,45,25,1
20-04-2025,Spices & Seasonings,GREEN SOUNF,15,60,40,20,1
20-04-2025,"Grains, Flours & Dals",Wheat Flour 1 kg,4,210,180,30,3
20-04-2025,Sweeteners,organic jaggery powder,16,99,99,0,1
20-04-2025,"Grains, Flours & Dals",MIXED FLOUR,4,338,338,0,1
20-04-2025,Spices & Seasonings,SONTI 50GM,15,30,20,10,1
20-04-2025,Snacks & Ready-to-Eat,VD PALLI LADDU,14,80,80,0,1
20-04-2025,Spices & Seasonings,3M.MIRCHI POWDER,15,408,275,133,1
20-04-2025,Spices & Seasonings,THREE MANGO RAI 200G,15,84,84,0,2
20-04-2025,Sweeteners,ACHU BELLAM 1KG,16,100,80,20,1
20-04-2025,Misc,VD00014,8,100,90,10,1
20-04-2025,Oils & Ghee,Sesame oil 1 L,9,1180,"1,120.00",60,2
20-04-2025,"Grains, Flours & Dals",PESARA PAPPU 1 KG,4,170,145,25,1
19-04-2025,Spices & Seasonings,RED COPRA 250GMS,15,85,74,11,1
19-04-2025,Household & Cleaning,vim 500ml,6,125,125,0,1
19-04-2025,"Grains, Flours & Dals",PESARA PAPPU 1 KG,4,170,145,25,1
19-04-2025,Spices & Seasonings,Menthulu 250 gms,15,50,45,5,1
19-04-2025,"Dry Fruits, Nuts & Seeds",Groundnuts 500 gms,2,190,170,20,2
19-04-2025,Sweeteners,NATURAL HONEY 250GM,16,150,130,20,1
19-04-2025,"Grains, Flours & Dals",SABDANA 500GM,4,270,210,60,3
19-04-2025,"Grains, Flours & Dals",PESARA PAPPU 500GMS,4,85,75,10,1
19-04-2025,Milk & Dairy,HERITAGE BUTTERMILK,7,40,40,0,4
19-04-2025,Spices & Seasonings,AV Iodized Salt 1KG,15,60,54,6,2
19-04-2025,Household & Cleaning,VIM MAHA BAR,6,60,60,0,6
19-04-2025,General Household & Kitchenware,SABEENA,3,30,30,0,2
19-04-2025,Milk & Dairy,HERITAGE TOTAL CURD 500GM,7,100,100,0,2
19-04-2025,Oils & Ghee,Groundnut oil 1 L,9,1080,990,90,3
19-04-2025,Household & Cleaning,ROOPERI PITAMBARI SILVER 50ML,6,220,220,0,2
19-04-2025,Beverages,REFRESH SHARBATH NORMAL,1,199,190,9,1
19-04-2025,Spices & Seasonings,Jeera 100GM,15,50,45,5,1
19-04-2025,"Grains, Flours & Dals",Wheat Flour 1 kg,4,420,360,60,6
19-04-2025,"Dry Fruits, Nuts & Seeds",ANJEER 250GM,2,800,720,80,2
19-04-2025,"Dry Fruits, Nuts & Seeds",wallnuts,2,380,320,60,1
19-04-2025,Spices & Seasonings,Masala Karam 250 gms,15,130,120,10,1
19-04-2025,Spices & Seasonings,MASALA KAR 500GMS,15,260,240,20,1
19-04-2025,Spices & Seasonings,Chilli powder 250 gms,15,145,110,35,1
19-04-2025,Spices & Seasonings,Coriander seeds 200 gms,15,96,80,16,2
19-04-2025,Spices & Seasonings,JEERA 250 gms,15,125,105,20,1
19-04-2025,Snacks & Ready-to-Eat,KURNOOL MARMURA,14,70,60,10,1
19-04-2025,Spices & Seasonings,Menthulu 250 gms,15,50,45,5,1
19-04-2025,Personal Care & Cosmetics,DWI NEEM TULSI SOAP 100GM,10,75,75,0,1
19-04-2025,"Grains, Flours & Dals",RICE FLOUR 1KG,4,70,55,15,1
19-04-2025,"Dry Fruits, Nuts & Seeds",ALMONDS 250GM,2,280,260,20,1
19-04-2025,"Dry Fruits, Nuts & Seeds",PUMPKIN SEEDS 250GM,2,200,160,40,1
19-04-2025,Snacks & Ready-to-Eat,SD KODO MILLET WITH PALM JAGGERY,14,135,135,0,1
19-04-2025,"Dry Fruits, Nuts & Seeds",wallnuts,2,380,320,60,1
19-04-2025,"Grains, Flours & Dals",KORRALU (FOXTAIL M) 1KG,4,150,110,40,1
19-04-2025,"Grains, Flours & Dals",chana flour 500 gms,4,60,54,6,1
19-04-2025,"Dry Fruits, Nuts & Seeds",SALTED PISTA 250GM,2,400,350,50,1
19-04-2025,"Grains, Flours & Dals",THICK POHA 500GM,4,40,35,5,1
19-04-2025,"Grains, Flours & Dals",Bajra Flour 500 gms,4,35,30,5,1
19-04-2025,"Dry Fruits, Nuts & Seeds",SUNFLOWER SEEDS 250GRM,2,150,130,20,1
19-04-2025,Spices & Seasonings,Chilli powder 250 gms,15,145,110,35,1
19-04-2025,"Grains, Flours & Dals",MELMEKER 250GMS,4,60,45,15,1
19-04-2025,"Dry Fruits, Nuts & Seeds",Groundnuts 1 kg,2,190,165,25,1
19-04-2025,"Grains, Flours & Dals",JOWAR WHITE 1 KG,4,80,70,10,1
19-04-2025,"Dry Fruits, Nuts & Seeds",PULMAKHANA 100 GM,2,180,170,10,1
19-04-2025,"Grains, Flours & Dals",unpolished turdall500grms,4,120,110,10,1
19-04-2025,Oils & Ghee,Safflower oil 1 L,9,440,400,40,1
19-04-2025,"Grains, Flours & Dals",Wheat Flour 1 kg,4,140,120,20,2
19-04-2025,Oils & Ghee,GANTASALA A2 COW GHEE 500ML,9,550,550,0,1
19-04-2025,"Grains, Flours & Dals",Wheat Flour 1 kg,4,70,60,10,1
19-04-2025,Snacks & Ready-to-Eat,RAJGIRA PEANUT CHIKKI,14,20,20,0,4
19-04-2025,Sweeteners,Natural Honey 500 gms,16,280,240,40,1
19-04-2025,"Grains, Flours & Dals",CHANA DAL 500GM,4,56,48,8,1
19-04-2025,"Grains, Flours & Dals",Kandulu 250GM,4,80,70,10,2
19-04-2025,"Grains, Flours & Dals",Black uluvalu 250 gms,4,45,35,10,1
19-04-2025,"Grains, Flours & Dals",Red Chana 250GM,4,70,60,10,2
19-04-2025,"Grains, Flours & Dals",white Bobarlu 500 gms,4,80,75,5,1
19-04-2025,"Grains, Flours & Dals",BLACKGRAM,4,70,70,0,1
19-04-2025,"Grains, Flours & Dals",Green gram 500 gms,4,75,70,5,1
19-04-2025,Snacks & Ready-to-Eat,VD RED CHILLI RICEPAPAD 150GM,14,50,50,0,1
19-04-2025,Spices & Seasonings,lavangam,15,50,50,0,1
19-04-2025,Spices & Seasonings,BIRYANI LEAF 10GM,15,30,20,10,1
19-04-2025,"Grains, Flours & Dals",RICE FLOUR 500 GM,4,35,28,7,1
19-04-2025,Spices & Seasonings,MASALA KAR 500GMS,15,260,240,20,1
19-04-2025,Spices & Seasonings,AV Iodized Salt 1KG,15,30,30,0,1
19-04-2025,Spices & Seasonings,SATHVI ANASAPUVUU 25GM,15,180,130,50,2
19-04-2025,Spices & Seasonings,KARAKAYA,15,50,30,20,1
19-04-2025,Spices & Seasonings,AVALU 100GM,15,25,20,5,1
19-04-2025,Spices & Seasonings,Coriander seeds 200 gms,15,48,40,8,1
19-04-2025,"Grains, Flours & Dals",white Bobarlu 500 gms,4,80,75,5,1
19-04-2025,Spices & Seasonings,SAJEERA,15,60,40,20,1
19-04-2025,Spices & Seasonings,Japatri 25GM,15,100,80,20,1
19-04-2025,"Grains, Flours & Dals",UNPOLISHED TURDALL 1KG,4,240,210,30,1
19-04-2025,Spices & Seasonings,SH CASSIA STICKS 50GM,15,75,75,0,1
19-04-2025,"Grains, Flours & Dals",DH URAD GOTA 1KG,4,215,190,25,1
19-04-2025,"Grains, Flours & Dals",chana flour 500 gms,4,60,54,6,1
19-04-2025,Spices & Seasonings,Elaichi 25GM,15,145,120,25,1
19-04-2025,Pooja & Spiritual Items,BANDA PUVVU 25GM 25GM,12,80,60,20,1
19-04-2025,"Grains, Flours & Dals",HS BAJRA FLAKES 250GM 1+1,4,119,119,0,1
19-04-2025,"Grains, Flours & Dals",AISHWARYA SP 1KG,4,400,350,50,5
19-04-2025,Pooja & Spiritual Items,SWASTIK CAMPHORE,12,180,180,0,2
19-04-2025,"Grains, Flours & Dals",SL Idly Rava 1KG,4,130,110,20,2
19-04-2025,Oils & Ghee,Groundnut oil 1 L,9,1080,990,90,3
19-04-2025,Milk & Dairy,BROWN EGGS TRAY 30P,7,360,330,30,1
19-04-2025,"Grains, Flours & Dals",YELLOW JOWER 1KG,4,90,90,0,1
19-04-2025,"Grains, Flours & Dals",JOWAR YELLOW 1 K,4,200,180,20,2
19-04-2025,"Grains, Flours & Dals",Bajra Flour 500 gms,4,35,30,5,1
19-04-2025,"Grains, Flours & Dals",SABDANA 500GM,4,90,70,20,1
19-04-2025,Snacks & Ready-to-Eat,DISANO VERMICELLI 425 GM,14,50,50,0,1
19-04-2025,"Dry Fruits, Nuts & Seeds",SATHVI CHIA SEEDS 100GM,2,100,80,20,1
19-04-2025,"Grains, Flours & Dals",Multigrain 1 kg,4,100,85,15,1
19-04-2025,Personal Care & Cosmetics,Soapnut 500GM,10,120,90,30,1
19-04-2025,Spices & Seasonings,DRY MIECHI 200GM,15,80,60,20,1
19-04-2025,"Grains, Flours & Dals",AISHWARYA SP 1KG,4,800,700,100,10
19-04-2025,Snacks & Ready-to-Eat,DOSA BATTER 1KG,14,60,60,0,1
19-04-2025,"Grains, Flours & Dals",HEALTH JOWAR RAWA,4,99,99,0,1
19-04-2025,Snacks & Ready-to-Eat,VD PALLI LADDU,14,80,80,0,1
19-04-2025,Snacks & Ready-to-Eat,NAVARATNA MIX,14,60,60,0,1
19-04-2025,"Grains, Flours & Dals",SA YELLOW JOWAR RAVA 500GM,4,95,95,0,1
19-04-2025,Snacks & Ready-to-Eat,JONNA RIBAN,14,60,60,0,1
19-04-2025,Snacks & Ready-to-Eat,NGT CHATPATTA CHANA 90GM,14,25,25,0,1
19-04-2025,Snacks & Ready-to-Eat,SATHVI REGIVADA 200GM,14,80,60,20,1
19-04-2025,Snacks & Ready-to-Eat,JUNNU POWDER 100GM,14,140,140,0,2
19-04-2025,"Health, Wellness & Ayurvedic Products",AMLA PACHAK,5,100,100,0,1
19-04-2025,Snacks & Ready-to-Eat,BELLAM MINAPA SUNADULLU,14,180,180,0,1
19-04-2025,Household & Cleaning,VIM MAHA BAR,6,20,20,0,2
19-04-2025,"Grains, Flours & Dals",COW B rice 1 kg,4,144,138,6,2
19-04-2025,Sweeteners,ACHU BELLAM 1KG,16,100,80,20,1
19-04-2025,"Grains, Flours & Dals",SPLIT URAD DAL,4,45,45,0,1
19-04-2025,"Grains, Flours & Dals",Sathya Javva Wheat Rava 500GM,4,90,90,0,1
19-04-2025,"Grains, Flours & Dals",SRILATHA RICE RAVVA 500GM,4,35,35,0,1
19-04-2025,Spices & Seasonings,AVALU 100GM,15,25,20,5,1
19-04-2025,Snacks & Ready-to-Eat,JONNA RIBAN,14,60,60,0,1
19-04-2025,"Dry Fruits, Nuts & Seeds",CASHEW,2,680,590,90,1
19-04-2025,"Dry Fruits, Nuts & Seeds",Groundnuts 500 gms,2,95,85,10,1
19-04-2025,"Grains, Flours & Dals",turdal 500 gms,4,110,85,25,1
19-04-2025,Oils & Ghee,Groundnut oil 1 L,9,360,330,30,1
19-04-2025,Oils & Ghee,Coconut oil 1 L,9,440,400,40,1
19-04-2025,Milk & Dairy,BROWN EGGS 1P,7,56,48,8,4
19-04-2025,Milk & Dairy,BROWN EGGS 1P,7,168,144,24,12
19-04-2025,Spices & Seasonings,LG 50GM,15,92,92,0,1
19-04-2025,Oils & Ghee,Coconut oil 1 L,9,440,400,40,1
19-04-2025,"Grains, Flours & Dals",SABDANA,4,40,35,5,1
19-04-2025,Oils & Ghee,Groundnut oil 1 L,9,360,330,30,1
19-04-2025,"Grains, Flours & Dals",SAMALU (Little millet) 500 gms,4,85,65,20,1
19-04-2025,"Grains, Flours & Dals",ANDU KORRALU (Brown top .mlt) 500,4,130,110,20,1
19-04-2025,"Grains, Flours & Dals",UDALU (Barnyard millet) 500 gms,4,70,60,10,1
19-04-2025,"Grains, Flours & Dals",Arikalu (kodo),4,70,65,5,1
19-04-2025,"Grains, Flours & Dals",KORRALU (FOXTAIL M) 500GM,4,65,55,10,1
19-04-2025,Snacks & Ready-to-Eat,SD Groundnut with palm jaggery 250gm,14,135,135,0,1
19-04-2025,Snacks & Ready-to-Eat,SS IDLY BATTER 1KG,14,60,60,0,1
19-04-2025,Misc,VD0009,8,100,100,0,1
19-04-2025,"Grains, Flours & Dals",Wheat Rava S 500GM,4,33,30,3,1
19-04-2025,"Grains, Flours & Dals",Brown RICE 1KG,4,70,65,5,1
19-04-2025,"Grains, Flours & Dals",chana flour 500 gms,4,60,54,6,1
19-04-2025,"Grains, Flours & Dals",Multigrain 1 kg,4,100,85,15,1
19-04-2025,"Grains, Flours & Dals",Multigrain 1 kg,4,100,85,15,1
19-04-2025,"Grains, Flours & Dals",chana flour 500 gms,4,60,54,6,1
19-04-2025,"Grains, Flours & Dals",Wheat Rava S 500GM,4,33,30,3,1
19-04-2025,"Grains, Flours & Dals",Wheat Rava M 500GM,4,33,30,3,1
19-04-2025,"Grains, Flours & Dals",Bombay Rava 500GM,4,35,30,5,1
19-04-2025,"Grains, Flours & Dals",RAGI FLOUR 500GRMS,4,40,35,5,1
19-04-2025,Snacks & Ready-to-Eat,TILLI CHIKKI,14,25,25,0,5
19-04-2025,Oils & Ghee,Groundnut oil 1 L,9,360,330,30,1
19-04-2025,Oils & Ghee,Sesame oil 1 L,9,590,560,30,1
19-04-2025,"Grains, Flours & Dals",BASMATHI RICE 1KG,4,150,135,15,1
19-04-2025,"Grains, Flours & Dals",AISHWARYA SP 1KG,4,400,350,50,5
19-04-2025,Snacks & Ready-to-Eat,VD PALLI LADDU,14,80,80,0,1
19-04-2025,Oils & Ghee,cow ghee 500 ml,9,860,780,80,2
19-04-2025,"Dry Fruits, Nuts & Seeds",SALTED PISTA 250GM,2,400,350,50,1
19-04-2025,"Health, Wellness & Ayurvedic Products",GS Wheat Grass Powder 100GMS,5,349,349,0,1
19-04-2025,"Dry Fruits, Nuts & Seeds",PUMPKIN SEEDS 250GM,2,200,160,40,1
19-04-2025,"Dry Fruits, Nuts & Seeds",PUMPKIN SEEDS 250GM,2,200,160,40,1
19-04-2025,"Grains, Flours & Dals",SL Idly Rava 1KG,4,65,55,10,1
19-04-2025,"Grains, Flours & Dals",chana flour 500 gms,4,60,54,6,1
19-04-2025,Milk & Dairy,BROWN EGGS 1P,7,84,72,12,6
19-04-2025,"Grains, Flours & Dals",RAGI FLOUR 500GRMS,4,40,35,5,1
19-04-2025,"Dry Fruits, Nuts & Seeds",ANJEER 250GM,2,400,360,40,1
19-04-2025,Snacks & Ready-to-Eat,MILLET NOODLES CURRY MASALA,14,129,129,0,1
19-04-2025,"Dry Fruits, Nuts & Seeds",SALTED PISTA 250GM,2,400,350,50,1
19-04-2025,Snacks & Ready-to-Eat,SD Flax seeds with dates 250gm,14,135,135,0,1
19-04-2025,"Dry Fruits, Nuts & Seeds",PULMAKHANA 100 GM,2,180,170,10,1
19-04-2025,Snacks & Ready-to-Eat,DOSA BATTER 1KG,14,60,60,0,1
19-04-2025,Snacks & Ready-to-Eat,BELLAM MINAPA SUNADULLU,14,180,180,0,1
19-04-2025,Spices & Seasonings,Masala Karam 250 gms,15,130,120,10,1
19-04-2025,Beverages,BISLERI 100ml,1,10,10,0,1
19-04-2025,Milk & Dairy,BROWN EGGS 1P,7,56,48,8,4
19-04-2025,"Grains, Flours & Dals",Green gram 500 gms,4,75,70,5,1
19-04-2025,"Grains, Flours & Dals",SPLIT BLACK GRAM 500 GM,4,90,85,5,1
19-04-2025,"Grains, Flours & Dals",POORI ATTA 500GM,4,35,30,5,1
19-04-2025,"Grains, Flours & Dals",AISHWARYA SP 1KG,4,80,70,10,1
19-04-2025,"Grains, Flours & Dals",MULTIMILLET IDLY RAVVA,4,130,130,0,2
19-04-2025,"Grains, Flours & Dals",KORRALU (FOXTAIL M) 500GM,4,65,55,10,1
19-04-2025,"Grains, Flours & Dals",yellow jowar flour 1kg,4,100,92,8,1
19-04-2025,"Grains, Flours & Dals",MAAGAANI LOW GI SP L 1KG,4,120,105,15,1
19-04-2025,Snacks & Ready-to-Eat,VD RED CHILLI RICEPAPAD 150GM,14,50,50,0,1
19-04-2025,"Grains, Flours & Dals",yellow jowar flour 1kg,4,200,184,16,2
19-04-2025,"Grains, Flours & Dals",RICE FLOUR 1KG,4,70,55,15,1
19-04-2025,General Household & Kitchenware,IRN WDN HDI KADAIA 10,3,275,275,0,1
19-04-2025,General Household & Kitchenware,GOOD HOME,3,30,30,0,2
19-04-2025,Spices & Seasonings,Turmeric powder 250 gms,15,200,150,50,2
19-04-2025,Snacks & Ready-to-Eat,VD PALLI CHIKKI,14,80,80,0,1
19-04-2025,Snacks & Ready-to-Eat,VD BOONDI 175GM,14,60,60,0,1
19-04-2025,"Grains, Flours & Dals",White jowar.F 1 kg,4,200,160,40,2
19-04-2025,Misc,VD0009,8,100,100,0,1
19-04-2025,Snacks & Ready-to-Eat,VD MIXTURE 175 GM,14,120,120,0,2
19-04-2025,Oils & Ghee,Coconut oil 1 L,9,440,400,40,1
19-04-2025,Snacks & Ready-to-Eat,sannakarampusa,14,60,60,0,1
19-04-2025,"Grains, Flours & Dals",SAMALU (Little millet) 500 gms,4,85,65,20,1
19-04-2025,"Grains, Flours & Dals",Wheat Rava S 1KG,4,65,55,10,1
19-04-2025,"Grains, Flours & Dals",Multigrain 1 kg,4,100,85,15,1
19-04-2025,"Grains, Flours & Dals",RAGULU 1 KG,4,70,60,10,1
19-04-2025,"Grains, Flours & Dals",BLACKGRAM,4,70,70,0,1
19-04-2025,"Grains, Flours & Dals",SABDANA 500GM,4,90,70,20,1
19-04-2025,"Grains, Flours & Dals",SRILATHA RICE RAVVA 500GM,4,70,70,0,2
19-04-2025,"Grains, Flours & Dals",Sathya Javva Wheat Rava 500GM,4,180,180,0,2
19-04-2025,"Grains, Flours & Dals",JOWAR UPMA RAVA,4,75,75,0,1
19-04-2025,"Grains, Flours & Dals",Urad dall 1 Kg,4,185,170,15,1
19-04-2025,"Dry Fruits, Nuts & Seeds",PUTNALU 500GMS,2,180,152,28,2
19-04-2025,"Grains, Flours & Dals",JOWAR YELLOW 1 K,4,100,90,10,1
19-04-2025,"Grains, Flours & Dals",Red Chana 250GM,4,35,30,5,1
19-04-2025,Baking & Cooking Aids,MTR GULAB JAMUN MIX 190GM,0,80,80,0,1
19-04-2025,"Dry Fruits, Nuts & Seeds",Groundnuts 1 kg,2,190,165,25,1
19-04-2025,Snacks & Ready-to-Eat,VD GUMMADI VADIYAM,14,75,75,0,1
19-04-2025,"Grains, Flours & Dals",Green gram 1 kg,4,150,130,20,1
19-04-2025,Spices & Seasonings,JEERA 250 gms,15,125,105,20,1
19-04-2025,"Grains, Flours & Dals",yellow jowar flour 1kg,4,100,92,8,1
19-04-2025,"Grains, Flours & Dals",SL Idly Rava 1KG,4,65,55,10,1
19-04-2025,"Grains, Flours & Dals",RICE FLOUR 1KG,4,280,220,60,4
19-04-2025,"Grains, Flours & Dals",HS MULTI UPMA RAVA,4,65,65,0,1
19-04-2025,"Grains, Flours & Dals",EM Ragi upma R 500g,4,75,75,0,1
19-04-2025,Snacks & Ready-to-Eat,SD KODO MILLET WITH PALM JAGGERY,14,135,135,0,1
19-04-2025,"Health, Wellness & Ayurvedic Products",RB Max Protein Jaggery Crunchy,5,175,175,0,1
19-04-2025,Pooja & Spiritual Items,BALAJI BEL PHOOL DHOOP STICKS 10STK,12,210,210,0,3
19-04-2025,General Household & Kitchenware,MATCH BOX,3,20,20,0,1
19-04-2025,Spices & Seasonings,lavangam,15,50,50,0,1
19-04-2025,Pooja & Spiritual Items,NAGA SINDHURAM,12,40,40,0,1
19-04-2025,Oils & Ghee,Sesame oil 1 L,9,590,560,30,1
19-04-2025,Snacks & Ready-to-Eat,VD GUMMADI CHAKKA,14,130,130,0,1
19-04-2025,Oils & Ghee,Coconut oil 500 ml,9,220,200,20,1
19-04-2025,Spices & Seasonings,Tamarind 250GMS,15,80,65,15,1
19-04-2025,Spices & Seasonings,3M.MIRCHI POWDER,15,290,230,60,2
19-04-2025,Spices & Seasonings,Turmeric powder 250 gms,15,100,75,25,1
19-04-2025,"Dry Fruits, Nuts & Seeds",KAJU HALF 250GM,2,310,290,20,1
19-04-2025,"Health, Wellness & Ayurvedic Products",GS Wheat Grass Powder 100GMS,5,349,349,0,1
19-04-2025,"Health, Wellness & Ayurvedic Products",AMLA PACHAK,5,100,100,0,1
19-04-2025,Sweeteners,organic jaggery powder,16,99,99,0,1
19-04-2025,Pooja & Spiritual Items,GD TULASI 75GM,12,60,60,0,1
19-04-2025,Pooja & Spiritual Items,GD Dhoop Sticks 26GM,12,20,20,0,1
19-04-2025,Personal Care & Cosmetics,MD Soapnut Choornam 100GM,10,80,80,0,1
19-04-2025,"Grains, Flours & Dals",RAGI FLOUR 1KG,4,80,70,10,1
19-04-2025,Beverages,REFRESH SHARBATH NORMAL,1,398,380,18,2
19-04-2025,"Grains, Flours & Dals",SH RED POHA 500GM,4,85,85,0,1
19-04-2025,"Health, Wellness & Ayurvedic Products",MH Millets Milk Powder 250GM,5,250,250,0,1
19-04-2025,Personal Care & Cosmetics,HERBAL BATH POWDER 200GM,10,80,80,0,1
19-04-2025,Snacks & Ready-to-Eat,VD MULTI CHAKKA,14,110,110,0,1
19-04-2025,Sweeteners,YB FOREST H 250 GMS,16,180,180,0,1
19-04-2025,Snacks & Ready-to-Eat,PUMPKIN CHIKKI 200GM,14,140,120,20,1
19-04-2025,Baking & Cooking Aids,GONDKATIRA Ag,0,85,75,10,1
19-04-2025,"Grains, Flours & Dals",AISHWARYA SP 1KG,4,400,350,50,5
19-04-2025,Oils & Ghee,Safflower oil 500 ml,9,220,200,20,1
19-04-2025,Sweeteners,GS Palm Jaggery Powder 400GM,16,180,180,0,1
19-04-2025,Milk & Dairy,SANGAM TONED MILK 500ML,7,90,90,0,3
19-04-2025,"Grains, Flours & Dals",White jowar.F 1 kg,4,200,160,40,2
19-04-2025,"Grains, Flours & Dals",Chana Flour 500 gms,4,140,110,30,1
19-04-2025,"Dry Fruits, Nuts & Seeds",FLAX SEEDS 250GM,2,60,50,10,1
19-04-2025,Oils & Ghee,Groundnut oil 500ml,9,180,165,15,1
19-04-2025,"Health, Wellness & Ayurvedic Products",MD Guduchi Choornam 100GM,5,110,110,0,1
19-04-2025,Oils & Ghee,GANTASALA A2 COW GHEE 250ML,9,299,299,0,1
19-04-2025,Snacks & Ready-to-Eat,VD NUVULLU CHIKKI,14,80,80,0,1
19-04-2025,"Grains, Flours & Dals",MULTIMILLET IDLY RAVVA,4,195,195,0,3
19-04-2025,"Dry Fruits, Nuts & Seeds",wallnuts,2,380,320,60,1
19-04-2025,"Grains, Flours & Dals",SOYA BEANS 1KG,4,200,180,20,1
19-04-2025,"Grains, Flours & Dals",JOWAR UPMA RAVA,4,150,150,0,2
19-04-2025,"Grains, Flours & Dals",Wheat Flour 1 kg,4,140,120,20,2
19-04-2025,Snacks & Ready-to-Eat,SOYA MURK,14,60,60,0,1
19-04-2025,Snacks & Ready-to-Eat,KARIVEPAKU MUR,14,60,60,0,1
19-04-2025,Snacks & Ready-to-Eat,VD MULTI CHAKKA,14,110,110,0,1
19-04-2025,"Grains, Flours & Dals",KORRALU (FOXTAIL M) 1KG,4,150,110,40,1
19-04-2025,"Grains, Flours & Dals",SL Idly Rava 1KG,4,130,110,20,2
19-04-2025,Sweeteners,SUGAR 1KG,16,120,112,8,2
19-04-2025,Spices & Seasonings,BIRYANI LEAF 10GM,15,30,20,10,1
19-04-2025,Spices & Seasonings,Chilli powder 500 gms,15,290,210,80,1
19-04-2025,"Grains, Flours & Dals",Green gram 500 gms,4,75,70,5,1
19-04-2025,"Grains, Flours & Dals",Arikadu ( kodo),4,140,130,10,1
19-04-2025,"Grains, Flours & Dals",Wheat Flour 1 kg,4,140,120,20,2
19-04-2025,"Health, Wellness & Ayurvedic Products",RB FRUITS &amp;seeds Cranberries,5,45,45,0,1
19-04-2025,"Grains, Flours & Dals",PESARA PAPPU 500GMS,4,85,75,10,1
19-04-2025,"Grains, Flours & Dals",RAGI FLOUR 500GRMS,4,40,35,5,1
19-04-2025,"Grains, Flours & Dals",Wheat Rava S 1KG,4,65,55,10,1
19-04-2025,"Grains, Flours & Dals",chana flour 500 gms,4,60,54,6,1
19-04-2025,"Health, Wellness & Ayurvedic Products",RB Max Protein Choco chips 55gm,5,50,50,0,1
19-04-2025,"Grains, Flours & Dals",turdal 1kg,4,440,390,50,2
19-04-2025,Spices & Seasonings,Jeera 100GM,15,50,45,5,1
19-04-2025,Spices & Seasonings,Elaichi 25GM,15,145,120,25,1
19-04-2025,Spices & Seasonings,AVALU 100GM,15,25,20,5,1
19-04-2025,Spices & Seasonings,DRY MIECHI 200GM,15,80,60,20,1
19-04-2025,Spices & Seasonings,SAJEERA,15,60,40,20,1
19-04-2025,Snacks & Ready-to-Eat,MIGHTY PUFF,14,25,25,0,1
19-04-2025,Spices & Seasonings,Turmeric powder 250 gms,15,100,75,25,1
19-04-2025,Snacks & Ready-to-Eat,RITEBITE MELTING CHOCOLATE,14,50,50,0,1
19-04-2025,"Dry Fruits, Nuts & Seeds",Groundnuts 500 gms,2,95,85,10,1
19-04-2025,"Grains, Flours & Dals",samalu,4,130,130,0,1
19-04-2025,Spices & Seasonings,Tamarind 500GM,15,160,130,30,1
19-04-2025,"Dry Fruits, Nuts & Seeds",Groundnuts 1 kg,2,190,165,25,1
19-04-2025,Spices & Seasonings,SATHVI ANASAPUVUU 25GM,15,90,65,25,1
19-04-2025,"Grains, Flours & Dals",Urad dall 1 Kg,4,370,340,30,2
19-04-2025,Snacks & Ready-to-Eat,VD MINAPA VADIYAM,14,65,65,0,1
19-04-2025,Spices & Seasonings,Coriander seeds 200 gms,15,48,40,8,1
19-04-2025,"Health, Wellness & Ayurvedic Products",RB Max Protein Choco Berry bar 50g,5,75,75,0,1
19-04-2025,"Grains, Flours & Dals",DOCTOR RICE DIABETIC SFR 1KG,4,360,360,0,3
19-04-2025,"Grains, Flours & Dals",Wheat Flour 1 kg,4,210,180,30,3
19-04-2025,"Grains, Flours & Dals",UNPOLISHED TURDALL 1KG,4,240,210,30,1
19-04-2025,"Grains, Flours & Dals",THICK POHA 1KG,4,80,70,10,1
19-04-2025,"Grains, Flours & Dals",HS JOWAR IDLY RAWA,4,65,65,0,1
19-04-2025,Personal Care & Cosmetics,MYSORE SANDAL SOAP 75G,10,168,168,0,4
19-04-2025,Spices & Seasonings,ROYAL SAFFRON,15,250,250,0,2
19-04-2025,Snacks & Ready-to-Eat,BD RAGI NOODLES,14,75,75,0,1
19-04-2025,Misc,NNF01245,8,100,100,0,2
19-04-2025,"Grains, Flours & Dals",Multigrain 1 kg,4,100,85,15,1
19-04-2025,Snacks & Ready-to-Eat,ELITE ELAICHI RUSK 200GM,14,35,35,0,1
19-04-2025,"Grains, Flours & Dals",UNPOLISHED TURDALL 1KG,4,240,210,30,1
19-04-2025,Personal Care & Cosmetics,KAIPO SANDALWOOD SOAP 100GM,10,60,60,0,1
19-04-2025,"Grains, Flours & Dals",WHEAT 1 KG,4,180,150,30,3
19-04-2025,"Grains, Flours & Dals",AISHWARYA SP 1KG,4,80,70,10,1
19-04-2025,Snacks & Ready-to-Eat,PEANUT CHILLI,14,20,20,0,4
19-04-2025,Snacks & Ready-to-Eat,MILLET PANCAKE CHOCOLATE,14,199,199,0,1
19-04-2025,Snacks & Ready-to-Eat,RSC ORANGE 100GMS,14,20,20,0,1
19-04-2025,Snacks & Ready-to-Eat,sannakarampusa,14,60,60,0,1
19-04-2025,Personal Care & Cosmetics,GOHNSONS BABY TOP TO TOE BATH 100ML,10,110,110,0,1
19-04-2025,Snacks & Ready-to-Eat,VD BELLAM GAVVALU 200GM,14,60,60,0,1
19-04-2025,Household & Cleaning,pour home,6,0,0,0,1
19-04-2025,"Grains, Flours & Dals",Multigrain 1 kg,4,100,85,15,1
19-04-2025,Snacks & Ready-to-Eat,NGT CHATPATTA CHANA 90GM,14,20,20,0,1
19-04-2025,Snacks & Ready-to-Eat,SATHVI REGIVADA 200GM,14,80,60,20,1
19-04-2025,Personal Care & Cosmetics,HERBAL BATH POWDER 200GM,10,80,80,0,1
19-04-2025,Baking & Cooking Aids,WEIKFIELD CUSTARD POWDER,0,43,43,0,1
19-04-2025,Pooja & Spiritual Items,GOW DURBAR GEETHA CAMPHOR,12,60,60,0,1
19-04-2025,Snacks & Ready-to-Eat,PEANUT CHIKKI,14,22,22,0,1
19-04-2025,Oils & Ghee,Sesame oil 500ml,9,295,280,15,1
19-04-2025,Snacks & Ready-to-Eat,RAJGIRA PEANUT CHIKKI,14,10,10,0,2
19-04-2025,Sweeteners,YB JAGGERY POWDER 500GMS,16,75,75,0,1
19-04-2025,Beverages,REFRESH SHARBATH SUGAR FREE,1,299,285,14,1
19-04-2025,Snacks & Ready-to-Eat,JUNNU POWDER 100GM,14,80,80,0,1
19-04-2025,"Health, Wellness & Ayurvedic Products",MH Millets Malt 500GM,5,200,190,10,1
19-04-2025,"Dry Fruits, Nuts & Seeds",BLACK KISMIS 250GM,2,175,140,35,1
19-04-2025,Sweeteners,GS JAGGERY NUGGETS 500GM,16,120,120,0,1
19-04-2025,Milk & Dairy,HRITAGE TOTAL CURD 130GM,7,10,10,0,1
19-04-2025,"Grains, Flours & Dals",BARLEY SEEDS 250GMS,4,40,35,5,1
19-04-2025,"Dry Fruits, Nuts & Seeds",SABJA SEEDS,2,70,70,0,1
19-04-2025,"Grains, Flours & Dals",SABDANA,4,40,35,5,1
19-04-2025,"Grains, Flours & Dals",AISHWARYA SP 25KG,4,1999,"1,690.00",309,1
19-04-2025,"Dry Fruits, Nuts & Seeds",PUTNALU 500GMS,2,90,76,14,1
19-04-2025,"Grains, Flours & Dals",Red Wheat Flour 1 kg,4,280,260,20,2
19-04-2025,"Dry Fruits, Nuts & Seeds",Groundnuts 1 kg,2,190,165,25,1
19-04-2025,"Grains, Flours & Dals",White jowar.F 1 kg,4,200,160,40,2
19-04-2025,"Grains, Flours & Dals",white Bobarlu 500 gms,4,80,75,5,1
19-04-2025,"Grains, Flours & Dals",PESARA PAPPU 1 KG,4,170,145,25,1
19-04-2025,Sweeteners,mishri 500g,16,70,60,10,1
19-04-2025,Household & Cleaning,LIZOL FORAL CLEANER,6,116,116,0,1
19-04-2025,"Grains, Flours & Dals",turdal 1kg,4,220,170,50,1
19-04-2025,"Grains, Flours & Dals",split greengram,4,140,140,0,1
19-04-2025,"Grains, Flours & Dals",THICK POHA 1KG,4,80,70,10,1
19-04-2025,"Grains, Flours & Dals",CHANA DAL 1KG,4,112,96,16,1
19-04-2025,"Dry Fruits, Nuts & Seeds",DIANUTS 500GM,2,240,240,0,2
19-04-2025,Spices & Seasonings,Menthulu 250 gms,15,50,45,5,1
19-04-2025,Spices & Seasonings,asafoetida,15,85,85,0,1
19-04-2025,Spices & Seasonings,3M.MIRCHI POWDER,15,720,454,266,2
19-04-2025,"Grains, Flours & Dals",Red Chana 500 GM,4,75,60,15,1
19-04-2025,"Grains, Flours & Dals",Urad dall 1 Kg,4,185,170,15,1
19-04-2025,Spices & Seasonings,Avalu small 500 gms,15,240,240,0,2
19-04-2025,Oils & Ghee,Sesame oil 1 L,9,1180,"1,120.00",60,2
19-04-2025,Oils & Ghee,Groundnut oil 5 L,9,1800,"1,600.00",200,1
19-04-2025,Oils & Ghee,Sesame oil 500ml,9,295,280,15,1
19-04-2025,"Grains, Flours & Dals",turdal 500 gms,4,220,170,50,2
19-04-2025,"Grains, Flours & Dals",SL Suji Rava 500GM,4,64,64,0,2
19-04-2025,General Household & Kitchenware,GOOD HOME,3,15,15,0,1
19-04-2025,Spices & Seasonings,RED COPRA 250GMS,15,85,78,7,1
19-04-2025,"Grains, Flours & Dals",SH WHITE POHA 500GM,4,75,75,0,1
19-04-2025,"Dry Fruits, Nuts & Seeds",PUTNALU 500GMS,2,90,76,14,1
19-04-2025,"Dry Fruits, Nuts & Seeds",Groundnuts 500 gms,2,95,85,10,1
19-04-2025,Oils & Ghee,Safflower oil 1 L,9,440,400,40,1
19-04-2025,"Grains, Flours & Dals",KORRALU (FOXTAIL M) 1KG,4,150,110,40,1
19-04-2025,Sweeteners,ACHUBELLAM 500GM,16,50,40,10,1
19-04-2025,"Grains, Flours & Dals",SL Idly Rava 1KG,4,65,55,10,1
19-04-2025,"Health, Wellness & Ayurvedic Products",RB Max Protein Spanish Tomato,5,45,45,0,1
19-04-2025,Pooja & Spiritual Items,GD Dhoop Cones 40GM,12,30,30,0,1
19-04-2025,Snacks & Ready-to-Eat,PEANUT CHILLI,14,30,30,0,6
19-04-2025,Snacks & Ready-to-Eat,TILLI CHIKKI,14,25,25,0,5
19-04-2025,Snacks & Ready-to-Eat,NAVARATNA MIX,14,60,60,0,1
19-04-2025,Snacks & Ready-to-Eat,Corn Chips 250GM,14,80,70,10,2
19-04-2025,"Grains, Flours & Dals",SRILATHA RICE RAVVA 500GM,4,70,70,0,2
19-04-2025,Snacks & Ready-to-Eat,SD Moringa with plam jaggery 250gm,14,135,135,0,1
19-04-2025,"Grains, Flours & Dals",Multigrain 1 kg,4,100,85,15,1
19-04-2025,Spices & Seasonings,RED COPRA 500GM,15,170,156,14,1
19-04-2025,"Grains, Flours & Dals",SL Idly Rava 1KG,4,65,55,10,1
19-04-2025,Spices & Seasonings,ROYAL SAFFRON,15,125,125,0,1
19-04-2025,Household & Cleaning,ROOPERI PITAMBARI SILVER 50ML,6,110,110,0,1
19-04-2025,"Grains, Flours & Dals",Bajra Flour 1 kg,4,70,60,10,1
19-04-2025,"Grains, Flours & Dals",White jowar.F 1 kg,4,100,80,20,1
19-04-2025,Snacks & Ready-to-Eat,VD DAHI MIRCHI(SALTED) 100GM,14,90,90,0,2
19-04-2025,Snacks & Ready-to-Eat,VD Minapa papad 200gm,14,60,60,0,1
19-04-2025,Snacks & Ready-to-Eat,Pani Poori Chips 250GM,14,50,40,10,1
19-04-2025,"Dry Fruits, Nuts & Seeds",Groundnuts 1 kg,2,380,330,50,2
19-04-2025,Snacks & Ready-to-Eat,VD MINAPA VADIYAM,14,130,130,0,2
19-04-2025,Snacks & Ready-to-Eat,VD GUMMADI VADIYAM,14,300,300,0,4
19-04-2025,Oils & Ghee,Groundnut oil 5 L,9,1800,"1,600.00",200,1
19-04-2025,Sweeteners,Natural Honey 500 gms,16,280,240,40,1
19-04-2025,Oils & Ghee,cow ghee 500 ml,9,410,370,40,1
19-04-2025,"Grains, Flours & Dals",VGR rice 1 kg,4,70,65,5,1
19-04-2025,"Health, Wellness & Ayurvedic Products",MH Millets Malt 500GM,5,200,190,10,1
19-04-2025,"Dry Fruits, Nuts & Seeds",PULMAKHANA 100 GM,2,180,170,10,1
19-04-2025,"Grains, Flours & Dals",Red Chana 500 GM,4,75,60,15,1
19-04-2025,"Grains, Flours & Dals",Green Batani 500GM,4,220,180,40,2
19-04-2025,Beverages,bisleri,1,20,20,0,1
19-04-2025,Snacks & Ready-to-Eat,NAVARATNA MIX,14,60,60,0,1
19-04-2025,Snacks & Ready-to-Eat,ONION MURK,14,120,120,0,2
19-04-2025,"Dry Fruits, Nuts & Seeds",PULMAKHANA 100 GM,2,180,170,10,1
19-04-2025,Snacks & Ready-to-Eat,VD PALLI LADDU,14,160,160,0,2
19-04-2025,"Grains, Flours & Dals",split black gram 1 kg,4,360,340,20,2
19-04-2025,"Grains, Flours & Dals",RAGI FLOUR 1KG,4,160,140,20,2
19-04-2025,Oils & Ghee,Groundnut oil 1 L,9,720,660,60,2
19-04-2025,Snacks & Ready-to-Eat,VD MURUKU 175GM,14,60,60,0,1
19-04-2025,"Grains, Flours & Dals",Wheat Flour 1 kg,4,140,120,20,2
19-04-2025,Snacks & Ready-to-Eat,VD MURUKU 175GM,14,60,60,0,1
19-04-2025,"Grains, Flours & Dals",BASMATHI RICE 1KG,4,150,135,15,1
19-04-2025,"Grains, Flours & Dals",POORI ATTA 500GM,4,35,30,5,1
19-04-2025,Oils & Ghee,Groundnut oil 5 L,9,1800,"1,600.00",200,1
19-04-2025,"Grains, Flours & Dals",PRO ORG KABULI CHANNA 500GM,4,196,196,0,1
19-04-2025,"Grains, Flours & Dals",Wheat Rava M 500GM,4,33,30,3,1
19-04-2025,Oils & Ghee,Groundnut oil 1 L,9,360,330,30,1
19-04-2025,Spices & Seasonings,AVALU 250grms,15,120,120,0,2
19-04-2025,Spices & Seasonings,ROYAL SAFFRON,15,125,125,0,1
19-04-2025,"Dry Fruits, Nuts & Seeds",Groundnuts 1 kg,2,380,330,50,2
19-04-2025,Spices & Seasonings,ROYAL SAFFRON 400GRMS,15,65,65,0,1
18-04-2025,"Health, Wellness & Ayurvedic Products",DWI BHRINGARAJA TAILAM 100ML,5,150,150,0,1
18-04-2025,Personal Care & Cosmetics,OVAL BODY LOOFAH,10,55,55,0,1
18-04-2025,Oils & Ghee,Sesame oil 1 L,9,1180,"1,120.00",60,2
18-04-2025,Oils & Ghee,Groundnut oil 1 L,9,360,330,30,1
18-04-2025,Pickles & Cooking Pastes,SD MANGO PICKLE,11,110,110,0,1
18-04-2025,Spices & Seasonings,DRY MIECHI 200GM,15,80,60,20,1
18-04-2025,Spices & Seasonings,JEERA 250 gms,15,125,105,20,1
18-04-2025,Spices & Seasonings,Turmeric powder 250 gms,15,200,150,50,2
18-04-2025,Spices & Seasonings,Coriander seeds 200 gms,15,96,80,16,2
18-04-2025,"Grains, Flours & Dals",turdal 1kg,4,220,170,50,1
18-04-2025,Spices & Seasonings,Chilli powder 500 gms,15,580,420,160,2
18-04-2025,"Health, Wellness & Ayurvedic Products",RB Max Protein DESI MASALA 60gm,5,45,45,0,1
18-04-2025,Oils & Ghee,Coconut oil 500 ml,9,220,200,20,1
18-04-2025,"Dry Fruits, Nuts & Seeds",SD Mango cubes 200gm,2,90,90,0,1
18-04-2025,Snacks & Ready-to-Eat,VD NUVULU CHEGODI 175GM,14,60,60,0,1
18-04-2025,Milk & Dairy,BROWN EGGS TRAY 30P,7,360,330,30,1
18-04-2025,Oils & Ghee,Groundnut oil 1 L,9,360,330,30,1
18-04-2025,Snacks & Ready-to-Eat,SD FINGER Millet with palm Jaggery 250gm,14,135,135,0,1
18-04-2025,Snacks & Ready-to-Eat,RSC ORANGE 100GMS,14,20,20,0,1
18-04-2025,Baking & Cooking Aids,GONDKATIRA Ag,0,85,75,10,1
18-04-2025,Snacks & Ready-to-Eat,DISANO MACARONI 850GM,14,105,105,0,1
18-04-2025,"Grains, Flours & Dals",THICK POHA 1KG,4,80,70,10,1
18-04-2025,Oils & Ghee,Sesame oil 500ml,9,295,280,15,1
18-04-2025,Milk & Dairy,SANGAM TONED MILK 500ML,7,31,31,0,1
18-04-2025,Snacks & Ready-to-Eat,SS IDLY BATTER 1KG,14,60,60,0,1
18-04-2025,"Grains, Flours & Dals",Bombay Rava 500GM,4,35,30,5,1
18-04-2025,Sweeteners,sugar 500 gms,16,30,28,2,1
18-04-2025,"Grains, Flours & Dals",THICK POHA 500GM,4,40,35,5,1
18-04-2025,"Grains, Flours & Dals",Wheat Rava S 1KG,4,65,55,10,1
18-04-2025,"Grains, Flours & Dals",MELMEKER 250GMS,4,60,45,15,1
18-04-2025,Sweeteners,MISHRI 250 GM,16,35,30,5,1
18-04-2025,Oils & Ghee,Groundnut oil 1 L,9,360,330,30,1
18-04-2025,"Grains, Flours & Dals",RICE FLOUR 500 GM,4,35,28,7,1
18-04-2025,"Grains, Flours & Dals",MAATEJA rice 1 kg,4,216,207,9,3
18-04-2025,Milk & Dairy,BROWN EGGS TRAY 30P,7,360,330,30,1
18-04-2025,"Grains, Flours & Dals",Chana Flour 500 gms,4,140,110,30,1
18-04-2025,Oils & Ghee,cow ghee 500 ml,9,430,390,40,1
18-04-2025,"Grains, Flours & Dals",split green gram 500 gms,4,75,70,5,1
18-04-2025,"Grains, Flours & Dals",KORRALU (FOXTAIL M) 500GM,4,65,55,10,1
18-04-2025,Spices & Seasonings,PN ORGANIC PINK SALT 1KG,15,124,124,0,1
18-04-2025,Snacks & Ready-to-Eat,VD MULTI CHAKKA,14,110,110,0,1
18-04-2025,"Grains, Flours & Dals",navara rice,4,400,360,40,2
18-04-2025,Pooja & Spiritual Items,GD Aiswarya Deepam 700ML,12,780,780,0,4
18-04-2025,Oils & Ghee,Coconut oil 500 ml,9,220,200,20,1
18-04-2025,Spices & Seasonings,Chilli powder 500 gms,15,290,210,80,1
18-04-2025,Spices & Seasonings,GS Pink Rock Salt 1KG,15,120,120,0,1
18-04-2025,Milk & Dairy,SANGAM CURD 450GM,7,38,38,0,1
18-04-2025,Spices & Seasonings,coriander,15,95,95,0,1
18-04-2025,"Dry Fruits, Nuts & Seeds",DIANUTS 500GM,2,120,120,0,1
18-04-2025,Spices & Seasonings,MASALA KAR 500GMS,15,260,240,20,1
18-04-2025,"Grains, Flours & Dals",MAAGAANI SP RICE 20 KGS,4,2300,"1,960.00",340,1
18-04-2025,Snacks & Ready-to-Eat,GREEN FRIED batana,14,40,40,0,2
18-04-2025,Oils & Ghee,Groundnut oil 1 L,9,360,330,30,1
18-04-2025,Oils & Ghee,Groundnut oil 1 L,9,360,330,30,1
18-04-2025,"Grains, Flours & Dals",RAGI FLOUR 1KG,4,80,70,10,1
18-04-2025,"Grains, Flours & Dals",ANDU KORRALU (Browntop.m) 1 kg,4,260,220,40,1
18-04-2025,Oils & Ghee,Coconut oil 500 ml,9,220,200,20,1
18-04-2025,Household & Cleaning,vim small,6,60,60,0,4
18-04-2025,Personal Care & Cosmetics,ORAL B KIDS,10,25,25,0,1
18-04-2025,Milk & Dairy,BROWN EGGS TRAY 30P,7,360,330,30,1
18-04-2025,Sweeteners,ACHU BELLAM 1KG,16,100,80,20,1
18-04-2025,Personal Care & Cosmetics,MD Soapnut Choornam 100GM,10,80,80,0,1
18-04-2025,"Health, Wellness & Ayurvedic Products",MADDI NEEM OIL 100ML,5,110,110,0,1
18-04-2025,"Grains, Flours & Dals",RAGI FLOUR 500GRMS,4,40,35,5,1
18-04-2025,"Grains, Flours & Dals",RAGI FLOUR 500GRMS,4,40,35,5,1
18-04-2025,"Grains, Flours & Dals",AISHWARYA SP 25KG,4,3998,"3,380.00",618,2
18-04-2025,"Dry Fruits, Nuts & Seeds",PULMAKHANA 100 GM,2,360,340,20,2
18-04-2025,Snacks & Ready-to-Eat,BELLAM MINAPA SUNADULLU,14,180,180,0,1
18-04-2025,"Grains, Flours & Dals",RAGI FLOUR 500GRMS,4,80,70,10,2
18-04-2025,Snacks & Ready-to-Eat,BLACK PEPPER RICE PAPAD,14,50,50,0,1
18-04-2025,"Grains, Flours & Dals",Wheat Flour 1 kg,4,70,60,10,1
18-04-2025,Snacks & Ready-to-Eat,NGT CHATPATTA CHANA 90GM,14,25,25,0,1
18-04-2025,Milk & Dairy,BROWN EGGS 1P,7,42,36,6,3
18-04-2025,Sweeteners,YB JAGGERY POWDER 500GMS,16,75,75,0,1
18-04-2025,Snacks & Ready-to-Eat,BLACK PEPPER RICE PAPAD,14,50,50,0,1
18-04-2025,Snacks & Ready-to-Eat,ONION MURK,14,60,60,0,1
18-04-2025,Snacks & Ready-to-Eat,GREEN FRIED batana,14,20,20,0,1
18-04-2025,Snacks & Ready-to-Eat,BD KODO MILLET NOODLES 200GM,14,75,75,0,1
18-04-2025,Snacks & Ready-to-Eat,JONNA RIBAN,14,60,60,0,1
18-04-2025,Snacks & Ready-to-Eat,KURNOOL MARMURA,14,160,130,30,2
18-04-2025,"Grains, Flours & Dals",WHITE BATANI,4,40,30,10,1
18-04-2025,"Grains, Flours & Dals",Red Chana 250GM,4,35,30,5,1
18-04-2025,"Grains, Flours & Dals",RAJMA 250GM,4,55,45,10,1
18-04-2025,Oils & Ghee,Groundnut oil 1 L,9,1080,990,90,3
18-04-2025,Spices & Seasonings,Telaga Pindi 500GM,15,80,70,10,1
18-04-2025,"Grains, Flours & Dals",UDALU (Barnyard millet) 1 kg,4,140,115,25,1
18-04-2025,"Grains, Flours & Dals",KORRALU (FOXTAIL M) 1KG,4,150,110,40,1
18-04-2025,"Grains, Flours & Dals",samalu,4,130,130,0,1
18-04-2025,"Health, Wellness & Ayurvedic Products",MH Millets Malt 500GM,5,200,190,10,1
18-04-2025,General Household & Kitchenware,VERMI COMPOST MIX,3,180,180,0,6
18-04-2025,"Grains, Flours & Dals",RAGI FLOUR 1KG,4,80,70,10,1
18-04-2025,Oils & Ghee,Groundnut oil 1 L,9,360,330,30,1
18-04-2025,Oils & Ghee,Sesame oil 1 L,9,590,560,30,1
18-04-2025,Snacks & Ready-to-Eat,VD BELLAM GAVVALU 200GM,14,60,60,0,1
18-04-2025,Snacks & Ready-to-Eat,VD BOONDI 175GM,14,60,60,0,1
18-04-2025,Snacks & Ready-to-Eat,TILLI CHIKKI,14,5,5,0,1
18-04-2025,"Grains, Flours & Dals",Wheat Flour 1 kg,4,70,60,10,1
18-04-2025,Beverages,REFRESH SHARBATH SUGAR FREE,1,299,285,14,1
18-04-2025,Spices & Seasonings,NUVVULU 250GM,15,80,65,15,1
18-04-2025,Snacks & Ready-to-Eat,VD NUVULLU CHIKKI,14,80,80,0,1
18-04-2025,"Grains, Flours & Dals",SAMALU (Little millet) 500 gms,4,85,65,20,1
18-04-2025,Oils & Ghee,Groundnut oil 1 L,9,720,660,60,2
18-04-2025,"Grains, Flours & Dals",yellow jowar flour 1kg,4,100,92,8,1
18-04-2025,Snacks & Ready-to-Eat,BROWN BREAD,14,55,55,0,1
18-04-2025,Spices & Seasonings,GROUNDNUT KARAM POWDER,15,65,65,0,1
18-04-2025,Snacks & Ready-to-Eat,VD PALLI CHIKKI,14,80,80,0,1
18-04-2025,"Grains, Flours & Dals",AISHWARYA SP 1KG,4,400,350,50,5
18-04-2025,"Grains, Flours & Dals",Arikalu (kodo),4,70,65,5,1
18-04-2025,"Grains, Flours & Dals",White jowar.F 1 kg,4,100,80,20,1
18-04-2025,"Grains, Flours & Dals",SRILATHA RICE RAVVA 500GM,4,210,210,0,6
18-04-2025,Spices & Seasonings,NUVVULU 500GM,15,320,260,60,2
18-04-2025,"Grains, Flours & Dals",SL Idly Rava 1KG,4,65,55,10,1
18-04-2025,"Grains, Flours & Dals",White Chana 500GM,4,120,100,20,1
18-04-2025,"Grains, Flours & Dals",RAGI FLOUR 1KG,4,80,70,10,1
18-04-2025,"Grains, Flours & Dals",SB Javva Wheat Ravva 500GM,4,95,95,0,1
18-04-2025,General Household & Kitchenware,SIRIDHANYALU BOOK,3,200,180,20,1
18-04-2025,Snacks & Ready-to-Eat,RSC ORANGE 100GMS,14,20,20,0,1
18-04-2025,Sweeteners,GS Palm Jaggery Powder 400GM,16,360,360,0,2
18-04-2025,Snacks & Ready-to-Eat,SD Vamu with palm jaggery 250gm,14,135,135,0,1
18-04-2025,Snacks & Ready-to-Eat,VD CORNFLAKES MIXTURE 175GM,14,60,60,0,1
18-04-2025,"Grains, Flours & Dals",yellow jowar flour 1kg,4,100,92,8,1
18-04-2025,"Grains, Flours & Dals",CHANA DAL 1KG,4,112,96,16,1
18-04-2025,"Grains, Flours & Dals",White jowar.F 1 kg,4,200,160,40,2
18-04-2025,"Grains, Flours & Dals",Red Chana 500 GM,4,75,60,15,1
18-04-2025,"Grains, Flours & Dals",split black gram 1 kg,4,180,170,10,1
18-04-2025,Spices & Seasonings,ROYAL SAFFRON 400GRMS,15,65,65,0,1
18-04-2025,Spices & Seasonings,SONTI 50GM,15,30,20,10,1
18-04-2025,"Grains, Flours & Dals",MAAGAANI W RICE 5KGS,4,899,535,364,1
18-04-2025,"Grains, Flours & Dals",Green gram 500 gms,4,75,70,5,1
18-04-2025,"Grains, Flours & Dals",MULTIMILLET IDLY RAVVA,4,65,65,0,1
18-04-2025,Spices & Seasonings,pickles chilli powder 500GM,15,325,325,0,1
18-04-2025,Snacks & Ready-to-Eat,SF PUFFED RICE,14,55,55,0,1
18-04-2025,Oils & Ghee,Coconut oil 1 L,9,440,400,40,1
18-04-2025,Oils & Ghee,Sesame oil 1 L,9,590,560,30,1
18-04-2025,"Grains, Flours & Dals",Wheat Flour 1 kg,4,140,120,20,2
18-04-2025,Spices & Seasonings,DURGA SALT CRYSTAL 1KG,15,25,25,0,1
18-04-2025,"Grains, Flours & Dals",VGR rice 1 kg,4,70,65,5,1
18-04-2025,"Grains, Flours & Dals",White jowar.F 1 kg,4,200,160,40,2
18-04-2025,"Grains, Flours & Dals",RAGI FLOUR 1KG,4,80,70,10,1
18-04-2025,"Grains, Flours & Dals",Wheat Flour 500 gms,4,35,30,5,1
18-04-2025,Snacks & Ready-to-Eat,Corn Chips 250GM,14,40,35,5,1
18-04-2025,Sweeteners,organic jaggery powder,16,99,99,0,1
18-04-2025,"Grains, Flours & Dals",Yellow jowar.F 500 gms,4,55,50,5,1
18-04-2025,Snacks & Ready-to-Eat,RINGS 200GM,14,30,30,0,1
18-04-2025,Snacks & Ready-to-Eat,VD DAHI MIRCHI(SALTED) 100GM,14,45,45,0,1
18-04-2025,"Grains, Flours & Dals",RAGI FLOUR 1KG,4,80,70,10,1
18-04-2025,Oils & Ghee,Coconut oil 1 L,9,440,400,40,1
18-04-2025,"Grains, Flours & Dals",Wheat Flour 1 kg,4,210,180,30,3
18-04-2025,Milk & Dairy,HERITAGE TONED MILK 500ML,7,31,31,0,1
18-04-2025,Spices & Seasonings,AV Iodized Salt 1KG,15,30,30,0,1
18-04-2025,Personal Care & Cosmetics,GOW DURBAR NAVA 100GM SOAP,10,40,40,0,1
18-04-2025,Oils & Ghee,Groundnut oil 1 L,9,720,660,60,2
18-04-2025,Spices & Seasonings,Masala Karam 250 gms,15,130,120,10,1
18-04-2025,"Grains, Flours & Dals",Wheat Flour 1 kg,4,70,60,10,1
18-04-2025,Snacks & Ready-to-Eat,Sprouted Ragi Biscuits 450GM,14,300,300,0,2
18-04-2025,"Grains, Flours & Dals",Multigrain 1 kg,4,300,255,45,3
18-04-2025,"Grains, Flours & Dals",RAGI FLOUR 500GRMS,4,80,70,10,2
18-04-2025,Beverages,BRU GREEN LABEL 1.2G,1,12,12,0,6
18-04-2025,"Grains, Flours & Dals",split green gram 500 gms,4,75,70,5,1
18-04-2025,Snacks & Ready-to-Eat,PEANUT CHILLI,14,10,10,0,2
18-04-2025,Snacks & Ready-to-Eat,MIGHTY PUFFS TOMATO,14,25,25,0,1
18-04-2025,Spices & Seasonings,SHAHI BIRYANI MASALA,15,42,42,0,1
18-04-2025,"Health, Wellness & Ayurvedic Products",MH Millets Malt 500GM,5,200,190,10,1
18-04-2025,Personal Care & Cosmetics,Soapnut 250GM,10,60,45,15,1
18-04-2025,"Grains, Flours & Dals",AISHWARYA SP 25KG,4,1999,"1,690.00",309,1
18-04-2025,"Grains, Flours & Dals",Red Wheat Flour 1 kg,4,560,520,40,4
18-04-2025,Oils & Ghee,Groundnut oil 1 L,9,720,660,60,2
18-04-2025,Spices & Seasonings,THREE MANGO RAI 200G,15,42,42,0,1
18-04-2025,"Grains, Flours & Dals",White Chana 500GM,4,120,100,20,1
18-04-2025,Snacks & Ready-to-Eat,ragi apadalu,14,90,90,0,1
18-04-2025,Oils & Ghee,Sesame oil 1 L,9,590,560,30,1
18-04-2025,Personal Care & Cosmetics,MD HERBAL HAIR SHAMPOO,10,300,300,0,1
18-04-2025,Sweeteners,GS Organic Jaggery Powder 600GM,16,99,99,0,1
18-04-2025,Oils & Ghee,GANTASALA A2 COW GHEE 500ML,9,550,550,0,1
18-04-2025,Spices & Seasonings,mesta,15,110,110,0,1
18-04-2025,Pickles & Cooking Pastes,bitter gourd,11,110,110,0,1
18-04-2025,Sweeteners,sugar 500 gms,16,30,28,2,1
18-04-2025,Personal Care & Cosmetics,Soapnut 500GM,10,120,90,30,1
18-04-2025,"Grains, Flours & Dals",Wheat Flour 1 kg,4,350,300,50,5
18-04-2025,Misc,NNF01245,8,50,50,0,1
18-04-2025,Snacks & Ready-to-Eat,Popcorn Seeds 250GM,14,45,40,5,1
18-04-2025,Spices & Seasonings,DRY MIECHI 200GM,15,80,60,20,1
18-04-2025,"Grains, Flours & Dals",MELMEKER 250GMS,4,60,45,15,1
18-04-2025,Snacks & Ready-to-Eat,JONNA RIBAN,14,60,60,0,1
18-04-2025,"Grains, Flours & Dals",Chittimuthaylu rice 1 kg,4,160,140,20,1
18-04-2025,Snacks & Ready-to-Eat,RAGI GAVVALU,14,60,60,0,1
18-04-2025,"Grains, Flours & Dals",Bajra Flour 1 kg,4,70,60,10,1
18-04-2025,Oils & Ghee,cow ghee 500 ml,9,430,390,40,1
18-04-2025,Snacks & Ready-to-Eat,RI SPORTS BAR 40G,14,45,45,0,1
18-04-2025,Snacks & Ready-to-Eat,NGT CHATPATTA CHANA 90GM,14,40,40,0,2
18-04-2025,Snacks & Ready-to-Eat,Corn Chips 250GM,14,40,35,5,1
18-04-2025,Spices & Seasonings,Chilli powder 1 kg,15,2320,"1,680.00",640,4
18-04-2025,"Grains, Flours & Dals",Wheat Flour 1 kg,4,350,300,50,5
18-04-2025,"Grains, Flours & Dals",Wheat Flour 1 kg,4,350,300,50,5
18-04-2025,Snacks & Ready-to-Eat,VD BELLAM GAVVALU 200GM,14,60,60,0,1
18-04-2025,Spices & Seasonings,Chilli powder 1 kg,15,1160,840,320,2
18-04-2025,Snacks & Ready-to-Eat,NGT CHATPATTA CHANA 90GM,14,50,50,0,2
18-04-2025,"Dry Fruits, Nuts & Seeds",Groundnuts 1 kg,2,190,165,25,1
18-04-2025,"Grains, Flours & Dals",Green gram 1 kg,4,150,130,20,1
18-04-2025,"Health, Wellness & Ayurvedic Products",UVIS NEEM OIL 100ML,5,120,120,0,1
18-04-2025,Snacks & Ready-to-Eat,SD MASALA GAVVALU 200GM,14,95,95,0,1
18-04-2025,Snacks & Ready-to-Eat,SD Little Millet WITH PLAM JAGGERY,14,135,135,0,1
18-04-2025,"Grains, Flours & Dals",Bajra Flour 1 kg,4,70,60,10,1
18-04-2025,Snacks & Ready-to-Eat,SD Ginger Candy 100g,14,120,120,0,2
18-04-2025,"Grains, Flours & Dals",MAATEJA rice 1 kg,4,720,690,30,10
18-04-2025,"Grains, Flours & Dals",KORRALU (FOXTAIL M) 1KG,4,300,220,80,2
18-04-2025,"Grains, Flours & Dals",MAGGANI RICE 5KG,4,315,315,0,1
18-04-2025,Snacks & Ready-to-Eat,MIGHTY PUFFS TOMATO,14,25,25,0,1
18-04-2025,"Grains, Flours & Dals",VGR rice 1 kg,4,140,130,10,2
18-04-2025,Milk & Dairy,HERITAGE BUTTERMILK,7,20,20,0,2
18-04-2025,"Grains, Flours & Dals",MAATEJA rice 1 kg,4,104,101,3,1
18-04-2025,Oils & Ghee,Groundnut oil 1 L,9,360,330,30,1
18-04-2025,Oils & Ghee,Sesame oil 500ml,9,295,280,15,1
18-04-2025,"Grains, Flours & Dals",RED TUDAL 1KG,4,150,140,10,1
18-04-2025,Spices & Seasonings,Menthulu 250 gms,15,100,90,10,2
18-04-2025,Beverages,BRU GREEN LABEL 1.2G,1,192,192,0,96
18-04-2025,"Grains, Flours & Dals",SRILALITHA MAIDA FLOUR 500G,4,64,64,0,2
18-04-2025,Snacks & Ready-to-Eat,VD SAGOPAPAD 150GM,14,55,55,0,1
18-04-2025,Snacks & Ready-to-Eat,VD DAHI MIRCHI(SALTED) 100GM,14,45,45,0,1
18-04-2025,Spices & Seasonings,DRY MIECHI 200GM,15,80,60,20,1
18-04-2025,"Grains, Flours & Dals",MAAGAANI W RICE 5KGS,4,899,535,364,1
18-04-2025,"Grains, Flours & Dals",RICE FLOUR 1KG,4,70,55,15,1
18-04-2025,Spices & Seasonings,NUVVULU 500GM,15,600,510,90,3
18-04-2025,Spices & Seasonings,ROYAL SAFFRON,15,375,375,0,3
18-04-2025,Misc,VD0009,8,100,100,0,1
18-04-2025,Pooja & Spiritual Items,GOW DURBAR GEETHA CAMPHOR,12,60,60,0,1
18-04-2025,"Grains, Flours & Dals",MAAGAANI SP RICE 5KGS,4,1998,"1,820.00",178,2
18-04-2025,"Grains, Flours & Dals",Wheat Flour 1 kg,4,70,60,10,1
18-04-2025,Milk & Dairy,BROWN EGGS 1P,7,140,120,20,10
18-04-2025,"Grains, Flours & Dals",Wheat Flour 1 kg,4,140,120,20,2
18-04-2025,Milk & Dairy,BROWN EGGS 1P,7,168,144,24,12
18-04-2025,Spices & Seasonings,GARAM MASALA 200GM,15,120,95,25,1
18-04-2025,"Grains, Flours & Dals",BASMATHI RICE 1KG,4,300,270,30,2
18-04-2025,"Grains, Flours & Dals",Brown RICE 1KG,4,140,130,10,2
18-04-2025,"Grains, Flours & Dals",turdal 500 gms,4,110,85,25,1
18-04-2025,"Grains, Flours & Dals",Multigrain 1 kg,4,100,85,15,1
18-04-2025,Sweeteners,GS Palm Jaggery Powder 400GM,16,180,180,0,1
18-04-2025,Snacks & Ready-to-Eat,NGT CHATPATTA CHANA 90GM,14,25,25,0,1
18-04-2025,"Grains, Flours & Dals",BARLEY SEEDS 500 GM,4,90,70,20,1
18-04-2025,"Grains, Flours & Dals",Bombay Rava 500GM,4,35,30,5,1
18-04-2025,"Grains, Flours & Dals",AISHWARYA SP 1KG,4,400,350,50,5
18-04-2025,Misc,C123,8,95,80,15,1
18-04-2025,"Grains, Flours & Dals",COW B rice 1 kg,4,144,138,6,2
18-04-2025,Sweeteners,organic jaggery powder,16,99,99,0,1
18-04-2025,"Dry Fruits, Nuts & Seeds",PUTNALU 500GMS,2,180,152,28,2
18-04-2025,"Grains, Flours & Dals",unpolished turdall500grms,4,120,110,10,1
18-04-2025,"Grains, Flours & Dals",BOMBAY RAVA,4,70,55,15,1
18-04-2025,"Grains, Flours & Dals",Wheat Rava S 1KG,4,65,55,10,1
18-04-2025,"Grains, Flours & Dals",JOWAR WHITE 1 KG,4,240,210,30,3
18-04-2025,Snacks & Ready-to-Eat,PEANUT CHILLI,14,5,5,0,1
18-04-2025,"Grains, Flours & Dals",samalu,4,130,130,0,1
18-04-2025,"Grains, Flours & Dals",BAJRA 1 KG,4,120,100,20,2
18-04-2025,Snacks & Ready-to-Eat,WHOLE WHEAT BREAD,14,55,55,0,1
18-04-2025,Milk & Dairy,BROWN EGGS 1P,7,140,120,20,10
18-04-2025,Spices & Seasonings,Jeera 100GM,15,50,45,5,1
18-04-2025,"Dry Fruits, Nuts & Seeds",SATHVI CHIA SEEDS 100GM,2,100,80,20,1
18-04-2025,"Dry Fruits, Nuts & Seeds",Groundnuts 500 gms,2,95,85,10,1
17-04-2025,Snacks & Ready-to-Eat,KURNOOL MARMURA,14,70,55,15,1
17-04-2025,Household & Cleaning,SCROTCG BITE B,6,190,180,10,1
17-04-2025,General Household & Kitchenware,chalk piece 1b,3,30,20,10,2
17-04-2025,General Household & Kitchenware,ODONIL ORCHID DEW,3,180,156,24,2
17-04-2025,Household & Cleaning,comfort lily fresh,6,58,58,0,1
17-04-2025,Sweeteners,YB N FOREST HONEY 700 GM,16,400,400,0,1
17-04-2025,Oils & Ghee,Sesame oil 1 L,9,590,560,30,1
17-04-2025,Milk & Dairy,BROWN EGGS 1P,7,168,144,24,12
17-04-2025,Household & Cleaning,vim dish liquid,6,55,55,0,1
17-04-2025,"Grains, Flours & Dals",Multigrain 1 kg,4,300,255,45,3
17-04-2025,Baking & Cooking Aids,Baking Soda 50GM,0,80,60,20,4
17-04-2025,"Grains, Flours & Dals",SRILATHA RICE RAVVA 500GM,4,70,70,0,2
17-04-2025,Oils & Ghee,groundnet oil,9,1600,"1,600.00",0,1
17-04-2025,Oils & Ghee,Groundnut oil 1 L,9,360,330,30,1
17-04-2025,"Dry Fruits, Nuts & Seeds",Groundnuts 500 gms,2,95,85,10,1
17-04-2025,"Grains, Flours & Dals",Multigrain 1 kg,4,100,85,15,1
17-04-2025,"Grains, Flours & Dals",chana flour 500 gms,4,60,54,6,1
17-04-2025,"Grains, Flours & Dals",Wheat Flour 1 kg,4,140,120,20,2
17-04-2025,"Grains, Flours & Dals",RAGI FLOUR 1KG,4,80,70,10,1
17-04-2025,Spices & Seasonings,AV Iodized Salt 1KG,15,28,25,3,1
17-04-2025,"Grains, Flours & Dals",RAGI FLOUR 1KG,4,80,70,10,1
17-04-2025,"Grains, Flours & Dals",Em little upma R 500g,4,129,129,0,1
17-04-2025,"Grains, Flours & Dals",HS RAGI Idly rava 500 gms,4,70,70,0,1
17-04-2025,General Household & Kitchenware,SABEENA,3,15,15,0,1
17-04-2025,Milk & Dairy,BROWN EGGS TRAY 30P,7,360,330,30,1
17-04-2025,"Grains, Flours & Dals",SABDANA 500GM,4,90,70,20,1
17-04-2025,"Grains, Flours & Dals",Multigrain 1 kg,4,100,85,15,1
17-04-2025,Oils & Ghee,Coconut oil 1 L,9,880,800,80,2
17-04-2025,Household & Cleaning,HERBAL LIQ DISH WASH 500ML,6,170,170,0,1
17-04-2025,"Grains, Flours & Dals",Wheat Flour 1 kg,4,70,60,10,1
17-04-2025,Household & Cleaning,vim dish liquid,6,55,55,0,1
17-04-2025,General Household & Kitchenware,GOOD HOME,3,15,15,0,1
17-04-2025,"Dry Fruits, Nuts & Seeds",Groundnuts 1 kg,2,380,330,50,2
17-04-2025,Snacks & Ready-to-Eat,KURNOOL MARMURA,14,70,55,15,1
17-04-2025,Snacks & Ready-to-Eat,SH PUFFED RICE 500GM,14,112,112,0,1
17-04-2025,Sweeteners,organic jaggery powder,16,99,99,0,1
17-04-2025,"Grains, Flours & Dals",White jowar.F 1 kg,4,100,80,20,1
17-04-2025,Personal Care & Cosmetics,MADDI BATH POWDER 400GM,10,150,150,0,1
17-04-2025,Sweeteners,Natural Honey 500 gms,16,280,240,40,1
17-04-2025,"Health, Wellness & Ayurvedic Products",MD Aamlaki Choornam 100GM,5,160,160,0,2
17-04-2025,Snacks & Ready-to-Eat,VD GUMMADI CHAKKA,14,130,130,0,1
17-04-2025,Snacks & Ready-to-Eat,JONNA RIBAN,14,60,60,0,1
17-04-2025,Snacks & Ready-to-Eat,SF MIGHTY PUFFS,14,75,75,0,3
17-04-2025,Snacks & Ready-to-Eat,MIGHTY PUFF,14,25,25,0,1
17-04-2025,"Grains, Flours & Dals",Brown RICE 1KG,4,70,65,5,1
17-04-2025,Snacks & Ready-to-Eat,SOYA MURK,14,60,60,0,1
17-04-2025,"Grains, Flours & Dals",BASMATHI RICE 1KG,4,150,135,15,1
17-04-2025,Snacks & Ready-to-Eat,ragi chegodi,14,60,60,0,1
17-04-2025,Snacks & Ready-to-Eat,BELLAM MINAPA SUNADULLU,14,180,180,0,1
17-04-2025,Snacks & Ready-to-Eat,SD barnyard Millet with palm jaggery,14,135,135,0,1
17-04-2025,"Grains, Flours & Dals",WHEAT 1 KG,4,180,150,30,3
17-04-2025,"Grains, Flours & Dals",BARLEY SEEDS 1KG,4,480,420,60,3
17-04-2025,Sweeteners,MISHRI D,16,80,60,20,2
17-04-2025,"Grains, Flours & Dals",RAGI FLOUR 1KG,4,80,70,10,1
17-04-2025,Oils & Ghee,Groundnut oil 1 L,9,360,330,30,1
17-04-2025,"Grains, Flours & Dals",RICE FLOUR 1KG,4,140,110,30,2
17-04-2025,"Grains, Flours & Dals",WHEAT 1 KG,4,240,200,40,4
17-04-2025,Oils & Ghee,Coconut oil 500 ml,9,220,200,20,1
17-04-2025,Snacks & Ready-to-Eat,VD PALLI LADDU,14,160,160,0,2
17-04-2025,Snacks & Ready-to-Eat,ANNAPURNA APPALAM,14,70,70,0,2
17-04-2025,Spices & Seasonings,Masala Karam 250 gms,15,130,120,10,1
17-04-2025,Spices & Seasonings,Turmeric powder 250 gms,15,100,75,25,1
17-04-2025,"Grains, Flours & Dals",Bajra Flour 1 kg,4,70,60,10,1
17-04-2025,"Grains, Flours & Dals",Wheat Flour 1 kg,4,70,60,10,1
17-04-2025,Spices & Seasonings,Chilli powder 500 gms,15,290,210,80,1
17-04-2025,"Grains, Flours & Dals",Arikalu (kodo),4,140,130,10,2
17-04-2025,Oils & Ghee,Sesame oil 500ml,9,295,280,15,1
17-04-2025,"Grains, Flours & Dals",KORRALU (FOXTAIL M) 1KG,4,150,110,40,1
17-04-2025,Oils & Ghee,Groundnut oil 1 L,9,720,660,60,2
17-04-2025,"Grains, Flours & Dals",UDALU (Barnyard millet) 1 kg,4,140,115,25,1
17-04-2025,Oils & Ghee,Groundnut oil 1 L,9,360,330,30,1
17-04-2025,"Health, Wellness & Ayurvedic Products",RB Max Protein NUTS &SEEDS 55gm,5,50,50,0,1
17-04-2025,Snacks & Ready-to-Eat,VD MURUKU 175GM,14,60,60,0,1
17-04-2025,Snacks & Ready-to-Eat,RI SPORTS BAR 40G,14,45,45,0,1
17-04-2025,"Health, Wellness & Ayurvedic Products",RB Nuts& Seeds cashews 35g,5,45,45,0,1
17-04-2025,Snacks & Ready-to-Eat,ONION MURK,14,60,60,0,1
17-04-2025,Snacks & Ready-to-Eat,MIGHTY PUFFS TOMATO,14,75,75,0,3
17-04-2025,"Grains, Flours & Dals",SL Suji Rava 500GM,4,32,32,0,1
17-04-2025,"Health, Wellness & Ayurvedic Products",gyan thyapobhumi,5,60,60,0,1
17-04-2025,"Grains, Flours & Dals",BASMATHI RICE 1KG,4,150,135,15,1
17-04-2025,Oils & Ghee,BUFFALLO GHEE 500ML,9,410,370,40,1
17-04-2025,Spices & Seasonings,3M.MIRCHI POWDER,15,408,275,133,1
17-04-2025,Oils & Ghee,Sesame oil 500ml,9,295,280,15,1
17-04-2025,"Grains, Flours & Dals",Wheat Rava M 500GM,4,33,30,3,1
17-04-2025,Spices & Seasonings,AV Iodized Salt 1KG,15,28,25,3,1
17-04-2025,Sweeteners,SUGAR 1KG,16,60,56,4,1
17-04-2025,Spices & Seasonings,SWASTIKS GINGER&amp;GARLIC,15,49,49,0,1
17-04-2025,"Grains, Flours & Dals",Wheat Flour 1 kg,4,70,60,10,1
17-04-2025,"Grains, Flours & Dals",turdal 1kg,4,220,170,50,1
17-04-2025,"Grains, Flours & Dals",SRILATHA RICE RAVVA 500GM,4,35,35,0,1
17-04-2025,"Grains, Flours & Dals",Wheat Flour 1 kg,4,210,180,30,3
17-04-2025,"Grains, Flours & Dals",RAGI FLOUR 500GRMS,4,40,35,5,1
17-04-2025,Oils & Ghee,Sesame oil 1 L,9,590,560,30,1
17-04-2025,"Grains, Flours & Dals",SH SONAMASURI BROWN RICE 1KG,4,125,125,0,1
17-04-2025,"Grains, Flours & Dals",Wheat Flour 1 kg,4,140,120,20,2
17-04-2025,Oils & Ghee,Groundnut oil 1 L,9,720,660,60,2
17-04-2025,Snacks & Ready-to-Eat,VD PALLI LADDU,14,80,80,0,1
17-04-2025,Snacks & Ready-to-Eat,JONNA RIBAN,14,60,60,0,1
17-04-2025,"Grains, Flours & Dals",AISHWARYA SP 1KG,4,400,350,50,5
17-04-2025,Snacks & Ready-to-Eat,ONION MURK,14,60,60,0,1
17-04-2025,General Household & Kitchenware,TEA CUP 1P,3,90,90,0,2
17-04-2025,"Dry Fruits, Nuts & Seeds",SABJA SEEDS,2,70,70,0,1
17-04-2025,"Grains, Flours & Dals",THICK POHA 500GM,4,40,35,5,1
17-04-2025,"Grains, Flours & Dals",RAGI FLOUR 500GRMS,4,40,35,5,1
17-04-2025,"Grains, Flours & Dals",Wheat Flour 1 kg,4,140,120,20,2
17-04-2025,"Grains, Flours & Dals",idly rava 1kg,4,60,50,10,1
17-04-2025,"Grains, Flours & Dals",PESARA PAPPU 500GMS,4,85,75,10,1
17-04-2025,Misc,ROLL D C,8,70,45,25,1
17-04-2025,Milk & Dairy,BROWN EGGS 1P,7,168,144,24,12
17-04-2025,Oils & Ghee,Groundnut oil 500ml,9,180,165,15,1
17-04-2025,Spices & Seasonings,Masala Karam 250 gms,15,130,120,10,1
17-04-2025,"Grains, Flours & Dals",Bombay Rava 500GM,4,35,30,5,1
17-04-2025,"Grains, Flours & Dals",WHITE BATANI,4,40,30,10,1
17-04-2025,"Grains, Flours & Dals",Green Batani 250GM,4,55,45,10,1
17-04-2025,"Grains, Flours & Dals",turdal 500 gms,4,110,85,25,1
17-04-2025,Oils & Ghee,Sesame oil 500ml,9,295,280,15,1
17-04-2025,Pooja & Spiritual Items,GD KASTHURI,12,60,60,0,1
17-04-2025,Snacks & Ready-to-Eat,VD DAHI MIRCHI(SALTED) 100GM,14,45,45,0,1
17-04-2025,Spices & Seasonings,ROYAL SAFFRON 400GRMS,15,65,65,0,1
17-04-2025,Beverages,BRU GREEN LABEL 1.2G,1,10,10,0,5
17-04-2025,Spices & Seasonings,DURGA SALT CRYSTAL 1KG,15,25,25,0,1
17-04-2025,Oils & Ghee,Groundnut oil 500ml,9,180,165,15,1
17-04-2025,Snacks & Ready-to-Eat,BELLAM MINAPA SUNADULLU,14,180,180,0,1
17-04-2025,Snacks & Ready-to-Eat,VD NUVULLU CHIKKI,14,80,80,0,1
17-04-2025,Snacks & Ready-to-Eat,VD PALLI CHIKKI,14,80,80,0,1
17-04-2025,Snacks & Ready-to-Eat,GROUNDNUT LADDU WITH DATES,14,135,135,0,1
17-04-2025,Snacks & Ready-to-Eat,SD FINGER Millet with palm Jaggery 250gm,14,135,135,0,1
17-04-2025,Pooja & Spiritual Items,GOW DURBAR GEETHA CAMPHOR,12,60,60,0,1
17-04-2025,"Grains, Flours & Dals",Wheat Flour 1 kg,4,140,120,20,2
17-04-2025,"Grains, Flours & Dals",split greengram,4,140,140,0,1
17-04-2025,Snacks & Ready-to-Eat,VD MURUKU 175GM,14,60,60,0,1
17-04-2025,"Grains, Flours & Dals",Multigrain 1 kg,4,200,170,30,2
17-04-2025,Snacks & Ready-to-Eat,VD Pappu Chekkalu 190gm,14,60,60,0,1
17-04-2025,"Grains, Flours & Dals",RICE FLOUR 1KG,4,140,110,30,2
17-04-2025,"Grains, Flours & Dals",Bombay Rava 500GM,4,35,30,5,1
17-04-2025,Oils & Ghee,Coconut oil 1 L,9,440,400,40,1
17-04-2025,Baking & Cooking Aids,Baking Soda 50GM,0,20,15,5,1
17-04-2025,"Grains, Flours & Dals",Em jowar idly R 500G,4,75,75,0,1
17-04-2025,Oils & Ghee,Sesame oil 1 L,9,1180,"1,120.00",60,2
17-04-2025,"Grains, Flours & Dals",RICE FLOUR 1KG,4,70,55,15,1
17-04-2025,Oils & Ghee,Groundnut oil 1 L,9,720,660,60,2
17-04-2025,"Grains, Flours & Dals",White jowar.F 1 kg,4,200,160,40,2
17-04-2025,"Grains, Flours & Dals",MULTIMILLET IDLY RAVVA,4,65,65,0,1
17-04-2025,"Grains, Flours & Dals",AISHWARYA SP 1KG,4,160,140,20,2
17-04-2025,Milk & Dairy,BROWN EGGS TRAY 30P,7,360,330,30,1
17-04-2025,Misc,VD0009,8,100,100,0,1
17-04-2025,"Grains, Flours & Dals",AISHWARYA SP 1KG,4,800,700,100,10
17-04-2025,"Grains, Flours & Dals",Wheat Flour 1 kg,4,210,180,30,3
17-04-2025,Spices & Seasonings,BIRYANI LEAF 10GM,15,30,20,10,1
17-04-2025,"Grains, Flours & Dals",PRO SOYA CHUNKS 200G,4,79,79,0,1
17-04-2025,Oils & Ghee,Groundnut oil 1 L,9,360,330,30,1
17-04-2025,Spices & Seasonings,Masala Karam 250 gms,15,130,120,10,1
17-04-2025,Snacks & Ready-to-Eat,PEANUT CHIKKI,14,22,22,0,1
17-04-2025,Snacks & Ready-to-Eat,KURNOOL MARMURA,14,70,55,15,1
17-04-2025,"Grains, Flours & Dals",PESARA PAPPU 1 KG,4,170,145,25,1
17-04-2025,"Grains, Flours & Dals",split black gram 1 kg,4,180,170,10,1
17-04-2025,Spices & Seasonings,Jeera 100GM,15,50,45,5,1
17-04-2025,"Grains, Flours & Dals",THICK POHA 1KG,4,80,70,10,1
17-04-2025,Household & Cleaning,SURFEXCEL BAR 80G,6,20,20,0,2
17-04-2025,Spices & Seasonings,GS Pink Rock Salt 1KG,15,120,120,0,1
17-04-2025,"Grains, Flours & Dals",Brown RICE 1KG,4,70,65,5,1
17-04-2025,"Grains, Flours & Dals",HEALTH JOWAR RAWA,4,99,99,0,1
17-04-2025,"Grains, Flours & Dals",VGR rice 1 kg,4,140,130,10,2
17-04-2025,Snacks & Ready-to-Eat,DOSA BATTER 1KG,14,120,120,0,2
17-04-2025,Snacks & Ready-to-Eat,Popcorn Seeds 250GM,14,45,40,5,1
17-04-2025,Sweeteners,YB JAGGERY POWDER 1KG,16,140,140,0,1
17-04-2025,"Grains, Flours & Dals",VGR rice 1 kg,4,140,130,10,2
17-04-2025,"Grains, Flours & Dals",AISHWARYA SP 1KG,4,320,280,40,4
17-04-2025,"Dry Fruits, Nuts & Seeds",FLAX SEEDS 250GM,2,60,50,10,1
17-04-2025,"Grains, Flours & Dals",SL Idly Rava 1KG,4,130,110,20,2
17-04-2025,Oils & Ghee,Groundnut oil 1 L,9,360,330,30,1
17-04-2025,Oils & Ghee,Groundnut oil 1 L,9,360,330,30,1
17-04-2025,Spices & Seasonings,Telaga Pindi 500GM,15,160,140,20,2
17-04-2025,Spices & Seasonings,NUVVULU 500GM,15,200,170,30,1
17-04-2025,"Grains, Flours & Dals",AISHWARYA SP 1KG,4,400,350,50,5
17-04-2025,Spices & Seasonings,ROYAL SAFFRON 400GRMS,15,65,65,0,1
17-04-2025,"Grains, Flours & Dals",Green gram 1 kg,4,150,130,20,1
17-04-2025,Spices & Seasonings,KALONJI SEEDS,15,180,160,20,2
17-04-2025,Oils & Ghee,Groundnut oil 1 L,9,720,660,60,2
17-04-2025,Oils & Ghee,Sesame oil 500ml,9,295,280,15,1
17-04-2025,Pooja & Spiritual Items,GD KASTHURI,12,60,60,0,1
17-04-2025,"Grains, Flours & Dals",Green gram 1 kg,4,150,130,20,1
17-04-2025,Spices & Seasonings,telaga pindi,15,140,140,0,2
17-04-2025,"Grains, Flours & Dals",AISHWARYA SP 1KG,4,400,350,50,5
17-04-2025,Spices & Seasonings,KALONJI SEEDS,15,180,160,20,2
17-04-2025,Oils & Ghee,Groundnut oil 1 L,9,360,330,30,1
17-04-2025,Spices & Seasonings,NUVVULU 500GM,15,200,170,30,1
17-04-2025,"Grains, Flours & Dals",HS JOWAR FLAKES 250GM 1+1,4,119,119,0,1
17-04-2025,Snacks & Ready-to-Eat,MAAGAANI M JOWAR PASTA 200GM,14,199,199,0,1
17-04-2025,Snacks & Ready-to-Eat,MIGHTY PUFFS KHATTA METTA,14,50,50,0,2
17-04-2025,Oils & Ghee,BUFFALLO GHEE 500ML,9,820,740,80,2
17-04-2025,"Health, Wellness & Ayurvedic Products",RB Max Protein Cheese&amp;,5,45,45,0,1
17-04-2025,"Grains, Flours & Dals",HS BAJRA FLAKES 250GM 1+1,4,119,119,0,1
17-04-2025,Personal Care & Cosmetics,MD Bath Powder 100GM,10,40,40,0,1
17-04-2025,Misc,VD0031,8,55,55,0,1
17-04-2025,Snacks & Ready-to-Eat,VD CORNFLAKES MIXTURE 175GM,14,60,60,0,1
17-04-2025,"Dry Fruits, Nuts & Seeds",Putnalu 250GM,2,45,38,7,1
17-04-2025,Snacks & Ready-to-Eat,SOYA MURK,14,60,60,0,1
17-04-2025,Snacks & Ready-to-Eat,BD PEARL MILLET NOODLES 200G,14,70,70,0,1
17-04-2025,Spices & Seasonings,DURGA SALT CRYSTAL 1KG,15,28,28,0,1
17-04-2025,"Dry Fruits, Nuts & Seeds",Groundnuts 500 gms,2,95,85,10,1
17-04-2025,"Grains, Flours & Dals",Wheat Flour 1 kg,4,70,60,10,1
17-04-2025,Snacks & Ready-to-Eat,RAJGIRA PEANUT CHIKKI,14,20,20,0,4
17-04-2025,Spices & Seasonings,GS Pink Rock Salt 1KG,15,120,120,0,1
17-04-2025,Oils & Ghee,Groundnut oil 500ml,9,180,165,15,1
17-04-2025,"Grains, Flours & Dals",Chana Flour 500 gms,4,140,110,30,1
17-04-2025,"Grains, Flours & Dals",RICE FLOUR 500 GM,4,70,56,14,2
17-04-2025,Milk & Dairy,ID PANEER,7,140,140,0,1
17-04-2025,Oils & Ghee,Groundnut oil 1 L,9,360,330,30,1
17-04-2025,Milk & Dairy,HERTG FULL CREAM M,7,41,41,0,1
17-04-2025,Snacks & Ready-to-Eat,VD PALLI CHIKKI,14,80,80,0,1
17-04-2025,Milk & Dairy,HERITAGE TONED MILK 500ML,7,31,31,0,1
17-04-2025,Spices & Seasonings,DURGA SALT CRYSTAL 1KG,15,25,25,0,1
17-04-2025,Snacks & Ready-to-Eat,BEETROOT MURK,14,60,60,0,1
17-04-2025,"Grains, Flours & Dals",turdal 500 gms,4,110,85,25,1
17-04-2025,Pooja & Spiritual Items,GD KASTHURI,12,60,60,0,1
17-04-2025,"Grains, Flours & Dals",White jowar.F 500 Gms,4,50,40,10,1
17-04-2025,Pooja & Spiritual Items,dhoop batti,12,45,45,0,1
17-04-2025,Pooja & Spiritual Items,GD Sree Chandan 50GM,12,50,50,0,1
17-04-2025,General Household & Kitchenware,SABEENA,3,15,15,0,1
17-04-2025,Oils & Ghee,Groundnut oil 1 L,9,360,330,30,1
17-04-2025,"Grains, Flours & Dals",RAGI FLOUR 500GRMS,4,40,35,5,1
17-04-2025,Oils & Ghee,Coconut oil 500 ml,9,220,200,20,1
17-04-2025,Oils & Ghee,Sesame oil 1 L,9,1180,"1,120.00",60,2
17-04-2025,Milk & Dairy,BROWN EGGS TRAY 30P,7,360,330,30,1
17-04-2025,Oils & Ghee,Groundnut oil 1 L,9,360,330,30,1
17-04-2025,Sweeteners,YB JAGGERY POWDER 500GMS,16,75,75,0,1
17-04-2025,"Grains, Flours & Dals",Wheat Flour 1 kg,4,140,120,20,2
17-04-2025,Oils & Ghee,Sesame oil 1 L,9,1180,"1,120.00",60,2
17-04-2025,Spices & Seasonings,Coriander seeds 200 gms,15,48,40,8,1
17-04-2025,Misc,VD0009,8,100,100,0,1
17-04-2025,Snacks & Ready-to-Eat,SD KODO MILLET WITH PALM JAGGERY,14,135,135,0,1
17-04-2025,"Grains, Flours & Dals",Wheat Rava M 500GM,4,33,30,3,1
17-04-2025,Milk & Dairy,SANGAM CURD 450GM,7,38,38,0,1
17-04-2025,Snacks & Ready-to-Eat,VD MURUKU 175GM,14,60,60,0,1
17-04-2025,Baking & Cooking Aids,MTR GULAB JAMUN MIX 190GM,0,80,80,0,1
17-04-2025,"Grains, Flours & Dals",AISHWARYA SP 1KG,4,80,70,10,1
17-04-2025,"Grains, Flours & Dals",VGR rice 1 kg,4,140,130,10,2
17-04-2025,"Grains, Flours & Dals",BASMATHI RICE 1KG,4,150,135,15,1
17-04-2025,Snacks & Ready-to-Eat,RAGI GAVVALU,14,60,60,0,1
17-04-2025,Snacks & Ready-to-Eat,SANDWICH BREAD,14,55,55,0,1
17-04-2025,Spices & Seasonings,telaga pindi,15,70,70,0,1
17-04-2025,Oils & Ghee,Sesame oil 1 L,9,1770,"1,680.00",90,3
17-04-2025,"Grains, Flours & Dals",SRILATHA RICE RAVVA 500GM,4,140,140,0,4
17-04-2025,"Health, Wellness & Ayurvedic Products",MH Millets Malt 1KG,5,800,760,40,2
17-04-2025,"Grains, Flours & Dals",KORRALU (FOXTAIL M) 1KG,4,450,330,120,3
17-04-2025,"Grains, Flours & Dals",SAMALU (Little millet) 1 kg,4,510,390,120,3
17-04-2025,Snacks & Ready-to-Eat,SD KODO MILLET WITH PALM JAGGERY,14,135,135,0,1
17-04-2025,"Grains, Flours & Dals",VGR rice 1 kg,4,350,325,25,5
17-04-2025,Milk & Dairy,BROWN EGGS TRAY 30P,7,720,660,60,2
17-04-2025,"Grains, Flours & Dals",CHANA DAL 1KG,4,112,96,16,1
17-04-2025,Spices & Seasonings,Chilli powder 500 gms,15,290,210,80,1
17-04-2025,Snacks & Ready-to-Eat,VD RICE MURUKU 150GM,14,50,50,0,1
17-04-2025,"Grains, Flours & Dals",Wheat Rava S 1KG,4,65,55,10,1
17-04-2025,Snacks & Ready-to-Eat,VD Minapa papad 200gm,14,70,70,0,1
17-04-2025,Spices & Seasonings,PN ORGANIC PINK SALT 1KG,15,124,124,0,1
17-04-2025,Spices & Seasonings,SATHVI ANASAPUVUU 25GM,15,90,65,25,1
17-04-2025,General Household & Kitchenware,GOOD HOME,3,30,30,0,2
17-04-2025,Misc,NNF01245,8,50,50,0,1
17-04-2025,"Dry Fruits, Nuts & Seeds",SABJA SEEDS,2,70,70,0,1
17-04-2025,"Grains, Flours & Dals",BARLEY SEEDS 250GMS,4,40,35,5,1
17-04-2025,"Dry Fruits, Nuts & Seeds",ANJEER 250GM,2,400,360,40,1
17-04-2025,Snacks & Ready-to-Eat,VD VAMUPUSA 175GM,14,60,60,0,1
17-04-2025,Snacks & Ready-to-Eat,JONNA RIBAN,14,60,60,0,1
17-04-2025,Snacks & Ready-to-Eat,SUNNUNDALU,14,120,120,0,1
17-04-2025,Sweeteners,YB JAGGERY POWDER 1KG,16,280,280,0,2
17-04-2025,Spices & Seasonings,RED COPRA 250GMS,15,85,74,11,1
17-04-2025,"Grains, Flours & Dals",Red Wheat Flour 1 kg,4,700,650,50,5
17-04-2025,"Grains, Flours & Dals",Urad dall 1 Kg,4,185,170,15,1
17-04-2025,"Grains, Flours & Dals",aishwarya rice,4,450,450,0,1
17-04-2025,Snacks & Ready-to-Eat,RAGI GAVVALU,14,60,60,0,1
17-04-2025,Snacks & Ready-to-Eat,ONION MURK,14,60,60,0,1
17-04-2025,Household & Cleaning,ROOPERI PITAMBARI SILVER 50ML,6,110,110,0,1
17-04-2025,Sweeteners,YB Brown Sugar 1KG,16,140,140,0,1
17-04-2025,Beverages,REFRESH SHARBATH NORMAL,1,199,190,9,1
17-04-2025,"Grains, Flours & Dals",yellow jowar flour 1kg,4,100,92,8,1
17-04-2025,Household & Cleaning,surfexcel Tl,6,170,170,0,1
17-04-2025,"Grains, Flours & Dals",EM Ragi idli R 500G,4,75,75,0,1
17-04-2025,"Grains, Flours & Dals",Wheat Rava S 1KG,4,65,55,10,1
17-04-2025,Spices & Seasonings,NUVVULU 500GM,15,160,130,30,1
17-04-2025,"Grains, Flours & Dals",Em jowar idly R 500G,4,150,150,0,2
17-04-2025,Snacks & Ready-to-Eat,VD MURUKU 175GM,14,60,60,0,1
17-04-2025,"Grains, Flours & Dals",turdal 500 gms,4,110,85,25,1
17-04-2025,"Grains, Flours & Dals",chana flour 500 gms,4,60,54,6,1
17-04-2025,Snacks & Ready-to-Eat,VD ATUKULU MIXTURE 175GM,14,60,60,0,1
17-04-2025,Milk & Dairy,SANGAM CURD 450GM,7,38,38,0,1
17-04-2025,"Grains, Flours & Dals",MELMEKER 250GMS,4,60,45,15,1
17-04-2025,"Grains, Flours & Dals",aishwarya rice,4,450,450,0,1
17-04-2025,Personal Care & Cosmetics,HERBAL BATH POWDER 200GM,10,80,80,0,1
17-04-2025,"Grains, Flours & Dals",Wheat Rava M 500GM,4,33,30,3,1
17-04-2025,Misc,C123,8,95,80,15,1
17-04-2025,Pooja & Spiritual Items,GOW DURBAR GEETHA CAMPHOR,12,60,60,0,1
17-04-2025,"Grains, Flours & Dals",RAGI FLOUR 500GRMS,4,40,35,5,1
17-04-2025,General Household & Kitchenware,ODONIL SANDAL BOQUET 150ML,3,120,120,0,1
17-04-2025,"Grains, Flours & Dals",Red Chana 250GM,4,35,30,5,1
17-04-2025,Spices & Seasonings,Turmeric powder 250 gms,15,100,75,25,1
17-04-2025,"Grains, Flours & Dals",Green Batani 250GM,4,55,45,10,1
17-04-2025,"Grains, Flours & Dals",CHANA DAL 500GM,4,56,48,8,1
17-04-2025,"Grains, Flours & Dals",Red Chana 250GM,4,35,30,5,1
17-04-2025,"Dry Fruits, Nuts & Seeds",PULMAKHANA 100 GM,2,180,170,10,1
17-04-2025,Spices & Seasonings,DRY MIECHI 200GM,15,80,60,20,1
17-04-2025,Snacks & Ready-to-Eat,VD JAGGERY GHEE 250GM,14,180,180,0,1
17-04-2025,"Grains, Flours & Dals",PESARA PAPPU 500GMS,4,85,75,10,1
17-04-2025,Snacks & Ready-to-Eat,NGT CHATPATTA CHANA 90GM,14,75,75,0,3
17-04-2025,"Grains, Flours & Dals",RAGI FLOUR 500GRMS,4,40,35,5,1
17-04-2025,Oils & Ghee,Coconut oil 500 ml,9,220,200,20,1
17-04-2025,"Grains, Flours & Dals",chana flour 500 gms,4,60,54,6,1
17-04-2025,"Grains, Flours & Dals",RAGI FLOUR 500GRMS,4,40,35,5,1
17-04-2025,"Grains, Flours & Dals",Wheat Flour 2 kgs,4,140,120,20,1
17-04-2025,Oils & Ghee,Sesame oil 500ml,9,295,280,15,1
17-04-2025,"Grains, Flours & Dals",PESARA PINDI,4,90,85,5,1
17-04-2025,"Grains, Flours & Dals",White jowar.F 500 Gms,4,50,40,10,1
17-04-2025,"Grains, Flours & Dals",AISWARYA SP RICE 10KGS,4,750,700,50,1
17-04-2025,Oils & Ghee,Groundnut oil 1 L,9,360,330,30,1
16-04-2025,Beverages,REFRESH SHARBATH NORMAL,1,199,190,9,1
16-04-2025,Personal Care & Cosmetics,UVIS ALOEVERA &amp;NEEM,10,175,175,0,1
16-04-2025,Snacks & Ready-to-Eat,MIGHTY PUFFS TOMATO,14,50,50,0,2
16-04-2025,Milk & Dairy,SANGAM TONED MILK 500ML,7,30,30,0,1
16-04-2025,Spices & Seasonings,RED COPRA 250GMS,15,85,74,11,1
16-04-2025,"Grains, Flours & Dals",Green gram 1 kg,4,150,130,20,1
16-04-2025,"Dry Fruits, Nuts & Seeds",Groundnuts 1 kg,2,190,165,25,1
16-04-2025,Spices & Seasonings,Coriander seeds 200 gms,15,48,40,8,1
16-04-2025,Spices & Seasonings,Turmeric powder 250 gms,15,100,75,25,1
16-04-2025,"Grains, Flours & Dals",SL Idly Rava 1KG,4,130,110,20,2
16-04-2025,"Grains, Flours & Dals",Chana Flour 500 gms,4,280,220,60,2
16-04-2025,Spices & Seasonings,AV Iodized Salt 1KG,15,28,25,3,1
16-04-2025,Sweeteners,sugar 500 gms,16,30,28,2,1
16-04-2025,"Grains, Flours & Dals",RAGI FLOUR 1KG,4,80,70,10,1
16-04-2025,Pooja & Spiritual Items,BALAJI BEL PHOOL STICKS 90GM,12,60,60,0,1
16-04-2025,"Grains, Flours & Dals",Wheat Flour 1 kg,4,210,180,30,3
16-04-2025,Spices & Seasonings,Jeera 100GM,15,50,45,5,1
16-04-2025,"Grains, Flours & Dals",split greengram,4,280,280,0,2
16-04-2025,"Dry Fruits, Nuts & Seeds",Putnalu 250GM,2,135,114,21,3
16-04-2025,"Grains, Flours & Dals",Wheat Flour 1 kg,4,140,120,20,2
16-04-2025,"Dry Fruits, Nuts & Seeds",SABJA SEEDS 100GM,2,80,70,10,1
16-04-2025,"Dry Fruits, Nuts & Seeds",SATHVI CHIA SEEDS 100GM,2,100,80,20,1
16-04-2025,Misc,VD00014,8,100,90,10,1
16-04-2025,"Health, Wellness & Ayurvedic Products",MD Fenugreek Choornam 100GM,5,80,80,0,1
16-04-2025,"Dry Fruits, Nuts & Seeds",MAHA BEERA SEEDS 100GM,2,60,60,0,1
16-04-2025,"Health, Wellness & Ayurvedic Products",MD Ashwagandha Choornam 100GM,5,170,170,0,1
16-04-2025,"Grains, Flours & Dals",SL Idly Rava 1KG,4,65,55,10,1
16-04-2025,"Dry Fruits, Nuts & Seeds",FLAX SEEDS 250GM,2,60,50,10,1
16-04-2025,"Grains, Flours & Dals",Sathya Javva Wheat Rava 500GM,4,90,90,0,1
16-04-2025,"Grains, Flours & Dals",MAAGAANI SP RICE 5KGS,4,649,560,89,1
16-04-2025,Snacks & Ready-to-Eat,SD Sesame laddu with dates250gm,14,135,135,0,1
16-04-2025,Oils & Ghee,Groundnut oil 1 L,9,720,660,60,2
16-04-2025,Snacks & Ready-to-Eat,SD Moringa with plam jaggery 250gm,14,135,135,0,1
16-04-2025,"Grains, Flours & Dals",SAMALU (Little millet) 500 gms,4,85,65,20,1
16-04-2025,"Health, Wellness & Ayurvedic Products",ZINDA TILISMATH 5ML,5,70,70,0,1
16-04-2025,"Grains, Flours & Dals",Arikalu (kodo),4,70,65,5,1
16-04-2025,"Grains, Flours & Dals",KORRALU (FOXTAIL M) 500GM,4,65,55,10,1
16-04-2025,"Grains, Flours & Dals",KORRALU (FOXTAIL M) 1KG,4,150,110,40,1
16-04-2025,"Grains, Flours & Dals",SAMALU (Little millet) 1 kg,4,170,130,40,1
16-04-2025,"Grains, Flours & Dals",UDALU (Barnyard millet) 1 kg,4,140,115,25,1
16-04-2025,"Grains, Flours & Dals",Wheat Flour 1 kg,4,70,60,10,1
16-04-2025,Oils & Ghee,Sesame oil 1 L,9,590,560,30,1
16-04-2025,Sweeteners,YB N FOREST HONEY 700 GM,16,1100,"1,100.00",0,2
16-04-2025,"Grains, Flours & Dals",White jowar.F 1 kg,4,200,160,40,2
16-04-2025,Snacks & Ready-to-Eat,PEANUT CHILLI,14,30,30,0,6
16-04-2025,Snacks & Ready-to-Eat,TILLI CHIKKI,14,35,35,0,7
16-04-2025,"Dry Fruits, Nuts & Seeds",Groundnuts 500 gms,2,95,85,10,1
16-04-2025,Sweeteners,MISHRI 250 GM,16,35,30,5,1
16-04-2025,Sweeteners,MISHRI D,16,40,30,10,1
16-04-2025,"Dry Fruits, Nuts & Seeds",YB GRANMA NUTS,2,90,90,0,1
16-04-2025,Snacks & Ready-to-Eat,RAJGIRA PEANUT CHIKKI,14,30,30,0,6
16-04-2025,"Grains, Flours & Dals",BLACKGRAM,4,70,70,0,1
16-04-2025,Spices & Seasonings,Black Till 250GM,15,90,75,15,1
16-04-2025,"Grains, Flours & Dals",white Bobarlu 500 gms,4,80,75,5,1
16-04-2025,"Grains, Flours & Dals",Kandulu 250GM,4,40,35,5,1
16-04-2025,"Grains, Flours & Dals",Black uluvalu 250 gms,4,45,35,10,1
16-04-2025,Snacks & Ready-to-Eat,MIGHTY PUFF,14,25,25,0,1
16-04-2025,"Grains, Flours & Dals",RAGI FLOUR 500GRMS,4,80,70,10,2
16-04-2025,"Grains, Flours & Dals",Multigrain 1 kg,4,200,170,30,2
16-04-2025,"Grains, Flours & Dals",Wheat Flour 1 kg,4,70,60,10,1
16-04-2025,"Dry Fruits, Nuts & Seeds",Groundnuts 500 gms,2,95,85,10,1
16-04-2025,Milk & Dairy,ID PANEER,7,135,135,0,1
16-04-2025,Milk & Dairy,ID PANEER,7,135,135,0,1
16-04-2025,Oils & Ghee,Coconut oil 1 L,9,440,400,40,1
16-04-2025,"Grains, Flours & Dals",Wheat Flour 1 kg,4,420,360,60,6
16-04-2025,Oils & Ghee,Sesame oil 1 L,9,590,560,30,1
16-04-2025,Snacks & Ready-to-Eat,MIGHTY PUFFS CHEDDAR CHEESE,14,75,75,0,3
16-04-2025,Snacks & Ready-to-Eat,SF MILLET NOODLES MILD MASALA 192GM,14,129,129,0,1
16-04-2025,"Grains, Flours & Dals",Green gram 1 kg,4,150,130,20,1
16-04-2025,Snacks & Ready-to-Eat,SANDWICH BREAD,14,55,55,0,1
16-04-2025,Snacks & Ready-to-Eat,GB SALT COOKIES,14,60,55,5,1
16-04-2025,"Grains, Flours & Dals",Green gram 1 kg,4,150,130,20,1
16-04-2025,"Dry Fruits, Nuts & Seeds",PULMAKHANA 100 GM,2,180,170,10,1
16-04-2025,"Health, Wellness & Ayurvedic Products",MH Millets Malt 1KG,5,400,380,20,1
16-04-2025,Snacks & Ready-to-Eat,sannakarampusa,14,60,60,0,1
16-04-2025,Oils & Ghee,Safflower oil 1 L,9,440,400,40,1
16-04-2025,Spices & Seasonings,GS Pink Rock Salt 1KG,15,120,120,0,1
16-04-2025,"Grains, Flours & Dals",PRO ORG RED POHA 500GM,4,89,89,0,1
16-04-2025,Spices & Seasonings,NUVVULU 250GM,15,80,65,15,1
16-04-2025,Spices & Seasonings,MIRYALU 50 GRMS,15,100,80,20,1
16-04-2025,"Grains, Flours & Dals",Multigrain 1 kg,4,100,85,15,1
16-04-2025,"Grains, Flours & Dals",idly rava 1kg,4,60,50,10,1
16-04-2025,Spices & Seasonings,GREEN SOUNF,15,60,40,20,1
16-04-2025,"Grains, Flours & Dals",SPLIT URAD DAL,4,45,45,0,1
16-04-2025,Spices & Seasonings,Elaichi 25GM,15,145,120,25,1
16-04-2025,"Dry Fruits, Nuts & Seeds",Putnalu 250GM,2,90,76,14,2
16-04-2025,"Health, Wellness & Ayurvedic Products",RB Max Protein Choco chips 55gm,5,100,100,0,2
16-04-2025,"Dry Fruits, Nuts & Seeds",Groundnuts 500 gms,2,95,85,10,1
16-04-2025,"Grains, Flours & Dals",SABDANA,4,40,35,5,1
16-04-2025,Snacks & Ready-to-Eat,Pani Poori Chips 250GM,14,50,40,10,1
16-04-2025,"Grains, Flours & Dals",SRILALITHA MAIDA FLOUR 500G,4,32,32,0,1
16-04-2025,"Grains, Flours & Dals",Urad dall 1 Kg,4,185,170,15,1
16-04-2025,Sweeteners,organic jaggery powder,16,99,99,0,1
16-04-2025,"Grains, Flours & Dals",Red Chana 250GM,4,35,30,5,1
16-04-2025,"Grains, Flours & Dals",WHITE BATANI 500GM,4,80,60,20,1
16-04-2025,"Grains, Flours & Dals",Bombay Rava 500GM,4,35,30,5,1
16-04-2025,"Grains, Flours & Dals",VGR RICE bag 1,4,1899,"1,650.00",249,1
16-04-2025,Spices & Seasonings,BIRYANI LEAF 10GM,15,30,20,10,1
16-04-2025,Snacks & Ready-to-Eat,VD MULTI CHAKKA,14,110,110,0,1
16-04-2025,Pooja & Spiritual Items,PACHAKARPURAM,12,60,50,10,1
16-04-2025,Sweeteners,SUGAR 1KG,16,120,112,8,2
16-04-2025,"Grains, Flours & Dals",White Chana 500GM,4,120,100,20,1
16-04-2025,Beverages,BISLERI 2 L,1,90,90,0,3
16-04-2025,Oils & Ghee,Groundnut oil 1 L,9,360,330,30,1
16-04-2025,"Grains, Flours & Dals",THICK POHA 500GM,4,40,35,5,1
16-04-2025,"Grains, Flours & Dals",turdal 1kg,4,220,170,50,1
16-04-2025,Snacks & Ready-to-Eat,NGT CHATPATTA CHANA 90GM,14,25,25,0,1
16-04-2025,"Grains, Flours & Dals",CHANADALL 250 GMS,4,28,24,4,1
16-04-2025,Snacks & Ready-to-Eat,ANNAPURNA APPALAM,14,35,35,0,1
16-04-2025,"Grains, Flours & Dals",AISHWARYA SP 1KG,4,160,140,20,2
16-04-2025,"Grains, Flours & Dals",VGR rice 1 kg,4,70,65,5,1
16-04-2025,"Health, Wellness & Ayurvedic Products",MH Millets Malt 500GM,5,400,380,20,2
16-04-2025,"Health, Wellness & Ayurvedic Products",MH Millets Milk Powder 250GM,5,250,250,0,1
16-04-2025,Pooja & Spiritual Items,s karpuram,12,180,180,0,1
16-04-2025,"Grains, Flours & Dals",WHEAT 1 KG,4,240,200,40,4
16-04-2025,"Grains, Flours & Dals",JOWAR YELLOW 1 K,4,100,90,10,1
16-04-2025,"Grains, Flours & Dals",BARLEY SEEDS 250GMS,4,40,35,5,1
16-04-2025,"Grains, Flours & Dals",RAGULU 1 KG,4,210,180,30,3
16-04-2025,"Grains, Flours & Dals",Multigrain 1 kg,4,100,85,15,1
16-04-2025,"Grains, Flours & Dals",RAGULU 1 KG,4,70,60,10,1
16-04-2025,"Grains, Flours & Dals",Green gram 500 gms,4,75,70,5,1
16-04-2025,"Grains, Flours & Dals",Sathya Javva Wheat Rava 500GM,4,90,90,0,1
16-04-2025,"Grains, Flours & Dals",chana flour 500 gms,4,60,54,6,1
16-04-2025,"Dry Fruits, Nuts & Seeds",wallnuts,2,380,320,60,1
16-04-2025,"Grains, Flours & Dals",RICE FLOUR 500 GM,4,35,28,7,1
16-04-2025,Milk & Dairy,ID PANEER,7,135,135,0,1
16-04-2025,"Dry Fruits, Nuts & Seeds",ALMONDS 250GM,2,280,260,20,1
16-04-2025,"Dry Fruits, Nuts & Seeds",cashew,2,340,310,30,1
16-04-2025,Baking & Cooking Aids,BROWN &POLSON CORN STARCH 100GM,0,30,30,0,1
16-04-2025,"Dry Fruits, Nuts & Seeds",Groundnuts 500 gms,2,95,85,10,1
16-04-2025,"Grains, Flours & Dals",JOWAR YELLOW 1 K,4,100,90,10,1
16-04-2025,"Grains, Flours & Dals",JOWAR WHITE 1 KG,4,80,70,10,1
16-04-2025,Spices & Seasonings,AVALU 100GM,15,25,20,5,1
16-04-2025,Oils & Ghee,Sesame oil 1 L,9,1180,"1,120.00",60,2
16-04-2025,Oils & Ghee,Groundnut oil 1 L,9,1080,990,90,3
16-04-2025,"Grains, Flours & Dals",AISHWARYA SP 1KG,4,240,210,30,3
16-04-2025,Snacks & Ready-to-Eat,MIGHTY PUFFS TOMATO,14,50,50,0,2
16-04-2025,"Grains, Flours & Dals",BARLEY SEEDS 250GMS,4,40,35,5,1
16-04-2025,Spices & Seasonings,Turmeric powder 250 gms,15,100,75,25,1
16-04-2025,Spices & Seasonings,Jeera 100GM,15,50,45,5,1
16-04-2025,"Grains, Flours & Dals",RAGI FLOUR 500GRMS,4,80,70,10,2
16-04-2025,Pooja & Spiritual Items,s karpuram,12,180,180,0,1
16-04-2025,Spices & Seasonings,NUVVULU 250GM,15,80,65,15,1
16-04-2025,Oils & Ghee,cow ghee 500 ml,9,430,390,40,1
16-04-2025,"Dry Fruits, Nuts & Seeds",PUMPKIN SEEDS 250GM,2,200,160,40,1
16-04-2025,Oils & Ghee,BUFFALLO GHEE 500ML,9,410,370,40,1
16-04-2025,"Grains, Flours & Dals",BARLEY SEEDS 250GMS,4,40,35,5,1
16-04-2025,Snacks & Ready-to-Eat,VD BOONDI 175GM,14,120,120,0,2
16-04-2025,Snacks & Ready-to-Eat,VD DAHI MIRCHI(SALTED) 100GM,14,90,90,0,2
16-04-2025,Spices & Seasonings,pickles chilli .pwdr 500 gms,15,355,325,30,1
16-04-2025,"Grains, Flours & Dals",Em jowar idly R 500G,4,300,300,0,4
16-04-2025,"Health, Wellness & Ayurvedic Products",MD Bringaraj Choornam 100GM,5,80,80,0,1
16-04-2025,Oils & Ghee,Groundnut oil 1 L,9,720,660,60,2
16-04-2025,Spices & Seasonings,Avalu small 500 gms,15,120,120,0,1
16-04-2025,Spices & Seasonings,3M.MIRCHI POWDER,15,408,275,133,1
16-04-2025,Snacks & Ready-to-Eat,SD FINGER Millet with palm Jaggery 250gm,14,135,135,0,1
16-04-2025,"Grains, Flours & Dals",Multigrain 1 kg,4,100,85,15,1
16-04-2025,"Health, Wellness & Ayurvedic Products",MD Aamlaki Choornam 100GM,5,100,100,0,1
16-04-2025,Milk & Dairy,BROWN EGGS 1P,7,84,72,12,6
16-04-2025,"Grains, Flours & Dals",Wheat Flour 1 kg,4,70,60,10,1
16-04-2025,"Grains, Flours & Dals",Multigrain 1 kg,4,100,85,15,1
16-04-2025,"Grains, Flours & Dals",RED RICE 1KG,4,150,120,30,1
16-04-2025,Sweeteners,GS Palm Jaggery Powder 400GM,16,180,180,0,1
16-04-2025,"Grains, Flours & Dals",White jowar.F 1 kg,4,100,80,20,1
16-04-2025,Snacks & Ready-to-Eat,VD MULTI CHAKKA,14,110,110,0,1
16-04-2025,Beverages,GANTASALA GREEN TEA 100GM,1,149,149,0,1
16-04-2025,"Dry Fruits, Nuts & Seeds",SD Mango cubes 200gm,2,180,180,0,2
16-04-2025,Snacks & Ready-to-Eat,SD Atreyapuram DRY Fruit ghee,14,300,300,0,2
16-04-2025,Snacks & Ready-to-Eat,SATHVI REGIVADA 200GM,14,160,120,40,2
16-04-2025,Oils & Ghee,Sesame oil 1 L,9,1180,"1,120.00",60,2
16-04-2025,Spices & Seasonings,Chilli powder 500 gms,15,290,210,80,1
16-04-2025,Household & Cleaning,SURFEXCEL BAR 80G,6,20,20,0,2
16-04-2025,Beverages,REFRESH SHARBATH NORMAL,1,199,190,9,1
16-04-2025,"Grains, Flours & Dals",COW B rice 1 kg,4,720,690,30,10
16-04-2025,Snacks & Ready-to-Eat,BB VERMICELLY 500GM,14,53,53,0,1
16-04-2025,Spices & Seasonings,Turmeric powder 250 gms,15,100,75,25,1
16-04-2025,Snacks & Ready-to-Eat,MIX MILLET NOODLES,14,75,75,0,1
16-04-2025,Spices & Seasonings,ROYAL SAFFRON 400GRMS,15,65,65,0,1
16-04-2025,Snacks & Ready-to-Eat,VD Pappu Chekkalu 190gm,14,180,180,0,3
16-04-2025,Sweeteners,GS A2 Buffalo Ghee 500ML,16,1100,"1,100.00",0,2
16-04-2025,Spices & Seasonings,Turmeric powder 250 gms,15,100,75,25,1
16-04-2025,Snacks & Ready-to-Eat,VD SAGOPAPAD 150GM,14,110,110,0,2
16-04-2025,Spices & Seasonings,Chilli powder 500 gms,15,290,210,80,1
16-04-2025,Snacks & Ready-to-Eat,JUNNU POWDER 100GM,14,70,70,0,1
16-04-2025,Pooja & Spiritual Items,GD Kumkum 50GM,12,30,30,0,1
16-04-2025,Pooja & Spiritual Items,SWAATHI GATTI DEEPAM VATTULU,12,90,90,0,3
16-04-2025,"Dry Fruits, Nuts & Seeds",SABJA SEEDS 100GM,2,80,70,10,1
16-04-2025,Snacks & Ready-to-Eat,VD RICE SAGO PAPAD 150GM,14,55,55,0,1
16-04-2025,Snacks & Ready-to-Eat,VD RED CHILLI RICEPAPAD 150GM,14,100,100,0,2
16-04-2025,Snacks & Ready-to-Eat,SH PUFFED RICE 500GM,14,112,112,0,1
16-04-2025,"Dry Fruits, Nuts & Seeds",PUTNALU 500GMS,2,180,152,28,2
16-04-2025,Spices & Seasonings,Vamu 100GM,15,60,50,10,1
16-04-2025,"Grains, Flours & Dals",URAD DALL,4,95,85,10,1
16-04-2025,Snacks & Ready-to-Eat,VD MURUKU 175GM,14,60,60,0,1
16-04-2025,Milk & Dairy,BROWN EGGS TRAY 30P,7,360,330,30,1
16-04-2025,Spices & Seasonings,ROYAL SAFFRON 400GRMS,15,130,130,0,2
16-04-2025,"Grains, Flours & Dals",BAJRA 1 KG,4,180,150,30,3
16-04-2025,Personal Care & Cosmetics,MD Soapnut Choornam 100GM,10,80,80,0,1
16-04-2025,Milk & Dairy,SANGAM TONED MILK 500ML,7,31,31,0,1
16-04-2025,Personal Care & Cosmetics,Soapnut 250GM,10,60,45,15,1
16-04-2025,Oils & Ghee,Sesame oil 1 L,9,590,560,30,1
16-04-2025,Spices & Seasonings,SD Little Millet Mix Karam Powder 100GM,15,75,75,0,1
16-04-2025,Milk & Dairy,SANGAM FULL CREAM MILK 500ML,7,39,39,0,1
16-04-2025,Milk & Dairy,SANGAM CURD 450GM,7,40,40,0,1
16-04-2025,"Grains, Flours & Dals",Wheat Rava M 500GM,4,33,30,3,1
16-04-2025,Spices & Seasonings,GS GARLIC KARAM 100GM,15,75,75,0,1
16-04-2025,Oils & Ghee,Groundnut oil 1 L,9,720,660,60,2
16-04-2025,Sweeteners,YB Brown Sugar 1KG,16,140,140,0,1
16-04-2025,Sweeteners,YB JAGGERY POWDER 1KG,16,140,140,0,1
16-04-2025,Oils & Ghee,Sesame oil 500ml,9,295,280,15,1
16-04-2025,Baking & Cooking Aids,GONDKATIRA Ag,0,85,75,10,1
16-04-2025,"Grains, Flours & Dals",SRILATHA RICE RAVVA 500GM,4,35,35,0,1
16-04-2025,Oils & Ghee,GROUNDNUT OIL 1KG,9,2160,"2,100.00",60,6
16-04-2025,"Dry Fruits, Nuts & Seeds",SD Mango cubes 200gm,2,90,90,0,1
16-04-2025,Snacks & Ready-to-Eat,SD FINGER Millet with palm Jaggery 250gm,14,135,135,0,1
16-04-2025,Snacks & Ready-to-Eat,VD PALLI LADDU,14,80,80,0,1
16-04-2025,Pickles & Cooking Pastes,SD RED CHILLI MESTA,11,110,110,0,1
16-04-2025,"Grains, Flours & Dals",Kandulu 500GM,4,80,70,10,1
16-04-2025,Milk & Dairy,HERITAGE TOTAL CURD 500GM,7,50,50,0,1
16-04-2025,Spices & Seasonings,ROYAL SAFFRON,15,125,125,0,1
16-04-2025,Snacks & Ready-to-Eat,BATANA NGT 70GMS,14,40,40,0,2
16-04-2025,Oils & Ghee,Groundnut oil 1 L,9,360,330,30,1
16-04-2025,Snacks & Ready-to-Eat,VD PALLI LADDU,14,160,160,0,2
16-04-2025,"Grains, Flours & Dals",Green gram 1 kg,4,150,130,20,1
16-04-2025,Snacks & Ready-to-Eat,RINGS 200GM,14,30,30,0,1
16-04-2025,"Grains, Flours & Dals",chana dall,4,24,24,0,1
16-04-2025,Spices & Seasonings,DRY MIECHI 200GM,15,80,60,20,1
16-04-2025,Sweeteners,YB Brown Sugar 500GM,16,75,75,0,1
16-04-2025,Snacks & Ready-to-Eat,ANNAPURNA APPALAM,14,35,35,0,1
16-04-2025,Spices & Seasonings,DURGA SALT CRYSTAL 1KG,15,25,25,0,1
16-04-2025,"Dry Fruits, Nuts & Seeds",Putnalu 250GM,2,45,38,7,1
16-04-2025,"Grains, Flours & Dals",PESARA PAPPU 500GMS,4,85,75,10,1
16-04-2025,Snacks & Ready-to-Eat,NGT CHATPATTA CHANA 90GM,14,50,50,0,2
16-04-2025,Oils & Ghee,Coconut oil 1 L,9,440,400,40,1
16-04-2025,Sweeteners,GS Palm Jaggery Powder 400GM,16,180,180,0,1
16-04-2025,Spices & Seasonings,NUVVULU 250GM,15,80,65,15,1
16-04-2025,"Grains, Flours & Dals",SRILATHA RICE RAVVA 500GM,4,35,35,0,1
16-04-2025,Oils & Ghee,Coconut oil 1 L,9,440,400,40,1
16-04-2025,Snacks & Ready-to-Eat,RAJGIRA PEANUT CHIKKI,14,10,10,0,2
16-04-2025,Oils & Ghee,Sesame oil 1 L,9,1770,"1,680.00",90,3
16-04-2025,"Grains, Flours & Dals",SABDANA 500GM,4,90,70,20,1
16-04-2025,"Grains, Flours & Dals",BOMBAY RAVA,4,70,55,15,1
16-04-2025,Oils & Ghee,Safflower oil 1 L,9,440,400,40,1
16-04-2025,"Dry Fruits, Nuts & Seeds",ANJEER 250GM,2,400,360,40,1
16-04-2025,"Dry Fruits, Nuts & Seeds",Putnalu 250GM,2,45,38,7,1
16-04-2025,Snacks & Ready-to-Eat,PEANUT CHIKKI,14,44,44,0,2
16-04-2025,Oils & Ghee,Groundnut oil 1 L,9,360,330,30,1
16-04-2025,Spices & Seasonings,menthulu,15,90,90,0,1
16-04-2025,Pooja & Spiritual Items,GD Bhagavatha Mallika 75GM,12,60,60,0,1
16-04-2025,Pooja & Spiritual Items,GB Bharatha Woods 75GM,12,60,60,0,1
16-04-2025,Personal Care & Cosmetics,MADDI BATH POWDER 400GM,10,150,150,0,1
16-04-2025,"Grains, Flours & Dals",Em Multimillet idli r 500g,4,129,129,0,1
16-04-2025,"Grains, Flours & Dals",EM Ragi idli R 500G,4,300,300,0,4
16-04-2025,Snacks & Ready-to-Eat,NGT CHATPATTA CHANA 90GM,14,50,50,0,2
16-04-2025,Snacks & Ready-to-Eat,VD MURMURA LADDU,14,50,50,0,1
16-04-2025,"Grains, Flours & Dals",RAGI FLOUR 1KG,4,80,70,10,1
16-04-2025,Beverages,REFRESH SHARBATH NORMAL,1,199,190,9,1
16-04-2025,"Grains, Flours & Dals",White jowar.F 1 kg,4,100,80,20,1
16-04-2025,Snacks & Ready-to-Eat,VD SAGOPAPAD 150GM,14,55,55,0,1
16-04-2025,Snacks & Ready-to-Eat,BD RED RICE NOODLES 200G,14,70,70,0,1
16-04-2025,"Grains, Flours & Dals",SPLIT URAD DHAL,4,80,80,0,1
16-04-2025,Misc,YBNP021,8,100,100,0,1
16-04-2025,"Grains, Flours & Dals",AISHWARYA SP 1KG,4,400,350,50,5
16-04-2025,Snacks & Ready-to-Eat,GS INSTANT RAGI DOSA MIX,14,99,99,0,1
16-04-2025,"Dry Fruits, Nuts & Seeds",Groundnuts 1 kg,2,190,165,25,1
16-04-2025,Personal Care & Cosmetics,rose water,10,225,225,0,1
16-04-2025,Personal Care & Cosmetics,UVIS SANDALWOOD POWDR 100gm,10,149,149,0,1
16-04-2025,Snacks & Ready-to-Eat,KURNOOL MARMURA,14,70,55,15,1
16-04-2025,"Grains, Flours & Dals",BARLY POWDER,4,40,40,0,1
16-04-2025,Snacks & Ready-to-Eat,GS INSTANT KORRA DOSA MIX 400GM,14,120,120,0,1
16-04-2025,Snacks & Ready-to-Eat,SF COOKIES CHOCO RAGI,14,99,99,0,1
16-04-2025,"Grains, Flours & Dals",Green gram 1 kg,4,150,130,20,1
16-04-2025,"Grains, Flours & Dals",RICE FLOUR 1KG,4,140,110,30,2
16-04-2025,Spices & Seasonings,beetroot powder,15,149,149,0,1
16-04-2025,Personal Care & Cosmetics,HERBAL BATH POWDER 200GM,10,80,80,0,1
16-04-2025,Oils & Ghee,Groundnut oil 1 L,9,720,660,60,2
16-04-2025,"Grains, Flours & Dals",MAAGAANI LOW GI SP L 1KG,4,120,105,15,1
16-04-2025,Snacks & Ready-to-Eat,GS Moongdal Dosa Mix 400GM,14,140,140,0,1
16-04-2025,Household & Cleaning,scotch brite,6,150,150,0,1
16-04-2025,Snacks & Ready-to-Eat,INSTANT JOWAR DOSA MIX,14,120,120,0,1
16-04-2025,"Grains, Flours & Dals",Chana Flour 500 gms,4,140,110,30,1
16-04-2025,Spices & Seasonings,NUVVULU 500GM,15,200,170,30,1
16-04-2025,Beverages,BISLERI 100ml,1,10,10,0,1
16-04-2025,Pooja & Spiritual Items,GD Aiswarya Deepam 700ML,12,585,585,0,3
16-04-2025,Spices & Seasonings,SH MUSTARD 100GM,15,150,150,0,5
16-04-2025,Personal Care & Cosmetics,BIOTIQUE HONEY WATER PORE,10,210,210,0,1
16-04-2025,Oils & Ghee,Safflower oil 1 L,9,880,800,80,2
16-04-2025,Oils & Ghee,Sesame oil 1 L,9,1180,"1,120.00",60,2
16-04-2025,"Grains, Flours & Dals",Multigrain 1 kg,4,100,85,15,1
16-04-2025,"Grains, Flours & Dals",Wheat Flour 1 kg,4,70,60,10,1
16-04-2025,"Grains, Flours & Dals",RAGI FLOUR 500GRMS,4,40,35,5,1
16-04-2025,Personal Care & Cosmetics,MD Bath Powder 100GM,10,40,40,0,1
16-04-2025,Spices & Seasonings,Tamarind 250GMS,15,80,65,15,1
16-04-2025,"Grains, Flours & Dals",KORRALU (FOXTAIL M) 500GM,4,65,55,10,1
16-04-2025,"Grains, Flours & Dals",VGR rice 1 kg,4,700,650,50,10
16-04-2025,"Grains, Flours & Dals",Quinova 500 gms,4,110,100,10,1
16-04-2025,"Grains, Flours & Dals",SA WHITE JOWAR RAVA 500GM,4,69,69,0,1
16-04-2025,"Grains, Flours & Dals",Multigrain 1 kg,4,200,170,30,2
16-04-2025,Spices & Seasonings,coconut powder,15,90,70,20,1
16-04-2025,Sweeteners,YB FOREST H 250 GMS,16,180,180,0,1
16-04-2025,Sweeteners,YB Brown Sugar 1KG,16,700,700,0,5
16-04-2025,"Grains, Flours & Dals",Wheat Flour 1 kg,4,280,240,40,4
16-04-2025,Oils & Ghee,Sesame oil 1 L,9,590,560,30,1
16-04-2025,Sweeteners,YB Palm Jaggery 250GM,16,200,200,0,1
16-04-2025,Spices & Seasonings,Jeera 100GM,15,100,90,10,2
16-04-2025,"Grains, Flours & Dals",AISHWARYA SP 1KG,4,640,560,80,8
16-04-2025,"Grains, Flours & Dals",split black gram 1 kg,4,180,170,10,1
16-04-2025,"Dry Fruits, Nuts & Seeds",PUTNALU 500GMS,2,90,76,14,1
16-04-2025,Spices & Seasonings,ROYAL SAFFRON 400GRMS,15,65,65,0,1
16-04-2025,"Dry Fruits, Nuts & Seeds",Groundnuts 1 kg,2,190,165,25,1
16-04-2025,Oils & Ghee,Sesame oil 500ml,9,295,280,15,1
16-04-2025,Spices & Seasonings,DURGA SALT CRYSTAL 1KG,15,28,28,0,1
16-04-2025,"Grains, Flours & Dals",PESARA PAPPU 1 KG,4,170,145,25,1
16-04-2025,"Dry Fruits, Nuts & Seeds",Groundnuts 500 gms,2,95,85,10,1
16-04-2025,Spices & Seasonings,NUVVULU 250GM,15,100,85,15,1
16-04-2025,Spices & Seasonings,THREE MANGO RAI 200G,15,42,42,0,1
16-04-2025,Misc,C123,8,95,80,15,1
16-04-2025,Oils & Ghee,Safflower oil 1 L,9,440,400,40,1
16-04-2025,Sweeteners,YB JAGGERY POWDER 1KG,16,280,280,0,2
16-04-2025,"Dry Fruits, Nuts & Seeds",Groundnuts 1 kg,2,190,165,25,1
16-04-2025,Snacks & Ready-to-Eat,VD PALLI LADDU,14,320,320,0,4
16-04-2025,Sweeteners,YB JAGGERY POWDER 1KG,16,280,280,0,2
16-04-2025,"Grains, Flours & Dals",Urad dall 1 Kg,4,185,170,15,1
16-04-2025,Oils & Ghee,Sesame oil 1 L,9,1180,"1,120.00",60,2
16-04-2025,Sweeteners,YB JAGGERY POWDER 500GMS,16,300,300,0,4
16-04-2025,"Grains, Flours & Dals",idly rava 1kg,4,60,50,10,1
16-04-2025,"Grains, Flours & Dals",turdal 1kg,4,220,170,50,1
16-04-2025,Misc,VD00014,8,200,180,20,2
16-04-2025,"Grains, Flours & Dals",Green gram 500 gms,4,75,70,5,1
16-04-2025,"Grains, Flours & Dals",THICK POHA 500GM,4,40,35,5,1
16-04-2025,"Dry Fruits, Nuts & Seeds",YB GRANMA NUTS,2,90,90,0,1
16-04-2025,Oils & Ghee,Groundnut oil 1 L,9,360,330,30,1
16-04-2025,Pooja & Spiritual Items,GD Sree Chandan 50GM,12,50,50,0,1
16-04-2025,Pooja & Spiritual Items,GD Aiswarya Deepam 700ML,12,195,195,0,1
16-04-2025,Pooja & Spiritual Items,GD Camphor 50GM,12,115,115,0,1
16-04-2025,Beverages,BRU GREEN LABEL 1.2G,1,28,28,0,14
16-04-2025,Oils & Ghee,BUFFALLO GHEE 500ML,9,410,370,40,1
16-04-2025,"Grains, Flours & Dals",KORRALU (FOXTAIL M) 1KG,4,300,220,80,2
16-04-2025,Beverages,REFRESH SHARBATH NORMAL,1,199,190,9,1
16-04-2025,Baking & Cooking Aids,GONDKATIRA Ag,0,85,75,10,1
16-04-2025,Oils & Ghee,Coconut oil 500 ml,9,220,200,20,1
16-04-2025,"Grains, Flours & Dals",Wheat Flour 1 kg,4,70,60,10,1
16-04-2025,"Grains, Flours & Dals",Chana Flour 500 gms,4,140,110,30,1
16-04-2025,Milk & Dairy,HERITAGE TOTAL CURD 500GM,7,50,50,0,1
16-04-2025,Milk & Dairy,HERTG FULL CREAM M,7,41,41,0,1
16-04-2025,Spices & Seasonings,NUVVULU 250GM,15,80,65,15,1
16-04-2025,"Grains, Flours & Dals",Wheat Rava M 500GM,4,33,30,3,1
16-04-2025,"Health, Wellness & Ayurvedic Products",MXP CREAM ONION,5,45,45,0,1
16-04-2025,"Grains, Flours & Dals",turdal 500 gms,4,110,85,25,1
16-04-2025,"Health, Wellness & Ayurvedic Products",RB Max Protein PERI PERI 60gm,5,45,45,0,1
16-04-2025,Spices & Seasonings,Coriander seeds 200 gms,15,48,40,8,1
16-04-2025,Oils & Ghee,cow ghee 500 ml,9,860,780,80,2
16-04-2025,Oils & Ghee,Sesame oil 1 L,9,590,560,30,1
16-04-2025,"Grains, Flours & Dals",chana flour 500 gms,4,60,54,6,1
16-04-2025,"Grains, Flours & Dals",Wheat Flour 1 kg,4,140,120,20,2
16-04-2025,Oils & Ghee,Groundnut oil 1 L,9,1080,990,90,3
16-04-2025,Milk & Dairy,ID PANEER,7,135,135,0,1
16-04-2025,"Dry Fruits, Nuts & Seeds",Groundnuts 1 kg,2,190,165,25,1
16-04-2025,Milk & Dairy,SANGAM TONED MILK 500ML,7,30,30,0,1
16-04-2025,"Dry Fruits, Nuts & Seeds",PUTNALU 500GMS,2,90,76,14,1
16-04-2025,"Grains, Flours & Dals",Bajra Flour 1 kg,4,70,60,10,1
16-04-2025,Snacks & Ready-to-Eat,SD Ginger Candy 100g,14,60,60,0,1
16-04-2025,Snacks & Ready-to-Eat,SD High Protein Laddu 175gm,14,190,190,0,1
16-04-2025,Oils & Ghee,Safflower oil 1 L,9,440,400,40,1
16-04-2025,Snacks & Ready-to-Eat,VD RICE MURUKU 150GM,14,50,50,0,1
16-04-2025,Snacks & Ready-to-Eat,SF MIGHTY PUFFS,14,50,50,0,2
16-04-2025,Snacks & Ready-to-Eat,SUNNUNDALU,14,120,120,0,1
16-04-2025,Oils & Ghee,Groundnut oil 500ml,9,180,165,15,1
16-04-2025,Snacks & Ready-to-Eat,VD RICE SAGO PAPAD 150GM,14,55,55,0,1
16-04-2025,"Grains, Flours & Dals",HS JOWAR IDLY RAWA,4,195,195,0,3
16-04-2025,"Grains, Flours & Dals",Em jowar idly R 500G,4,75,75,0,1
16-04-2025,Oils & Ghee,Black Sesame oil 1 L,9,440,380,60,1
16-04-2025,"Dry Fruits, Nuts & Seeds",FLAX SEEDS 250GM,2,60,50,10,1
16-04-2025,Spices & Seasonings,pickle chili powder,15,180,165,15,1
16-04-2025,"Health, Wellness & Ayurvedic Products",SAI DURGA MORINGA LEAVES 100GM,5,75,75,0,1
16-04-2025,"Grains, Flours & Dals",Multigrain 1 kg,4,100,85,15,1
16-04-2025,Milk & Dairy,BROWN EGGS 1P,7,126,108,18,9
16-04-2025,Snacks & Ready-to-Eat,VD GUMMADI VADIYAM,14,75,75,0,1
16-04-2025,"Dry Fruits, Nuts & Seeds",PUTNALU 500GMS,2,90,76,14,1
16-04-2025,"Grains, Flours & Dals",White jowar.F 1 kg,4,100,80,20,1
16-04-2025,"Grains, Flours & Dals",PESARA PAPPU 1 KG,4,170,145,25,1
16-04-2025,"Grains, Flours & Dals",Green gram 1 kg,4,150,130,20,1
16-04-2025,"Dry Fruits, Nuts & Seeds",Groundnuts 1 kg,2,190,165,25,1
16-04-2025,"Grains, Flours & Dals",MELMEKER 250GMS,4,60,45,15,1
16-04-2025,Sweeteners,organic jaggery powder,16,99,99,0,1
16-04-2025,"Grains, Flours & Dals",RED TUDAL 1KG,4,150,140,10,1
16-04-2025,Spices & Seasonings,AV Iodized Salt 1KG,15,28,25,3,1
16-04-2025,"Grains, Flours & Dals",RAGI FLOUR 1KG,4,80,70,10,1
16-04-2025,Spices & Seasonings,coconut powder,15,90,70,20,1
16-04-2025,"Grains, Flours & Dals",BOMBAY RAVA,4,70,55,15,1
16-04-2025,"Grains, Flours & Dals",THICK POHA 1KG,4,80,70,10,1
16-04-2025,"Grains, Flours & Dals",white Bobarlu 1 KG,4,170,150,20,1
16-04-2025,"Grains, Flours & Dals",SABDANA 500GM,4,90,70,20,1
16-04-2025,"Grains, Flours & Dals",UNPOLISHED TURDALL 1KG,4,240,210,30,1
16-04-2025,"Grains, Flours & Dals",Wheat Flour 1 kg,4,140,120,20,2
16-04-2025,Milk & Dairy,HERITAGE TONED MILK 500ML,7,62,62,0,2
16-04-2025,Snacks & Ready-to-Eat,BROWN BREAD,14,55,55,0,1
16-04-2025,"Grains, Flours & Dals",Multigrain 1 kg,4,100,85,15,1
16-04-2025,Milk & Dairy,SANGAM TONED MILK 500ML,7,30,30,0,1
16-04-2025,"Grains, Flours & Dals",RAGI FLOUR 500GRMS,4,40,35,5,1
16-04-2025,Milk & Dairy,BROWN EGGS 1P,7,168,144,24,12
16-04-2025,Personal Care & Cosmetics,GOW DURBAR NAVA 100GM SOAP,10,40,40,0,1
15-04-2025,Pooja & Spiritual Items,NALLAS VAISHNAVI MAISHAKSHI 50GM,12,50,50,0,1
15-04-2025,Snacks & Ready-to-Eat,VD MURMURA LADDU,14,50,50,0,1
15-04-2025,Misc,VD0009,8,100,100,0,1
15-04-2025,Pooja & Spiritual Items,GD Dhoop Cones 40GM,12,60,60,0,2
15-04-2025,"Grains, Flours & Dals",RICE FLOUR 500 GM,4,70,56,14,2
15-04-2025,Pooja & Spiritual Items,GD Bhagavatha Mallika 75GM,12,60,60,0,1
15-04-2025,Personal Care & Cosmetics,GOW DURBAR NAVA 100GM SOAP,10,40,40,0,1
15-04-2025,Pooja & Spiritual Items,GOW DURBAR GEETHA CAMPHOR,12,60,60,0,1
15-04-2025,Snacks & Ready-to-Eat,VD NUVULU CHEGODI 175GM,14,60,60,0,1
15-04-2025,"Dry Fruits, Nuts & Seeds",Putnalu 250GM,2,45,38,7,1
15-04-2025,Snacks & Ready-to-Eat,VD MURUKU 175GM,14,60,60,0,1
15-04-2025,Pooja & Spiritual Items,GD Kumkum 50GM,12,30,30,0,1
15-04-2025,Spices & Seasonings,GD Turmeric 50GM,15,25,25,0,1
15-04-2025,"Grains, Flours & Dals",BOMBAY RAVA,4,70,55,15,1
15-04-2025,Pooja & Spiritual Items,GD KASTHURI,12,60,60,0,1
15-04-2025,Pooja & Spiritual Items,SRI HARI KRISHNA DOOM 12PIC,12,80,80,0,1
15-04-2025,Personal Care & Cosmetics,gow durbar sandal,10,40,40,0,1
15-04-2025,"Grains, Flours & Dals",split black gram 1 kg,4,180,170,10,1
15-04-2025,Personal Care & Cosmetics,SVE RED SANDAL SOAP 100GM,10,90,90,0,1
15-04-2025,Oils & Ghee,Sesame oil 500ml,9,295,280,15,1
15-04-2025,Sweeteners,PN ORGANIC BROWN SUGAR 500GM,16,78,78,0,1
15-04-2025,Snacks & Ready-to-Eat,RINGS 200GM,14,30,30,0,1
15-04-2025,Snacks & Ready-to-Eat,SD Groundnut with palm jaggery 250gm,14,135,135,0,1
15-04-2025,"Health, Wellness & Ayurvedic Products",RB Max Protein Salt & Caramel Bar 50g,5,150,150,0,2
15-04-2025,Misc,VD0009,8,100,100,0,1
15-04-2025,Milk & Dairy,BROWN EGGS TRAY 30P,7,360,330,30,1
15-04-2025,Snacks & Ready-to-Eat,VD MURMURA LADDU,14,50,50,0,1
15-04-2025,Snacks & Ready-to-Eat,Sprouted Ragi Biscuits 450GM,14,150,150,0,1
15-04-2025,Snacks & Ready-to-Eat,VD MURUKU 175GM,14,60,60,0,1
15-04-2025,"Grains, Flours & Dals",Wheat Flour 1 kg,4,140,120,20,2
15-04-2025,"Grains, Flours & Dals",White jowar.F 1 kg,4,200,160,40,2
15-04-2025,Oils & Ghee,Groundnut oil 1 L,9,720,660,60,2
15-04-2025,"Grains, Flours & Dals",Bombay Rava 500GM,4,35,30,5,1
15-04-2025,"Grains, Flours & Dals",RICE FLOUR 500 GM,4,35,28,7,1
15-04-2025,Snacks & Ready-to-Eat,RAJGIRA PEANUT CHIKKI,14,20,20,0,4
15-04-2025,Sweeteners,MISHRI 250 GM,16,35,30,5,1
15-04-2025,"Grains, Flours & Dals",Wheat Flour 1 kg,4,140,120,20,2
15-04-2025,Snacks & Ready-to-Eat,WHOLE WHEAT BREAD,14,55,55,0,1
15-04-2025,"Grains, Flours & Dals",RAGI FLOUR 500GRMS,4,40,35,5,1
15-04-2025,"Grains, Flours & Dals",chana flour 500 gms,4,60,54,6,1
15-04-2025,Spices & Seasonings,Jeera 100GM,15,50,45,5,1
15-04-2025,"Grains, Flours & Dals",Multigrain 1 kg,4,100,85,15,1
15-04-2025,"Grains, Flours & Dals",URAD DALL,4,95,85,10,1
15-04-2025,"Dry Fruits, Nuts & Seeds",cashew,2,340,310,30,1
15-04-2025,Sweeteners,sugar 500 gms,16,30,28,2,1
15-04-2025,"Grains, Flours & Dals",White jowar.F 1 kg,4,100,80,20,1
15-04-2025,Pooja & Spiritual Items,SWASTIK CAMPHORE,12,90,90,0,1
15-04-2025,"Dry Fruits, Nuts & Seeds",Groundnuts 500 gms,2,95,85,10,1
15-04-2025,Snacks & Ready-to-Eat,KURNOOL MARMURA,14,70,55,15,1
15-04-2025,Spices & Seasonings,SONTI 50GM,15,30,20,10,1
15-04-2025,"Dry Fruits, Nuts & Seeds",SD Mango cubes 100gm,2,45,45,0,1
15-04-2025,Snacks & Ready-to-Eat,SF PUFFED RICE,14,55,55,0,1
15-04-2025,Sweeteners,NATURAL HONEY 250GM,16,150,130,20,1
15-04-2025,"Grains, Flours & Dals",RAGI FLOUR 500GRMS,4,40,35,5,1
15-04-2025,Oils & Ghee,Coconut oil 500 ml,9,220,200,20,1
15-04-2025,"Grains, Flours & Dals",RICE FLOUR 500 GM,4,35,28,7,1
15-04-2025,"Grains, Flours & Dals",Bombay Rava 500GM,4,35,30,5,1
15-04-2025,Spices & Seasonings,sf red chilli,15,85,85,0,1
15-04-2025,"Grains, Flours & Dals",SAMALU (Little millet) 1 kg,4,340,260,80,2
15-04-2025,"Grains, Flours & Dals",UDALU (Barnyard millet) 1 kg,4,140,115,25,1
15-04-2025,"Grains, Flours & Dals",KORRALU (FOXTAIL M) 1KG,4,150,110,40,1
15-04-2025,"Dry Fruits, Nuts & Seeds",FLAX SEEDS 250GM,2,60,50,10,1
15-04-2025,Personal Care & Cosmetics,garnier black naturals,10,135,135,0,3
15-04-2025,"Grains, Flours & Dals",ANDU KORRALU (Browntop.m) 1 kg,4,260,220,40,1
15-04-2025,Spices & Seasonings,Coriander seeds 200 gms,15,48,40,8,1
15-04-2025,Snacks & Ready-to-Eat,VD Pappu Chekkalu 190gm,14,60,60,0,1
15-04-2025,"Dry Fruits, Nuts & Seeds",Groundnuts 500 gms,2,95,85,10,1
15-04-2025,"Grains, Flours & Dals",JOWAR YELLOW 1 K,4,100,90,10,1
15-04-2025,"Dry Fruits, Nuts & Seeds",SABJA SEEDS 100GM,2,80,70,10,1
15-04-2025,"Grains, Flours & Dals",Quinova 1 kg,4,220,195,25,1
15-04-2025,"Grains, Flours & Dals",SA Sprouted Ragi Flour 500GM,4,69,69,0,1
15-04-2025,"Grains, Flours & Dals",AISHWARYA SP 1KG,4,400,350,50,5
15-04-2025,"Dry Fruits, Nuts & Seeds",Groundnuts 1 kg,2,190,165,25,1
15-04-2025,Oils & Ghee,Sesame oil 1 L,9,590,560,30,1
15-04-2025,"Grains, Flours & Dals",RAGI FLOUR 500GRMS,4,40,35,5,1
15-04-2025,"Grains, Flours & Dals",ragi umpa ravva,4,70,70,0,1
15-04-2025,"Grains, Flours & Dals",SA WHITE JOWAR RAVA 500GM,4,69,69,0,1
15-04-2025,"Grains, Flours & Dals",MULTIMILLET IDLY RAVVA,4,65,65,0,1
15-04-2025,"Grains, Flours & Dals",KORRALU (FOXTAIL M) 500GM,4,65,55,10,1
15-04-2025,"Grains, Flours & Dals",white Bobarlu 500 gms,4,80,75,5,1
15-04-2025,"Grains, Flours & Dals",UDALU (Barnyard millet) 500 gms,4,70,60,10,1
15-04-2025,"Grains, Flours & Dals",Green gram 500 gms,4,75,70,5,1
15-04-2025,"Grains, Flours & Dals",Multigrain 1 kg,4,100,85,15,1
15-04-2025,Sweeteners,YB JAGGERY POWDER 500GMS,16,75,75,0,1
15-04-2025,"Grains, Flours & Dals",White Chana 500GM,4,120,100,20,1
15-04-2025,Oils & Ghee,Black Sesame oil 1 L,9,880,760,120,2
15-04-2025,Pooja & Spiritual Items,GD Aiswarya Deepam 700ML,12,585,585,0,3
15-04-2025,Personal Care & Cosmetics,Soapnut 500GM,10,240,180,60,2
15-04-2025,Spices & Seasonings,ROYAL SAFFRON,15,250,250,0,2
15-04-2025,"Grains, Flours & Dals",VGR rice 1 kg,4,210,195,15,3
15-04-2025,"Grains, Flours & Dals",Urad dall 1 Kg,4,185,170,15,1
15-04-2025,Personal Care & Cosmetics,GAYATHRI KUMKUDUKAYA,10,300,300,0,2
15-04-2025,"Grains, Flours & Dals",Green gram 500 gms,4,75,70,5,1
15-04-2025,"Grains, Flours & Dals",Red Bobarlu 500 gms,4,95,85,10,1
15-04-2025,"Grains, Flours & Dals",Red Chana 250GM,4,35,30,5,1
15-04-2025,"Grains, Flours & Dals",SABDANA,4,40,35,5,1
15-04-2025,"Grains, Flours & Dals",SABDANA,4,40,35,5,1
15-04-2025,Snacks & Ready-to-Eat,KURNOOL MARMURA,14,70,55,15,1
15-04-2025,Spices & Seasonings,AVALU 100GM,15,25,20,5,1
15-04-2025,Snacks & Ready-to-Eat,VD PALLI LADDU,14,80,80,0,1
15-04-2025,"Grains, Flours & Dals",turdal 500 gms,4,110,85,25,1
15-04-2025,"Dry Fruits, Nuts & Seeds",SD Mango cubes 100gm,2,45,45,0,1
15-04-2025,Spices & Seasonings,ROYAL SAFFRON 400GRMS,15,65,65,0,1
15-04-2025,"Grains, Flours & Dals",Urad dall 1 Kg,4,185,170,15,1
15-04-2025,"Grains, Flours & Dals",Wheat Rava M 500GM,4,33,30,3,1
15-04-2025,"Grains, Flours & Dals",Bombay Rava 500GM,4,35,30,5,1
15-04-2025,Household & Cleaning,VIM MAHA BAR,6,20,20,0,2
15-04-2025,Snacks & Ready-to-Eat,VD MURMURA LADDU,14,50,50,0,1
15-04-2025,Sweeteners,SUGAR 1KG,16,60,56,4,1
15-04-2025,Spices & Seasonings,Tamarind 250GMS,15,80,65,15,1
15-04-2025,Spices & Seasonings,KALONJI SEEDS,15,90,80,10,1
15-04-2025,Snacks & Ready-to-Eat,Corn Chips 250GM,14,40,35,5,1
15-04-2025,"Grains, Flours & Dals",PESARA PAPPU 500GMS,4,85,75,10,1
15-04-2025,"Grains, Flours & Dals",Wheat Flour 1 kg,4,140,120,20,2
15-04-2025,"Grains, Flours & Dals",turdal 1kg,4,220,170,50,1
15-04-2025,Snacks & Ready-to-Eat,DISANO VERMICELLI 425 GM,14,50,50,0,1
15-04-2025,"Grains, Flours & Dals",Red Bobarlu 500 gms,4,95,85,10,1
15-04-2025,"Dry Fruits, Nuts & Seeds",Groundnuts 500 gms,2,95,85,10,1
15-04-2025,"Grains, Flours & Dals",MELMEKER 250GMS,4,60,45,15,1
15-04-2025,Sweeteners,SUGAR 1KG,16,60,56,4,1
15-04-2025,Spices & Seasonings,NUVVULU 250GM,15,100,85,15,1
15-04-2025,"Grains, Flours & Dals",Bombay Rava 500GM,4,35,30,5,1
15-04-2025,Personal Care & Cosmetics,SVE TURMERIC SOAP 100GM,10,90,90,0,1
15-04-2025,Personal Care & Cosmetics,SVE MULTANI MITTI SOAP 100GM,10,90,90,0,1
15-04-2025,Spices & Seasonings,LG 50GM,15,92,92,0,1
15-04-2025,Personal Care & Cosmetics,SVE PREMIUM PAPAYA SOAP 100GM,10,110,110,0,1
15-04-2025,"Grains, Flours & Dals",THIN POHA 500GM,4,40,35,5,1
15-04-2025,Snacks & Ready-to-Eat,KURNOOL MARMURA,14,70,55,15,1
15-04-2025,Milk & Dairy,SANGAM TONED MILK 500ML,7,60,60,0,2
15-04-2025,Snacks & Ready-to-Eat,VD PALLI LADDU,14,80,80,0,1
15-04-2025,"Dry Fruits, Nuts & Seeds",Groundnuts 500 gms,2,95,85,10,1
15-04-2025,Snacks & Ready-to-Eat,VD BELLAM GAVVALU 200GM,14,60,60,0,1
15-04-2025,Milk & Dairy,HERTG FULL CREAM M,7,41,41,0,1
15-04-2025,Milk & Dairy,BROWN EGGS 1P,7,84,72,12,6
15-04-2025,Snacks & Ready-to-Eat,sannakarampusa,14,60,60,0,1
15-04-2025,"Grains, Flours & Dals",Wheat Flour 1 kg,4,70,60,10,1
15-04-2025,Sweeteners,SUGAR 1KG,16,60,56,4,1
15-04-2025,"Grains, Flours & Dals",COW B rice 1 kg,4,360,345,15,5
15-04-2025,"Grains, Flours & Dals",Bombay Rava 500GM,4,35,30,5,1
15-04-2025,Beverages,BRU GREEN LABEL 1.2G,1,20,20,0,10
15-04-2025,"Grains, Flours & Dals",AISHWARYA SP 1KG,4,160,140,20,2
15-04-2025,Beverages,3roses,1,225,225,0,1
15-04-2025,Misc,NNF01245,8,150,150,0,3
15-04-2025,Pickles & Cooking Pastes,tamoto,11,120,120,0,1
15-04-2025,Snacks & Ready-to-Eat,VD PALLI LADDU,14,80,80,0,1
15-04-2025,Snacks & Ready-to-Eat,NGT CHATPATTA CHANA 90GM,14,50,50,0,2
15-04-2025,Misc,VD00014,8,100,90,10,1
15-04-2025,Misc,VD00115,8,60,60,0,1
15-04-2025,"Grains, Flours & Dals",SL Idly Rava 1KG,4,65,55,10,1
15-04-2025,General Household & Kitchenware,MATCH BOX,3,20,20,0,1
15-04-2025,"Dry Fruits, Nuts & Seeds",FLAX SEEDS 250GM,2,60,50,10,1
15-04-2025,Oils & Ghee,Groundnut oil 1 L,9,360,330,30,1
15-04-2025,Pooja & Spiritual Items,PACHAKARPURAM,12,60,50,10,1
15-04-2025,Spices & Seasonings,lavangam,15,50,50,0,1
15-04-2025,Pooja & Spiritual Items,SWASTIK CAMPHOR 25GM,12,45,45,0,1
15-04-2025,Pooja & Spiritual Items,SIVA SHAKTHI PUJA PURPOSE 10G,12,20,20,0,1
15-04-2025,"Health, Wellness & Ayurvedic Products",DWI LAVANGA TAILA 20ML,5,60,60,0,1
15-04-2025,"Grains, Flours & Dals",MULTIMILLET IDLY RAVVA,4,65,65,0,1
15-04-2025,Pooja & Spiritual Items,GD KASTHURI,12,60,60,0,1
15-04-2025,Pooja & Spiritual Items,divya deeparadhana oil,12,190,190,0,1
15-04-2025,Spices & Seasonings,LG 50GM,15,92,92,0,1
15-04-2025,Pooja & Spiritual Items,BALAJI BEL PHOOL STICKS 90GM,12,60,60,0,1
15-04-2025,Oils & Ghee,GANTASALA A2 COW GHEE 250ML,9,299,299,0,1
15-04-2025,Spices & Seasonings,MIRYALU 50 GRMS,15,100,80,20,1
15-04-2025,Oils & Ghee,Mustard oil 500 ml,9,220,195,25,1
15-04-2025,Oils & Ghee,Groundnut oil 1 L,9,360,330,30,1
15-04-2025,"Grains, Flours & Dals",SL Idly Rava 1KG,4,65,55,10,1
15-04-2025,Spices & Seasonings,AV Iodized Salt 1KG,15,28,25,3,1
15-04-2025,Sweeteners,ACHUBELLAM 500GM,16,50,40,10,1
15-04-2025,Household & Cleaning,VIM MAHA BAR,6,20,20,0,2
15-04-2025,Household & Cleaning,VIM EXTRA 110GM,6,20,20,0,2
15-04-2025,Snacks & Ready-to-Eat,VD RICE SAGO PAPAD 150GM,14,55,55,0,1
15-04-2025,Personal Care & Cosmetics,COLGATE ACTIVE SALT,10,20,20,0,1
15-04-2025,Household & Cleaning,vim small,6,15,15,0,1
15-04-2025,Household & Cleaning,comfort lily fresh,6,58,58,0,1
15-04-2025,"Grains, Flours & Dals",chana flour 500 gms,4,60,54,6,1
15-04-2025,"Dry Fruits, Nuts & Seeds",SALTED PISTA 250GM,2,400,350,50,1
15-04-2025,"Grains, Flours & Dals",RAGI FLOUR 500GRMS,4,40,35,5,1
15-04-2025,"Grains, Flours & Dals",THICK POHA 500GM,4,40,35,5,1
15-04-2025,"Grains, Flours & Dals",Red Bobarlu 500 gms,4,95,85,10,1
15-04-2025,"Grains, Flours & Dals",Kandulu 250GM,4,40,35,5,1
15-04-2025,Household & Cleaning,surf excel,6,150,150,0,1
15-04-2025,Oils & Ghee,Sesame oil 500ml,9,295,280,15,1
15-04-2025,Oils & Ghee,rice bran oil f,9,194,169,25,1
15-04-2025,Misc,NNF01245,8,50,50,0,1
15-04-2025,"Dry Fruits, Nuts & Seeds",Groundnuts 1 kg,2,190,165,25,1
15-04-2025,Snacks & Ready-to-Eat,VD PALLI CHIKKI,14,80,80,0,1
15-04-2025,Beverages,BRU GREEN LABEL 1.2G,1,8,8,0,4
15-04-2025,Spices & Seasonings,Coriander seeds 200 gms,15,48,40,8,1
15-04-2025,Snacks & Ready-to-Eat,VD ATUKULU MIXTURE 175GM,14,60,60,0,1
15-04-2025,"Dry Fruits, Nuts & Seeds",SH GROUNDNUT 500GM,2,163,130,33,1
15-04-2025,Oils & Ghee,Sesame oil 1 L,9,590,560,30,1
15-04-2025,Spices & Seasonings,Jeera 100GM,15,50,45,5,1
15-04-2025,"Grains, Flours & Dals",yellow jowar flour 1kg,4,100,92,8,1
15-04-2025,"Grains, Flours & Dals",Chana Flour 500 gms,4,140,110,30,1
15-04-2025,"Grains, Flours & Dals",RICE FLOUR 1KG,4,70,55,15,1
15-04-2025,Household & Cleaning,vim,6,60,60,0,1
15-04-2025,Snacks & Ready-to-Eat,GOLDEN SALT COOKIES,14,60,60,0,1
15-04-2025,Household & Cleaning,VIM SOAP,6,10,10,0,2
15-04-2025,Snacks & Ready-to-Eat,BB VERMICELLI 1KG,14,95,90,5,1
15-04-2025,Snacks & Ready-to-Eat,Pani Poori Chips 250GM,14,100,80,20,2
15-04-2025,Spices & Seasonings,garam masala,15,52,52,0,1
15-04-2025,Spices & Seasonings,SHAHI BIRYANI MASALA,15,42,42,0,1
15-04-2025,"Grains, Flours & Dals",WHITE BATANI 500GM,4,80,60,20,1
15-04-2025,Oils & Ghee,rice bran oil f,9,194,169,25,1
15-04-2025,"Grains, Flours & Dals",RAGI FLOUR 1KG,4,160,140,20,2
15-04-2025,Spices & Seasonings,ROYAL SAFFRON,15,125,125,0,1
15-04-2025,"Grains, Flours & Dals",BOMBAY RAVA,4,70,55,15,1
15-04-2025,Spices & Seasonings,Chilli powder 500 gms,15,290,210,80,1
15-04-2025,"Grains, Flours & Dals",Wheat Rava S 1KG,4,130,110,20,2
15-04-2025,Spices & Seasonings,EVEREST PANI PURI MASALA 50GM,15,40,40,0,1
15-04-2025,"Grains, Flours & Dals",turdal 1kg,4,220,170,50,1
15-04-2025,"Dry Fruits, Nuts & Seeds",PLAIN PISTA 250GM,2,660,550,110,1
15-04-2025,Spices & Seasonings,Tamarind 250GMS,15,400,325,75,5
15-04-2025,"Grains, Flours & Dals",THICK POHA 500GM,4,40,35,5,1
15-04-2025,"Grains, Flours & Dals",Multigrain 1 kg,4,100,85,15,1
15-04-2025,"Dry Fruits, Nuts & Seeds",SUNFLOWER SEEDS 250GRM,2,150,130,20,1
15-04-2025,Spices & Seasonings,Elaichi 25GM,15,145,120,25,1
15-04-2025,Spices & Seasonings,MIRYALU 50 GRMS,15,100,80,20,1
15-04-2025,Spices & Seasonings,Chilli powder 500 gms,15,290,210,80,1
15-04-2025,"Grains, Flours & Dals",Wheat Flour 1 kg,4,70,60,10,1
15-04-2025,Spices & Seasonings,Turmeric powder 250 gms,15,100,75,25,1
15-04-2025,Spices & Seasonings,SATHVI ANASAPUVUU 25GM,15,90,65,25,1
15-04-2025,Sweeteners,SUGAR 500 GM,16,30,25,5,1
15-04-2025,Misc,100248,8,155,155,0,1
15-04-2025,Spices & Seasonings,Gasagasalu 50GM,15,130,110,20,1
15-04-2025,"Grains, Flours & Dals",Urad dall 1 Kg,4,185,170,15,1
15-04-2025,"Grains, Flours & Dals",WHITE BATANI,4,40,30,10,1
15-04-2025,"Grains, Flours & Dals",AISHWARYA SP 1KG,4,800,700,100,10
15-04-2025,Spices & Seasonings,pickles chilli powder 500GM,15,325,325,0,1
15-04-2025,"Grains, Flours & Dals",Green gram 1 kg,4,150,130,20,1
15-04-2025,Spices & Seasonings,JEERA 250 gms,15,125,105,20,1
15-04-2025,Spices & Seasonings,DURGA SALT CRYSTAL 1KG,15,25,25,0,1
15-04-2025,Snacks & Ready-to-Eat,ANNAPURNA APPALAM,14,280,280,0,8
15-04-2025,Spices & Seasonings,Menthulu 250 gms,15,50,45,5,1
15-04-2025,Spices & Seasonings,DRY MIECHI 200GM,15,80,60,20,1
15-04-2025,Spices & Seasonings,SAJEERA,15,60,40,20,1
15-04-2025,Spices & Seasonings,Coriander seeds 200 gms,15,240,200,40,5
15-04-2025,"Grains, Flours & Dals",unpolished turdall500grms,4,120,110,10,1
15-04-2025,"Dry Fruits, Nuts & Seeds",Groundnuts 1 kg,2,380,330,50,2
15-04-2025,Spices & Seasonings,RED COPRA 250GMS,15,85,74,11,1
15-04-2025,Spices & Seasonings,Japatri 25GM,15,100,80,20,1
15-04-2025,Misc,NNFch01,8,24,24,0,1
15-04-2025,"Dry Fruits, Nuts & Seeds",PUMPKIN SEEDS 250GM,2,200,160,40,1
15-04-2025,Spices & Seasonings,AVALU 250grms,15,120,120,0,2
15-04-2025,Spices & Seasonings,AV Iodized Salt 1KG,15,28,25,3,1
15-04-2025,"Dry Fruits, Nuts & Seeds",WATERMELON SEEDS 250GRM,2,320,280,40,1
15-04-2025,Spices & Seasonings,lavangam,15,50,50,0,1
15-04-2025,Oils & Ghee,Groundnut oil 1 L,9,360,330,30,1
15-04-2025,"Grains, Flours & Dals",PRO ORG SOOJI RAVA 500G,4,74,74,0,1
15-04-2025,Spices & Seasonings,Telaga Pindi 500GM,15,80,70,10,1
15-04-2025,"Grains, Flours & Dals",Red uluvalu 500 gms,4,90,75,15,1
15-04-2025,Oils & Ghee,Coconut oil 1 L,9,440,400,40,1
15-04-2025,Spices & Seasonings,Turmeric powder 250 gms,15,100,75,25,1
15-04-2025,Spices & Seasonings,SAMBAR POWDER 200GM,15,130,110,20,1
15-04-2025,Misc,VD00115,8,60,60,0,1
15-04-2025,Personal Care & Cosmetics,whisper,10,105,105,0,1
15-04-2025,Milk & Dairy,BROWN EGGS 1P,7,70,60,10,5
15-04-2025,Snacks & Ready-to-Eat,VD RICE MURUKU 150GM,14,100,100,0,2
15-04-2025,Personal Care & Cosmetics,GAYATHRI KUMKUDUKAYA,10,150,150,0,1
15-04-2025,Spices & Seasonings,Jeera 100GM,15,50,45,5,1
15-04-2025,Personal Care & Cosmetics,SANTOOR,10,120,100,20,1
15-04-2025,Personal Care & Cosmetics,MYSORE SANDAL SOAP 75G,10,84,84,0,2
15-04-2025,Snacks & Ready-to-Eat,RSC ORANGE 100GMS,14,40,40,0,2
15-04-2025,"Grains, Flours & Dals",VGR rice 1 kg,4,70,65,5,1
15-04-2025,Misc,NNF01245,8,50,50,0,1
15-04-2025,"Grains, Flours & Dals",split black gram 1 kg,4,180,170,10,1
15-04-2025,Oils & Ghee,Safflower oil 500 ml,9,220,200,20,1
15-04-2025,Oils & Ghee,Groundnut oil 1 L,9,360,330,30,1
15-04-2025,"Dry Fruits, Nuts & Seeds",FLAX SEEDS 250GM,2,60,50,10,1
15-04-2025,"Dry Fruits, Nuts & Seeds",WATERMELON SEEDS 250GRM,2,320,280,40,1
15-04-2025,"Grains, Flours & Dals",Wheat Flour 1 kg,4,70,60,10,1
15-04-2025,"Grains, Flours & Dals",BOMBAY RAVA,4,70,55,15,1
15-04-2025,"Grains, Flours & Dals",Red Bobarlu 500 gms,4,95,85,10,1
15-04-2025,"Grains, Flours & Dals",chana flour 500 gms,4,60,54,6,1
15-04-2025,"Grains, Flours & Dals",Green gram 500 gms,4,75,70,5,1
15-04-2025,"Grains, Flours & Dals",Wheat Rava M 1KG,4,65,55,10,1
15-04-2025,"Grains, Flours & Dals",RICE FLOUR 500 GM,4,35,28,7,1
15-04-2025,Misc,VD0041,8,60,60,0,1
15-04-2025,Snacks & Ready-to-Eat,ANNAPURNA APPALAM,14,70,70,0,2
15-04-2025,"Grains, Flours & Dals",Red Chana 250GM,4,70,60,10,2
15-04-2025,Spices & Seasonings,SAJEERA,15,60,40,20,1
15-04-2025,"Grains, Flours & Dals",IG B B RICE,4,187,168,19,1
15-04-2025,Spices & Seasonings,SATHVI ANASAPUVUU 25GM,15,90,65,25,1
15-04-2025,Snacks & Ready-to-Eat,VD DAHI MIRCHI(SALTED) 100GM,14,45,45,0,1
15-04-2025,Snacks & Ready-to-Eat,SD FLAX SEED APPADALU,14,90,90,0,1
15-04-2025,"Grains, Flours & Dals",MELMEKER 250GMS,4,60,45,15,1
15-04-2025,Spices & Seasonings,Japatri 25GM,15,100,80,20,1
15-04-2025,Misc,100248,8,0,0,0,1
15-04-2025,"Grains, Flours & Dals",Sathya Javva Wheat Rava 500GM,4,90,90,0,1
15-04-2025,Oils & Ghee,Groundnut oil 1 L,9,360,330,30,1
15-04-2025,Snacks & Ready-to-Eat,BD RAGI NOODLES,14,75,75,0,1
15-04-2025,"Dry Fruits, Nuts & Seeds",WATERMELON SEEDS 250GRM,2,320,280,40,1
15-04-2025,Milk & Dairy,HRITAGE TOTAL CURD 130GM,7,10,10,0,1
15-04-2025,"Grains, Flours & Dals",RAGI FLOUR 500GRMS,4,40,35,5,1
15-04-2025,"Dry Fruits, Nuts & Seeds",SD Mango cubes 200gm,2,90,90,0,1
15-04-2025,Snacks & Ready-to-Eat,VD MULTI CHAKKA,14,110,110,0,1
15-04-2025,Sweeteners,MISHRI 250 GM,16,35,30,5,1
15-04-2025,"Grains, Flours & Dals",CORN FOUR 250GM,4,40,35,5,1
15-04-2025,Milk & Dairy,BROWN EGGS 1P,7,140,120,20,10
15-04-2025,Snacks & Ready-to-Eat,ELITE MILK RUSK 200GM,14,35,35,0,1
15-04-2025,Snacks & Ready-to-Eat,VD ATUKULU MIXTURE 175GM,14,60,60,0,1
15-04-2025,Sweeteners,organic jaggery powder,16,99,99,0,1
15-04-2025,Snacks & Ready-to-Eat,KURNOOL MARMURA,14,70,55,15,1
15-04-2025,"Grains, Flours & Dals",White jowar.F 1 kg,4,100,80,20,1
15-04-2025,Spices & Seasonings,pickles chilli powder 500GM,15,0,0,0,1
15-04-2025,Spices & Seasonings,DURGA SALT CRYSTAL 1KG,15,25,25,0,1
15-04-2025,Pooja & Spiritual Items,divya deeparadhana oil,12,380,380,0,2
15-04-2025,Spices & Seasonings,DRY MIECHI 200GM,15,160,120,40,2
15-04-2025,"Grains, Flours & Dals",AISHWARYA SP 1KG,4,160,140,20,2
15-04-2025,"Grains, Flours & Dals",RAGI FLOUR 1KG,4,80,70,10,1
15-04-2025,Spices & Seasonings,ROYAL SAFFRON,15,125,125,0,1
15-04-2025,"Grains, Flours & Dals",RICE FLOUR 1KG,4,140,110,30,2
15-04-2025,Snacks & Ready-to-Eat,BB ROASTED VERMICELLY 850GM,14,117,117,0,1
15-04-2025,Oils & Ghee,Groundnut oil 1 L,9,1080,990,90,3
15-04-2025,"Grains, Flours & Dals",SABDANA 500GM,4,180,140,40,2
15-04-2025,"Grains, Flours & Dals",BOMBAY RAVA,4,70,55,15,1
15-04-2025,"Grains, Flours & Dals",THICK POHA 500GM,4,40,35,5,1
15-04-2025,"Grains, Flours & Dals",SABDANA 500GM,4,180,140,40,2
15-04-2025,"Grains, Flours & Dals",BOMBAY RAVA,4,70,55,15,1
15-04-2025,Pooja & Spiritual Items,divya deeparadhana oil,12,380,380,0,2
15-04-2025,"Grains, Flours & Dals",White jowar.F 1 kg,4,100,80,20,1
15-04-2025,Spices & Seasonings,DRY MIECHI 200GM,15,160,120,40,2
15-04-2025,Spices & Seasonings,pickle chili powder,15,180,165,15,1
15-04-2025,Snacks & Ready-to-Eat,BB ROASTED VERMICELLY 850GM,14,117,117,0,1
15-04-2025,Oils & Ghee,Groundnut oil 1 L,9,1080,990,90,3
15-04-2025,"Grains, Flours & Dals",RICE FLOUR 1KG,4,140,110,30,2
15-04-2025,"Grains, Flours & Dals",RAGI FLOUR 1KG,4,80,70,10,1
15-04-2025,Milk & Dairy,BROWN EGGS 1P,7,140,120,20,10
15-04-2025,Pooja & Spiritual Items,divya deeparadhana oil,12,190,190,0,1
15-04-2025,Snacks & Ready-to-Eat,PEANUT CHILLI,14,60,60,0,12
15-04-2025,Snacks & Ready-to-Eat,PEANUT CHIKKI 450GM,14,125,125,0,1
15-04-2025,"Dry Fruits, Nuts & Seeds",SD Mango cubes 200gm,2,90,90,0,1
15-04-2025,"Dry Fruits, Nuts & Seeds",FLAX SEEDS 250GM,2,60,50,10,1
15-04-2025,Milk & Dairy,BROWN EGGS 1P,7,210,180,30,15
15-04-2025,Beverages,BRU GREEN LABEL 1.2G,1,48,48,0,24
15-04-2025,Sweeteners,NATURAL HONEY 1KG,16,560,480,80,1
15-04-2025,Oils & Ghee,Groundnut oil 1 L,9,360,330,30,1
15-04-2025,Snacks & Ready-to-Eat,GANTASALA FLAX SEEDS SPICY,14,90,90,0,1
15-04-2025,"Grains, Flours & Dals",chana flour 500 gms,4,60,54,6,1
15-04-2025,"Grains, Flours & Dals",Wheat Flour 1 kg,4,70,60,10,1
15-04-2025,"Grains, Flours & Dals",Multigrain 1 kg,4,100,85,15,1
15-04-2025,Spices & Seasonings,LG 50GM,15,92,92,0,1
15-04-2025,"Grains, Flours & Dals",UDALU (Barnyard millet) 500 gms,4,70,60,10,1
15-04-2025,"Grains, Flours & Dals",Quinova 1 kg,4,220,195,25,1
15-04-2025,"Grains, Flours & Dals",SAMALU (Little millet) 500 gms,4,85,65,20,1
15-04-2025,"Grains, Flours & Dals",AISHWARYA SP 1KG,4,1200,"1,050.00",150,15
15-04-2025,"Grains, Flours & Dals",KORRALU (FOXTAIL M) 500GM,4,65,55,10,1
15-04-2025,Sweeteners,organic jaggery powder,16,99,99,0,1
15-04-2025,"Dry Fruits, Nuts & Seeds",wallnuts,2,290,290,0,1
15-04-2025,"Dry Fruits, Nuts & Seeds",BLACK KISMIS 250GM,2,175,140,35,1
15-04-2025,"Dry Fruits, Nuts & Seeds",YELLOW KISHMISH 250GM,2,130,110,20,1
15-04-2025,Spices & Seasonings,NUVVULU 250GM,15,100,85,15,1
15-04-2025,"Dry Fruits, Nuts & Seeds",FLAX SEEDS 250GM,2,60,50,10,1
15-04-2025,"Dry Fruits, Nuts & Seeds",DRYDATES YELLOW 250GM,2,135,120,15,1
15-04-2025,"Dry Fruits, Nuts & Seeds",PUMPKIN SEEDS 250GM,2,200,160,40,1
15-04-2025,"Dry Fruits, Nuts & Seeds",ALMONDS 250GM,2,280,260,20,1
15-04-2025,"Dry Fruits, Nuts & Seeds",ANJEER 250GM,2,400,360,40,1
15-04-2025,"Grains, Flours & Dals",white Bobarlu 1 KG,4,170,150,20,1
15-04-2025,"Grains, Flours & Dals",Green gram 500 gms,4,75,70,5,1
15-04-2025,"Grains, Flours & Dals",VGR rice 1 kg,4,700,650,50,10
15-04-2025,"Grains, Flours & Dals",AISHWARYA SP 1KG,4,400,350,50,5
15-04-2025,"Grains, Flours & Dals",KORRALU (FOXTAIL M) 1KG,4,150,110,40,1
15-04-2025,Milk & Dairy,BROWN EGGS TRAY 30P,7,360,330,30,1
15-04-2025,Oils & Ghee,Groundnut oil 1 L,9,720,660,60,2
15-04-2025,Oils & Ghee,Sesame oil 500ml,9,295,280,15,1
15-04-2025,"Grains, Flours & Dals",AISHWARYA SP 1KG,4,1008,882,126,12.6
15-04-2025,"Dry Fruits, Nuts & Seeds",ANJEER 250GM,2,400,360,40,1
15-04-2025,"Grains, Flours & Dals",Multigrain 1 kg,4,100,85,15,1
15-04-2025,"Grains, Flours & Dals",chana flour 500 gms,4,60,54,6,1
15-04-2025,"Grains, Flours & Dals",Em jowar idly R 500G,4,150,150,0,2
15-04-2025,"Grains, Flours & Dals",Wheat Rava S 1KG,4,65,55,10,1
15-04-2025,"Grains, Flours & Dals",MELMEKER 250GMS,4,60,45,15,1
15-04-2025,"Grains, Flours & Dals",UDALU (Barnyard millet) 1 kg,4,140,115,25,1
15-04-2025,"Grains, Flours & Dals",KORRALU (FOXTAIL M) 1KG,4,150,110,40,1
15-04-2025,Oils & Ghee,Groundnut oil 1 L,9,360,330,30,1
15-04-2025,Household & Cleaning,vim small,6,15,15,0,1
15-04-2025,Milk & Dairy,HERITAGE TOTAL CURD 500GM,7,50,50,0,1
15-04-2025,Milk & Dairy,HERITAGE TONED MILK 500ML,7,31,31,0,1
15-04-2025,"Grains, Flours & Dals",KORRALU (FOXTAIL M) 500GM,4,65,55,10,1
15-04-2025,"Dry Fruits, Nuts & Seeds",SH GROUNDNUT 500GM,2,163,130,33,1
15-04-2025,"Grains, Flours & Dals",UDALU (Barnyard millet) 500 gms,4,70,60,10,1
15-04-2025,General Household & Kitchenware,LASER STAINLESS 50N,3,120,120,0,1
15-04-2025,"Grains, Flours & Dals",KORRALU (FOXTAIL M) 1KG,4,150,110,40,1
15-04-2025,Oils & Ghee,Groundnut oil 1 L,9,360,330,30,1
15-04-2025,"Grains, Flours & Dals",Arikalu (kodo),4,70,65,5,1
15-04-2025,"Grains, Flours & Dals",SAMALU (Little millet) 500 gms,4,85,65,20,1
15-04-2025,Milk & Dairy,BROWN EGGS 1P,7,168,144,24,12
15-04-2025,Snacks & Ready-to-Eat,NGT CHATPATTA CHANA 90GM,14,50,50,0,2
15-04-2025,"Grains, Flours & Dals",Bombay Rava 500GM,4,35,30,5,1
15-04-2025,"Grains, Flours & Dals",SB Javva Wheat Ravva 500GM,4,95,95,0,1
15-04-2025,Beverages,REFRESH SHARBATH NORMAL,1,199,190,9,1
15-04-2025,"Grains, Flours & Dals",Chittimuthaylu rice 1 kg,4,160,140,20,1
15-04-2025,Spices & Seasonings,SAJEERA,15,60,40,20,1
15-04-2025,"Grains, Flours & Dals",Urad dall 1 Kg,4,370,340,30,2
15-04-2025,"Grains, Flours & Dals",Wheat Flour 1 kg,4,70,60,10,1
15-04-2025,Spices & Seasonings,idli karam powdwer,15,65,65,0,1
15-04-2025,"Grains, Flours & Dals",PESARA PAPPU 1 KG,4,170,145,25,1
14-04-2025,Snacks & Ready-to-Eat,VD ARISELU 5 PIC,14,100,100,0,1
14-04-2025,Spices & Seasonings,Turmeric powder 250 gms,15,100,75,25,1
14-04-2025,Snacks & Ready-to-Eat,VD MURUKU 175GM,14,60,60,0,1
14-04-2025,"Grains, Flours & Dals",RAGI FLOUR 500GRMS,4,40,35,5,1
14-04-2025,"Dry Fruits, Nuts & Seeds",SATHVI CHIA SEEDS 100GM,2,100,80,20,1
14-04-2025,Oils & Ghee,Groundnut oil 1 L,9,360,330,30,1
14-04-2025,Snacks & Ready-to-Eat,VD MIXTURE 175 GM,14,120,120,0,2
14-04-2025,Oils & Ghee,Groundnut oil 5 L,9,1800,"1,600.00",200,1
14-04-2025,Snacks & Ready-to-Eat,VD VAMUPUSA 175GM,14,60,60,0,1
14-04-2025,Snacks & Ready-to-Eat,VD ATUKULU MIXTURE 175GM,14,60,60,0,1
14-04-2025,Snacks & Ready-to-Eat,VD CORNFLAKES MIXTURE 175GM,14,60,60,0,1
14-04-2025,Snacks & Ready-to-Eat,VD PAPPU CHEGODI 200GM,14,60,60,0,1
14-04-2025,Snacks & Ready-to-Eat,VD BOONDI 175GM,14,120,120,0,2
14-04-2025,Snacks & Ready-to-Eat,VD PALLI LADDU,14,80,80,0,1
14-04-2025,Snacks & Ready-to-Eat,VD Pappu Chekkalu 190gm,14,120,120,0,2
14-04-2025,Snacks & Ready-to-Eat,SUNNUNDALU,14,240,240,0,2
14-04-2025,Snacks & Ready-to-Eat,VD BOONDI 175GM,14,60,60,0,1
14-04-2025,"Dry Fruits, Nuts & Seeds",YELLOW KISHMISH 250GM,2,260,220,40,2
14-04-2025,Snacks & Ready-to-Eat,VD NUVULU CHEGODI 175GM,14,120,120,0,2
14-04-2025,Sweeteners,Natural Honey 500 gms,16,280,240,40,1
14-04-2025,Snacks & Ready-to-Eat,VD MULTI CHAKKA,14,220,220,0,2
14-04-2025,Snacks & Ready-to-Eat,VD NUVULLU CHIKKI,14,160,160,0,2
14-04-2025,Snacks & Ready-to-Eat,VD VAMUPUSA 175GM,14,60,60,0,1
14-04-2025,"Grains, Flours & Dals",Wheat Flour 1 kg,4,70,60,10,1
14-04-2025,"Grains, Flours & Dals",Brown RICE 1KG,4,70,65,5,1
14-04-2025,Snacks & Ready-to-Eat,GB SALT COOKIES,14,60,55,5,1
14-04-2025,"Grains, Flours & Dals",SABDANA,4,40,35,5,1
14-04-2025,"Grains, Flours & Dals",RAGI FLOUR 500GRMS,4,80,70,10,2
14-04-2025,Snacks & Ready-to-Eat,VD DRY FRUIT PUTHAREKULU,14,120,120,0,1
14-04-2025,"Grains, Flours & Dals",MAAGAANI LOW GI SP L 1KG,4,120,105,15,1
14-04-2025,Misc,C123,8,95,80,15,1
14-04-2025,Snacks & Ready-to-Eat,VD DRY FRUIT PUTHAREKULU,14,120,120,0,1
14-04-2025,Misc,C123,8,95,80,15,1
14-04-2025,"Grains, Flours & Dals",SABDANA,4,40,35,5,1
14-04-2025,"Grains, Flours & Dals",RAGI FLOUR 500GRMS,4,40,35,5,1
14-04-2025,"Grains, Flours & Dals",RAGI FLOUR 500GRMS,4,80,70,10,2
14-04-2025,"Dry Fruits, Nuts & Seeds",SATHVI CHIA SEEDS 100GM,2,200,160,40,2
14-04-2025,Oils & Ghee,Groundnut oil 1 L,9,360,330,30,1
14-04-2025,"Dry Fruits, Nuts & Seeds",Groundnuts 1 kg,2,190,165,25,1
14-04-2025,Sweeteners,SUGAR 500 GM,16,60,56,4,2
14-04-2025,"Grains, Flours & Dals",Arikalu (kodo),4,70,65,5,1
14-04-2025,Spices & Seasonings,Turmeric powder 250 gms,15,100,75,25,1
14-04-2025,Spices & Seasonings,KARAKAYA,15,50,30,20,1
14-04-2025,"Grains, Flours & Dals",ANDU KORRALU (Browntop.m) 1 kg,4,260,220,40,1
14-04-2025,Snacks & Ready-to-Eat,MILLET PANCAKE CHOCOLATE,14,796,796,0,4
14-04-2025,Spices & Seasonings,Black Till 250GM,15,90,75,15,1
14-04-2025,"Dry Fruits, Nuts & Seeds",KAJU HALF 250GM,2,310,290,20,1
14-04-2025,"Grains, Flours & Dals",Red Chana 250GM,4,35,30,5,1
14-04-2025,Pooja & Spiritual Items,divya deeparadhana oil,12,190,190,0,1
14-04-2025,Spices & Seasonings,Coriander seeds 200 gms,15,48,40,8,1
14-04-2025,"Grains, Flours & Dals",Urad dall 1 Kg,4,185,170,15,1
14-04-2025,"Grains, Flours & Dals",Kandulu 250GM,4,80,70,10,2
14-04-2025,Spices & Seasonings,Jeera 100GM,15,50,45,5,1
14-04-2025,"Dry Fruits, Nuts & Seeds",SATHVI CHIA SEEDS 100GM,2,100,80,20,1
14-04-2025,Spices & Seasonings,Chilli powder 500 gms,15,580,420,160,2
14-04-2025,"Grains, Flours & Dals",Wheat Flour 1 kg,4,70,60,10,1
14-04-2025,"Dry Fruits, Nuts & Seeds",SUNFLOWER SEEDS 250GRM,2,150,130,20,1
14-04-2025,"Grains, Flours & Dals",idly rava 1kg,4,240,200,40,4
14-04-2025,Milk & Dairy,BROWN EGGS TRAY 30P,7,360,330,30,1
14-04-2025,Pooja & Spiritual Items,VRP APOORVA JAVADHU POW,12,35,35,0,1
14-04-2025,"Grains, Flours & Dals",KORRALU (FOXTAIL M) 1KG,4,150,110,40,1
14-04-2025,Spices & Seasonings,ROYAL SAFFRON,15,375,375,0,3
14-04-2025,"Dry Fruits, Nuts & Seeds",PUMPKIN SEEDS 250GM,2,200,160,40,1
14-04-2025,"Grains, Flours & Dals",SAMALU (Little millet) 1 kg,4,170,130,40,1
14-04-2025,Oils & Ghee,OLIVANA 100ML,9,179,169,10,1
14-04-2025,"Grains, Flours & Dals",UDALU (Barnyard millet) 1 kg,4,140,115,25,1
14-04-2025,Milk & Dairy,HERITAGE TOTAL CURD 500GM,7,50,50,0,1
14-04-2025,Milk & Dairy,SANGAM TONED MILK 500ML,7,124,124,0,4
14-04-2025,Milk & Dairy,SANGAM FULL CREAM MILK 500ML,7,39,39,0,1
14-04-2025,"Grains, Flours & Dals",chana flour 500 gms,4,60,54,6,1
14-04-2025,"Grains, Flours & Dals",Wheat Flour 1 kg,4,70,60,10,1
14-04-2025,"Grains, Flours & Dals",RICE FLOUR 500 GM,4,35,28,7,1
14-04-2025,Snacks & Ready-to-Eat,DOSA BATTER 1KG,14,60,60,0,1
14-04-2025,Snacks & Ready-to-Eat,GB SALT COOKIES,14,60,55,5,1
14-04-2025,Snacks & Ready-to-Eat,KURNOOL MARMURA,14,140,110,30,2
14-04-2025,"Grains, Flours & Dals",AISHWARYA SP 25KG,4,3998,"3,380.00",618,2
14-04-2025,"Grains, Flours & Dals",Wheat Flour 1 kg,4,140,120,20,2
14-04-2025,Snacks & Ready-to-Eat,BELLAM MINAPA SUNADULLU,14,180,180,0,1
14-04-2025,Beverages,BISLERI SODA 750ML,1,20,20,0,1
14-04-2025,Snacks & Ready-to-Eat,BELLAM MINAPA SUNADULLU,14,180,180,0,1
14-04-2025,"Grains, Flours & Dals",turdal 500 gms,4,110,85,25,1
14-04-2025,"Dry Fruits, Nuts & Seeds",Groundnuts 500 gms,2,95,85,10,1
14-04-2025,"Grains, Flours & Dals",SABDANA,4,40,35,5,1
14-04-2025,"Grains, Flours & Dals",URAD DALL,4,95,85,10,1
14-04-2025,"Dry Fruits, Nuts & Seeds",Putnalu 250GM,2,45,38,7,1
14-04-2025,"Grains, Flours & Dals",Wheat Flour 1 kg,4,70,60,10,1
14-04-2025,"Grains, Flours & Dals",chana flour 500 gms,4,60,54,6,1
14-04-2025,"Grains, Flours & Dals",PESARA PAPPU 500GMS,4,85,75,10,1
14-04-2025,"Grains, Flours & Dals",RAGI FLOUR 500GRMS,4,40,35,5,1
14-04-2025,"Grains, Flours & Dals",THICK POHA 1KG,4,80,70,10,1
14-04-2025,"Grains, Flours & Dals",BOMBAY RAVA,4,70,55,15,1
14-04-2025,"Grains, Flours & Dals",SL Idly Rava 1KG,4,65,55,10,1
14-04-2025,"Grains, Flours & Dals",RICE FLOUR 1KG,4,70,55,15,1
14-04-2025,General Household & Kitchenware,SIRIDHANYALU BOOK,3,200,180,20,1
14-04-2025,Snacks & Ready-to-Eat,FOXTAIL BIS,14,135,135,0,1
14-04-2025,Spices & Seasonings,RED COPRA 250GMS,15,85,74,11,1
14-04-2025,Snacks & Ready-to-Eat,SD barnyard Millet with palm jaggery,14,135,135,0,1
14-04-2025,Oils & Ghee,Groundnut oil 1 L,9,720,660,60,2
14-04-2025,Oils & Ghee,Coconut oil 1 L,9,440,400,40,1
14-04-2025,Oils & Ghee,Safflower oil 1 L,9,440,400,40,1
14-04-2025,Sweeteners,NATURAL HONEY 1KG,16,560,480,80,1
14-04-2025,"Dry Fruits, Nuts & Seeds",Groundnuts 500 gms,2,95,85,10,1
14-04-2025,"Grains, Flours & Dals",THICK POHA 1KG,4,80,70,10,1
14-04-2025,"Grains, Flours & Dals",Multigrain 1 kg,4,100,85,15,1
14-04-2025,"Grains, Flours & Dals",ANDU KORRALU (Brown top .mlt) 500,4,130,110,20,1
14-04-2025,"Grains, Flours & Dals",ANDU KORRALU (Browntop.m) 1 kg,4,260,220,40,1
14-04-2025,"Grains, Flours & Dals",KORRALU (FOXTAIL M) 1KG,4,150,110,40,1
14-04-2025,"Grains, Flours & Dals",UDALU (Barnyard millet) 1 kg,4,140,115,25,1
14-04-2025,"Grains, Flours & Dals",SAMALU (Little millet) 1 kg,4,170,130,40,1
14-04-2025,Oils & Ghee,Groundnut oil 5 L,9,1800,"1,600.00",200,1
14-04-2025,"Grains, Flours & Dals",KORRALU (FOXTAIL M) 1KG,4,150,110,40,1
14-04-2025,"Grains, Flours & Dals",RAGI FLOUR 500GRMS,4,40,35,5,1
14-04-2025,"Grains, Flours & Dals",JOWAR WHITE 1 KG,4,80,70,10,1
14-04-2025,"Grains, Flours & Dals",BAJRA 1 KG,4,60,50,10,1
14-04-2025,"Grains, Flours & Dals",White jowar.F 1 kg,4,200,160,40,2
14-04-2025,Sweeteners,SD DrybFruit Honey 500GM,16,550,550,0,1
14-04-2025,Spices & Seasonings,AVALU 100GM,15,25,20,5,1
14-04-2025,"Dry Fruits, Nuts & Seeds",PULMAKHANA 100 GM,2,180,170,10,1
14-04-2025,Spices & Seasonings,DHANIYA POWDER 200GM,15,100,85,15,1
14-04-2025,Snacks & Ready-to-Eat,MILK BREAD,14,55,55,0,1
14-04-2025,Snacks & Ready-to-Eat,DOSA BATTER 1KG,14,60,60,0,1
14-04-2025,"Dry Fruits, Nuts & Seeds",PUTNALU 500GMS,2,90,76,14,1
14-04-2025,"Dry Fruits, Nuts & Seeds",Groundnuts 1 kg,2,190,165,25,1
14-04-2025,Beverages,BRU GREEN LABEL 1.2G,1,48,48,0,24
14-04-2025,"Dry Fruits, Nuts & Seeds",cashew,2,340,310,30,1
14-04-2025,Snacks & Ready-to-Eat,VD MULTI CHAKKA,14,110,110,0,1
14-04-2025,"Dry Fruits, Nuts & Seeds",ALMONDS 250GM,2,280,260,20,1
14-04-2025,Spices & Seasonings,GARAM MASALA 200GM,15,120,95,25,1
14-04-2025,"Grains, Flours & Dals",RAGI FLOUR 1KG,4,320,280,40,4
14-04-2025,Spices & Seasonings,Masala Karam 250 gms,15,130,120,10,1
14-04-2025,Beverages,BISLERI WATER 1L,1,20,20,0,1
14-04-2025,"Grains, Flours & Dals",UNPOLISHED TURDALL 1KG,4,240,210,30,1
14-04-2025,Snacks & Ready-to-Eat,VD MURUKU 175GM,14,120,120,0,2
14-04-2025,"Grains, Flours & Dals",THICK POHA 1KG,4,80,70,10,1
14-04-2025,"Grains, Flours & Dals",Red uluvalu 500 gms,4,90,75,15,1
14-04-2025,Snacks & Ready-to-Eat,VD PAPPU CHEGODI 200GM,14,60,60,0,1
14-04-2025,Sweeteners,GS Palm Jaggery Powder 400GM,16,180,180,0,1
14-04-2025,"Dry Fruits, Nuts & Seeds",SUNFLOWER SEEDS 250GRM,2,150,130,20,1
14-04-2025,"Grains, Flours & Dals",RAGI FLOUR 500GRMS,4,80,70,10,2
14-04-2025,"Grains, Flours & Dals",Multigrain 1 kg,4,400,340,60,4
14-04-2025,"Grains, Flours & Dals",chana flour 500 gms,4,60,54,6,1
14-04-2025,"Grains, Flours & Dals",SRILALITHA MAIDA FLOUR 500G,4,32,32,0,1
14-04-2025,"Grains, Flours & Dals",JOWAR YELLOW 1 K,4,400,360,40,4
14-04-2025,"Grains, Flours & Dals",White Chana 500GM,4,120,100,20,1
14-04-2025,"Grains, Flours & Dals",Bajra Flour 1 kg,4,70,60,10,1
14-04-2025,"Grains, Flours & Dals",WHEAT 1 KG,4,360,300,60,6
14-04-2025,"Grains, Flours & Dals",SL Idly Rava 1KG,4,65,55,10,1
14-04-2025,"Grains, Flours & Dals",SH RED POHA 500GM,4,85,85,0,1
14-04-2025,"Health, Wellness & Ayurvedic Products",RB Max Protein NUTS &SEEDS 55gm,5,50,50,0,1
14-04-2025,Snacks & Ready-to-Eat,BROWN BREAD,14,55,55,0,1
14-04-2025,Sweeteners,ACHU BELLAM 1KG,16,100,80,20,1
14-04-2025,Snacks & Ready-to-Eat,VD MULTI CHAKKA,14,110,110,0,1
14-04-2025,Snacks & Ready-to-Eat,SD Little Millet WITH PLAM JAGGERY,14,135,135,0,1
14-04-2025,"Dry Fruits, Nuts & Seeds",cashew,2,340,310,30,1
14-04-2025,"Grains, Flours & Dals",KORRALU (FOXTAIL M) 1KG,4,300,220,80,2
14-04-2025,"Dry Fruits, Nuts & Seeds",ALMONDS 250GM,2,280,260,20,1
14-04-2025,"Health, Wellness & Ayurvedic Products",SAI DURGA MORINGA LEAVES 100GM,5,75,75,0,1
14-04-2025,Snacks & Ready-to-Eat,SD Moringa with plam jaggery 250gm,14,135,135,0,1
14-04-2025,Personal Care & Cosmetics,Soapnut 250GM,10,60,45,15,1
14-04-2025,Snacks & Ready-to-Eat,SUNNUNDALU,14,120,120,0,1
14-04-2025,Snacks & Ready-to-Eat,MIGHTY PUFFS TOMATO,14,25,25,0,1
14-04-2025,Snacks & Ready-to-Eat,RSC ORANGE 100GMS,14,20,20,0,1
14-04-2025,"Dry Fruits, Nuts & Seeds",PUTNALU 500GMS,2,90,76,14,1
14-04-2025,Snacks & Ready-to-Eat,SD Sesame laddu with dates250gm,14,135,135,0,1
14-04-2025,"Grains, Flours & Dals",MELMEKER 250GMS,4,60,45,15,1
14-04-2025,"Grains, Flours & Dals",Red Wheat Flour 1 kg,4,700,650,50,5
14-04-2025,Spices & Seasonings,DRY MIECHI 200GM,15,80,60,20,1
14-04-2025,Snacks & Ready-to-Eat,BB VERMICELLI 1KG,14,95,90,5,1
14-04-2025,"Dry Fruits, Nuts & Seeds",PUMPKIN SEEDS 250GM,2,200,160,40,1
14-04-2025,Spices & Seasonings,RED COPRA 500GM,15,170,148,22,1
14-04-2025,Spices & Seasonings,BIRYANI LEAF 10GM,15,30,20,10,1
14-04-2025,Spices & Seasonings,Elaichi 25GM,15,290,240,50,2
14-04-2025,"Grains, Flours & Dals",PRO SABUDHANA 500GM,4,89,89,0,1
14-04-2025,Oils & Ghee,Safflower oil 1 L,9,440,400,40,1
14-04-2025,"Grains, Flours & Dals",SL Suji Rava 500GM,4,32,32,0,1
14-04-2025,Sweeteners,YB Brown Sugar 500GM,16,75,75,0,1
14-04-2025,Oils & Ghee,Sesame oil 500ml,9,295,280,15,1
14-04-2025,"Grains, Flours & Dals",rice ravva,4,35,35,0,1
14-04-2025,Snacks & Ready-to-Eat,SD FINGER Millet with palm Jaggery 250gm,14,135,135,0,1
14-04-2025,Pooja & Spiritual Items,GD Aiswarya Deepam 700ML,12,195,195,0,1
14-04-2025,Oils & Ghee,Groundnut oil 500ml,9,180,165,15,1
14-04-2025,"Grains, Flours & Dals",SPLIT URAD DAL,4,45,45,0,1
14-04-2025,Spices & Seasonings,ROYAL SAFFRON 400GRMS,15,65,65,0,1
14-04-2025,"Grains, Flours & Dals",RAGI FLOUR 1KG,4,160,140,20,2
14-04-2025,Oils & Ghee,Sesame oil 1 L,9,1180,"1,120.00",60,2
14-04-2025,Milk & Dairy,BROWN EGGS 1P,7,210,180,30,15
14-04-2025,Oils & Ghee,Coconut oil 1 L,9,440,400,40,1
14-04-2025,"Grains, Flours & Dals",RAGI FLOUR 500GRMS,4,40,35,5,1
14-04-2025,Oils & Ghee,cow ghee 500 ml,9,430,390,40,1
14-04-2025,Snacks & Ready-to-Eat,RAJGIRA PEANUT CHIKKI,14,10,10,0,2
14-04-2025,"Dry Fruits, Nuts & Seeds",SUNFLOWER SEEDS 250GRM,2,150,130,20,1
14-04-2025,"Dry Fruits, Nuts & Seeds",PUMPKIN SEEDS 250GM,2,200,160,40,1
14-04-2025,Snacks & Ready-to-Eat,VD NUVULU CHEGODI 175GM,14,60,60,0,1
14-04-2025,Snacks & Ready-to-Eat,BELLAM MINAPA SUNADULLU,14,180,180,0,1
14-04-2025,Snacks & Ready-to-Eat,VD Pappu Chekkalu 190gm,14,60,60,0,1
14-04-2025,Snacks & Ready-to-Eat,VD CORNFLAKES MIXTURE 175GM,14,60,60,0,1
14-04-2025,Spices & Seasonings,AV Iodized Salt 1KG,15,28,25,3,1
14-04-2025,"Dry Fruits, Nuts & Seeds",Groundnuts 1 kg,2,190,165,25,1
14-04-2025,"Grains, Flours & Dals",White jowar.F 1 kg,4,100,80,20,1
14-04-2025,"Grains, Flours & Dals",MAAGAANI SP RICE 20 KGS,4,2300,"1,960.00",340,1
14-04-2025,"Grains, Flours & Dals",BAJRA 1 KG,4,60,50,10,1
14-04-2025,Spices & Seasonings,ROYAL SAFFRON 400GRMS,15,65,65,0,1
14-04-2025,Oils & Ghee,rice bran oil f,9,194,169,25,1
14-04-2025,"Grains, Flours & Dals",SH WHITE POHA 500GM,4,75,75,0,1
14-04-2025,Spices & Seasonings,SONTI 50GM,15,30,20,10,1
14-04-2025,"Dry Fruits, Nuts & Seeds",Groundnuts 500 gms,2,95,85,10,1
14-04-2025,"Grains, Flours & Dals",chana flour 500 gms,4,60,54,6,1
14-04-2025,Snacks & Ready-to-Eat,Corn Chips 250GM,14,40,35,5,1
14-04-2025,Snacks & Ready-to-Eat,GOLDEN SALT COOKIES,14,60,60,0,1
14-04-2025,"Grains, Flours & Dals",yellow jowar flour 1kg,4,200,184,16,2
14-04-2025,Oils & Ghee,Groundnut oil 1 L,9,720,660,60,2
14-04-2025,"Grains, Flours & Dals",HS MULTI UPMA RAVA,4,65,65,0,1
14-04-2025,Sweeteners,organic jaggery powder,16,99,99,0,1
14-04-2025,"Grains, Flours & Dals",Em jowar idly R 500G,4,75,75,0,1
14-04-2025,"Grains, Flours & Dals",JOWAR UPMA RAVA,4,75,75,0,1
14-04-2025,Oils & Ghee,Sesame oil 1 L,9,1180,"1,120.00",60,2
14-04-2025,Oils & Ghee,Sesame oil 1 L,9,1180,"1,120.00",60,2
14-04-2025,"Grains, Flours & Dals",SAMALU (Little millet) 500 gms,4,85,65,20,1
14-04-2025,"Grains, Flours & Dals",UDALU (Barnyard millet) 500 gms,4,70,60,10,1
14-04-2025,Oils & Ghee,Groundnut oil 1 L,9,720,660,60,2
14-04-2025,"Grains, Flours & Dals",KORRALU (FOXTAIL M) 500GM,4,65,55,10,1
14-04-2025,Snacks & Ready-to-Eat,PN ORGANIC PUFFED RICE 200GM,14,55,55,0,1
14-04-2025,"Grains, Flours & Dals",white Bobarlu 500 gms,4,80,75,5,1
14-04-2025,Household & Cleaning,vim dish liquid,6,55,55,0,1
14-04-2025,Household & Cleaning,comfort morning fresh,6,58,58,0,1
14-04-2025,Oils & Ghee,Coconut oil 500 ml,9,220,200,20,1
14-04-2025,"Grains, Flours & Dals",Multigrain 1 kg,4,100,85,15,1
14-04-2025,Snacks & Ready-to-Eat,NGT CHATPATTA CHANA 90GM,14,25,25,0,1
14-04-2025,Snacks & Ready-to-Eat,GOLDEN SALT COOKIES,14,60,60,0,1
14-04-2025,"Grains, Flours & Dals",Multigrain 1 kg,4,100,85,15,1
14-04-2025,Spices & Seasonings,NUVVULU 250GM,15,80,65,15,1
14-04-2025,"Grains, Flours & Dals",turdal 1kg,4,220,170,50,1
14-04-2025,Spices & Seasonings,Menthulu 250 gms,15,50,45,5,1
14-04-2025,"Grains, Flours & Dals",VGR rice 1 kg,4,350,325,25,5
14-04-2025,Spices & Seasonings,DRY MIECHI 200GM,15,80,60,20,1
14-04-2025,Spices & Seasonings,JEERA 250 gms,15,125,105,20,1
14-04-2025,Spices & Seasonings,Tamarind 500GM,15,160,130,30,1
14-04-2025,Spices & Seasonings,AV Iodized Salt 1KG,15,28,25,3,1
14-04-2025,Spices & Seasonings,AVALU 250grms,15,60,60,0,1
14-04-2025,Oils & Ghee,Groundnut oil 1 L,9,360,330,30,1
14-04-2025,Spices & Seasonings,mesta,15,110,110,0,1
14-04-2025,"Health, Wellness & Ayurvedic Products",RB Max Protein Jaggery Crunchy,5,175,175,0,1
14-04-2025,Oils & Ghee,BUFFALLO GHEE 500ML,9,410,370,40,1
14-04-2025,Baking & Cooking Aids,MTR GULAB JAMUN MIX 190GM,0,80,80,0,1
14-04-2025,"Grains, Flours & Dals",ulavalu red,4,40,40,0,1
14-04-2025,Snacks & Ready-to-Eat,KURNOOL MARMURA,14,70,55,15,1
14-04-2025,"Grains, Flours & Dals",White jowar.F 1 kg,4,200,160,40,2
14-04-2025,Snacks & Ready-to-Eat,RSC ORANGE 100GMS,14,20,20,0,1
14-04-2025,"Grains, Flours & Dals",Red Chana 250GM,4,35,30,5,1
14-04-2025,Snacks & Ready-to-Eat,BB VERMICELLY 500GM,14,53,53,0,1
14-04-2025,Spices & Seasonings,MIRYALU 50 GRMS,15,100,80,20,1
14-04-2025,"Grains, Flours & Dals",Wheat Flour 1 kg,4,280,240,40,4
14-04-2025,Snacks & Ready-to-Eat,NGT CHATPATTA CHANA 90GM,14,50,50,0,2
14-04-2025,"Health, Wellness & Ayurvedic Products",RB Max Protein Salt & Caramel Bar 50g,5,75,75,0,1
14-04-2025,"Grains, Flours & Dals",RICE FLOUR 1KG,4,70,55,15,1
14-04-2025,"Grains, Flours & Dals",Bombay Rava 500GM,4,35,30,5,1
14-04-2025,"Health, Wellness & Ayurvedic Products",MXP CHOCO CLASSIC BAR,5,70,70,0,1
14-04-2025,"Grains, Flours & Dals",VGR RICE bag 1,4,1899,"1,650.00",249,1
14-04-2025,Oils & Ghee,Groundnut oil 1 L,9,360,330,30,1
14-04-2025,Snacks & Ready-to-Eat,FOXTAIL BIS,14,270,270,0,2
14-04-2025,Snacks & Ready-to-Eat,SD Aswagandha with palm Jaggery250Gm,14,270,270,0,2
14-04-2025,Spices & Seasonings,Turmeric powder 250 gms,15,100,75,25,1
14-04-2025,"Health, Wellness & Ayurvedic Products",RAMA BALM 10ML,5,50,50,0,1
14-04-2025,Spices & Seasonings,Masala karam 1 kg,15,520,480,40,1
14-04-2025,"Dry Fruits, Nuts & Seeds",DIANUTS 500GM,2,120,120,0,1
14-04-2025,Sweeteners,GS Palm Jaggery Powder 400GM,16,360,360,0,2
14-04-2025,Personal Care & Cosmetics,GAYATHRI KUMKUDUKAYA,10,150,150,0,1
14-04-2025,"Grains, Flours & Dals",Wheat Flour 1 kg,4,70,60,10,1
14-04-2025,Personal Care & Cosmetics,MD HERBAL HAIR SHAMPOO,10,300,300,0,1
14-04-2025,"Grains, Flours & Dals",THIN POHA 500GM,4,40,35,5,1
14-04-2025,"Grains, Flours & Dals",SABDANA,4,40,35,5,1
14-04-2025,Spices & Seasonings,DRY MIECHI 200GM,15,80,60,20,1
14-04-2025,Snacks & Ready-to-Eat,SD FINGER Millet with palm Jaggery 250gm,14,270,270,0,2
14-04-2025,Spices & Seasonings,BIRYANI LEAF 10GM,15,30,20,10,1
14-04-2025,"Grains, Flours & Dals",UDALU (Barnyard millet) 1 kg,4,140,115,25,1
14-04-2025,"Dry Fruits, Nuts & Seeds",Groundnuts 1 kg,2,190,165,25,1
14-04-2025,Sweeteners,COCONUT SUGAR,16,299,284,15,1
14-04-2025,Spices & Seasonings,PN ORGANIC PINK SALT 1KG,15,124,124,0,1
14-04-2025,"Grains, Flours & Dals",Em Foxtail upma r 500 g,4,109,109,0,1
14-04-2025,"Grains, Flours & Dals",EM Foxtail idli r 500 g,4,109,109,0,1
14-04-2025,"Grains, Flours & Dals",EM kodo upma R 500g,4,129,129,0,1
14-04-2025,"Grains, Flours & Dals",JOWAR UPMA RAVA,4,65,65,0,1
14-04-2025,"Grains, Flours & Dals",MULTIMILLET IDLY RAVVA,4,65,65,0,1
14-04-2025,"Grains, Flours & Dals",HS JOWAR IDLY RAWA,4,65,65,0,1
14-04-2025,"Grains, Flours & Dals",HS JOWAR FLAKES 250GM 1+1,4,119,119,0,1
14-04-2025,"Grains, Flours & Dals",HS BARLEY FLAKES 250GM 1+1,4,119,119,0,1
14-04-2025,Personal Care & Cosmetics,UVIS ONION HAIR OIL100ML,10,199,199,0,1
14-04-2025,Snacks & Ready-to-Eat,Sprouted Ragi Biscuits 450GM,14,150,150,0,1
14-04-2025,"Dry Fruits, Nuts & Seeds",FLAX SEEDS 250GM,2,120,100,20,2
14-04-2025,Spices & Seasonings,RED COPRA 500GM,15,170,148,22,1
14-04-2025,Sweeteners,SH JAGGERY POWDER 500GM,16,80,68,12,1
14-04-2025,Sweeteners,organic jaggery powder,16,99,99,0,1
14-04-2025,"Grains, Flours & Dals",White jowar.F 1 kg,4,100,80,20,1
14-04-2025,Spices & Seasonings,Tamarind 500GM,15,160,130,30,1
14-04-2025,"Grains, Flours & Dals",Urad dall 1 Kg,4,555,510,45,3
14-04-2025,"Dry Fruits, Nuts & Seeds",PUTNALU 500GMS,2,90,76,14,1
14-04-2025,Sweeteners,ACHU BELLAM 1KG,16,100,80,20,1
14-04-2025,"Grains, Flours & Dals",Wheat Rava M 500GM,4,33,30,3,1
14-04-2025,Oils & Ghee,Groundnut oil 1 L,9,720,660,60,2
14-04-2025,"Grains, Flours & Dals",SL Idly Rava 1KG,4,65,55,10,1
14-04-2025,"Grains, Flours & Dals",MAATEJA rice 1 kg,4,360,345,15,5
14-04-2025,Household & Cleaning,vim small,6,30,30,0,2
14-04-2025,Household & Cleaning,vim,6,60,60,0,1
14-04-2025,"Grains, Flours & Dals",chana dall,4,24,24,0,1
14-04-2025,Personal Care & Cosmetics,dettol,10,165,165,0,1
14-04-2025,Oils & Ghee,Coconut oil 1 L,9,880,800,80,2
14-04-2025,"Grains, Flours & Dals",AISHWARYA SP 25KG,4,1999,"1,690.00",309,1
14-04-2025,Oils & Ghee,Groundnut oil 1 L,9,360,330,30,1
14-04-2025,Oils & Ghee,Coconut oil 1 L,9,440,400,40,1
14-04-2025,Oils & Ghee,Sesame oil 1 L,9,590,560,30,1
14-04-2025,"Grains, Flours & Dals",turdal 1kg,4,440,340,100,2
14-04-2025,Spices & Seasonings,DURGA SALT CRYSTAL 1KG,15,25,25,0,1
14-04-2025,"Dry Fruits, Nuts & Seeds",Groundnuts 1 kg,2,190,165,25,1
14-04-2025,Household & Cleaning,VIM MAHA BAR,6,120,120,0,12
14-04-2025,Oils & Ghee,Groundnut oil 1 L,9,360,330,30,1
14-04-2025,"Grains, Flours & Dals",CHANA DAL 1KG,4,112,96,16,1
14-04-2025,"Grains, Flours & Dals",Multigrain 1 kg,4,200,170,30,2
14-04-2025,"Grains, Flours & Dals",Wheat Flour 1 kg,4,140,120,20,2
14-04-2025,"Grains, Flours & Dals",JOWAR UPMA RAVA,4,65,65,0,1
14-04-2025,"Dry Fruits, Nuts & Seeds",KAJU HALF 250GM,2,310,290,20,1
14-04-2025,Spices & Seasonings,DRY MIECHI 200GM,15,80,60,20,1
14-04-2025,Snacks & Ready-to-Eat,MILLET PANCAKE CHOCOLATE,14,199,199,0,1
14-04-2025,"Dry Fruits, Nuts & Seeds",PUTNALU 500GMS,2,90,76,14,1
14-04-2025,Snacks & Ready-to-Eat,ID CHAPATI,14,79,79,0,1
14-04-2025,Milk & Dairy,HERITAGE BUTTERMILK,7,40,40,0,4
14-04-2025,"Health, Wellness & Ayurvedic Products",MH Baby Food 400GM,5,200,200,0,1
14-04-2025,Misc,C123,8,95,80,15,1
14-04-2025,Snacks & Ready-to-Eat,GANTASALA FLAX SEEDS SPICY,14,90,90,0,1
14-04-2025,Snacks & Ready-to-Eat,SD FINGER Millet with palm Jaggery 250gm,14,135,135,0,1
14-04-2025,"Dry Fruits, Nuts & Seeds",PLAIN PISTA 250GM,2,660,550,110,1
14-04-2025,Personal Care & Cosmetics,GAYATHRI KUMKUDUKAYA,10,150,150,0,1
14-04-2025,Oils & Ghee,Coconut oil 500 ml,9,220,200,20,1
14-04-2025,General Household & Kitchenware,AMBIPUR CAR FRESH 75G,3,299,299,0,1
14-04-2025,Milk & Dairy,SANGAM CURD 450GM,7,114,114,0,3
14-04-2025,Snacks & Ready-to-Eat,SD Moringa with plam jaggery 250gm,14,135,135,0,1
14-04-2025,"Grains, Flours & Dals",Wheat Flour 1 kg,4,70,60,10,1
14-04-2025,"Grains, Flours & Dals",Multigrain 1 kg,4,100,85,15,1
14-04-2025,Oils & Ghee,Safflower oil 1 L,9,440,400,40,1
14-04-2025,"Grains, Flours & Dals",turdal 1kg,4,220,170,50,1
14-04-2025,"Grains, Flours & Dals",RAGI FLOUR 500GRMS,4,80,70,10,2
14-04-2025,Sweeteners,YB N FOREST HONEY 700 GM,16,400,400,0,1
14-04-2025,Spices & Seasonings,JEERA 250 gms,15,125,105,20,1
14-04-2025,Spices & Seasonings,DRY MIECHI 200GM,15,80,60,20,1
14-04-2025,Spices & Seasonings,DURGA SALT CRYSTAL 1KG,15,25,25,0,1
14-04-2025,Pooja & Spiritual Items,GD JASMINE 75GM,12,60,60,0,1
14-04-2025,Spices & Seasonings,AV Iodized Salt 1KG,15,56,50,6,2
14-04-2025,Oils & Ghee,Groundnut oil 1 L,9,360,330,30,1
14-04-2025,Spices & Seasonings,ROYAL SAFFRON,15,125,125,0,1
14-04-2025,Spices & Seasonings,pickle chili powder,15,180,165,15,1
14-04-2025,"Health, Wellness & Ayurvedic Products",j s pnature,5,136,136,0,1
14-04-2025,Spices & Seasonings,AVALU 250grms,15,60,60,0,1
14-04-2025,"Grains, Flours & Dals",Wheat Rava S 500GM,4,33,30,3,1
14-04-2025,"Grains, Flours & Dals",SL Idly Rava 1KG,4,195,165,30,3
14-04-2025,Personal Care & Cosmetics,GOW DURBAR 75G,10,60,60,0,1
14-04-2025,Pooja & Spiritual Items,GD Dhoop Cones 40GM,12,60,60,0,2
14-04-2025,"Grains, Flours & Dals",Bombay Rava 500GM,4,35,30,5,1
14-04-2025,Pooja & Spiritual Items,GD Aiswarya Deepam 700ML,12,390,390,0,2
13-04-2025,Personal Care & Cosmetics,COLGATE ACTIVE SALT,10,20,20,0,1
13-04-2025,Household & Cleaning,vim dish liquid,6,55,55,0,1
13-04-2025,Snacks & Ready-to-Eat,VD MURUKU 175GM,14,60,60,0,1
13-04-2025,Snacks & Ready-to-Eat,sannakarampusa,14,60,60,0,1
13-04-2025,Household & Cleaning,SURFEXCEL BAR 80G,6,50,50,0,5
13-04-2025,Personal Care & Cosmetics,MYSORE SANDAL SOAP 75G,10,126,126,0,3
13-04-2025,Pooja & Spiritual Items,divya deeparadhana oil,12,190,190,0,1
13-04-2025,"Dry Fruits, Nuts & Seeds",Groundnuts 500 gms,2,95,85,10,1
13-04-2025,"Grains, Flours & Dals",unpolished turdall500grms,4,120,110,10,1
13-04-2025,Personal Care & Cosmetics,Soapnut 250GM,10,60,45,15,1
13-04-2025,"Grains, Flours & Dals",SAMALU (Little millet) 1 kg,4,170,130,40,1
13-04-2025,Snacks & Ready-to-Eat,DOSA BATTER 1KG,14,60,60,0,1
13-04-2025,Snacks & Ready-to-Eat,SUNNUNDALU,14,120,120,0,1
13-04-2025,"Grains, Flours & Dals",Green gram 1 kg,4,150,130,20,1
13-04-2025,Snacks & Ready-to-Eat,GROUNDNUT LADDU WITH DATES,14,135,135,0,1
13-04-2025,"Grains, Flours & Dals",unpolished turdall500grms,4,120,110,10,1
13-04-2025,Sweeteners,ACHU BELLAM 1KG,16,100,80,20,1
13-04-2025,Snacks & Ready-to-Eat,VD MURMURA LADDU,14,50,50,0,1
13-04-2025,"Dry Fruits, Nuts & Seeds",cashew,2,340,310,30,1
13-04-2025,"Dry Fruits, Nuts & Seeds",ANJEER 250GM,2,400,360,40,1
13-04-2025,Snacks & Ready-to-Eat,NGT CHATPATTA CHANA 90GM,14,75,75,0,3
13-04-2025,"Grains, Flours & Dals",idly rava 1kg,4,60,50,10,1
13-04-2025,Oils & Ghee,BUFFALLO GHEE 500ML,9,410,370,40,1
13-04-2025,"Grains, Flours & Dals",Urad dall 1 Kg,4,185,170,15,1
13-04-2025,Snacks & Ready-to-Eat,RAGI LADDU,14,120,120,0,1
13-04-2025,"Dry Fruits, Nuts & Seeds",PULMAKHANA 100 GM,2,180,170,10,1
13-04-2025,Snacks & Ready-to-Eat,MB SORGHUM NOODLES 180GM,14,95,95,0,1
13-04-2025,Spices & Seasonings,DRY MIECHI 200GM,15,80,60,20,1
13-04-2025,Snacks & Ready-to-Eat,MB PEARL MILLET NOODLES 180GM,14,95,95,0,1
13-04-2025,Snacks & Ready-to-Eat,SD DrybFruit LADDU WITH DATES 175GM,14,170,170,0,1
13-04-2025,Oils & Ghee,Groundnut oil 1 L,9,360,330,30,1
13-04-2025,"Grains, Flours & Dals",RAGI FLOUR 1KG,4,80,70,10,1
13-04-2025,"Grains, Flours & Dals",yellow jowar flour 1kg,4,100,92,8,1
13-04-2025,"Dry Fruits, Nuts & Seeds",Groundnuts 500 gms,2,95,85,10,1
13-04-2025,"Grains, Flours & Dals",Urad dall 1 Kg,4,370,340,30,2
13-04-2025,"Grains, Flours & Dals",idly rava 1kg,4,60,50,10,1
13-04-2025,"Grains, Flours & Dals",Wheat Flour 1 kg,4,70,60,10,1
13-04-2025,"Grains, Flours & Dals",Multigrain 1 kg,4,100,85,15,1
13-04-2025,Spices & Seasonings,Tamarind 250GMS,15,80,65,15,1
13-04-2025,"Dry Fruits, Nuts & Seeds",ANJEER 250GM,2,400,360,40,1
13-04-2025,"Dry Fruits, Nuts & Seeds",SALTED PISTA 250GM,2,400,350,50,1
13-04-2025,"Grains, Flours & Dals",RAGI FLOUR 1KG,4,80,70,10,1
13-04-2025,"Grains, Flours & Dals",White jowar.F 1 kg,4,100,80,20,1
13-04-2025,Household & Cleaning,VIM SOAP,6,25,25,0,5
13-04-2025,"Grains, Flours & Dals",SABDANA,4,40,35,5,1
13-04-2025,"Grains, Flours & Dals",chana flour 500 gms,4,60,54,6,1
13-04-2025,"Grains, Flours & Dals",Wheat Flour 1 kg,4,70,60,10,1
13-04-2025,"Grains, Flours & Dals",SAMALU (Little millet) 500 gms,4,85,65,20,1
13-04-2025,Snacks & Ready-to-Eat,PUMPKIN CHIKKI 200GM,14,140,120,20,1
13-04-2025,"Grains, Flours & Dals",UDALU (Barnyard millet) 500 gms,4,70,60,10,1
13-04-2025,"Grains, Flours & Dals",Arikalu (kodo),4,70,65,5,1
13-04-2025,Spices & Seasonings,Menthulu 250 gms,15,50,45,5,1
13-04-2025,"Grains, Flours & Dals",KORRALU (FOXTAIL M) 500GM,4,65,55,10,1
13-04-2025,"Grains, Flours & Dals",Bombay Rava 500GM,4,35,30,5,1
13-04-2025,"Grains, Flours & Dals",RICE FLOUR 500 GM,4,35,28,7,1
13-04-2025,Oils & Ghee,Groundnut oil 1 L,9,1080,990,90,3
13-04-2025,Personal Care & Cosmetics,GOW DURBAR 75G,10,60,60,0,1
13-04-2025,"Grains, Flours & Dals",DISANO ROLED OATS,4,200,200,0,1
13-04-2025,Spices & Seasonings,ROYAL SAFFRON,15,125,125,0,1
13-04-2025,Personal Care & Cosmetics,herbal antitan,10,50,50,0,1
13-04-2025,"Grains, Flours & Dals",BOMBAY RAVA,4,70,55,15,1
13-04-2025,"Grains, Flours & Dals",RAGULU 1 KG,4,70,60,10,1
13-04-2025,"Grains, Flours & Dals",Wheat Flour 1 kg,4,140,120,20,2
13-04-2025,"Grains, Flours & Dals",chana flour 500 gms,4,60,54,6,1
13-04-2025,"Grains, Flours & Dals",RAGI FLOUR 500GRMS,4,40,35,5,1
13-04-2025,Oils & Ghee,Safflower oil 1 L,9,880,800,80,2
13-04-2025,"Grains, Flours & Dals",turdal 1kg,4,440,340,100,2
13-04-2025,"Dry Fruits, Nuts & Seeds",SABJA SEEDS 100GM,2,80,70,10,1
13-04-2025,"Grains, Flours & Dals",Green gram 500 gms,4,75,70,5,1
13-04-2025,"Grains, Flours & Dals",CHANA DAL 500GM,4,56,48,8,1
13-04-2025,"Grains, Flours & Dals",Red Chana 250GM,4,35,30,5,1
13-04-2025,"Grains, Flours & Dals",split green gram 500 gms,4,75,70,5,1
13-04-2025,Pooja & Spiritual Items,divya deeparadhana oil,12,190,190,0,1
13-04-2025,Snacks & Ready-to-Eat,Popcorn Seeds 250GM,14,45,40,5,1
13-04-2025,"Grains, Flours & Dals",BASMATHI RICE 1KG,4,150,135,15,1
13-04-2025,"Grains, Flours & Dals",White jowar.F 1 kg,4,100,80,20,1
13-04-2025,"Dry Fruits, Nuts & Seeds",PULMAKHANA 100 GM,2,180,170,10,1
13-04-2025,Personal Care & Cosmetics,Soapnut 250GM,10,60,45,15,1
13-04-2025,"Grains, Flours & Dals",Urad dall 1 Kg,4,185,170,15,1
13-04-2025,"Grains, Flours & Dals",PESARA PAPPU 1 KG,4,170,145,25,1
13-04-2025,Snacks & Ready-to-Eat,VD Minapa papad 200gm,14,60,60,0,1
13-04-2025,Snacks & Ready-to-Eat,GB SALT COOKIES,14,60,55,5,1
13-04-2025,Snacks & Ready-to-Eat,SF PUFFED RICE,14,55,55,0,1
13-04-2025,Snacks & Ready-to-Eat,RINGS 200GM,14,30,30,0,1
13-04-2025,Snacks & Ready-to-Eat,VD Pappu Chekkalu 190gm,14,60,60,0,1
13-04-2025,Snacks & Ready-to-Eat,VD SAGOPAPAD 150GM,14,55,55,0,1
13-04-2025,Oils & Ghee,Groundnut oil 1 L,9,360,330,30,1
13-04-2025,"Grains, Flours & Dals",Multigrain 1 kg,4,100,85,15,1
13-04-2025,Oils & Ghee,Sesame oil 1 L,9,590,560,30,1
13-04-2025,"Grains, Flours & Dals",Wheat Flour 1 kg,4,70,60,10,1
13-04-2025,"Grains, Flours & Dals",Wheat Flour 1 kg,4,70,60,10,1
13-04-2025,"Grains, Flours & Dals",MAATEJA rice 1 kg,4,360,345,15,5
13-04-2025,"Grains, Flours & Dals",Urad dall 1 Kg,4,185,170,15,1
13-04-2025,Spices & Seasonings,Turmeric powder 250 gms,15,100,75,25,1
13-04-2025,Spices & Seasonings,Chilli powder 500 gms,15,290,210,80,1
13-04-2025,Milk & Dairy,SANGAM CURD 450GM,7,40,40,0,1
13-04-2025,Oils & Ghee,Coconut oil 500 ml,9,220,200,20,1
13-04-2025,Milk & Dairy,HERTG FULL CREAM M,7,41,41,0,1
13-04-2025,"Grains, Flours & Dals",Green gram 500 gms,4,75,70,5,1
13-04-2025,Snacks & Ready-to-Eat,sagopapad red chilli,14,55,55,0,1
13-04-2025,"Grains, Flours & Dals",Wheat Flour 1 kg,4,70,60,10,1
13-04-2025,Milk & Dairy,SANGAM CURD 450GM,7,38,38,0,1
13-04-2025,"Grains, Flours & Dals",Wheat Rava S 1KG,4,65,55,10,1
13-04-2025,Spices & Seasonings,NUVVULU 500GM,15,200,170,30,1
13-04-2025,"Grains, Flours & Dals",RAGI FLOUR 1KG,4,160,140,20,2
13-04-2025,"Grains, Flours & Dals",RICE FLOUR 1KG,4,70,55,15,1
13-04-2025,Spices & Seasonings,ROYAL SAFFRON,15,125,125,0,1
13-04-2025,"Grains, Flours & Dals",turdal 1kg,4,220,170,50,1
13-04-2025,Snacks & Ready-to-Eat,VD MANGO JELLY 250GRMS,14,80,80,0,1
13-04-2025,"Grains, Flours & Dals",Wheat Rava S 1KG,4,65,55,10,1
13-04-2025,"Grains, Flours & Dals",Wheat Flour 1 kg,4,140,120,20,2
13-04-2025,"Grains, Flours & Dals",idly rava 1kg,4,60,50,10,1
13-04-2025,Oils & Ghee,Sesame oil 500ml,9,295,280,15,1
13-04-2025,"Grains, Flours & Dals",Urad dall 1 Kg,4,185,170,15,1
13-04-2025,Snacks & Ready-to-Eat,Popcorn Seeds 250GM,14,45,40,5,1
13-04-2025,Spices & Seasonings,Tamarind 500GM,15,160,130,30,1
13-04-2025,"Grains, Flours & Dals",MAAGAANI W RICE 1KG,4,278,220,58,2
13-04-2025,Oils & Ghee,Groundnut oil 1 L,9,360,330,30,1
13-04-2025,Misc,ROLL D C,8,70,45,25,1
13-04-2025,"Dry Fruits, Nuts & Seeds",SUNFLOWER SEEDS 250GRM,2,150,130,20,1
13-04-2025,"Dry Fruits, Nuts & Seeds",SATHVI CHIA SEEDS 100GM,2,100,80,20,1
13-04-2025,"Dry Fruits, Nuts & Seeds",PUMPKIN SEEDS 250GM,2,200,160,40,1
13-04-2025,Oils & Ghee,Groundnut oil 1 L,9,360,330,30,1
13-04-2025,"Dry Fruits, Nuts & Seeds",WATERMELON SEEDS 250GRM,2,320,280,40,1
13-04-2025,Snacks & Ready-to-Eat,SD Little Millet WITH PLAM JAGGERY,14,135,135,0,1
13-04-2025,"Dry Fruits, Nuts & Seeds",wallnuts,2,380,320,60,1
13-04-2025,"Dry Fruits, Nuts & Seeds",WATERMELON SEEDS 250GRM,2,320,280,40,1
13-04-2025,"Dry Fruits, Nuts & Seeds",PUMPKIN SEEDS 250GM,2,200,160,40,1
13-04-2025,"Grains, Flours & Dals",BARLEY SEEDS 250GMS,4,40,35,5,1
13-04-2025,"Grains, Flours & Dals",SABDANA,4,40,35,5,1
13-04-2025,Spices & Seasonings,Coriander seeds 200 gms,15,48,40,8,1
13-04-2025,Snacks & Ready-to-Eat,VD Pappu Chekkalu 190gm,14,60,60,0,1
13-04-2025,"Dry Fruits, Nuts & Seeds",SD Mango cubes 100gm,2,45,45,0,1
13-04-2025,Snacks & Ready-to-Eat,RSC ORANGE 100GMS,14,20,20,0,1
13-04-2025,Spices & Seasonings,PRO ORG TURMERIC POWDER 100G,15,70,70,0,1
13-04-2025,"Grains, Flours & Dals",Wheat Rava S 1KG,4,65,55,10,1
13-04-2025,Misc,ROLL D C,8,70,45,25,1
13-04-2025,"Dry Fruits, Nuts & Seeds",SUNFLOWER SEEDS 250GRM,2,150,130,20,1
13-04-2025,Snacks & Ready-to-Eat,VD NUVULLU CHIKKI,14,80,80,0,1
13-04-2025,"Grains, Flours & Dals",RAGI FLOUR 500GRMS,4,40,35,5,1
13-04-2025,"Grains, Flours & Dals",SABDANA,4,40,35,5,1
13-04-2025,Oils & Ghee,rice bran oil f,9,194,169,25,1
13-04-2025,"Grains, Flours & Dals",AISHWARYA SP 1KG,4,80,70,10,1
13-04-2025,"Grains, Flours & Dals",KORRALU (FOXTAIL M) 500GM,4,65,55,10,1
13-04-2025,"Grains, Flours & Dals",Arikalu (kodo),4,70,65,5,1
13-04-2025,"Dry Fruits, Nuts & Seeds",Groundnuts 1 kg,2,190,165,25,1
13-04-2025,"Grains, Flours & Dals",KORRALU (FOXTAIL M) 1KG,4,150,110,40,1
13-04-2025,"Grains, Flours & Dals",Quinova 1 kg,4,220,195,25,1
13-04-2025,Snacks & Ready-to-Eat,VD MYSOREPAK 6PIC,14,100,100,0,1
13-04-2025,"Grains, Flours & Dals",AISHWARYA SP 1KG,4,400,350,50,5
13-04-2025,Pooja & Spiritual Items,GD Ramayana Sandal 75GM,12,60,60,0,1
13-04-2025,Personal Care & Cosmetics,GOW DURBAR 75G,10,60,60,0,1
13-04-2025,Snacks & Ready-to-Eat,BATANA NGT 70GMS,14,20,20,0,1
13-04-2025,"Grains, Flours & Dals",RAGI FLOUR 500GRMS,4,40,35,5,1
13-04-2025,"Grains, Flours & Dals",turdal 1kg,4,220,170,50,1
13-04-2025,Snacks & Ready-to-Eat,NGT CHATPATTA CHANA 90GM,14,50,50,0,2
13-04-2025,Oils & Ghee,Sesame oil 1 L,9,1180,"1,120.00",60,2
13-04-2025,Oils & Ghee,Coconut oil 1 L,9,440,400,40,1
13-04-2025,"Grains, Flours & Dals",RAGI FLOUR 1KG,4,80,70,10,1
13-04-2025,"Dry Fruits, Nuts & Seeds",cashew,2,340,310,30,1
13-04-2025,Snacks & Ready-to-Eat,BELLAM MINAPA SUNADULLU,14,180,180,0,1
13-04-2025,"Health, Wellness & Ayurvedic Products",RB FRUITS &amp;seeds Cranberries,5,45,45,0,1
13-04-2025,Spices & Seasonings,PRO ORG CUMIN 100G,15,176,176,0,1
13-04-2025,Oils & Ghee,Safflower oil 500 ml,9,220,200,20,1
13-04-2025,Snacks & Ready-to-Eat,SF MIGHTY PUFFS,14,25,25,0,1
13-04-2025,Personal Care & Cosmetics,MARGO,10,225,180,45,1
13-04-2025,Personal Care & Cosmetics,OVAL BODY LOOFAH,10,55,55,0,1
13-04-2025,Snacks & Ready-to-Eat,VD Minapa papad 200gm,14,60,60,0,1
13-04-2025,Snacks & Ready-to-Eat,MP CHOCO ALMOND COOKIE,14,60,60,0,1
13-04-2025,Snacks & Ready-to-Eat,PEANUT CHILLI,14,10,10,0,2
13-04-2025,General Household & Kitchenware,GOOD HOME,3,15,15,0,1
13-04-2025,Milk & Dairy,SANGAM TONED MILK 500ML,7,31,31,0,1
13-04-2025,Snacks & Ready-to-Eat,VD MULTI CHAKKA,14,110,110,0,1
13-04-2025,Milk & Dairy,HERITAGE BUTTERMILK,7,10,10,0,1
13-04-2025,Milk & Dairy,HRITAGE TOTAL CURD 130GM,7,20,20,0,2
13-04-2025,"Dry Fruits, Nuts & Seeds",SABJA SEEDS 100GM,2,80,70,10,1
13-04-2025,Spices & Seasonings,Telaga Pindi 250 GM,15,40,35,5,1
13-04-2025,Snacks & Ready-to-Eat,Sprouted Ragi Biscuits 450GM,14,150,150,0,1
13-04-2025,"Grains, Flours & Dals",THICK POHA 500GM,4,40,35,5,1
13-04-2025,"Grains, Flours & Dals",Multigrain 1 kg,4,100,85,15,1
13-04-2025,"Grains, Flours & Dals",MULTIMILLET IDLY RAVVA,4,65,65,0,1
13-04-2025,Spices & Seasonings,MASALA KAR 500GMS,15,260,240,20,1
13-04-2025,Snacks & Ready-to-Eat,SD Vamu with palm jaggery 250gm,14,135,135,0,1
13-04-2025,"Grains, Flours & Dals",AISHWARYA SP 25KG,4,1999,"1,690.00",309,1
13-04-2025,Snacks & Ready-to-Eat,PEANUT CHILLI,14,10,10,0,2
13-04-2025,Snacks & Ready-to-Eat,GROUNDNUT LADDU WITH DATES,14,135,135,0,1
13-04-2025,"Grains, Flours & Dals",White jowar.F 1 kg,4,100,80,20,1
13-04-2025,Snacks & Ready-to-Eat,SF MIGHTY PUFFS,14,25,25,0,1
13-04-2025,Snacks & Ready-to-Eat,SD Atreyapuram DRY Fruit ghee,14,150,150,0,1
13-04-2025,Oils & Ghee,Groundnut oil 5 L,9,1800,"1,600.00",200,1
13-04-2025,Personal Care & Cosmetics,SVE PREMIUM WILD TURMEIC 100GM,10,110,110,0,1
13-04-2025,"Grains, Flours & Dals",Red Chana 500 GM,4,75,60,15,1
13-04-2025,Spices & Seasonings,DB SAFRON,15,180,180,0,1
13-04-2025,"Grains, Flours & Dals",PRO ORGANIC MOONG GREEN,4,148,148,0,1
13-04-2025,"Dry Fruits, Nuts & Seeds",SUNFLOWER SEEDS 250GRM,2,150,130,20,1
13-04-2025,"Grains, Flours & Dals",Red Bobarlu 500 gms,4,95,85,10,1
13-04-2025,"Grains, Flours & Dals",Wheat Flour 1 kg,4,350,300,50,5
13-04-2025,"Grains, Flours & Dals",chana flour 500 gms,4,240,216,24,4
13-04-2025,Oils & Ghee,Safflower oil 1 L,9,440,400,40,1
13-04-2025,Oils & Ghee,Groundnut oil 1 L,9,360,330,30,1
13-04-2025,Oils & Ghee,Groundnut oil 1 L,9,720,660,60,2
13-04-2025,"Dry Fruits, Nuts & Seeds",Groundnuts 500 gms,2,95,85,10,1
13-04-2025,"Grains, Flours & Dals",White jowar.F 1 kg,4,100,80,20,1
13-04-2025,Snacks & Ready-to-Eat,SD Groundnut with palm jaggery 250gm,14,135,135,0,1
13-04-2025,Spices & Seasonings,Masala Karam 250 gms,15,130,120,10,1
13-04-2025,Pooja & Spiritual Items,999 SINGAPORE DHOOP POW 50GM,12,35,35,0,1
13-04-2025,Household & Cleaning,SURFEXCEL BAR 80G,6,10,10,0,1
13-04-2025,"Grains, Flours & Dals",RAGI FLOUR 500GRMS,4,40,35,5,1
13-04-2025,Personal Care & Cosmetics,MD Soapnut Choornam 100GM,10,80,80,0,1
13-04-2025,Personal Care & Cosmetics,garnier black naturals,10,45,45,0,1
13-04-2025,"Grains, Flours & Dals",BARLEY SEEDS 250GMS,4,40,35,5,1
13-04-2025,General Household & Kitchenware,SABEENA,3,30,30,0,2
13-04-2025,Oils & Ghee,Black Sesame oil 500 ml,9,220,190,30,1
13-04-2025,Spices & Seasonings,NUVVULU 500GM,15,200,170,30,1
13-04-2025,Sweeteners,Natural Honey 500 gms,16,280,240,40,1
13-04-2025,Oils & Ghee,Groundnut oil 1 L,9,720,660,60,2
13-04-2025,"Grains, Flours & Dals",RAGULU 1 KG,4,70,60,10,1
13-04-2025,"Grains, Flours & Dals",Wheat Flour 1 kg,4,70,60,10,1
13-04-2025,"Dry Fruits, Nuts & Seeds",SABJA SEEDS 100GM,2,80,70,10,1
13-04-2025,Spices & Seasonings,GREEN SOUNF,15,60,40,20,1
13-04-2025,Spices & Seasonings,SATHVI ANASAPUVUU 25GM,15,90,65,25,1
13-04-2025,Spices & Seasonings,SAJEERA,15,60,40,20,1
13-04-2025,"Grains, Flours & Dals",BASMATHI RICE 1KG,4,150,135,15,1
13-04-2025,Spices & Seasonings,Japatri 25GM,15,100,80,20,1
13-04-2025,Spices & Seasonings,Tamarind 500GM,15,320,260,60,2
13-04-2025,Spices & Seasonings,Turmeric powder 250 gms,15,100,75,25,1
13-04-2025,Spices & Seasonings,RED COPRA 250GMS,15,85,74,11,1
13-04-2025,"Grains, Flours & Dals",idly rava 1kg,4,60,50,10,1
13-04-2025,"Grains, Flours & Dals",Multigrain 1 kg,4,100,85,15,1
13-04-2025,"Grains, Flours & Dals",URAD DALL,4,95,85,10,1
13-04-2025,"Grains, Flours & Dals",RICE FLOUR 1KG,4,70,55,15,1
13-04-2025,Snacks & Ready-to-Eat,HS JOWAR BISCUITS,14,50,50,0,1
13-04-2025,"Grains, Flours & Dals",RICE FLOUR 1KG,4,70,55,15,1
13-04-2025,Oils & Ghee,cow ghee 500 ml,9,430,390,40,1
13-04-2025,Snacks & Ready-to-Eat,NGT CHATPATTA CHANA 90GM,14,100,100,0,4
13-04-2025,"Grains, Flours & Dals",Wheat Flour 1 kg,4,210,180,30,3
13-04-2025,"Grains, Flours & Dals",Multigrain 1 kg,4,100,85,15,1
13-04-2025,Snacks & Ready-to-Eat,VD Minapa papad 200gm,14,60,60,0,1
13-04-2025,Oils & Ghee,Groundnut oil 1 L,9,720,660,60,2
13-04-2025,Snacks & Ready-to-Eat,VD GUMMADI CHAKKA,14,260,260,0,2
13-04-2025,Pooja & Spiritual Items,BALAJI BEL PHOOL STICKS 90GM,12,180,180,0,3
13-04-2025,"Grains, Flours & Dals",Multigrain 1 kg,4,200,170,30,2
13-04-2025,Snacks & Ready-to-Eat,NGT CHATPATTA CHANA 90GM,14,25,25,0,1
13-04-2025,Oils & Ghee,Groundnut oil 1 L,9,360,330,30,1
13-04-2025,"Grains, Flours & Dals",Chana Flour 500 gms,4,120,108,12,1
13-04-2025,Sweeteners,SUGAR 500 GM,16,30,25,5,1
13-04-2025,"Grains, Flours & Dals",BAJRA 1 KG,4,60,50,10,1
13-04-2025,Snacks & Ready-to-Eat,VD PALLI LADDU,14,160,160,0,2
13-04-2025,"Grains, Flours & Dals",VGR rice 1 kg,4,700,650,50,10
13-04-2025,Oils & Ghee,Safflower oil 1 L,9,880,800,80,2
13-04-2025,Oils & Ghee,Groundnut oil 1 L,9,360,330,30,1
13-04-2025,Oils & Ghee,Castor oil 200 ml,9,100,80,20,1
13-04-2025,Milk & Dairy,HERITAGE TOTAL CURD 500GM,7,50,50,0,1
13-04-2025,Milk & Dairy,HERITAGE BUTTERMILK,7,40,40,0,4
13-04-2025,Oils & Ghee,Sesame oil 500ml,9,295,280,15,1
13-04-2025,Beverages,BRU GREEN LABEL 1.2G,1,8,8,0,4
13-04-2025,Oils & Ghee,mustard oil,9,195,195,0,1
13-04-2025,Milk & Dairy,HERTG FULL CREAM M,7,41,41,0,1
13-04-2025,Pickles & Cooking Pastes,SD MANGO TOKKU,11,110,110,0,1
13-04-2025,Oils & Ghee,Sesame oil 1 L,9,1180,"1,120.00",60,2
13-04-2025,Spices & Seasonings,THREE MANGO RAI 200G,15,210,210,0,5
13-04-2025,Oils & Ghee,Safflower oil 5 L,9,2200,"1,950.00",250,1
13-04-2025,"Dry Fruits, Nuts & Seeds",ANJEER 250GM,2,400,360,40,1
13-04-2025,Spices & Seasonings,Konark Crystal Salt 1KG,15,20,20,0,1
13-04-2025,Oils & Ghee,Coconut oil 1 L,9,440,400,40,1
13-04-2025,"Dry Fruits, Nuts & Seeds",SH GROUNDNUT 500GM,2,163,130,33,1
13-04-2025,Sweeteners,Natural Honey 500 gms,16,560,480,80,2
13-04-2025,"Grains, Flours & Dals",Black RICE 1 KG,4,340,310,30,1
13-04-2025,Oils & Ghee,Groundnut oil 1 L,9,360,330,30,1
13-04-2025,Snacks & Ready-to-Eat,VD SAGOPAPAD 150GM,14,55,55,0,1
13-04-2025,"Grains, Flours & Dals",turdal 500 gms,4,220,170,50,2
13-04-2025,"Grains, Flours & Dals",CHANADALL 250 GMS,4,28,24,4,1
13-04-2025,"Dry Fruits, Nuts & Seeds",PULMAKHANA 100 GM,2,180,170,10,1
13-04-2025,"Grains, Flours & Dals",AISHWARYA SP 1KG,4,240,210,30,3
13-04-2025,Pooja & Spiritual Items,GD Dhoop Sticks 26GM,12,40,40,0,2
13-04-2025,"Grains, Flours & Dals",RAGI FLOUR 500GRMS,4,40,35,5,1
13-04-2025,Spices & Seasonings,ROYAL SAFFRON,15,250,250,0,2
13-04-2025,Oils & Ghee,Groundnut oil 1 L,9,720,660,60,2
13-04-2025,"Grains, Flours & Dals",BAJRA 1 KG,4,120,100,20,2
13-04-2025,Sweeteners,GS Palm Jaggery Powder 400GM,16,360,360,0,2
13-04-2025,"Grains, Flours & Dals",RAGULU 1 KG,4,210,180,30,3
13-04-2025,"Grains, Flours & Dals",Multigrain 1 kg,4,300,255,45,3
13-04-2025,"Grains, Flours & Dals",SAMALU (Little millet) 500 gms,4,85,65,20,1
13-04-2025,Snacks & Ready-to-Eat,VD CORNFLAKES MIXTURE 175GM,14,60,60,0,1
13-04-2025,"Grains, Flours & Dals",UDALU (Barnyard millet) 500 gms,4,70,60,10,1
13-04-2025,"Grains, Flours & Dals",KORRALU (FOXTAIL M) 500GM,4,65,55,10,1
13-04-2025,"Grains, Flours & Dals",Arikalu (kodo),4,70,65,5,1
13-04-2025,Oils & Ghee,groundnet oil,9,1600,"1,600.00",0,1
13-04-2025,Household & Cleaning,ROOPERI PITAMBARI SILVER 50ML,6,110,110,0,1
13-04-2025,Spices & Seasonings,SATHVI ANASAPUVUU 25GM,15,90,65,25,1
13-04-2025,Oils & Ghee,Sesame oil 500ml,9,295,280,15,1
13-04-2025,Oils & Ghee,Coconut oil 500 ml,9,220,200,20,1
13-04-2025,Pooja & Spiritual Items,GD Kumkum 50GM,12,30,30,0,1
13-04-2025,"Grains, Flours & Dals",ANDU KORRALU (Brown top .mlt) 500,4,130,110,20,1
13-04-2025,"Dry Fruits, Nuts & Seeds",SABJA SEEDS 100GM,2,80,70,10,1
13-04-2025,Oils & Ghee,Sesame oil 1 L,9,590,560,30,1
13-04-2025,Oils & Ghee,Groundnut oil 1 L,9,360,330,30,1
13-04-2025,Oils & Ghee,Safflower oil 500 ml,9,440,400,40,2
13-04-2025,"Grains, Flours & Dals",Arikalu (kodo),4,70,65,5,1
13-04-2025,Snacks & Ready-to-Eat,VD Pappu Chekkalu 190gm,14,60,60,0,1
13-04-2025,"Dry Fruits, Nuts & Seeds",PULMAKHANA 100 GM,2,180,170,10,1
13-04-2025,Oils & Ghee,Safflower oil 500 ml,9,220,200,20,1
13-04-2025,Snacks & Ready-to-Eat,jungle pasta,14,249,249,0,1
13-04-2025,Snacks & Ready-to-Eat,VD DASA DINUSULU,14,199,199,0,1
13-04-2025,Snacks & Ready-to-Eat,VD MURUKU 175GM,14,60,60,0,1
13-04-2025,Spices & Seasonings,sf red chilli,15,85,85,0,1
13-04-2025,Oils & Ghee,Groundnut oil 500ml,9,180,165,15,1
13-04-2025,Spices & Seasonings,pickle chili powder,15,360,330,30,2
13-04-2025,Oils & Ghee,Sesame oil 500ml,9,295,280,15,1
13-04-2025,"Grains, Flours & Dals",Urad dall 1 Kg,4,185,170,15,1
13-04-2025,Snacks & Ready-to-Eat,VD NUVVULU LADDU,14,80,80,0,1
13-04-2025,Oils & Ghee,Groundnut oil 500ml,9,180,165,15,1
13-04-2025,Oils & Ghee,Coconut oil 500 ml,9,220,200,20,1
13-04-2025,"Grains, Flours & Dals",RAGI FLOUR 500GRMS,4,40,35,5,1
13-04-2025,Snacks & Ready-to-Eat,PEANUT CHILLI,14,50,50,0,10
13-04-2025,Oils & Ghee,Sesame oil 5 L,9,2950,"2,750.00",200,1
13-04-2025,Milk & Dairy,BROWN EGGS TRAY 30P,7,720,660,60,2
13-04-2025,"Grains, Flours & Dals",Bombay Rava 500GM,4,35,30,5,1
13-04-2025,Oils & Ghee,Groundnut oil 1 L,9,720,660,60,2
13-04-2025,"Dry Fruits, Nuts & Seeds",Putnalu 250GM,2,45,38,7,1
13-04-2025,"Grains, Flours & Dals",Multigrain 1 kg,4,200,170,30,2
13-04-2025,"Grains, Flours & Dals",Red uluvalu 250 gms,4,45,40,5,1
13-04-2025,Pooja & Spiritual Items,BANDA PUVVU 25GM 25GM,12,80,60,20,1
13-04-2025,Oils & Ghee,Coconut oil 500 ml,9,220,200,20,1
13-04-2025,Spices & Seasonings,LG 50GM,15,92,92,0,1
13-04-2025,Spices & Seasonings,GREEN SOUNF,15,60,40,20,1
13-04-2025,"Grains, Flours & Dals",PESARA PAPPU 500GMS,4,85,75,10,1
13-04-2025,Spices & Seasonings,Jeera 100GM,15,50,45,5,1
13-04-2025,Spices & Seasonings,SAJEERA,15,60,40,20,1
13-04-2025,"Dry Fruits, Nuts & Seeds",KAJU HALF 250GM,2,310,290,20,1
13-04-2025,"Grains, Flours & Dals",unpolished turdall500grms,4,120,110,10,1
13-04-2025,Pooja & Spiritual Items,GD Dhoop Sticks 26GM,12,20,20,0,1
13-04-2025,"Grains, Flours & Dals",MULTIMILLET IDLY RAVVA,4,65,65,0,1
13-04-2025,"Grains, Flours & Dals",split black gram 1 kg,4,180,170,10,1
13-04-2025,Sweeteners,SUGAR 500 GM,16,30,25,5,1
13-04-2025,"Grains, Flours & Dals",CHANADALL 250 GMS,4,28,24,4,1
13-04-2025,"Grains, Flours & Dals",Arikalu (kodo),4,140,130,10,2
13-04-2025,"Grains, Flours & Dals",SAMALU (Little millet) 1 kg,4,170,130,40,1
13-04-2025,"Grains, Flours & Dals",KORRALU (FOXTAIL M) 1KG,4,150,110,40,1
13-04-2025,"Grains, Flours & Dals",RAGULU 1 KG,4,70,60,10,1
13-04-2025,Oils & Ghee,mustard oil,9,195,195,0,1
13-04-2025,"Dry Fruits, Nuts & Seeds",SUNFLOWER SEEDS 250GRM,2,150,130,20,1
13-04-2025,Oils & Ghee,BUFFALLO GHEE 500ML,9,410,370,40,1
13-04-2025,Spices & Seasonings,Black Till 250GM,15,90,75,15,1
13-04-2025,Milk & Dairy,SANGAM TONED MILK 500ML,7,120,120,0,4
13-04-2025,"Dry Fruits, Nuts & Seeds",PUMPKIN SEEDS 250GM,2,200,160,40,1
13-04-2025,Beverages,BISLERI 100ml,1,10,10,0,1
13-04-2025,"Grains, Flours & Dals",SAMALU (Little millet) 1 kg,4,170,130,40,1
13-04-2025,Snacks & Ready-to-Eat,SD FINGER Millet with palm Jaggery 250gm,14,135,135,0,1
13-04-2025,Snacks & Ready-to-Eat,SD High Protein Laddu 175gm,14,190,190,0,1
13-04-2025,Beverages,REFRESH SHARBATH NORMAL,1,199,190,9,1
13-04-2025,"Dry Fruits, Nuts & Seeds",SATHVI CHIA SEEDS 100GM,2,100,80,20,1
13-04-2025,Spices & Seasonings,Turmeric powder 250 gms,15,100,75,25,1
13-04-2025,Spices & Seasonings,DRY MIECHI 200GM,15,80,60,20,1
13-04-2025,Spices & Seasonings,DURGA SALT CRYSTAL 1KG,15,25,25,0,1
13-04-2025,Spices & Seasonings,THREE MANGO RAI 200G,15,42,42,0,1
13-04-2025,"Grains, Flours & Dals",chana flour 500 gms,4,60,54,6,1
13-04-2025,Oils & Ghee,Coconut oil 500 ml,9,220,200,20,1
13-04-2025,"Grains, Flours & Dals",Em jowar idly R 500G,4,75,75,0,1
13-04-2025,Personal Care & Cosmetics,MESWAK 100GM,10,70,70,0,1
13-04-2025,"Grains, Flours & Dals",Wheat Flour 1 kg,4,70,60,10,1
13-04-2025,"Grains, Flours & Dals",RAGI FLOUR 500GRMS,4,40,35,5,1
13-04-2025,"Grains, Flours & Dals",Red Wheat Flour 1 kg,4,140,130,10,1
13-04-2025,Oils & Ghee,Groundnut oil 1 L,9,720,660,60,2
13-04-2025,Sweeteners,YB Brown Sugar 1KG,16,140,140,0,1
13-04-2025,"Grains, Flours & Dals",VGR RICE bag 1,4,1899,"1,650.00",249,1
13-04-2025,Pooja & Spiritual Items,BALAJI KASTURI DHOOP STICKS,12,70,70,0,1
13-04-2025,Oils & Ghee,Sesame oil 1 L,9,590,560,30,1
13-04-2025,Spices & Seasonings,Avalu small 250 gms,15,60,40,20,1
13-04-2025,Pooja & Spiritual Items,GB Bharatha Woods 75GM,12,60,60,0,1
13-04-2025,Sweeteners,MISHRI D,16,40,30,10,1
13-04-2025,"Dry Fruits, Nuts & Seeds",Groundnuts 500 gms,2,95,85,10,1
13-04-2025,"Grains, Flours & Dals",Red Chana 250GM,4,35,30,5,1
13-04-2025,"Dry Fruits, Nuts & Seeds",PULMAKHANA 100 GM,2,180,170,10,1
13-04-2025,Oils & Ghee,Coconut oil 500 ml,9,220,200,20,1
13-04-2025,Oils & Ghee,Safflower oil 1 L,9,440,400,40,1
13-04-2025,"Grains, Flours & Dals",RICE FLOUR 500 GM,4,70,56,14,2
13-04-2025,Milk & Dairy,BROWN EGGS 1P,7,112,96,16,8
13-04-2025,"Grains, Flours & Dals",RAGI FLOUR 500GRMS,4,40,35,5,1
13-04-2025,"Grains, Flours & Dals",Multigrain 1 kg,4,100,85,15,1
13-04-2025,"Health, Wellness & Ayurvedic Products",RB Max Protein Choco Almond bar 50g,5,75,75,0,1
13-04-2025,Spices & Seasonings,Turmeric powder 250 gms,15,100,75,25,1
13-04-2025,Snacks & Ready-to-Eat,TILLI CHIKKI,14,30,30,0,6
13-04-2025,"Grains, Flours & Dals",RICE FLOUR 1KG,4,70,55,15,1
13-04-2025,"Grains, Flours & Dals",RICE FLOUR 500 GM,4,35,28,7,1
13-04-2025,"Grains, Flours & Dals",Wheat Flour 1 kg,4,70,60,10,1
13-04-2025,Milk & Dairy,BROWN EGGS 1P,7,56,48,8,4
13-04-2025,Spices & Seasonings,Turmeric powder 250 gms,15,100,75,25,1
13-04-2025,Spices & Seasonings,Telaga Pindi 250 GM,15,40,35,5,1
13-04-2025,Oils & Ghee,Sesame oil 1 L,9,590,560,30,1
13-04-2025,"Grains, Flours & Dals",turdal 1kg,4,220,170,50,1
13-04-2025,Milk & Dairy,SANGAM TONED MILK 500ML,7,90,90,0,3
13-04-2025,Milk & Dairy,SANGAM FULL CREAM MILK 500ML,7,38,38,0,1
13-04-2025,Milk & Dairy,BROWN EGGS 1P,7,168,144,24,12
13-04-2025,Oils & Ghee,Groundnut oil 1 L,9,360,330,30,1
13-04-2025,"Grains, Flours & Dals",KORRALU (FOXTAIL M) 1KG,4,150,110,40,1
13-04-2025,"Grains, Flours & Dals",Arikadu ( kodo),4,140,130,10,1
12-04-2025,"Grains, Flours & Dals",SAMALU (Little millet) 500 gms,4,85,65,20,1
12-04-2025,"Grains, Flours & Dals",Quinova 500 gms,4,110,100,10,1
12-04-2025,"Grains, Flours & Dals",KORRALU (FOXTAIL M) 500GM,4,65,55,10,1
12-04-2025,Snacks & Ready-to-Eat,VD MULTI CHAKKA,14,110,110,0,1
12-04-2025,"Dry Fruits, Nuts & Seeds",PUMPKIN SEEDS 250GM,2,200,160,40,1
12-04-2025,"Dry Fruits, Nuts & Seeds",FLAX SEEDS 250GM,2,60,50,10,1
12-04-2025,"Dry Fruits, Nuts & Seeds",WATERMELON SEEDS 250GRM,2,320,280,40,1
12-04-2025,Spices & Seasonings,Jeera 100GM,15,50,45,5,1
12-04-2025,Spices & Seasonings,GS Pink Rock Salt 1KG,15,120,120,0,1
12-04-2025,Spices & Seasonings,DURGA SALT CRYSTAL 1KG,15,25,25,0,1
12-04-2025,"Dry Fruits, Nuts & Seeds",PULMAKHANA 100 GM,2,180,170,10,1
12-04-2025,"Dry Fruits, Nuts & Seeds",Groundnuts 500 gms,2,95,85,10,1
12-04-2025,"Dry Fruits, Nuts & Seeds",Groundnuts 1 kg,2,190,165,25,1
12-04-2025,"Grains, Flours & Dals",Wheat Flour 1 kg,4,210,180,30,3
12-04-2025,"Grains, Flours & Dals",PESARA PAPPU 500GMS,4,85,75,10,1
12-04-2025,Spices & Seasonings,AV Iodized Salt 1KG,15,28,25,3,1
12-04-2025,"Grains, Flours & Dals",split black gram 1 kg,4,180,170,10,1
12-04-2025,"Grains, Flours & Dals",AISHWARYA SP 1KG,4,240,210,30,3
12-04-2025,"Dry Fruits, Nuts & Seeds",SD Mango cubes 100gm,2,45,45,0,1
12-04-2025,"Dry Fruits, Nuts & Seeds",SABJA SEEDS 100GM,2,80,70,10,1
12-04-2025,"Dry Fruits, Nuts & Seeds",DRYDATES 250GM,2,150,120,30,1
12-04-2025,"Dry Fruits, Nuts & Seeds",PUMPKIN SEEDS 250GM,2,200,160,40,1
12-04-2025,"Health, Wellness & Ayurvedic Products",MXP CHOCO CLASSIC BAR,5,70,70,0,1
12-04-2025,"Dry Fruits, Nuts & Seeds",DRYDATES YELLOW 250GM,2,135,120,15,1
12-04-2025,Pooja & Spiritual Items,GD Ramayana Sandal 75GM,12,60,60,0,1
12-04-2025,"Dry Fruits, Nuts & Seeds",PUTNALU 500GMS,2,90,76,14,1
12-04-2025,"Grains, Flours & Dals",BASMATHI RICE 1KG,4,150,135,15,1
12-04-2025,Snacks & Ready-to-Eat,MP CHOCO ALMOND COOKIE,14,60,60,0,1
12-04-2025,"Health, Wellness & Ayurvedic Products",gyan thyapobhumi,5,60,60,0,1
12-04-2025,Snacks & Ready-to-Eat,VD PALLI LADDU,14,80,80,0,1
12-04-2025,Oils & Ghee,BUFFALLO GHEE 500ML,9,410,370,40,1
12-04-2025,Snacks & Ready-to-Eat,ELITE MILK RUSK 200GM,14,35,35,0,1
12-04-2025,Snacks & Ready-to-Eat,RI Yogurt Berry Oats 35g,14,45,45,0,1
12-04-2025,Snacks & Ready-to-Eat,SD DrybFruit LADDU WITH DATES 175GM,14,170,170,0,1
12-04-2025,"Health, Wellness & Ayurvedic Products",RB Max Protein Cheese&amp;,5,45,45,0,1
12-04-2025,"Grains, Flours & Dals",SAMALU (Little millet) 500 gms,4,85,65,20,1
12-04-2025,Snacks & Ready-to-Eat,SATHVI REGIVADA 200GM,14,160,120,40,2
12-04-2025,Snacks & Ready-to-Eat,VD PALLI LADDU,14,80,80,0,1
12-04-2025,"Grains, Flours & Dals",Arikalu (kodo),4,70,65,5,1
12-04-2025,"Grains, Flours & Dals",split black gram 1 kg,4,180,170,10,1
12-04-2025,"Dry Fruits, Nuts & Seeds",cashew,2,340,310,30,1
12-04-2025,"Dry Fruits, Nuts & Seeds",WATERMELON SEEDS 250GRM,2,320,280,40,1
12-04-2025,Spices & Seasonings,Chilli powder 500 gms,15,290,210,80,1
12-04-2025,"Dry Fruits, Nuts & Seeds",PLAIN PISTA 250GM,2,660,550,110,1
12-04-2025,Snacks & Ready-to-Eat,ragi apadalu,14,90,90,0,1
12-04-2025,"Grains, Flours & Dals",BOMBAY RAVA,4,70,55,15,1
12-04-2025,Snacks & Ready-to-Eat,SD FLAX SEED APPADALU,14,90,90,0,1
12-04-2025,"Dry Fruits, Nuts & Seeds",PULMAKHANA 100 GM,2,180,170,10,1
12-04-2025,"Dry Fruits, Nuts & Seeds",SD Mango cubes 100gm,2,45,45,0,1
12-04-2025,Spices & Seasonings,PN ORGANIC PINK SALT 1KG,15,124,124,0,1
12-04-2025,Snacks & Ready-to-Eat,VD MINAPA VADIYAM,14,65,65,0,1
12-04-2025,"Grains, Flours & Dals",Red Chana 500 GM,4,75,60,15,1
12-04-2025,Spices & Seasonings,DURGA SALT CRYSTAL 1KG,15,25,25,0,1
12-04-2025,"Dry Fruits, Nuts & Seeds",YELLOW KISHMISH 250GM,2,130,110,20,1
12-04-2025,Spices & Seasonings,DRY MANGO POWDER,15,45,45,0,1
12-04-2025,"Dry Fruits, Nuts & Seeds",D kimia,2,310,180,130,1
12-04-2025,Snacks & Ready-to-Eat,SD FINGER Millet with palm Jaggery 250gm,14,135,135,0,1
12-04-2025,General Household & Kitchenware,wipro 9w led bulb 1pic,3,240,240,0,1
12-04-2025,Household & Cleaning,VIM EXTRA 110GM,6,60,60,0,6
12-04-2025,Misc,VD0009,8,100,100,0,1
12-04-2025,Snacks & Ready-to-Eat,SD MASALA GAVVALU 200GM,14,95,95,0,1
12-04-2025,Snacks & Ready-to-Eat,BATANA NGT 70GMS,14,20,20,0,1
12-04-2025,"Grains, Flours & Dals",Wheat Rava S 1KG,4,65,55,10,1
12-04-2025,Snacks & Ready-to-Eat,NGT CHATPATTA CHANA 90GM,14,25,25,0,1
12-04-2025,"Grains, Flours & Dals",HS JOWAR IDLY RAWA,4,65,65,0,1
12-04-2025,Spices & Seasonings,DURGA SALT CRYSTAL 1KG,15,25,25,0,1
12-04-2025,"Dry Fruits, Nuts & Seeds",Groundnuts 500 gms,2,95,85,10,1
12-04-2025,"Grains, Flours & Dals",JOWAR UPMA RAVA,4,65,65,0,1
12-04-2025,"Dry Fruits, Nuts & Seeds",WATERMELON SEEDS 250GRM,2,320,280,40,1
12-04-2025,Snacks & Ready-to-Eat,BD RAGI NOODLES,14,75,75,0,1
12-04-2025,Snacks & Ready-to-Eat,SD FINGER Millet with palm Jaggery 250gm,14,135,135,0,1
12-04-2025,"Dry Fruits, Nuts & Seeds",cashew,2,340,310,30,1
12-04-2025,"Grains, Flours & Dals",CHANADALL 250 GMS,4,28,24,4,1
12-04-2025,"Grains, Flours & Dals",Urad dall 1 Kg,4,185,170,15,1
12-04-2025,"Grains, Flours & Dals",Red Bobarlu 500 gms,4,95,85,10,1
12-04-2025,"Grains, Flours & Dals",SRILATHA RICE RAVVA 500GM,4,35,35,0,1
12-04-2025,"Grains, Flours & Dals",idly rava 1kg,4,60,50,10,1
12-04-2025,"Grains, Flours & Dals",Wheat Flour 1 kg,4,70,60,10,1
12-04-2025,Spices & Seasonings,pickle chili powder,15,180,165,15,1
12-04-2025,"Dry Fruits, Nuts & Seeds",PUMPKIN SEEDS 250GM,2,200,160,40,1
12-04-2025,"Grains, Flours & Dals",RAGI FLOUR 1KG,4,80,70,10,1
12-04-2025,Spices & Seasonings,Turmeric powder 250 gms,15,100,75,25,1
12-04-2025,"Grains, Flours & Dals",THIN POHA 500GM,4,40,35,5,1
12-04-2025,"Grains, Flours & Dals",White jowar.F 1 kg,4,100,80,20,1
12-04-2025,"Grains, Flours & Dals",BASMATHI RICE 1KG,4,150,135,15,1
12-04-2025,"Grains, Flours & Dals",White jowar.F 500 Gms,4,50,40,10,1
12-04-2025,Snacks & Ready-to-Eat,Popcorn Seeds 250GM,14,45,40,5,1
12-04-2025,Spices & Seasonings,GS Pink Rock Salt 1KG,15,120,120,0,1
12-04-2025,Sweeteners,YB JAGGERY POWDER 500GMS,16,75,75,0,1
12-04-2025,"Grains, Flours & Dals",RAGI FLOUR 500GRMS,4,40,35,5,1
12-04-2025,Pooja & Spiritual Items,BALAJI BEL PHOOL STICKS 90GM,12,60,60,0,1
12-04-2025,"Grains, Flours & Dals",Arikadu ( kodo),4,140,130,10,1
12-04-2025,Milk & Dairy,SANGAM CURD 450GM,7,80,80,0,2
12-04-2025,Snacks & Ready-to-Eat,SF COOKIES CHOCO RAGI,14,99,99,0,1
12-04-2025,Personal Care & Cosmetics,Soapnut 250GM,10,60,45,15,1
12-04-2025,Snacks & Ready-to-Eat,SF MIGHTY PUFFS,14,25,25,0,1
12-04-2025,"Grains, Flours & Dals",ANDU KORRALU (Browntop.m) 1 kg,4,260,220,40,1
12-04-2025,Beverages,BISLERI 100ml,1,10,10,0,1
12-04-2025,"Grains, Flours & Dals",UDALU (Barnyard millet) 1 kg,4,140,115,25,1
12-04-2025,"Grains, Flours & Dals",SAMALU (Little millet) 1 kg,4,170,130,40,1
12-04-2025,Milk & Dairy,HERITAGE BUTTERMILK,7,10,10,0,1
12-04-2025,"Grains, Flours & Dals",KORRALU (FOXTAIL M) 1KG,4,150,110,40,1
12-04-2025,Snacks & Ready-to-Eat,BELLAM MINAPA SUNADULLU,14,180,180,0,1
12-04-2025,Snacks & Ready-to-Eat,SD FINGER Millet with palm Jaggery 250gm,14,135,135,0,1
12-04-2025,Spices & Seasonings,Chilli powder 500 gms,15,290,210,80,1
12-04-2025,Snacks & Ready-to-Eat,RAJGIRA PEANUT CHIKKI 450GM,14,125,125,0,1
12-04-2025,"Grains, Flours & Dals",White jowar.F 1 kg,4,500,400,100,5
12-04-2025,"Health, Wellness & Ayurvedic Products",MH Millets Malt 500GM,5,200,190,10,1
12-04-2025,Spices & Seasonings,Turmeric powder 250 gms,15,100,75,25,1
12-04-2025,"Grains, Flours & Dals",Arikalu (kodo),4,70,65,5,1
12-04-2025,"Dry Fruits, Nuts & Seeds",Groundnuts 1 kg,2,190,165,25,1
12-04-2025,"Grains, Flours & Dals",Urad dall 1 Kg,4,185,170,15,1
12-04-2025,Personal Care & Cosmetics,harbal shampoo,10,175,175,0,1
12-04-2025,Snacks & Ready-to-Eat,VD GUMMADI VADIYAM,14,150,150,0,2
12-04-2025,"Grains, Flours & Dals",Wheat Rava M 500GM,4,33,30,3,1
12-04-2025,"Grains, Flours & Dals",Quinova 1 kg,4,220,195,25,1
12-04-2025,"Grains, Flours & Dals",SAMALU (Little millet) 500 gms,4,85,65,20,1
12-04-2025,"Grains, Flours & Dals",turdal 1kg,4,220,170,50,1
12-04-2025,"Grains, Flours & Dals",THICK POHA 500GM,4,40,35,5,1
12-04-2025,"Grains, Flours & Dals",idly rava 1kg,4,60,50,10,1
12-04-2025,"Grains, Flours & Dals",Wheat Flour 1 kg,4,70,60,10,1
12-04-2025,"Grains, Flours & Dals",URAD DALL,4,95,85,10,1
12-04-2025,Snacks & Ready-to-Eat,SD Sesame laddu with dates250gm,14,135,135,0,1
12-04-2025,"Grains, Flours & Dals",BARLY POWDER,4,40,40,0,1
12-04-2025,"Grains, Flours & Dals",THIN POHA 500GM,4,40,35,5,1
12-04-2025,"Dry Fruits, Nuts & Seeds",Groundnuts 1 kg,2,190,165,25,1
12-04-2025,Spices & Seasonings,BIRYANI LEAF 10GM,15,30,20,10,1
12-04-2025,Snacks & Ready-to-Eat,SD Ginger Candy 100g,14,60,60,0,1
12-04-2025,Oils & Ghee,Groundnut oil 1 L,9,360,330,30,1
12-04-2025,Household & Cleaning,vim small,6,15,15,0,1
12-04-2025,Snacks & Ready-to-Eat,VD MULTI CHAKKA,14,220,220,0,2
12-04-2025,Snacks & Ready-to-Eat,BATANA NGT 70GMS,14,20,20,0,1
12-04-2025,Snacks & Ready-to-Eat,SATHVI REGIVADA 200GM,14,80,60,20,1
12-04-2025,"Grains, Flours & Dals",Green gram 500 gms,4,75,70,5,1
12-04-2025,Snacks & Ready-to-Eat,NGT CHATPATTA CHANA 90GM,14,75,75,0,3
12-04-2025,"Grains, Flours & Dals",THICK POHA 1KG,4,80,70,10,1
12-04-2025,"Grains, Flours & Dals",Red Chana 250GM,4,35,30,5,1
12-04-2025,"Grains, Flours & Dals",Kandulu 250GM,4,40,35,5,1
12-04-2025,Pooja & Spiritual Items,JAGI KAYA 25GM,12,80,60,20,1
12-04-2025,Snacks & Ready-to-Eat,VD BOONDI 175GM,14,60,60,0,1
12-04-2025,"Grains, Flours & Dals",YB CHITTIMUTYALU RICE 1KG,4,400,400,0,2
12-04-2025,Spices & Seasonings,KALONJI SEEDS,15,90,80,10,1
12-04-2025,Baking & Cooking Aids,GONDKATIRA Ag,0,170,150,20,2
12-04-2025,Snacks & Ready-to-Eat,sagopapad red chilli,14,55,55,0,1
12-04-2025,"Grains, Flours & Dals",idly rava 1kg,4,60,50,10,1
12-04-2025,Oils & Ghee,Safflower oil 1 L,9,440,400,40,1
12-04-2025,"Grains, Flours & Dals",Wheat Rava S 1KG,4,65,55,10,1
12-04-2025,"Grains, Flours & Dals",Wheat Flour 1 kg,4,70,60,10,1
12-04-2025,"Dry Fruits, Nuts & Seeds",Groundnuts 1 kg,2,190,165,25,1
12-04-2025,Spices & Seasonings,AVALU 100GM,15,25,20,5,1
12-04-2025,Spices & Seasonings,Turmeric powder 250 gms,15,100,75,25,1
12-04-2025,"Dry Fruits, Nuts & Seeds",PULMAKHANA 100 GM,2,180,170,10,1
12-04-2025,Snacks & Ready-to-Eat,MIGHTY PUFFS CHEDDAR CHEESE,14,50,50,0,2
12-04-2025,Spices & Seasonings,RED COPRA 250GMS,15,85,74,11,1
12-04-2025,"Dry Fruits, Nuts & Seeds",cashew,2,340,310,30,1
12-04-2025,"Dry Fruits, Nuts & Seeds",SATHVI CHIA SEEDS 100GM,2,200,160,40,2
12-04-2025,Spices & Seasonings,Elaichi 25GM,15,145,120,25,1
12-04-2025,"Grains, Flours & Dals",SAMALU (Little millet) 500 gms,4,85,65,20,1
12-04-2025,"Grains, Flours & Dals",UDALU (Barnyard millet) 500 gms,4,70,60,10,1
12-04-2025,"Grains, Flours & Dals",ANDU KORRALU (Brown top .mlt) 500,4,130,110,20,1
12-04-2025,Spices & Seasonings,Miriyalu 50GM,15,100,80,20,1
12-04-2025,"Grains, Flours & Dals",Arikalu (kodo),4,70,65,5,1
12-04-2025,"Grains, Flours & Dals",turdal 500 gms,4,110,85,25,1
12-04-2025,"Grains, Flours & Dals",KORRALU (FOXTAIL M) 500GM,4,65,55,10,1
12-04-2025,"Grains, Flours & Dals",CHANA DAL 500GM,4,56,48,8,1
12-04-2025,"Grains, Flours & Dals",BARLEY SEEDS 250GMS,4,40,35,5,1
12-04-2025,"Grains, Flours & Dals",RED TURDAL 500GM,4,75,70,5,1
12-04-2025,"Grains, Flours & Dals",Urad dall 1 Kg,4,185,170,15,1
12-04-2025,"Grains, Flours & Dals",MELMEKER 250GMS,4,60,45,15,1
12-04-2025,"Grains, Flours & Dals",SABDANA,4,40,35,5,1
12-04-2025,"Dry Fruits, Nuts & Seeds",PUTNALU 500GMS,2,90,76,14,1
12-04-2025,Spices & Seasonings,AVALU 100GM,15,25,20,5,1
12-04-2025,"Grains, Flours & Dals",WHITE BATANI,4,40,30,10,1
12-04-2025,"Dry Fruits, Nuts & Seeds",Groundnuts 500 gms,2,95,85,10,1
12-04-2025,"Health, Wellness & Ayurvedic Products",ZINDA TILISMATH 5ML,5,70,70,0,1
12-04-2025,"Grains, Flours & Dals",Green gram 1 kg,4,150,130,20,1
12-04-2025,Household & Cleaning,VIM SOAP,6,25,25,0,5
12-04-2025,"Grains, Flours & Dals",AISHWARYA SP 25KG,4,1999,"1,690.00",309,1
12-04-2025,Spices & Seasonings,ROYAL SAFFRON 400GRMS,15,130,130,0,2
12-04-2025,Spices & Seasonings,Jeera 100GM,15,100,90,10,2
12-04-2025,"Grains, Flours & Dals",SABDANA 500GM,4,90,70,20,1
12-04-2025,Baking & Cooking Aids,GONDKATIRA Ag,0,85,75,10,1
12-04-2025,"Dry Fruits, Nuts & Seeds",SATHVI CHIA SEEDS 100GM,2,100,80,20,1
12-04-2025,"Grains, Flours & Dals",Wheat Flour 1 kg,4,140,120,20,2
12-04-2025,Spices & Seasonings,GREEN SOUNF,15,60,40,20,1
12-04-2025,"Grains, Flours & Dals",THICK POHA 1KG,4,80,70,10,1
12-04-2025,"Grains, Flours & Dals",chana flour 500 gms,4,120,108,12,2
12-04-2025,"Grains, Flours & Dals",White Chana 250 GM,4,60,50,10,1
12-04-2025,Spices & Seasonings,KALONJI SEEDS,15,90,80,10,1
12-04-2025,Spices & Seasonings,NUVVULU 500GM,15,160,130,30,1
12-04-2025,"Grains, Flours & Dals",idly rava 1kg,4,120,100,20,2
12-04-2025,"Grains, Flours & Dals",Wheat Rava S 1KG,4,65,55,10,1
12-04-2025,Personal Care & Cosmetics,KAIPO SANDALWOOD SOAP 100GM,10,60,60,0,1
12-04-2025,"Grains, Flours & Dals",Bombay Rava 500GM,4,35,30,5,1
12-04-2025,"Dry Fruits, Nuts & Seeds",PUMPKIN SEEDS 250GM,2,200,160,40,1
12-04-2025,Snacks & Ready-to-Eat,MILK BREAD,14,30,30,0,1
12-04-2025,"Dry Fruits, Nuts & Seeds",WATERMELON SEEDS 250GRM,2,320,280,40,1
12-04-2025,"Grains, Flours & Dals",RAGI FLOUR 1KG,4,80,70,10,1
12-04-2025,Sweeteners,SUGAR 1KG,16,60,50,10,1
12-04-2025,Beverages,BRU GREEN LABEL 1.2G,1,20,20,0,10
12-04-2025,"Grains, Flours & Dals",BOMBAY RAVA,4,70,55,15,1
12-04-2025,"Grains, Flours & Dals",Wheat Flour 1 kg,4,70,60,10,1
12-04-2025,Spices & Seasonings,THREE MANGO RAI 200G,15,42,42,0,1
12-04-2025,Oils & Ghee,Sesame oil 500ml,9,295,280,15,1
12-04-2025,Snacks & Ready-to-Eat,SF COOKIES CHOCO RAGI,14,99,99,0,1
12-04-2025,Spices & Seasonings,DRY MIECHI 200GM,15,80,60,20,1
12-04-2025,Snacks & Ready-to-Eat,BD LITTLE MILLET NOODLES 200G,14,75,75,0,1
12-04-2025,Oils & Ghee,Sesame oil 500ml,9,295,280,15,1
12-04-2025,"Grains, Flours & Dals",EM Foxtail idli r 500 g,4,109,109,0,1
12-04-2025,Spices & Seasonings,AVALU 100GM,15,25,20,5,1
12-04-2025,"Health, Wellness & Ayurvedic Products",RB Max Protein Cheese&amp;,5,45,45,0,1
12-04-2025,"Grains, Flours & Dals",RAGI FLOUR 500GRMS,4,40,35,5,1
12-04-2025,"Grains, Flours & Dals",Wheat Flour 1 kg,4,70,60,10,1
12-04-2025,Oils & Ghee,Coconut oil 500 ml,9,220,200,20,1
12-04-2025,Spices & Seasonings,Jeera 100GM,15,50,45,5,1
12-04-2025,"Grains, Flours & Dals",Multigrain 1 kg,4,100,85,15,1
12-04-2025,Snacks & Ready-to-Eat,Corn Chips 250GM,14,40,35,5,1
12-04-2025,"Dry Fruits, Nuts & Seeds",SATHVI CHIA SEEDS 100GM,2,100,80,20,1
12-04-2025,Household & Cleaning,VIM EXTRA 110GM,6,20,20,0,2
12-04-2025,Beverages,3ROSES,1,90,90,0,1
12-04-2025,"Grains, Flours & Dals",Em Little idli R 500g,4,129,129,0,1
12-04-2025,Spices & Seasonings,AV Iodized Salt 1KG,15,28,25,3,1
12-04-2025,Snacks & Ready-to-Eat,FOXTAIL NOODLES,14,150,150,0,2
12-04-2025,Oils & Ghee,Groundnut oil 1 L,9,360,330,30,1
12-04-2025,Snacks & Ready-to-Eat,VD MULTI CHAKKA,14,220,220,0,2
12-04-2025,"Grains, Flours & Dals",Multigrain 1 kg,4,100,85,15,1
12-04-2025,Snacks & Ready-to-Eat,SATHVI REGIVADA 200GM,14,240,180,60,3
12-04-2025,"Grains, Flours & Dals",Wheat Flour 1 kg,4,210,180,30,3
12-04-2025,Oils & Ghee,Safflower oil 1 L,9,880,800,80,2
12-04-2025,Oils & Ghee,Sesame oil 1 L,9,1180,"1,120.00",60,2
12-04-2025,Oils & Ghee,Groundnut oil 1 L,9,360,330,30,1
12-04-2025,"Health, Wellness & Ayurvedic Products",RB Max Protein Salt & Caramel Bar 50g,5,75,75,0,1
12-04-2025,Oils & Ghee,Groundnut oil 1 L,9,360,330,30,1
12-04-2025,"Grains, Flours & Dals",SABDANA,4,40,35,5,1
12-04-2025,Beverages,BRU GREEN LABEL 1.2G,1,48,48,0,24
12-04-2025,Snacks & Ready-to-Eat,GB SALT COOKIES,14,60,55,5,1
12-04-2025,Snacks & Ready-to-Eat,SF COOKIES CHOCO RAGI,14,99,99,0,1
12-04-2025,"Dry Fruits, Nuts & Seeds",PULMAKHANA 100 GM,2,180,170,10,1
12-04-2025,Personal Care & Cosmetics,SVE MULTANI MITTI SOAP 100GM,10,180,180,0,2
12-04-2025,"Dry Fruits, Nuts & Seeds",SABJA SEEDS 100GM,2,80,70,10,1
12-04-2025,"Grains, Flours & Dals",RAGI FLOUR 500GRMS,4,40,35,5,1
12-04-2025,Personal Care & Cosmetics,DABUR ALMOND HAIR OIL 485ML,10,305,305,0,1
12-04-2025,Milk & Dairy,BROWN EGGS 1P,7,168,144,24,12
12-04-2025,Snacks & Ready-to-Eat,VD NUVULU CHEGODI 175GM,14,60,60,0,1
12-04-2025,Sweeteners,NATURAL HONEY 1KG,16,560,480,80,1
12-04-2025,"Grains, Flours & Dals",yellow jowar flour 1kg,4,100,92,8,1
12-04-2025,"Grains, Flours & Dals",Wheat Rava S 500GM,4,33,30,3,1
12-04-2025,"Dry Fruits, Nuts & Seeds",PULMAKHANA 100 GM,2,180,170,10,1
12-04-2025,"Grains, Flours & Dals",turdal 500 gms,4,110,85,25,1
12-04-2025,Personal Care & Cosmetics,UVIS BLACK HENNA 100GM,10,175,175,0,1
12-04-2025,"Grains, Flours & Dals",Sathya Javva Wheat Rava 500GM,4,90,90,0,1
12-04-2025,"Dry Fruits, Nuts & Seeds",Putnalu 250GM,2,45,38,7,1
12-04-2025,"Grains, Flours & Dals",Wheat Rava S 1KG,4,65,55,10,1
12-04-2025,"Grains, Flours & Dals",SL Idly Rava 1KG,4,65,55,10,1
12-04-2025,Snacks & Ready-to-Eat,GS Instant Brown Rice Dosa Mix 400 GM,14,120,120,0,1
12-04-2025,Snacks & Ready-to-Eat,urban murmura,14,60,55,5,1
12-04-2025,"Grains, Flours & Dals",KORRALU (FOXTAIL M) 500GM,4,65,55,10,1
12-04-2025,Milk & Dairy,SANGAM TONED MILK 500ML,7,30,30,0,1
12-04-2025,Snacks & Ready-to-Eat,PEANUT CHILLI,14,10,10,0,2
12-04-2025,Beverages,BRU GREEN LABEL 1.2G,1,8,8,0,4
12-04-2025,"Grains, Flours & Dals",CHANADALL 250 GMS,4,28,24,4,1
12-04-2025,"Grains, Flours & Dals",Em jowar idly R 500G,4,75,75,0,1
12-04-2025,Milk & Dairy,HERTG FULL CREAM M,7,41,41,0,1
12-04-2025,Snacks & Ready-to-Eat,NGT CHATPATTA CHANA 90GM,14,25,25,0,1
12-04-2025,Spices & Seasonings,pickle chili powder,15,180,165,15,1
12-04-2025,Snacks & Ready-to-Eat,MILK BREAD,14,30,30,0,1
12-04-2025,"Grains, Flours & Dals",RICE FLOUR 1KG,4,70,55,15,1
12-04-2025,Oils & Ghee,rice bran oil f,9,194,169,25,1
12-04-2025,"Health, Wellness & Ayurvedic Products",RB Max Protein PERI PERI 60gm,5,45,45,0,1
12-04-2025,Snacks & Ready-to-Eat,GB SALT COOKIES,14,60,55,5,1
12-04-2025,Milk & Dairy,HERITAGE TONED MILK 500ML,7,31,31,0,1
12-04-2025,Oils & Ghee,castor oil,9,95,95,0,1
12-04-2025,Pooja & Spiritual Items,PUDINA PUVVU,12,60,60,0,1
12-04-2025,Spices & Seasonings,vam ouvu,15,60,60,0,1
12-04-2025,Oils & Ghee,Groundnut oil 1 L,9,360,330,30,1
12-04-2025,Pooja & Spiritual Items,PACHA KARPURAM 10GM,12,60,60,0,1
12-04-2025,"Grains, Flours & Dals",CHANA DAL 500GM,4,56,48,8,1
12-04-2025,"Grains, Flours & Dals",MIXED FLOUR,4,160,148,12,1
12-04-2025,Snacks & Ready-to-Eat,JUNNU POWDER 100GM,14,420,420,0,6
12-04-2025,Oils & Ghee,BUFFALLO GHEE 500ML,9,410,370,40,1
12-04-2025,Sweeteners,SUGAR 1KG,16,60,50,10,1
12-04-2025,Spices & Seasonings,Turmeric powder 250 gms,15,100,75,25,1
12-04-2025,Oils & Ghee,Groundnut oil 1 L,9,720,660,60,2
12-04-2025,"Grains, Flours & Dals",chana flour 500 gms,4,60,54,6,1
12-04-2025,"Grains, Flours & Dals",turdal 1kg,4,220,170,50,1
12-04-2025,"Grains, Flours & Dals",AISHWARYA SP 25KG,4,1999,"1,690.00",309,1
12-04-2025,"Grains, Flours & Dals",turdal 1kg,4,220,170,50,1
12-04-2025,"Grains, Flours & Dals",DH URAD GOTA 1KG,4,215,190,25,1
12-04-2025,"Grains, Flours & Dals",Wheat Flour 1 kg,4,70,60,10,1
12-04-2025,Household & Cleaning,LIZOL FORAL CLEANER,6,116,116,0,1
12-04-2025,Household & Cleaning,VIM EXTRA 110GM,6,20,20,0,2
12-04-2025,Oils & Ghee,Groundnut oil 1 L,9,720,660,60,2
12-04-2025,Spices & Seasonings,Tamarind 500GM,15,160,130,30,1
12-04-2025,Oils & Ghee,Sesame oil 1 L,9,590,560,30,1
12-04-2025,Oils & Ghee,Groundnut oil 1 L,9,360,330,30,1
12-04-2025,Milk & Dairy,HERITAGE TOTAL CURD 500GM,7,100,100,0,2
12-04-2025,"Grains, Flours & Dals",BASMATHI RICE 1KG,4,300,270,30,2
12-04-2025,Spices & Seasonings,Gasagasalu 50GM,15,520,440,80,4
12-04-2025,Spices & Seasonings,Turmeric powder 250 gms,15,200,150,50,2
12-04-2025,Spices & Seasonings,JEERA 250 gms,15,125,105,20,1
12-04-2025,Spices & Seasonings,PN ORGANIC PINK SALT 1KG,15,124,124,0,1
12-04-2025,"Dry Fruits, Nuts & Seeds",Groundnuts 1 kg,2,190,165,25,1
12-04-2025,"Grains, Flours & Dals",White jowar.F 1 kg,4,100,80,20,1
12-04-2025,Spices & Seasonings,NUVVULU 250GM,15,80,65,15,1
12-04-2025,"Grains, Flours & Dals",Wheat Flour 1 kg,4,140,120,20,2
12-04-2025,"Grains, Flours & Dals",Multigrain 1 kg,4,200,170,30,2
12-04-2025,Oils & Ghee,Sesame oil 1 L,9,1180,"1,120.00",60,2
12-04-2025,"Grains, Flours & Dals",RAGI FLOUR 1KG,4,80,70,10,1
12-04-2025,Spices & Seasonings,AVALU 250grms,15,60,60,0,1
12-04-2025,Oils & Ghee,Groundnut oil 1 L,9,720,660,60,2
12-04-2025,Spices & Seasonings,MASALA KAR 500GMS,15,260,240,20,1
12-04-2025,Milk & Dairy,SANGAM TONED MILK 500ML,7,90,90,0,3
12-04-2025,"Grains, Flours & Dals",unpolished turdall500grms,4,120,110,10,1
12-04-2025,"Dry Fruits, Nuts & Seeds",Groundnuts 500 gms,2,95,85,10,1
12-04-2025,Personal Care & Cosmetics,MYSORE SANDAL SOAP 75G,10,42,42,0,1
12-04-2025,Milk & Dairy,HERITAGE TONED MILK 500ML,7,31,31,0,1
12-04-2025,"Dry Fruits, Nuts & Seeds",Groundnuts 1 kg,2,190,165,25,1
12-04-2025,"Grains, Flours & Dals",BOMBAY RAVA,4,70,55,15,1
12-04-2025,"Grains, Flours & Dals",VL Sabdana 500GM,4,77,77,0,1
12-04-2025,Oils & Ghee,Safflower oil 1 L,9,440,400,40,1
12-04-2025,Snacks & Ready-to-Eat,VD MURMURA LADDU,14,50,50,0,1
11-04-2025,"Dry Fruits, Nuts & Seeds",D kimia,2,310,180,130,1
11-04-2025,Spices & Seasonings,LG 50GM,15,92,92,0,1
11-04-2025,"Grains, Flours & Dals",Multigrain 1 kg,4,200,170,30,2
11-04-2025,Beverages,REFRESH SHARBATH SUGAR FREE,1,299,285,14,1
11-04-2025,Oils & Ghee,Sesame oil 1 L,9,590,560,30,1
11-04-2025,Pooja & Spiritual Items,BALAJI KASTURI DHOOP STICKS,12,140,140,0,2
11-04-2025,Pooja & Spiritual Items,BALAJI BEL PHOOL DHOOP STICKS 10STK,12,140,140,0,2
11-04-2025,Pooja & Spiritual Items,GD Aiswarya Deepam 700ML,12,195,195,0,1
11-04-2025,Snacks & Ready-to-Eat,SD barnyard Millet with palm jaggery,14,135,135,0,1
11-04-2025,Snacks & Ready-to-Eat,VD MULTI CHAKKA,14,110,110,0,1
11-04-2025,Misc,VD0009,8,100,100,0,1
11-04-2025,Snacks & Ready-to-Eat,sagopapad red chilli,14,55,55,0,1
11-04-2025,Snacks & Ready-to-Eat,VD GUMMADI VADIYAM,14,75,75,0,1
11-04-2025,Spices & Seasonings,Turmeric powder 250 gms,15,100,75,25,1
11-04-2025,"Grains, Flours & Dals",AISHWARYA SP 25KG,4,1999,"1,690.00",309,1
11-04-2025,"Health, Wellness & Ayurvedic Products",RB Max Protein PERI PERI 60gm,5,45,45,0,1
11-04-2025,Sweeteners,GS JAGGERY NUGGETS 500GM,16,120,120,0,1
11-04-2025,Oils & Ghee,Sesame oil 1 L,9,590,560,30,1
11-04-2025,"Grains, Flours & Dals",Wheat Flour 1 kg,4,70,60,10,1
11-04-2025,Household & Cleaning,herbal ant rep,6,240,240,0,1
11-04-2025,"Grains, Flours & Dals",UNPOLISHED TURDALL 1KG,4,240,210,30,1
11-04-2025,"Health, Wellness & Ayurvedic Products",MD Trikatu Choornam 30GM,5,150,150,0,1
11-04-2025,Snacks & Ready-to-Eat,VD PAPPU CHEGODI 200GM,14,60,60,0,1
11-04-2025,"Health, Wellness & Ayurvedic Products",AMLAKI CHOORNAM,5,100,100,0,1
11-04-2025,Personal Care & Cosmetics,MD Soapnut Choornam 100GM,10,80,80,0,1
11-04-2025,Oils & Ghee,Groundnut oil 1 L,9,720,660,60,2
11-04-2025,Snacks & Ready-to-Eat,BELLAM MINAPA SUNADULLU,14,540,540,0,3
11-04-2025,Snacks & Ready-to-Eat,VD MANGO JELLY 250GRMS,14,80,80,0,1
11-04-2025,Snacks & Ready-to-Eat,VD PALLI LADDU,14,80,80,0,1
11-04-2025,Snacks & Ready-to-Eat,VD PALLI CHIKKI,14,160,160,0,2
11-04-2025,"Dry Fruits, Nuts & Seeds",Groundnuts 1 kg,2,380,330,50,2
11-04-2025,Snacks & Ready-to-Eat,FOXTAIL BIS,14,135,135,0,1
11-04-2025,"Grains, Flours & Dals",White jowar.F 1 kg,4,200,160,40,2
11-04-2025,Snacks & Ready-to-Eat,SD barnyard Millet with palm jaggery,14,135,135,0,1
11-04-2025,Pooja & Spiritual Items,GD Bhagavatha Mallika 75GM,12,60,60,0,1
11-04-2025,"Grains, Flours & Dals",Wheat Rava S 1KG,4,65,55,10,1
11-04-2025,"Grains, Flours & Dals",Multigrain 1 kg,4,100,85,15,1
11-04-2025,Pooja & Spiritual Items,GD Dhoop Sticks 26GM,12,20,20,0,1
11-04-2025,Pooja & Spiritual Items,rudraksha malla,12,25,25,0,1
11-04-2025,Snacks & Ready-to-Eat,GB SALT COOKIES,14,60,55,5,1
11-04-2025,"Grains, Flours & Dals",RICE FLOUR 1KG,4,70,55,15,1
11-04-2025,"Grains, Flours & Dals",COW B rice 1 kg,4,216,207,9,3
11-04-2025,Milk & Dairy,BROWN EGGS TRAY 30P,7,360,330,30,1
11-04-2025,Oils & Ghee,Groundnut oil 1 L,9,720,660,60,2
11-04-2025,Oils & Ghee,Sesame oil 1 L,9,590,560,30,1
11-04-2025,"Grains, Flours & Dals",RAGI FLOUR 500GRMS,4,40,35,5,1
11-04-2025,Snacks & Ready-to-Eat,RAGI LADDU,14,120,120,0,1
11-04-2025,"Grains, Flours & Dals",White jowar.F 1 kg,4,200,160,40,2
11-04-2025,Snacks & Ready-to-Eat,SH PUFFED RICE 500GM,14,112,112,0,1
11-04-2025,"Grains, Flours & Dals",RAGI FLOUR 1KG,4,160,140,20,2
11-04-2025,Snacks & Ready-to-Eat,VD ATUKULU MIXTURE 175GM,14,60,60,0,1
11-04-2025,"Dry Fruits, Nuts & Seeds",Putnalu 250GM,2,45,38,7,1
11-04-2025,"Dry Fruits, Nuts & Seeds",Groundnuts 1 kg,2,190,165,25,1
11-04-2025,Spices & Seasonings,DRY MIECHI 200GM,15,80,60,20,1
11-04-2025,Oils & Ghee,Groundnut oil 1 L,9,360,330,30,1
11-04-2025,Oils & Ghee,Groundnut oil 1 L,9,360,330,30,1
11-04-2025,Sweeteners,YB JAGGERY POWDER 500GMS,16,75,75,0,1
11-04-2025,"Grains, Flours & Dals",White jowar.F 1 kg,4,100,80,20,1
11-04-2025,Snacks & Ready-to-Eat,VD PALLI CHIKKI,14,160,160,0,2
11-04-2025,Personal Care & Cosmetics,ORAL B KIDS,10,50,50,0,2
11-04-2025,Pooja & Spiritual Items,GD Aiswarya Deepam 700ML,12,390,390,0,2
11-04-2025,Oils & Ghee,Groundnut oil 1 L,9,360,330,30,1
11-04-2025,Snacks & Ready-to-Eat,VD MURMURA LADDU,14,50,50,0,1
11-04-2025,Baking & Cooking Aids,GONDKATIRA Ag,0,85,75,10,1
11-04-2025,Spices & Seasonings,LG 50GM,15,92,92,0,1
11-04-2025,Oils & Ghee,Coconut oil 500 ml,9,220,200,20,1
11-04-2025,"Grains, Flours & Dals",Wheat Flour 1 kg,4,210,180,30,3
11-04-2025,Oils & Ghee,Coconut oil 1 L,9,440,400,40,1
11-04-2025,"Grains, Flours & Dals",Urad dall 1 Kg,4,370,340,30,2
11-04-2025,Oils & Ghee,Groundnut oil 1 L,9,720,660,60,2
11-04-2025,"Grains, Flours & Dals",RICE FLOUR 500 GM,4,35,28,7,1
11-04-2025,"Grains, Flours & Dals",chana flour 500 gms,4,60,54,6,1
11-04-2025,"Grains, Flours & Dals",RAGI FLOUR 500GRMS,4,40,35,5,1
11-04-2025,"Grains, Flours & Dals",Wheat Flour 1 kg,4,70,60,10,1
11-04-2025,Beverages,BRU GREEN LABEL 1.2G,1,10,10,0,5
11-04-2025,Snacks & Ready-to-Eat,VD PALLI CHIKKI,14,160,160,0,2
11-04-2025,Oils & Ghee,Coconut oil 500 ml,9,220,200,20,1
11-04-2025,Snacks & Ready-to-Eat,NGT CHATPATTA CHANA 90GM,14,50,50,0,2
11-04-2025,Milk & Dairy,BROWN EGGS 1P,7,210,180,30,15
11-04-2025,"Grains, Flours & Dals",Multigrain 1 kg,4,100,85,15,1
11-04-2025,"Grains, Flours & Dals",RAGULU 1 KG,4,70,60,10,1
11-04-2025,Snacks & Ready-to-Eat,SD KODO MILLET WITH PALM JAGGERY,14,135,135,0,1
11-04-2025,Oils & Ghee,Groundnut oil 1 L,9,360,330,30,1
11-04-2025,"Grains, Flours & Dals",JOWAR YELLOW 1 K,4,100,90,10,1
11-04-2025,"Grains, Flours & Dals",BARLEY SEEDS 250GMS,4,40,35,5,1
11-04-2025,Spices & Seasonings,Turmeric powder 250 gms,15,100,75,25,1
11-04-2025,Snacks & Ready-to-Eat,VD GUMMADI VADIYAM,14,75,75,0,1
11-04-2025,"Grains, Flours & Dals",rice ravva sri,4,35,35,0,1
11-04-2025,Spices & Seasonings,NUVVULU 250GM,15,80,65,15,1
11-04-2025,"Grains, Flours & Dals",Multigrain 1 kg,4,200,170,30,2
11-04-2025,Pooja & Spiritual Items,SWAATHI GATTI DEEPAM VATTULU,12,120,120,0,4
11-04-2025,Snacks & Ready-to-Eat,VD PALLI LADDU,14,80,80,0,1
11-04-2025,Snacks & Ready-to-Eat,VD NUVVULU LADDU,14,80,80,0,1
11-04-2025,Snacks & Ready-to-Eat,VD NUVULU CHEGODI 175GM,14,60,60,0,1
11-04-2025,Snacks & Ready-to-Eat,MB FOXTAIL MILLET NOODLES 180GM,14,95,95,0,1
11-04-2025,Sweeteners,ACHU BELLAM 1KG,16,100,80,20,1
11-04-2025,Snacks & Ready-to-Eat,SESAME CHIKKI,14,120,100,20,1
11-04-2025,Snacks & Ready-to-Eat,VD MURMURA LADDU,14,50,50,0,1
11-04-2025,Oils & Ghee,Groundnut oil 5 L,9,1800,"1,600.00",200,1
11-04-2025,Misc,VD00014,8,100,90,10,1
11-04-2025,Snacks & Ready-to-Eat,VD DASA DINUSULU,14,398,398,0,2
11-04-2025,"Grains, Flours & Dals",chana flour 500 gms,4,120,108,12,2
11-04-2025,"Grains, Flours & Dals",RAGI FLOUR 500GRMS,4,40,35,5,1
11-04-2025,Snacks & Ready-to-Eat,VD MANGO JELLY 250GRMS,14,80,80,0,1
11-04-2025,"Grains, Flours & Dals",Wheat Flour 1 kg,4,70,60,10,1
11-04-2025,Snacks & Ready-to-Eat,SF NOODLES CLKASSIC MASALA,14,129,129,0,1
11-04-2025,"Health, Wellness & Ayurvedic Products",MH Baby Food 400GM,5,600,600,0,3
11-04-2025,Snacks & Ready-to-Eat,SATHVI REGIVADA 200GM,14,160,120,40,2
11-04-2025,"Grains, Flours & Dals",Wheat Flour 1 kg,4,280,240,40,4
11-04-2025,"Grains, Flours & Dals",VGR rice 1 kg,4,140,130,10,2
11-04-2025,Spices & Seasonings,SATHVI ANASAPUVUU 25GM,15,90,65,25,1
11-04-2025,"Dry Fruits, Nuts & Seeds",Groundnuts 500 gms,2,95,85,10,1
11-04-2025,Spices & Seasonings,Japatri 25GM,15,100,80,20,1
11-04-2025,Household & Cleaning,VIM SOAP,6,80,80,0,16
11-04-2025,Sweeteners,SUGAR 1KG,16,60,50,10,1
11-04-2025,"Grains, Flours & Dals",Em Multimillet idli r 500g,4,129,129,0,1
11-04-2025,Spices & Seasonings,Elaichi 25GM,15,145,120,25,1
11-04-2025,"Grains, Flours & Dals",EM Ragi idli R 500G,4,300,300,0,4
11-04-2025,"Grains, Flours & Dals",SRILATHA RICE RAVVA 500GM,4,140,140,0,4
11-04-2025,"Grains, Flours & Dals",Em jowar idly R 500G,4,300,300,0,4
11-04-2025,Spices & Seasonings,EVEREST PANI PURI MASALA 50GM,15,40,40,0,1
11-04-2025,Baking & Cooking Aids,GONDKATIRA Ag,0,85,75,10,1
11-04-2025,Pooja & Spiritual Items,s karpuram,12,180,180,0,1
11-04-2025,Household & Cleaning,vim dish liquid,6,55,55,0,1
11-04-2025,Oils & Ghee,Sesame oil 1 L,9,1180,"1,120.00",60,2
11-04-2025,Oils & Ghee,Groundnut oil 1 L,9,360,330,30,1
11-04-2025,Spices & Seasonings,MAMTA BLACK PEPPER POWDER,15,90,90,0,1
11-04-2025,"Grains, Flours & Dals",Em Little idli R 500g,4,129,129,0,1
11-04-2025,Spices & Seasonings,lavangam,15,50,50,0,1
11-04-2025,Spices & Seasonings,dalchin chekka,15,50,40,10,1
11-04-2025,Personal Care & Cosmetics,HERBAL BATH POWDER 200GM,10,160,160,0,2
11-04-2025,"Grains, Flours & Dals",yellow jowar flour 1kg,4,100,92,8,1
11-04-2025,"Grains, Flours & Dals",Em little upma R 500g,4,129,129,0,1
11-04-2025,Sweeteners,ACHU BELLAM 1KG,16,100,80,20,1
11-04-2025,"Grains, Flours & Dals",AISHWARYA SP 1KG,4,80,70,10,1
11-04-2025,"Grains, Flours & Dals",multi mllit umpa ravva,4,129,129,0,1
11-04-2025,Spices & Seasonings,NUVVULU 500GM,15,200,170,30,1
11-04-2025,Spices & Seasonings,NUVVULU 250GM,15,100,85,15,1
11-04-2025,Snacks & Ready-to-Eat,VD MURMURA LADDU,14,50,50,0,1
11-04-2025,Household & Cleaning,vim dish liquid,6,55,55,0,1
11-04-2025,Oils & Ghee,mustard oil,9,195,195,0,1
11-04-2025,"Grains, Flours & Dals",SABDANA,4,40,35,5,1
11-04-2025,Snacks & Ready-to-Eat,RINGS 200GM,14,30,30,0,1
11-04-2025,Sweeteners,YB Brown Sugar 500GM,16,75,75,0,1
11-04-2025,Sweeteners,SUGAR 1KG,16,60,50,10,1
11-04-2025,"Grains, Flours & Dals",WHITE BATANI,4,40,30,10,1
11-04-2025,Snacks & Ready-to-Eat,VD PALLI LADDU,14,80,80,0,1
11-04-2025,Spices & Seasonings,PN ORGANIC PINK SALT 1KG,15,124,124,0,1
11-04-2025,Misc,VD00014,8,100,90,10,1
11-04-2025,"Grains, Flours & Dals",idly rava 1kg,4,60,50,10,1
11-04-2025,"Grains, Flours & Dals",RAGI FLOUR 500GRMS,4,40,35,5,1
11-04-2025,"Grains, Flours & Dals",Wheat Flour 1 kg,4,210,180,30,3
11-04-2025,"Grains, Flours & Dals",Wheat Rava S 1KG,4,65,55,10,1
11-04-2025,Sweeteners,YB JAGGERY POWDER 500GMS,16,75,75,0,1
11-04-2025,Snacks & Ready-to-Eat,VD CORNFLAKES MIXTURE 175GM,14,120,120,0,2
11-04-2025,Household & Cleaning,vim dish liquid,6,55,55,0,1
11-04-2025,Snacks & Ready-to-Eat,VD RICE MURUKU 150GM,14,50,50,0,1
11-04-2025,Oils & Ghee,mustard oil,9,195,195,0,1
11-04-2025,Snacks & Ready-to-Eat,RINGS 200GM,14,30,30,0,1
11-04-2025,"Grains, Flours & Dals",SABDANA,4,40,35,5,1
11-04-2025,"Dry Fruits, Nuts & Seeds",BLACK KISMIS 250GM,2,175,140,35,1
11-04-2025,"Dry Fruits, Nuts & Seeds",WATERMELON SEEDS 250GRM,2,320,280,40,1
11-04-2025,"Dry Fruits, Nuts & Seeds",PUMPKIN SEEDS 250GM,2,200,160,40,1
11-04-2025,"Dry Fruits, Nuts & Seeds",SUNFLOWER SEEDS 250GRM,2,150,130,20,1
11-04-2025,"Grains, Flours & Dals",Wheat Flour 1 kg,4,140,120,20,2
11-04-2025,Beverages,BRU GREEN LABEL 1.2G,1,24,24,0,12
11-04-2025,Oils & Ghee,Groundnut oil 1 L,9,720,660,60,2
11-04-2025,Spices & Seasonings,pickle chili powder,15,180,165,15,1
11-04-2025,Household & Cleaning,VIM EXTRA 110GM,6,50,50,0,5
11-04-2025,"Grains, Flours & Dals",MAAGAANI LOW GI SP L 1KG,4,240,210,30,2
11-04-2025,Snacks & Ready-to-Eat,VD NUVULU CHEGODI 175GM,14,60,60,0,1
11-04-2025,Misc,VD0009,8,100,100,0,1
11-04-2025,Spices & Seasonings,pickle chili powder,15,180,165,15,1
11-04-2025,Snacks & Ready-to-Eat,VD MULTI CHAKKA,14,110,110,0,1
11-04-2025,"Grains, Flours & Dals",RAGI FLOUR 500GRMS,4,40,35,5,1
11-04-2025,"Grains, Flours & Dals",Wheat Flour 1 kg,4,140,120,20,2
11-04-2025,Snacks & Ready-to-Eat,VD CORNFLAKES MIXTURE 175GM,14,60,60,0,1
11-04-2025,Snacks & Ready-to-Eat,VD PALLI CHIKKI,14,80,80,0,1
11-04-2025,Snacks & Ready-to-Eat,VD BOONDI 175GM,14,60,60,0,1
11-04-2025,"Grains, Flours & Dals",Multigrain 1 kg,4,600,510,90,6
11-04-2025,Milk & Dairy,SANGAM CURD 450GM,7,40,40,0,1
11-04-2025,"Dry Fruits, Nuts & Seeds",D kimia,2,310,180,130,1
11-04-2025,Spices & Seasonings,NUVVULU 500GM,15,200,170,30,1
11-04-2025,"Health, Wellness & Ayurvedic Products",MD Bringaraj Choornam 100GM,5,80,80,0,1
11-04-2025,Oils & Ghee,Groundnut oil 1 L,9,360,330,30,1
11-04-2025,Oils & Ghee,Coconut oil 1 L,9,440,400,40,1
11-04-2025,Oils & Ghee,Sesame oil 1 L,9,590,560,30,1
11-04-2025,"Grains, Flours & Dals",SH JOWAR DALIYA,4,65,65,0,1
11-04-2025,"Grains, Flours & Dals",Wheat Rava S 1KG,4,65,55,10,1
11-04-2025,Oils & Ghee,Safflower oil 1 L,9,440,400,40,1
11-04-2025,"Grains, Flours & Dals",idly rava 1kg,4,60,50,10,1
11-04-2025,Spices & Seasonings,Black Till 250GM,15,90,75,15,1
11-04-2025,Personal Care & Cosmetics,MD Henna Choornam 100GM,10,80,80,0,1
11-04-2025,"Dry Fruits, Nuts & Seeds",Groundnuts 500 gms,2,95,85,10,1
11-04-2025,Snacks & Ready-to-Eat,VD PALLI LADDU,14,80,80,0,1
11-04-2025,Snacks & Ready-to-Eat,SD VAMU APPADALU 200GM,14,80,80,0,1
11-04-2025,"Dry Fruits, Nuts & Seeds",BLACK KISMIS 250GM,2,175,140,35,1
11-04-2025,Snacks & Ready-to-Eat,VD SAGOPAPAD 150GM,14,55,55,0,1
11-04-2025,Snacks & Ready-to-Eat,NGT CHATPATTA CHANA 90GM,14,25,25,0,1
11-04-2025,Spices & Seasonings,NUVVULU 250GM,15,80,65,15,1
11-04-2025,"Dry Fruits, Nuts & Seeds",PLAIN PISTA 250GM,2,660,550,110,1
11-04-2025,"Dry Fruits, Nuts & Seeds",cashew,2,680,620,60,2
11-04-2025,Sweeteners,Natural Honey 500 gms,16,280,240,40,1
11-04-2025,"Health, Wellness & Ayurvedic Products",MD Ashwagandha Choornam 100GM,5,170,170,0,1
11-04-2025,Personal Care & Cosmetics,Soapnut 500GM,10,120,90,30,1
11-04-2025,Oils & Ghee,Castor oil 200 ml,9,300,240,60,3
11-04-2025,"Dry Fruits, Nuts & Seeds",DRYDATES YELLOW 250GM,2,135,120,15,1
11-04-2025,Snacks & Ready-to-Eat,SD Ginger Candy 100g,14,60,60,0,1
11-04-2025,Pooja & Spiritual Items,BALAJI KASTURI DHOOP STICKS,12,70,70,0,1
11-04-2025,"Dry Fruits, Nuts & Seeds",PUMPKIN SEEDS 250GM,2,200,160,40,1
11-04-2025,Snacks & Ready-to-Eat,VD DAHI MIRCHI(SALTED) 100GM,14,45,45,0,1
11-04-2025,"Grains, Flours & Dals",CHANADALL 250 GMS,4,28,24,4,1
11-04-2025,Spices & Seasonings,JEERA 250 gms,15,125,105,20,1
11-04-2025,Snacks & Ready-to-Eat,VD NUVULLU CHIKKI,14,80,80,0,1
11-04-2025,Personal Care & Cosmetics,UVIS MULTANI MITTI 200GM,10,90,90,0,1
11-04-2025,Snacks & Ready-to-Eat,VD GUMMADI CHAKKA,14,130,130,0,1
11-04-2025,Snacks & Ready-to-Eat,VD ATUKULU MIXTURE 175GM,14,60,60,0,1
11-04-2025,Oils & Ghee,Coconut oil 1 L,9,880,800,80,2
11-04-2025,Spices & Seasonings,KALONJI SEEDS,15,90,80,10,1
11-04-2025,Spices & Seasonings,MIRYALU 50 GRMS,15,100,80,20,1
11-04-2025,Oils & Ghee,Safflower oil 1 L,9,440,400,40,1
11-04-2025,Oils & Ghee,Groundnut oil 1 L,9,360,330,30,1
11-04-2025,Milk & Dairy,BROWN EGGS TRAY 30P,7,360,330,30,1
11-04-2025,Sweeteners,ACHU BELLAM 1KG,16,100,80,20,1
11-04-2025,"Grains, Flours & Dals",idly rava 1kg,4,60,50,10,1
11-04-2025,"Dry Fruits, Nuts & Seeds",Groundnuts 500 gms,2,95,85,10,1
11-04-2025,"Grains, Flours & Dals",unpolished turdall500grms,4,120,110,10,1
11-04-2025,Snacks & Ready-to-Eat,VD MULTI CHAKKA,14,110,110,0,1
11-04-2025,Oils & Ghee,Groundnut oil 1 L,9,360,330,30,1
11-04-2025,Snacks & Ready-to-Eat,SATHVI REGIVADA 200GM,14,80,60,20,1
11-04-2025,Spices & Seasonings,Jeera 100GM,15,50,45,5,1
11-04-2025,"Grains, Flours & Dals",BOMBAY RAVA,4,70,55,15,1
11-04-2025,"Grains, Flours & Dals",DH URAD GOTA 1KG,4,215,190,25,1
11-04-2025,Spices & Seasonings,AVALU 100GM,15,25,20,5,1
11-04-2025,Snacks & Ready-to-Eat,BB VERMICELLI 1KG,14,95,90,5,1
11-04-2025,"Dry Fruits, Nuts & Seeds",Groundnuts 1 kg,2,190,165,25,1
11-04-2025,Beverages,REFRESH SHARBATH NORMAL,1,199,190,9,1
11-04-2025,Beverages,BISLERI SODA 750ML,1,40,40,0,2
11-04-2025,Oils & Ghee,Groundnut oil 1 L,9,360,330,30,1
11-04-2025,Sweeteners,YB FOREST H 250 GMS,16,180,180,0,1
11-04-2025,Spices & Seasonings,Chilli powder 500 gms,15,290,210,80,1
11-04-2025,"Grains, Flours & Dals",Wheat Flour 1 kg,4,70,60,10,1
11-04-2025,Spices & Seasonings,Turmeric powder 250 gms,15,200,150,50,2
11-04-2025,Spices & Seasonings,white pepper,15,115,115,0,1
11-04-2025,Snacks & Ready-to-Eat,VD PALLI CHIKKI,14,80,80,0,1
11-04-2025,Household & Cleaning,mostick,6,240,240,0,1
11-04-2025,"Health, Wellness & Ayurvedic Products",MD Kasturi Pasupu Choornam 50GM,5,80,80,0,1
11-04-2025,Oils & Ghee,Coconut oil 500 ml,9,220,200,20,1
11-04-2025,Snacks & Ready-to-Eat,VD CORNFLAKES MIXTURE 175GM,14,60,60,0,1
11-04-2025,"Grains, Flours & Dals",RAGULU 1 KG,4,90,90,0,1
11-04-2025,Sweeteners,brown sugar,16,78,78,0,1
11-04-2025,Snacks & Ready-to-Eat,TILLI CHIKKI,14,5,5,0,1
11-04-2025,Snacks & Ready-to-Eat,VD MURMURA LADDU,14,50,50,0,1
11-04-2025,Pooja & Spiritual Items,BALAJI KASTURI DHOOP STICKS,12,70,70,0,1
11-04-2025,Oils & Ghee,Groundnut oil 500ml,9,180,165,15,1
11-04-2025,Spices & Seasonings,Jeera 100GM,15,50,45,5,1
11-04-2025,"Grains, Flours & Dals",SRILALITHA MAIDA FLOUR 500G,4,32,32,0,1
11-04-2025,Spices & Seasonings,AVALU 100GM,15,25,20,5,1
11-04-2025,"Grains, Flours & Dals",Black gram 500 gms,4,75,70,5,1
11-04-2025,Milk & Dairy,HERITAGE TONED MILK 500ML,7,31,31,0,1
11-04-2025,"Grains, Flours & Dals",AISHWARYA SP 1KG,4,80,70,10,1
11-04-2025,Spices & Seasonings,dry miVD0019,15,45,45,0,1
11-04-2025,Oils & Ghee,Groundnut oil 500ml,9,180,165,15,1
11-04-2025,Personal Care & Cosmetics,UVIS ALOEVERA &amp;NEEM,10,175,175,0,1
11-04-2025,Oils & Ghee,Sesame oil 1 L,9,590,560,30,1
11-04-2025,"Grains, Flours & Dals",SRILATHA RICE RAVVA 500GM,4,70,70,0,2
11-04-2025,Snacks & Ready-to-Eat,JUNNU POWDER 100GM,14,70,70,0,1
11-04-2025,"Grains, Flours & Dals",DOCTOR RICE DIABETIC SFR 1KG,4,600,600,0,5
11-04-2025,"Grains, Flours & Dals",RAGI FLOUR 1KG,4,80,70,10,1
11-04-2025,Oils & Ghee,Groundnut oil 1 L,9,360,330,30,1
11-04-2025,"Grains, Flours & Dals",Wheat Rava S 1KG,4,130,110,20,2
11-04-2025,Spices & Seasonings,DRY MIECHI 200GM,15,160,120,40,2
11-04-2025,Spices & Seasonings,telaga pindi,15,70,70,0,1
11-04-2025,Spices & Seasonings,pickle chili powder,15,180,165,15,1
11-04-2025,Snacks & Ready-to-Eat,SD barnyard Millet with palm jaggery,14,270,270,0,2
11-04-2025,Snacks & Ready-to-Eat,SUNNUNDALU,14,240,240,0,2
11-04-2025,Snacks & Ready-to-Eat,VD PALLI CHIKKI,14,80,80,0,1
11-04-2025,Oils & Ghee,Coconut oil 1 L,9,440,400,40,1
11-04-2025,Spices & Seasonings,Chilli powder 500 gms,15,290,210,80,1
11-04-2025,Milk & Dairy,BROWN EGGS TRAY 30P,7,360,330,30,1
11-04-2025,"Grains, Flours & Dals",SL Idly Rava 1KG,4,65,55,10,1
11-04-2025,"Grains, Flours & Dals",Wheat Flour 3 kgs,4,210,180,30,1
11-04-2025,"Grains, Flours & Dals",SPLIT BLACK GRAM 500 GM,4,90,85,5,1
11-04-2025,Oils & Ghee,Coconut oil 500 ml,9,220,200,20,1
11-04-2025,Milk & Dairy,BROWN EGGS 1P,7,140,120,20,10
11-04-2025,Oils & Ghee,groundnet oil,9,1600,"1,600.00",0,1
11-04-2025,"Grains, Flours & Dals",Multigrain 1 kg,4,100,85,15,1
11-04-2025,Snacks & Ready-to-Eat,Corn Chips 250GM,14,40,35,5,1
11-04-2025,Snacks & Ready-to-Eat,MASALA PAPAD,14,80,80,0,1
11-04-2025,Oils & Ghee,Sesame oil 500ml,9,295,280,15,1
11-04-2025,"Grains, Flours & Dals",MELMEKER 250GMS,4,60,45,15,1
11-04-2025,"Grains, Flours & Dals",SPLIT BLACK GRAM 500 GM,4,90,85,5,1
11-04-2025,Sweeteners,NATURAL HONEY 1KG,16,560,480,80,1
11-04-2025,Milk & Dairy,BROWN EGGS TRAY 30P,7,360,330,30,1
11-04-2025,Oils & Ghee,Groundnut oil 1 L,9,360,330,30,1
11-04-2025,"Grains, Flours & Dals",Multigrain 1 kg,4,100,85,15,1
11-04-2025,"Dry Fruits, Nuts & Seeds",SATHVI CHIA SEEDS 100GM,2,100,80,20,1
11-04-2025,"Grains, Flours & Dals",Wheat Rava S 1KG,4,65,55,10,1
11-04-2025,"Grains, Flours & Dals",MELMEKER 250GMS,4,60,45,15,1
11-04-2025,"Grains, Flours & Dals",SINGLE POLISH 1KG,4,195,195,0,3
11-04-2025,Household & Cleaning,VIM EXTRA 110GM,6,10,10,0,1
11-04-2025,Snacks & Ready-to-Eat,PEANUT CHIKKI,14,22,22,0,1
11-04-2025,Snacks & Ready-to-Eat,VD NUVULLU CHIKKI,14,80,80,0,1
11-04-2025,"Health, Wellness & Ayurvedic Products",RB Max Protein Fruit &amp;Nut 50g,5,150,150,0,2
11-04-2025,Snacks & Ready-to-Eat,NGT CHATPATTA CHANA 90GM,14,20,20,0,1
11-04-2025,Snacks & Ready-to-Eat,VD Pappu Chekkalu 190gm,14,60,60,0,1
11-04-2025,"Grains, Flours & Dals",White jowar.F 1 kg,4,100,80,20,1
11-04-2025,Snacks & Ready-to-Eat,TILLI CHIKKI,14,5,5,0,1
11-04-2025,Personal Care & Cosmetics,MYSORE SANDAL SOAP 75G,10,42,42,0,1
11-04-2025,Pooja & Spiritual Items,999 SINGAPORE DHOOP POW 50GM,12,35,35,0,1
11-04-2025,Milk & Dairy,SANGAM TONED MILK 500ML,7,90,90,0,3
11-04-2025,"Grains, Flours & Dals",White jowar.F 500 Gms,4,50,40,10,1
11-04-2025,Milk & Dairy,HERITAGE BUTTERMILK,7,60,60,0,6
11-04-2025,"Grains, Flours & Dals",chana flour 500 gms,4,60,54,6,1
11-04-2025,Baking & Cooking Aids,GONDKATIRA Ag,0,85,75,10,1
11-04-2025,Snacks & Ready-to-Eat,PEANUT CHIKKI 450GM,14,125,125,0,1
11-04-2025,Milk & Dairy,SANGAM TONED MILK 500ML,7,30,30,0,1
11-04-2025,Beverages,BRU GREEN LABEL 1.2G,1,48,48,0,24
11-04-2025,Snacks & Ready-to-Eat,VD PALLI LADDU,14,80,80,0,1
11-04-2025,"Grains, Flours & Dals",chana flour 500 gms,4,60,54,6,1
11-04-2025,Milk & Dairy,SANGAM FULL CREAM MILK 500ML,7,38,38,0,1
11-04-2025,Milk & Dairy,BROWN EGGS 1P,7,70,60,10,5
11-04-2025,Milk & Dairy,HERITAGE TOTAL CURD 500GM,7,50,50,0,1
11-04-2025,Milk & Dairy,BROWN EGGS TRAY 30P,7,360,330,30,1
11-04-2025,Milk & Dairy,HERITAGE TOTAL CURD 500GM,7,50,50,0,1
11-04-2025,Snacks & Ready-to-Eat,VD PALLI CHIKKI,14,80,80,0,1
11-04-2025,"Grains, Flours & Dals",turdal 500 gms,4,110,85,25,1
11-04-2025,"Grains, Flours & Dals",Multigrain 1 kg,4,100,85,15,1
11-04-2025,Milk & Dairy,HERTG FULL CREAM M,7,82,82,0,2
11-04-2025,Oils & Ghee,Coconut oil 500 ml,9,220,200,20,1
11-04-2025,Oils & Ghee,groundnet oil,9,1600,"1,600.00",0,1
11-04-2025,Spices & Seasonings,pickle chili powder,15,180,165,15,1
11-04-2025,Milk & Dairy,HERITAGE TONED MILK 500ML,7,62,62,0,2
11-04-2025,"Grains, Flours & Dals",MAIDA 1KG,4,70,60,10,1
11-04-2025,Snacks & Ready-to-Eat,DOSA BATTER 1KG,14,60,60,0,1
11-04-2025,Spices & Seasonings,PRO HIMALAYAN PINK SALT 500GM,15,68,68,0,1
10-04-2025,"Dry Fruits, Nuts & Seeds",PULMAKHANA 100 GM,2,180,170,10,1
10-04-2025,"Grains, Flours & Dals",Red uluvalu 250 gms,4,90,80,10,2
10-04-2025,"Grains, Flours & Dals",HS JOWAR FLAKES 250GM 1+1,4,119,119,0,1
10-04-2025,Snacks & Ready-to-Eat,VD MURMURA LADDU,14,50,50,0,1
10-04-2025,Oils & Ghee,Groundnut oil 1 L,9,360,330,30,1
10-04-2025,Oils & Ghee,Groundnut oil 5 L,9,1800,"1,600.00",200,1
10-04-2025,Oils & Ghee,Black Sesame oil 500 ml,9,440,380,60,2
10-04-2025,Spices & Seasonings,Black Till 250GM,15,180,150,30,2
10-04-2025,Spices & Seasonings,JEERA 250 gms,15,125,105,20,1
10-04-2025,Spices & Seasonings,MIRYALU 50 GRMS,15,100,80,20,1
10-04-2025,Spices & Seasonings,NUVVULU 250GM,15,80,65,15,1
10-04-2025,"Grains, Flours & Dals",Arikadu ( kodo),4,140,130,10,1
10-04-2025,Personal Care & Cosmetics,SVE MULTANI MITTI SOAP 100GM,10,180,180,0,2
10-04-2025,Sweeteners,GS Palm Jaggery Powder 400GM,16,180,180,0,1
10-04-2025,"Grains, Flours & Dals",SH KABULI CHANA 1KG,4,356,356,0,1
10-04-2025,"Grains, Flours & Dals",Quinova 1 kg,4,440,390,50,2
10-04-2025,Snacks & Ready-to-Eat,MAAGAANI M JOWAR PASTA 200GM,14,199,199,0,1
10-04-2025,"Grains, Flours & Dals",KORRALU (FOXTAIL M) 1KG,4,150,110,40,1
10-04-2025,"Grains, Flours & Dals",SAMALU (Little millet) 1 kg,4,170,130,40,1
10-04-2025,Personal Care & Cosmetics,SVE SUNNI PINDI SCRUBSOAP 100GM,10,200,200,0,2
10-04-2025,Sweeteners,YB Brown Sugar 500GM,16,75,75,0,1
10-04-2025,"Grains, Flours & Dals",MULTIMILLET IDLY RAVVA,4,65,65,0,1
10-04-2025,Beverages,BRU GREEN LABEL 1.2G,1,8,8,0,4
10-04-2025,Snacks & Ready-to-Eat,VD MINAPA VADIYAM,14,65,65,0,1
10-04-2025,"Grains, Flours & Dals",RICE FLOUR 500 GM,4,35,28,7,1
10-04-2025,Personal Care & Cosmetics,DWI FOOT CARE 30G,10,90,90,0,1
10-04-2025,Oils & Ghee,Sesame oil 1 L,9,590,560,30,1
10-04-2025,"Grains, Flours & Dals",Multigrain 1 kg,4,300,255,45,3
10-04-2025,"Grains, Flours & Dals",Wheat Flour 1 kg,4,140,120,20,2
10-04-2025,"Grains, Flours & Dals",Quinova 1 kg,4,440,390,50,2
10-04-2025,"Grains, Flours & Dals",KORRALU (FOXTAIL M) 1KG,4,150,110,40,1
10-04-2025,"Grains, Flours & Dals",SRILALITHA MAIDA FLOUR 500G,4,32,32,0,1
10-04-2025,Snacks & Ready-to-Eat,VD Pappu Chekkalu 190gm,14,60,60,0,1
10-04-2025,"Grains, Flours & Dals",RAGI FLOUR 500GRMS,4,40,35,5,1
10-04-2025,"Grains, Flours & Dals",Wheat Flour 1 kg,4,140,120,20,2
10-04-2025,"Grains, Flours & Dals",Wheat Flour 1 kg,4,140,120,20,2
10-04-2025,Spices & Seasonings,Turmeric powder 250 gms,15,100,75,25,1
10-04-2025,Oils & Ghee,Groundnut oil 1 L,9,720,660,60,2
10-04-2025,Snacks & Ready-to-Eat,VD MURMURA LADDU,14,50,50,0,1
10-04-2025,"Grains, Flours & Dals",SL Idly Rava 1KG,4,65,55,10,1
10-04-2025,Household & Cleaning,MR WHITE 500GM,6,48,48,0,1
10-04-2025,"Grains, Flours & Dals",Sathya Javva Wheat Rava 500GM,4,90,90,0,1
10-04-2025,Beverages,BRU GREEN LABEL 1.2G,1,24,24,0,12
10-04-2025,Household & Cleaning,VIM SOAP,6,10,10,0,2
10-04-2025,Spices & Seasonings,Turmeric powder 250 gms,15,100,75,25,1
10-04-2025,Oils & Ghee,Groundnut oil 1 L,9,720,660,60,2
10-04-2025,"Grains, Flours & Dals",SL Idly Rava 1KG,4,65,55,10,1
10-04-2025,"Grains, Flours & Dals",Wheat Flour 1 kg,4,140,120,20,2
10-04-2025,"Health, Wellness & Ayurvedic Products",RB Max Protein Cheese&amp;,5,45,45,0,1
10-04-2025,"Grains, Flours & Dals",AISHWARYA SP 1KG,4,400,350,50,5
10-04-2025,Pooja & Spiritual Items,divya deeparadhana oil,12,190,190,0,1
10-04-2025,Snacks & Ready-to-Eat,VD SAGOPAPAD 150GM,14,55,55,0,1
10-04-2025,Snacks & Ready-to-Eat,VD RICE MURUKU 150GM,14,50,50,0,1
10-04-2025,Oils & Ghee,Groundnut oil 1 L,9,360,330,30,1
10-04-2025,"Grains, Flours & Dals",Wheat Flour 1 kg,4,70,60,10,1
10-04-2025,Oils & Ghee,Safflower oil 1 L,9,1320,"1,200.00",120,3
10-04-2025,Snacks & Ready-to-Eat,VD KOBARI LADDU,14,80,80,0,1
10-04-2025,"Grains, Flours & Dals",Sathya Javva Wheat Rava 500GM,4,90,90,0,1
10-04-2025,"Grains, Flours & Dals",MELMEKER 250GMS,4,60,45,15,1
10-04-2025,"Grains, Flours & Dals",yellow jowar .f 500g,4,50,50,0,1
10-04-2025,"Grains, Flours & Dals",navara rice,4,200,180,20,1
10-04-2025,"Grains, Flours & Dals",Em little upma R 500g,4,129,129,0,1
10-04-2025,"Grains, Flours & Dals",Bajra Flour 1 kg,4,70,60,10,1
10-04-2025,Oils & Ghee,Groundnut oil 1 L,9,360,330,30,1
10-04-2025,"Grains, Flours & Dals",RICE FLOUR 1KG,4,70,55,15,1
10-04-2025,"Grains, Flours & Dals",RAGI FLOUR 1KG,4,160,140,20,2
10-04-2025,Oils & Ghee,Safflower oil 1 L,9,440,400,40,1
10-04-2025,Sweeteners,YB JAGGERY POWDER 500GMS,16,150,150,0,2
10-04-2025,"Grains, Flours & Dals",Wheat Flour 1 kg,4,70,60,10,1
10-04-2025,"Grains, Flours & Dals",Wheat Flour 1 kg,4,70,60,10,1
10-04-2025,"Grains, Flours & Dals",RAGI FLOUR 500GRMS,4,40,35,5,1
10-04-2025,"Grains, Flours & Dals",Red Wheat Flour 1 kg,4,280,260,20,2
10-04-2025,Snacks & Ready-to-Eat,RINGS 200GM,14,30,30,0,1
10-04-2025,"Grains, Flours & Dals",RED TURDAL 500GM,4,75,70,5,1
10-04-2025,Snacks & Ready-to-Eat,SUNNUNDALU,14,240,240,0,2
10-04-2025,Spices & Seasonings,ROYAL SAFFRON 400GRMS,15,130,130,0,2
10-04-2025,"Grains, Flours & Dals",RICE FLOUR 1KG,4,70,55,15,1
10-04-2025,"Grains, Flours & Dals",RICE FLOUR 500 GM,4,70,56,14,2
10-04-2025,Snacks & Ready-to-Eat,SD Atreyapuram DRY Fruit ghee,14,150,150,0,1
10-04-2025,Snacks & Ready-to-Eat,VD MURMURA LADDU,14,50,50,0,1
10-04-2025,Snacks & Ready-to-Eat,VD PALLI CHIKKI,14,80,80,0,1
10-04-2025,Milk & Dairy,SANGAM TONED MILK 500ML,7,62,62,0,2
10-04-2025,"Grains, Flours & Dals",SL Idly Rava 1KG,4,65,55,10,1
10-04-2025,Spices & Seasonings,AV Iodized Salt 1KG,15,28,25,3,1
10-04-2025,Spices & Seasonings,Jeera 100GM,15,50,45,5,1
10-04-2025,"Dry Fruits, Nuts & Seeds",SATHVI CHIA SEEDS 100GM,2,200,160,40,2
10-04-2025,Household & Cleaning,VIM MAHA BAR,6,30,30,0,3
10-04-2025,"Dry Fruits, Nuts & Seeds",ALMONDS 250GM,2,280,260,20,1
10-04-2025,Snacks & Ready-to-Eat,VD NUVULU CHEGODI 175GM,14,60,60,0,1
10-04-2025,"Grains, Flours & Dals",yellow jowar flour 1kg,4,100,92,8,1
10-04-2025,Snacks & Ready-to-Eat,SD barnyard Millet with palm jaggery,14,135,135,0,1
10-04-2025,Snacks & Ready-to-Eat,DOSA BATTER 1KG,14,60,60,0,1
10-04-2025,Snacks & Ready-to-Eat,VD Pappu Chekkalu 190gm,14,60,60,0,1
10-04-2025,"Grains, Flours & Dals",Green Batani 500GM,4,110,90,20,1
10-04-2025,"Dry Fruits, Nuts & Seeds",PULMAKHANA 100 GM,2,180,170,10,1
10-04-2025,Snacks & Ready-to-Eat,VD GUMMADI VADIYAM,14,75,75,0,1
10-04-2025,Snacks & Ready-to-Eat,VD MURUKU 175GM,14,60,60,0,1
10-04-2025,"Grains, Flours & Dals",Wheat Flour 1 kg,4,70,60,10,1
10-04-2025,Snacks & Ready-to-Eat,VD CORNFLAKES MIXTURE 175GM,14,60,60,0,1
10-04-2025,"Grains, Flours & Dals",Multigrain 1 kg,4,100,85,15,1
10-04-2025,Personal Care & Cosmetics,MD Bath Powder 100GM,10,40,40,0,1
10-04-2025,Household & Cleaning,LIZOL FORAL CLEANER,6,116,116,0,1
10-04-2025,Snacks & Ready-to-Eat,VD MANGO JELLY 250GRMS,14,80,80,0,1
10-04-2025,Oils & Ghee,cow ghee 500 ml,9,430,390,40,1
10-04-2025,Oils & Ghee,Groundnut oil 1 L,9,360,330,30,1
10-04-2025,Snacks & Ready-to-Eat,HS Ragi biscuits,14,50,50,0,1
10-04-2025,Snacks & Ready-to-Eat,FOXTAIL BIS,14,135,135,0,1
10-04-2025,"Dry Fruits, Nuts & Seeds",ROASTED FLAXSEED,2,75,75,0,1
10-04-2025,"Dry Fruits, Nuts & Seeds",SD Mango cubes 100gm,2,45,45,0,1
10-04-2025,"Grains, Flours & Dals",WHEAT 1 KG,4,180,150,30,3
10-04-2025,Snacks & Ready-to-Eat,FOXTAIL NOODLES,14,75,75,0,1
10-04-2025,Snacks & Ready-to-Eat,PEANUT CHIKKI,14,22,22,0,1
10-04-2025,Snacks & Ready-to-Eat,TILLI CHIKKI,14,5,5,0,1
10-04-2025,Snacks & Ready-to-Eat,VD Pappu Chekkalu 190gm,14,60,60,0,1
10-04-2025,Snacks & Ready-to-Eat,VD PALLI CHIKKI,14,80,80,0,1
10-04-2025,"Grains, Flours & Dals",RAGI FLOUR 500GRMS,4,40,35,5,1
10-04-2025,"Grains, Flours & Dals",SAMALU (Little millet) 500 gms,4,85,65,20,1
10-04-2025,Snacks & Ready-to-Eat,VD KOBARI LADDU,14,80,80,0,1
10-04-2025,"Dry Fruits, Nuts & Seeds",SUNFLOWER SEEDS 250GRM,2,150,130,20,1
10-04-2025,"Dry Fruits, Nuts & Seeds",PUMPKIN SEEDS 250GM,2,200,160,40,1
10-04-2025,"Grains, Flours & Dals",yellow jowar flour 1kg,4,100,92,8,1
10-04-2025,Snacks & Ready-to-Eat,VD MURMURA LADDU,14,50,50,0,1
10-04-2025,Snacks & Ready-to-Eat,VD RED CHILLI RICEPAPAD 150GM,14,50,50,0,1
10-04-2025,Spices & Seasonings,LG 50GM,15,92,92,0,1
10-04-2025,Oils & Ghee,Safflower oil 1 L,9,440,400,40,1
10-04-2025,Sweeteners,GS Palm Jaggery Powder 400GM,16,540,540,0,3
10-04-2025,"Grains, Flours & Dals",chana flour 500 gms,4,60,54,6,1
10-04-2025,Pooja & Spiritual Items,SWAATHI GATTI DEEPAM VATTULU,12,60,60,0,2
10-04-2025,"Grains, Flours & Dals",HS JOWAR IDLY RAWA,4,130,130,0,2
10-04-2025,Sweeteners,YB JAGGERY POWDER 500GMS,16,225,225,0,3
10-04-2025,Pooja & Spiritual Items,GD JASMINE 75GM,12,60,60,0,1
10-04-2025,Personal Care & Cosmetics,swastik gulab,10,145,145,0,1
10-04-2025,Oils & Ghee,Sesame oil 500ml,9,295,280,15,1
10-04-2025,"Dry Fruits, Nuts & Seeds",FLAX SEEDS 250GM,2,60,50,10,1
10-04-2025,Personal Care & Cosmetics,GOW DURBAR 75G,10,60,60,0,1
10-04-2025,Oils & Ghee,Groundnut oil 1 L,9,720,660,60,2
10-04-2025,"Grains, Flours & Dals",RAGI FLOUR 500GRMS,4,80,70,10,2
10-04-2025,"Grains, Flours & Dals",HS JOWAR IDLY RAWA,4,195,195,0,3
10-04-2025,"Grains, Flours & Dals",UNPOLISHED TURDALL 1KG,4,240,210,30,1
10-04-2025,"Grains, Flours & Dals",Wheat Rava S 1KG,4,65,55,10,1
10-04-2025,Oils & Ghee,Sesame oil 1 L,9,1180,"1,120.00",60,2
10-04-2025,Oils & Ghee,Groundnut oil 1 L,9,360,330,30,1
10-04-2025,"Grains, Flours & Dals",Green gram 1 kg,4,150,130,20,1
10-04-2025,"Grains, Flours & Dals",BASMATHI RICE 1KG,4,150,135,15,1
10-04-2025,Snacks & Ready-to-Eat,MB PEARL MILLET NOODLES 180GM,14,95,95,0,1
10-04-2025,"Grains, Flours & Dals",white Bobarlu 500 gms,4,80,75,5,1
10-04-2025,Snacks & Ready-to-Eat,MB SORGHUM NOODLES 180GM,14,95,95,0,1
10-04-2025,"Grains, Flours & Dals",MELMEKER 250GMS,4,60,45,15,1
10-04-2025,Spices & Seasonings,Vamu 100GM,15,60,50,10,1
10-04-2025,"Dry Fruits, Nuts & Seeds",FLAX SEEDS 250GM,2,60,50,10,1
10-04-2025,Spices & Seasonings,THREE MANGO RAI 200G,15,42,42,0,1
10-04-2025,Spices & Seasonings,DURGA SALT CRYSTAL 1KG,15,25,25,0,1
10-04-2025,Oils & Ghee,Sesame oil 1 L,9,590,560,30,1
10-04-2025,"Grains, Flours & Dals",Wheat Flour 1 kg,4,70,60,10,1
10-04-2025,Snacks & Ready-to-Eat,Sprouted Ragi Biscuits 450GM,14,150,150,0,1
10-04-2025,Oils & Ghee,Groundnut oil 1 L,9,360,330,30,1
10-04-2025,Pooja & Spiritual Items,GD Aiswarya Deepam 700ML,12,195,195,0,1
10-04-2025,"Dry Fruits, Nuts & Seeds",Groundnuts 1 kg,2,190,165,25,1
10-04-2025,"Grains, Flours & Dals",Urad dall 1 Kg,4,185,170,15,1
10-04-2025,Personal Care & Cosmetics,UVIS LACTO TAN SOAP 100GM,10,99,99,0,1
10-04-2025,"Grains, Flours & Dals",Arikadu ( kodo),4,140,130,10,1
10-04-2025,"Grains, Flours & Dals",KORRALU (FOXTAIL M) 1KG,4,150,110,40,1
10-04-2025,"Grains, Flours & Dals",SAMALU (Little millet) 1 kg,4,170,130,40,1
10-04-2025,"Grains, Flours & Dals",UDALU (Barnyard millet) 1 kg,4,140,115,25,1
10-04-2025,"Grains, Flours & Dals",KORRALU (FOXTAIL M) 1KG,4,300,220,80,2
10-04-2025,"Grains, Flours & Dals",UDALU (Barnyard millet) 1 kg,4,280,230,50,2
10-04-2025,"Grains, Flours & Dals",SAMALU (Little millet) 1 kg,4,340,260,80,2
10-04-2025,"Grains, Flours & Dals",Arikadu ( kodo),4,280,260,20,2
10-04-2025,"Dry Fruits, Nuts & Seeds",SATHVI CHIA SEEDS 100GM,2,100,80,20,1
10-04-2025,Oils & Ghee,Safflower oil 1 L,9,880,800,80,2
10-04-2025,"Dry Fruits, Nuts & Seeds",DRYDATES 250GM,2,150,120,30,1
10-04-2025,Oils & Ghee,Groundnut oil 1 L,9,360,330,30,1
10-04-2025,Beverages,REFRESH SHARBATH NORMAL,1,199,190,9,1
10-04-2025,"Grains, Flours & Dals",unpolished turdall500grms,4,120,110,10,1
10-04-2025,Beverages,BRU GREEN LABEL 1.2G,1,20,20,0,10
10-04-2025,Oils & Ghee,Coconut oil 1 L,9,440,400,40,1
10-04-2025,Pooja & Spiritual Items,BALAJI BEL PHOOL STICKS 90GM,12,60,60,0,1
10-04-2025,"Grains, Flours & Dals",Wheat Flour 1 kg,4,140,120,20,2
10-04-2025,"Grains, Flours & Dals",CHANA DAL 1KG,4,112,96,16,1
10-04-2025,Oils & Ghee,Groundnut oil 1 L,9,360,330,30,1
10-04-2025,Spices & Seasonings,JEERA 250 gms,15,125,105,20,1
10-04-2025,"Dry Fruits, Nuts & Seeds",Groundnuts 1 kg,2,190,165,25,1
10-04-2025,"Grains, Flours & Dals",Chana Flour 500 gms,4,120,108,12,1
10-04-2025,Pooja & Spiritual Items,divya deeparadhana oil,12,190,190,0,1
10-04-2025,Snacks & Ready-to-Eat,BD KODO MILLET NOODLES 200GM,14,75,75,0,1
10-04-2025,Spices & Seasonings,DRY MIECHI 200GM,15,80,60,20,1
10-04-2025,"Dry Fruits, Nuts & Seeds",Groundnuts 1 kg,2,190,165,25,1
10-04-2025,"Grains, Flours & Dals",PESARA PAPPU 1 KG,4,170,145,25,1
10-04-2025,"Dry Fruits, Nuts & Seeds",Putnalu 250GM,2,45,38,7,1
10-04-2025,Spices & Seasonings,LG 50GM,15,92,92,0,1
10-04-2025,Milk & Dairy,HERITAGE TOTAL CURD 500GM,7,50,50,0,1
10-04-2025,Household & Cleaning,ROOPERI PITAMBARI SILVER 50ML,6,110,110,0,1
10-04-2025,"Grains, Flours & Dals",SL Idly Rava 1KG,4,65,55,10,1
10-04-2025,"Grains, Flours & Dals",SF BESAN 500GM,4,100,100,0,1
10-04-2025,Sweeteners,Natural Honey 500 gms,16,280,240,40,1
10-04-2025,Personal Care & Cosmetics,DWI NEEM TULSI SOAP 100GM,10,75,75,0,1
10-04-2025,Snacks & Ready-to-Eat,VD NUVULU CHEGODI 175GM,14,60,60,0,1
10-04-2025,Snacks & Ready-to-Eat,VD MULTI CHAKKA,14,110,110,0,1
10-04-2025,Oils & Ghee,Groundnut oil 1 L,9,360,330,30,1
10-04-2025,Spices & Seasonings,sf jeera,15,120,120,0,1
10-04-2025,"Dry Fruits, Nuts & Seeds",cashew,2,340,310,30,1
10-04-2025,"Grains, Flours & Dals",Urad dall 1 Kg,4,185,170,15,1
10-04-2025,"Grains, Flours & Dals",CHANA DAL 500GM,4,56,48,8,1
10-04-2025,Spices & Seasonings,Tamarind 500GM,15,160,130,30,1
10-04-2025,"Grains, Flours & Dals",SRILALITHA MAIDA FLOUR 500G,4,32,32,0,1
10-04-2025,"Grains, Flours & Dals",IG PURE BASMATHI RICE,4,252,227,25,1
10-04-2025,Sweeteners,SUGAR 1KG,16,120,100,20,2
10-04-2025,"Health, Wellness & Ayurvedic Products",gyan thyapobhumi,5,60,60,0,1
10-04-2025,Snacks & Ready-to-Eat,DOSA BATTER 1KG,14,60,60,0,1
10-04-2025,Spices & Seasonings,BLACK JEERA 50 GM,15,45,30,15,1
10-04-2025,"Grains, Flours & Dals",KORRALU (FOXTAIL M) 500GM,4,65,55,10,1
10-04-2025,Snacks & Ready-to-Eat,VD PALLI CHIKKI,14,80,80,0,1
10-04-2025,"Grains, Flours & Dals",Green gram 1 kg,4,150,130,20,1
10-04-2025,Snacks & Ready-to-Eat,VD Minapa papad 200gm,14,60,60,0,1
10-04-2025,Pooja & Spiritual Items,bilwa patra,12,60,60,0,1
10-04-2025,Spices & Seasonings,Menthulu 250 gms,15,50,45,5,1
10-04-2025,Snacks & Ready-to-Eat,JUNNU POWDER 100GM,14,70,70,0,1
10-04-2025,Beverages,REFRESH SHARBATH SUGAR FREE,1,299,285,14,1
10-04-2025,"Grains, Flours & Dals",PESARA PAPPU 500GMS,4,85,75,10,1
10-04-2025,"Grains, Flours & Dals",idly rava 1kg,4,60,50,10,1
10-04-2025,Snacks & Ready-to-Eat,MASALA PAPAD,14,80,80,0,1
10-04-2025,Personal Care & Cosmetics,GAYATHRI KUMKUDUKAYA,10,150,150,0,1
10-04-2025,"Grains, Flours & Dals",BOMBAY RAVA,4,70,55,15,1
10-04-2025,Spices & Seasonings,LG 50GM,15,92,92,0,1
10-04-2025,"Grains, Flours & Dals",turdal 1kg,4,220,170,50,1
10-04-2025,"Grains, Flours & Dals",SRILATHA RICE RAVVA 500GM,4,35,35,0,1
10-04-2025,Snacks & Ready-to-Eat,VD DASA DINUSULU,14,199,199,0,1
10-04-2025,Snacks & Ready-to-Eat,VD MANGO JELLY 250GRMS,14,80,80,0,1
10-04-2025,Spices & Seasonings,Vamu 100GM,15,60,50,10,1
10-04-2025,"Grains, Flours & Dals",THICK POHA 500GM,4,40,35,5,1
10-04-2025,Spices & Seasonings,Jeera 100GM,15,50,45,5,1
10-04-2025,"Grains, Flours & Dals",SAMALU (Little millet) 500 gms,4,85,65,20,1
10-04-2025,"Grains, Flours & Dals",idly rava 1kg,4,60,50,10,1
10-04-2025,Snacks & Ready-to-Eat,Corn Chips 250GM,14,40,35,5,1
10-04-2025,Snacks & Ready-to-Eat,VD ATUKULU MIXTURE 175GM,14,60,60,0,1
10-04-2025,"Grains, Flours & Dals",Multigrain 1 kg,4,100,85,15,1
10-04-2025,"Grains, Flours & Dals",BOMBAY RAVA,4,70,55,15,1
10-04-2025,"Grains, Flours & Dals",yellow jowar flour 1kg,4,100,92,8,1
10-04-2025,Oils & Ghee,Groundnut oil 1 L,9,360,330,30,1
10-04-2025,"Grains, Flours & Dals",RICE FLOUR 1KG,4,140,110,30,2
10-04-2025,Pooja & Spiritual Items,GD Camphor 50GM,12,115,115,0,1
10-04-2025,"Grains, Flours & Dals",IG B B RICE,4,187,168,19,1
10-04-2025,"Dry Fruits, Nuts & Seeds",PULMAKHANA 100 GM,2,180,170,10,1
10-04-2025,"Grains, Flours & Dals",CHANADALL 250 GMS,4,28,24,4,1
10-04-2025,"Dry Fruits, Nuts & Seeds",Groundnuts 1 kg,2,190,165,25,1
10-04-2025,"Grains, Flours & Dals",Red Chana 250GM,4,35,30,5,1
10-04-2025,"Grains, Flours & Dals",Red Wheat Flour 1 kg,4,280,260,20,2
10-04-2025,"Grains, Flours & Dals",unpolished turdall500grms,4,120,110,10,1
10-04-2025,"Grains, Flours & Dals",MELMEKER 250GMS,4,60,45,15,1
10-04-2025,Snacks & Ready-to-Eat,BD PEARL MILLET NOODLES 200G,14,70,70,0,1
10-04-2025,"Grains, Flours & Dals",THIN POHA 500GM,4,40,35,5,1
10-04-2025,"Grains, Flours & Dals",SA YELLOW JOWAR RAVA 500GM,4,95,95,0,1
10-04-2025,"Grains, Flours & Dals",split green gram 500 gms,4,75,70,5,1
10-04-2025,"Dry Fruits, Nuts & Seeds",Groundnuts 1 kg,2,190,165,25,1
10-04-2025,"Grains, Flours & Dals",CHANA DAL 500GM,4,56,48,8,1
10-04-2025,"Grains, Flours & Dals",SRILALITHA MAIDA FLOUR 500G,4,32,32,0,1
10-04-2025,"Grains, Flours & Dals",Wheat Flour 1 kg,4,70,60,10,1
10-04-2025,"Grains, Flours & Dals",Wheat Flour 1 kg,4,140,120,20,2
10-04-2025,Oils & Ghee,Sesame oil 1 L,9,590,560,30,1
10-04-2025,Pooja & Spiritual Items,divya deeparadhana oil,12,190,190,0,1
10-04-2025,"Dry Fruits, Nuts & Seeds",Groundnuts 1 kg,2,190,165,25,1
10-04-2025,"Dry Fruits, Nuts & Seeds",ALMONDS 250GM,2,280,260,20,1
10-04-2025,"Grains, Flours & Dals",AISHWARYA SP 25KG,4,1999,"1,690.00",309,1
10-04-2025,"Dry Fruits, Nuts & Seeds",PULMAKHANA 100 GM,2,180,170,10,1
10-04-2025,Snacks & Ready-to-Eat,VD MANGO JELLY 250GRMS,14,80,80,0,1
10-04-2025,Spices & Seasonings,NUVVULU 500GM,15,160,130,30,1
10-04-2025,"Grains, Flours & Dals",SRILATHA RICE RAVVA 500GM,4,35,35,0,1
10-04-2025,"Grains, Flours & Dals",Arikalu (kodo),4,70,65,5,1
10-04-2025,"Dry Fruits, Nuts & Seeds",ANJEER 250GM,2,400,360,40,1
10-04-2025,"Dry Fruits, Nuts & Seeds",wallnuts,2,380,320,60,1
10-04-2025,Spices & Seasonings,AV Iodized Salt 1KG,15,28,25,3,1
10-04-2025,Household & Cleaning,VIM COOLING FRESHNESS MINT,6,20,20,0,1
10-04-2025,"Dry Fruits, Nuts & Seeds",Groundnuts 500 gms,2,95,85,10,1
10-04-2025,"Grains, Flours & Dals",unpolished turdall500grms,4,120,110,10,1
10-04-2025,Sweeteners,SUGAR 500 GM,16,30,25,5,1
10-04-2025,"Grains, Flours & Dals",SH WHITE POHA 500GM,4,75,75,0,1
10-04-2025,"Grains, Flours & Dals",Urad dall 1 Kg,4,185,170,15,1
10-04-2025,Oils & Ghee,Sesame oil 1 L,9,590,560,30,1
10-04-2025,Oils & Ghee,Safflower oil 1 L,9,440,400,40,1
10-04-2025,"Grains, Flours & Dals",Sathya Javva Wheat Rava 500GM,4,95,95,0,1
10-04-2025,"Grains, Flours & Dals",Wheat Flour 1 kg,4,140,120,20,2
10-04-2025,Spices & Seasonings,PRO ORG CUMIN 100G,15,176,176,0,1
10-04-2025,Household & Cleaning,LIZOL JAQSMINE 500ML,6,116,116,0,1
10-04-2025,"Grains, Flours & Dals",BOMBAY RAVA,4,70,55,15,1
10-04-2025,Spices & Seasonings,PRO ORG MUSTARD SMALL -RAI 200G,15,84,84,0,1
10-04-2025,"Grains, Flours & Dals",SABDANA 500GM,4,90,70,20,1
10-04-2025,Oils & Ghee,Safflower oil 1 L,9,440,400,40,1
10-04-2025,Oils & Ghee,Sesame oil 1 L,9,1180,"1,120.00",60,2
10-04-2025,Oils & Ghee,Groundnut oil 1 L,9,360,330,30,1
10-04-2025,"Grains, Flours & Dals",Bombay Rava 500GM,4,35,30,5,1
10-04-2025,Spices & Seasonings,ROYAL SAFFRON,15,125,125,0,1
10-04-2025,"Dry Fruits, Nuts & Seeds",wallnuts,2,380,320,60,1
10-04-2025,"Grains, Flours & Dals",RAJMA 250GM,4,55,45,10,1
10-04-2025,"Dry Fruits, Nuts & Seeds",DRYDATES 250GM,2,150,120,30,1
10-04-2025,Milk & Dairy,BROWN EGGS 1P,7,168,144,24,12
10-04-2025,"Dry Fruits, Nuts & Seeds",ANJEER 250GM,2,400,360,40,1
10-04-2025,Milk & Dairy,HERTG FULL CREAM M,7,82,82,0,2
10-04-2025,"Grains, Flours & Dals",BARLEY SEEDS 250GMS,4,40,35,5,1
10-04-2025,"Grains, Flours & Dals",KORRALU (FOXTAIL M) 500GM,4,65,55,10,1
10-04-2025,"Grains, Flours & Dals",Red Chana 500 GM,4,75,60,15,1
10-04-2025,"Dry Fruits, Nuts & Seeds",FLAX SEEDS 250GM,2,60,50,10,1
10-04-2025,Spices & Seasonings,KALONJI SEEDS,15,90,80,10,1
10-04-2025,"Grains, Flours & Dals",Wheat Flour 1 kg,4,210,180,30,3
10-04-2025,Spices & Seasonings,NUVVULU 500GM,15,160,130,30,1
10-04-2025,Snacks & Ready-to-Eat,VD SAGOPAPAD 150GM,14,55,55,0,1
10-04-2025,Household & Cleaning,vim 500ml,6,250,250,0,2
10-04-2025,"Dry Fruits, Nuts & Seeds",Groundnuts 1 kg,2,190,165,25,1
10-04-2025,Oils & Ghee,Groundnut oil 1 L,9,720,660,60,2
10-04-2025,Snacks & Ready-to-Eat,jeera papad,14,80,80,0,1
10-04-2025,Baking & Cooking Aids,GONDKATIRA Ag,0,170,150,20,2
10-04-2025,"Grains, Flours & Dals",PESARA PAPPU 500GMS,4,85,75,10,1
10-04-2025,Oils & Ghee,Sesame oil 1 L,9,590,560,30,1
10-04-2025,"Grains, Flours & Dals",SINGLE POLISH 1KG,4,195,195,0,3
10-04-2025,Snacks & Ready-to-Eat,TILLI CHIKKI,14,5,5,0,1
10-04-2025,"Grains, Flours & Dals",MULTIMILLET IDLY RAVVA,4,65,65,0,1
10-04-2025,"Grains, Flours & Dals",Urad dall 1 Kg,4,185,170,15,1
10-04-2025,"Dry Fruits, Nuts & Seeds",Groundnuts 1 kg,2,190,165,25,1
10-04-2025,"Grains, Flours & Dals",JOWAR YELLOW 1 K,4,100,90,10,1
10-04-2025,"Grains, Flours & Dals",RAGULU 1 KG,4,70,60,10,1
10-04-2025,"Grains, Flours & Dals",UDALU (Barnyard millet) 500 gms,4,70,60,10,1
10-04-2025,"Health, Wellness & Ayurvedic Products",MAX PROTEIN,5,50,50,0,1
10-04-2025,"Grains, Flours & Dals",SINGLE POLISH 1KG,4,130,130,0,2
10-04-2025,Oils & Ghee,Safflower oil 1 L,9,440,400,40,1
10-04-2025,"Grains, Flours & Dals",RAGI FLOUR 1KG,4,80,70,10,1
10-04-2025,"Grains, Flours & Dals",Bajra Flour 1 kg,4,140,120,20,2
10-04-2025,Spices & Seasonings,Coriander seeds 200 gms,15,96,80,16,2
10-04-2025,"Grains, Flours & Dals",White jowar.F 1 kg,4,300,240,60,3
10-04-2025,"Grains, Flours & Dals",chana flour 500 gms,4,60,54,6,1
10-04-2025,"Grains, Flours & Dals",Wheat Flour 1 kg,4,70,60,10,1
10-04-2025,"Dry Fruits, Nuts & Seeds",Putnalu 250GM,2,45,38,7,1
10-04-2025,General Household & Kitchenware,RED LINE 20GM,3,75,75,0,1
10-04-2025,"Dry Fruits, Nuts & Seeds",Groundnuts 1 kg,2,190,165,25,1
10-04-2025,"Grains, Flours & Dals",Bajra Flour 1 kg,4,70,60,10,1
10-04-2025,"Grains, Flours & Dals",yellow jowar flour 1kg,4,200,184,16,2
10-04-2025,Milk & Dairy,BROWN EGGS 1P,7,84,72,12,6
10-04-2025,"Grains, Flours & Dals",RAGI FLOUR 500GRMS,4,40,35,5,1
10-04-2025,"Grains, Flours & Dals",KORRALU (FOXTAIL M) 500GM,4,65,55,10,1
10-04-2025,Snacks & Ready-to-Eat,VD MINAPA VADIYAM,14,65,65,0,1
10-04-2025,"Grains, Flours & Dals",Multigrain 1 kg,4,100,85,15,1
10-04-2025,Snacks & Ready-to-Eat,VD MURUKU 175GM,14,60,60,0,1
10-04-2025,Oils & Ghee,Sesame oil 1 L,9,590,560,30,1
10-04-2025,Milk & Dairy,HERTG FULL CREAM M,7,41,41,0,1
10-04-2025,Milk & Dairy,HERITAGE TONED MILK 500ML,7,31,31,0,1
10-04-2025,Oils & Ghee,Sesame oil 500ml,9,295,280,15,1
10-04-2025,"Grains, Flours & Dals",RAGI FLOUR 1KG,4,80,70,10,1
10-04-2025,"Grains, Flours & Dals",Wheat Flour 1 kg,4,70,60,10,1
10-04-2025,Milk & Dairy,SANGAM FULL CREAM MILK 500ML,7,38,38,0,1
09-04-2025,"Grains, Flours & Dals",Bajra Flour 500 gms,4,35,30,5,1
09-04-2025,"Dry Fruits, Nuts & Seeds",SUNFLOWER SEEDS 250GRM,2,150,130,20,1
09-04-2025,"Grains, Flours & Dals",chana flour 500 gms,4,60,54,6,1
09-04-2025,"Grains, Flours & Dals",RAGI FLOUR 500GRMS,4,80,70,10,2
09-04-2025,"Dry Fruits, Nuts & Seeds",SABJA SEEDS 100GM,2,80,70,10,1
09-04-2025,"Dry Fruits, Nuts & Seeds",PULMAKHANA 100 GM,2,180,170,10,1
09-04-2025,"Grains, Flours & Dals",White jowar.F 1 kg,4,100,80,20,1
09-04-2025,"Dry Fruits, Nuts & Seeds",FLAX SEEDS 250GM,2,60,50,10,1
09-04-2025,"Grains, Flours & Dals",SA Multi Grain Mix 500GM,4,159,159,0,1
09-04-2025,"Dry Fruits, Nuts & Seeds",PUMPKIN SEEDS 250GM,2,200,160,40,1
09-04-2025,Snacks & Ready-to-Eat,SATHVI REGIVADA 200GM,14,80,60,20,1
09-04-2025,"Grains, Flours & Dals",CHANA DAL 500GM,4,56,48,8,1
09-04-2025,"Health, Wellness & Ayurvedic Products",MORINGA LEAF POWDER M,5,80,75,5,1
09-04-2025,"Grains, Flours & Dals",Urad dall 1 Kg,4,185,170,15,1
09-04-2025,Spices & Seasonings,DRY MIECHI 200GM,15,80,60,20,1
09-04-2025,"Dry Fruits, Nuts & Seeds",SD Mango cubes 100gm,2,45,45,0,1
09-04-2025,Spices & Seasonings,DRY MIECHI 200GM,15,80,60,20,1
09-04-2025,"Dry Fruits, Nuts & Seeds",Groundnuts 500 gms,2,95,85,10,1
09-04-2025,Snacks & Ready-to-Eat,VD MURMURA LADDU,14,50,50,0,1
09-04-2025,Snacks & Ready-to-Eat,JUNNU POWDER 100GM,14,70,70,0,1
09-04-2025,"Grains, Flours & Dals",turdal 1kg,4,220,170,50,1
09-04-2025,Spices & Seasonings,Tamarind 250GMS,15,80,65,15,1
09-04-2025,"Grains, Flours & Dals",DH URAD GOTA 1KG,4,215,190,25,1
09-04-2025,"Grains, Flours & Dals",chana flour 500 gms,4,60,54,6,1
09-04-2025,"Grains, Flours & Dals",KORRALU (FOXTAIL M) 1KG,4,300,220,80,2
09-04-2025,Snacks & Ready-to-Eat,BROWN BREAD,14,55,55,0,1
09-04-2025,"Grains, Flours & Dals",HS MULTI UPMA RAVA,4,65,65,0,1
09-04-2025,"Grains, Flours & Dals",Bombay Rava 500GM,4,35,30,5,1
09-04-2025,"Dry Fruits, Nuts & Seeds",Groundnuts 1 kg,2,380,330,50,2
09-04-2025,"Grains, Flours & Dals",SABDANA,4,40,35,5,1
09-04-2025,"Grains, Flours & Dals",Urad dall 1 Kg,4,370,340,30,2
09-04-2025,Personal Care & Cosmetics,Soapnut 250GM,10,60,45,15,1
09-04-2025,Snacks & Ready-to-Eat,BD KODO MILLET NOODLES 200GM,14,75,75,0,1
09-04-2025,"Grains, Flours & Dals",split greengram,4,140,140,0,1
09-04-2025,"Grains, Flours & Dals",THICK POHA 500GM,4,40,35,5,1
09-04-2025,"Grains, Flours & Dals",Wheat Flour 1 kg,4,70,60,10,1
09-04-2025,"Grains, Flours & Dals",turdal 1kg,4,220,170,50,1
09-04-2025,"Grains, Flours & Dals",Red Bobarlu 500 gms,4,95,85,10,1
09-04-2025,"Grains, Flours & Dals",RAJMA 500GM,4,100,90,10,1
09-04-2025,Spices & Seasonings,Jeera 100GM,15,50,45,5,1
09-04-2025,"Grains, Flours & Dals",THICK POHA 1KG,4,80,70,10,1
09-04-2025,"Grains, Flours & Dals",idly rava 1kg,4,60,50,10,1
09-04-2025,Spices & Seasonings,Elaichi 25GM,15,145,120,25,1
09-04-2025,Household & Cleaning,HERBAL LIQ DISH WASH 500ML,6,170,170,0,1
09-04-2025,"Grains, Flours & Dals",Wheat Rava S 1KG,4,65,55,10,1
09-04-2025,"Dry Fruits, Nuts & Seeds",cashew,2,340,310,30,1
09-04-2025,Oils & Ghee,Safflower oil 5 L,9,2200,"1,950.00",250,1
09-04-2025,Pooja & Spiritual Items,GD Bhagavatha Mallika 75GM,12,120,120,0,2
09-04-2025,Snacks & Ready-to-Eat,VD MULTI CHAKKA,14,110,110,0,1
09-04-2025,Household & Cleaning,ROOPERI PITAMBARI SILVER 50ML,6,110,110,0,1
09-04-2025,"Grains, Flours & Dals",RAGI FLOUR 1KG,4,80,70,10,1
09-04-2025,Spices & Seasonings,SAMBAR POWDER 200GM,15,130,110,20,1
09-04-2025,Spices & Seasonings,AVALU 100GM,15,25,20,5,1
09-04-2025,Pooja & Spiritual Items,rudraksha malla,12,25,25,0,1
09-04-2025,Spices & Seasonings,DURGA SALT CRYSTAL 1KG,15,25,25,0,1
09-04-2025,"Grains, Flours & Dals",split black gram 1 kg,4,180,170,10,1
09-04-2025,"Grains, Flours & Dals",Green gram 1 kg,4,150,130,20,1
09-04-2025,Spices & Seasonings,Turmeric powder 250 gms,15,100,75,25,1
09-04-2025,"Grains, Flours & Dals",idly rava 1kg,4,60,50,10,1
09-04-2025,"Grains, Flours & Dals",PESARA PAPPU 500GMS,4,85,75,10,1
09-04-2025,Sweeteners,GS Palm Jaggery Powder 400GM,16,180,180,0,1
09-04-2025,"Grains, Flours & Dals",UNPOLISHED TURDALL 1KG,4,240,210,30,1
09-04-2025,Spices & Seasonings,Jeera 100GM,15,50,45,5,1
09-04-2025,Spices & Seasonings,AV Iodized Salt 1KG,15,28,25,3,1
09-04-2025,Beverages,3ROSES,1,90,90,0,1
09-04-2025,Sweeteners,YB Brown Sugar 1KG,16,140,140,0,1
09-04-2025,Household & Cleaning,VIM MAHA BAR,6,20,20,0,2
09-04-2025,"Grains, Flours & Dals",AISHWARYA SP 1KG,4,800,700,100,10
09-04-2025,Snacks & Ready-to-Eat,SATHVI REGIVADA 200GM,14,80,60,20,1
09-04-2025,Milk & Dairy,BROWN EGGS 1P,7,140,120,20,10
09-04-2025,Snacks & Ready-to-Eat,VD MYSOREPAK 6PIC,14,100,100,0,1
09-04-2025,Snacks & Ready-to-Eat,VD KOBARI LADDU,14,80,80,0,1
09-04-2025,"Dry Fruits, Nuts & Seeds",SABJA SEEDS 100GM,2,160,140,20,2
09-04-2025,Snacks & Ready-to-Eat,DOSA BATTER 1KG,14,60,60,0,1
09-04-2025,"Grains, Flours & Dals",SABDANA,4,40,35,5,1
09-04-2025,Snacks & Ready-to-Eat,TILLI CHIKKI,14,25,25,0,5
09-04-2025,"Dry Fruits, Nuts & Seeds",YB GRANMA NUTS,2,90,90,0,1
09-04-2025,Snacks & Ready-to-Eat,SD Ginger Candy 100g,14,60,60,0,1
09-04-2025,Sweeteners,YB JAGGERY POWDER 500GMS,16,75,75,0,1
09-04-2025,Snacks & Ready-to-Eat,VD MANGO JELLY 250GRMS,14,80,80,0,1
09-04-2025,"Grains, Flours & Dals",URAD DALL,4,95,85,10,1
09-04-2025,Snacks & Ready-to-Eat,VD BELLAM GAVVALU 200GM,14,60,60,0,1
09-04-2025,"Grains, Flours & Dals",PESARA PAPPU 500GMS,4,85,75,10,1
09-04-2025,"Grains, Flours & Dals",MELMEKER 250GMS,4,60,45,15,1
09-04-2025,Snacks & Ready-to-Eat,RAGI LADDU,14,120,120,0,1
09-04-2025,Snacks & Ready-to-Eat,TILLI CHIKKI,14,50,50,0,10
09-04-2025,Oils & Ghee,Groundnut oil 1 L,9,360,330,30,1
09-04-2025,Snacks & Ready-to-Eat,VD MULTI CHAKKA,14,110,110,0,1
09-04-2025,Snacks & Ready-to-Eat,VD MIXTURE 175 GM,14,60,60,0,1
09-04-2025,Misc,VD0009,8,100,100,0,1
09-04-2025,Snacks & Ready-to-Eat,VD CORNFLAKES MIXTURE 175GM,14,60,60,0,1
09-04-2025,"Grains, Flours & Dals",Red Bobarlu 500 gms,4,95,85,10,1
09-04-2025,"Grains, Flours & Dals",White Chana 250 GM,4,60,50,10,1
09-04-2025,"Grains, Flours & Dals",Red Chana 250GM,4,35,30,5,1
09-04-2025,"Dry Fruits, Nuts & Seeds",Groundnuts 500 gms,2,95,85,10,1
09-04-2025,"Grains, Flours & Dals",white Bobarlu 500 gms,4,80,75,5,1
09-04-2025,"Grains, Flours & Dals",Green Batani 500GM,4,110,90,20,1
09-04-2025,Pooja & Spiritual Items,divya deeparadhana oil,12,190,190,0,1
09-04-2025,"Dry Fruits, Nuts & Seeds",PUMPKIN SEEDS 250GM,2,200,160,40,1
09-04-2025,"Dry Fruits, Nuts & Seeds",WATERMELON SEEDS 250GRM,2,320,280,40,1
09-04-2025,Oils & Ghee,Groundnut oil 1 L,9,1080,990,90,3
09-04-2025,"Dry Fruits, Nuts & Seeds",SUNFLOWER SEEDS 250GRM,2,150,130,20,1
09-04-2025,"Grains, Flours & Dals",chana flour 500 gms,4,60,54,6,1
09-04-2025,"Grains, Flours & Dals",RAGI FLOUR 500GRMS,4,80,70,10,2
09-04-2025,"Grains, Flours & Dals",Wheat Flour 1 kg,4,70,60,10,1
09-04-2025,"Grains, Flours & Dals",SA YELLOW JOWAR RAVA 500GM,4,95,95,0,1
09-04-2025,"Grains, Flours & Dals",yellow jowar flour 1kg,4,100,92,8,1
09-04-2025,Oils & Ghee,Groundnut oil 1 L,9,720,660,60,2
09-04-2025,"Grains, Flours & Dals",RICE FLOUR 500 GM,4,35,28,7,1
09-04-2025,Snacks & Ready-to-Eat,FOXTAIL NOODLES,14,75,75,0,1
09-04-2025,"Grains, Flours & Dals",RAGI FLOUR 500GRMS,4,40,35,5,1
09-04-2025,Snacks & Ready-to-Eat,NGT CHATPATTA CHANA 90GM,14,25,25,0,1
09-04-2025,Oils & Ghee,Groundnut oil 1 L,9,720,660,60,2
09-04-2025,"Health, Wellness & Ayurvedic Products",MD Bringaraj Choornam 100GM,5,80,80,0,1
09-04-2025,"Grains, Flours & Dals",AISHWARYA SP 1KG,4,400,350,50,5
09-04-2025,Spices & Seasonings,DRY MIECHI 200GM,15,80,60,20,1
09-04-2025,Spices & Seasonings,ROYAL SAFFRON 400GRMS,15,65,65,0,1
09-04-2025,Beverages,BRU GREEN LABEL 1.2G,1,24,24,0,12
09-04-2025,Oils & Ghee,rice bran oil f,9,194,169,25,1
09-04-2025,Snacks & Ready-to-Eat,VD GUMMADI VADIYAM,14,75,75,0,1
09-04-2025,"Grains, Flours & Dals",SAMALU (Little millet) 500 gms,4,85,65,20,1
09-04-2025,"Grains, Flours & Dals",Wheat Flour 1 kg,4,70,60,10,1
09-04-2025,Spices & Seasonings,GS Pink Rock Salt 1KG,15,120,120,0,1
09-04-2025,Oils & Ghee,Coconut oil 1 L,9,440,400,40,1
09-04-2025,"Grains, Flours & Dals",RAGI FLOUR 1KG,4,80,70,10,1
09-04-2025,Snacks & Ready-to-Eat,VD MURMURA LADDU,14,50,50,0,1
09-04-2025,Snacks & Ready-to-Eat,VD SAGOPAPAD 150GM,14,55,55,0,1
09-04-2025,"Grains, Flours & Dals",SL Idly Rava 1KG,4,65,55,10,1
09-04-2025,"Grains, Flours & Dals",RICE FLOUR 500 GM,4,35,28,7,1
09-04-2025,Spices & Seasonings,AV Iodized Salt 1KG,15,28,25,3,1
09-04-2025,Pooja & Spiritual Items,SWASTIK CAMPHORE,12,90,90,0,1
09-04-2025,Spices & Seasonings,Coriander seeds 200 gms,15,48,40,8,1
09-04-2025,Spices & Seasonings,DRY MIECHI 200GM,15,80,60,20,1
09-04-2025,Sweeteners,SUGAR 500 GM,16,30,25,5,1
09-04-2025,"Grains, Flours & Dals",idly rava 1kg,4,60,50,10,1
09-04-2025,Snacks & Ready-to-Eat,DISANO VERMICELLI 425 GM,14,50,50,0,1
09-04-2025,"Grains, Flours & Dals",BOMBAY RAVA,4,70,55,15,1
09-04-2025,"Grains, Flours & Dals",SABDANA 500GM,4,90,70,20,1
09-04-2025,"Grains, Flours & Dals",Wheat Flour 1 kg,4,70,60,10,1
09-04-2025,"Grains, Flours & Dals",DH URAD GOTA 1KG,4,215,190,25,1
09-04-2025,"Grains, Flours & Dals",Wheat Rava S 1KG,4,65,55,10,1
09-04-2025,"Grains, Flours & Dals",turdal 1kg,4,220,170,50,1
09-04-2025,Sweeteners,YB JAGGERY POWDER 500GMS,16,225,225,0,3
09-04-2025,Snacks & Ready-to-Eat,VD MURUKU 175GM,14,60,60,0,1
09-04-2025,Snacks & Ready-to-Eat,VD ATUKULU MIXTURE 175GM,14,60,60,0,1
09-04-2025,"Dry Fruits, Nuts & Seeds",SATHVI CHIA SEEDS 100GM,2,100,80,20,1
09-04-2025,"Dry Fruits, Nuts & Seeds",Putnalu 250GM,2,45,38,7,1
09-04-2025,Snacks & Ready-to-Eat,sannakarampusa,14,60,60,0,1
09-04-2025,Baking & Cooking Aids,GONDKATIRA Ag,0,170,150,20,2
09-04-2025,Pooja & Spiritual Items,GD Kumkum 50GM,12,30,30,0,1
09-04-2025,"Dry Fruits, Nuts & Seeds",SUNFLOWER SEEDS 250GRM,2,150,130,20,1
09-04-2025,Snacks & Ready-to-Eat,VD MANGO JELLY 250GRMS,14,80,80,0,1
09-04-2025,"Grains, Flours & Dals",WHEAT 1 KG,4,180,150,30,3
09-04-2025,Misc,VD0009,8,100,100,0,1
09-04-2025,Oils & Ghee,Groundnut oil 5 L,9,1800,"1,600.00",200,1
09-04-2025,"Dry Fruits, Nuts & Seeds",PUMPKIN SEEDS 250GM,2,200,160,40,1
09-04-2025,"Dry Fruits, Nuts & Seeds",WATERMELON SEEDS 250GRM,2,320,280,40,1
09-04-2025,Oils & Ghee,Black Sesame oil 500 ml,9,440,380,60,2
09-04-2025,Spices & Seasonings,DRY MIECHI 200GM,15,80,60,20,1
09-04-2025,"Dry Fruits, Nuts & Seeds",PULMAKHANA 100 GM,2,180,170,10,1
09-04-2025,Snacks & Ready-to-Eat,VD GUMMADI VADIYAM,14,75,75,0,1
09-04-2025,Spices & Seasonings,Turmeric powder 250 gms,15,100,75,25,1
09-04-2025,Spices & Seasonings,DURGA SALT CRYSTAL 1KG,15,25,25,0,1
09-04-2025,Oils & Ghee,Coconut oil 500 ml,9,220,200,20,1
09-04-2025,Sweeteners,NATURAL HONEY 1KG,16,560,480,80,1
09-04-2025,Milk & Dairy,ID PANEER,7,135,135,0,1
09-04-2025,Oils & Ghee,Groundnut oil 1 L,9,360,330,30,1
09-04-2025,"Health, Wellness & Ayurvedic Products",RB Max Protein DESI MASALA 60gm,5,45,45,0,1
09-04-2025,"Grains, Flours & Dals",VYS.SP RICE 1 KG,4,420,390,30,6
09-04-2025,"Dry Fruits, Nuts & Seeds",ANJEER 250GM,2,400,360,40,1
09-04-2025,"Grains, Flours & Dals",Wheat Flour 1 kg,4,140,120,20,2
09-04-2025,Spices & Seasonings,Chilli powder 500 gms,15,580,420,160,2
09-04-2025,"Dry Fruits, Nuts & Seeds",SABJA SEEDS 100GM,2,80,70,10,1
09-04-2025,Snacks & Ready-to-Eat,TILLI CHIKKI,14,20,20,0,4
09-04-2025,Snacks & Ready-to-Eat,VD DRY FRUIT PUTHAREKULU,14,120,120,0,1
09-04-2025,Misc,VD0009,8,100,100,0,1
09-04-2025,Oils & Ghee,Coconut oil 500 ml,9,220,200,20,1
09-04-2025,Milk & Dairy,BROWN EGGS 1P,7,140,120,20,10
09-04-2025,Baking & Cooking Aids,GONDKATIRA Ag,0,85,75,10,1
09-04-2025,"Dry Fruits, Nuts & Seeds",SABJA SEEDS 100GM,2,80,70,10,1
09-04-2025,Milk & Dairy,HRITAGE TOTAL CURD 130GM,7,10,10,0,1
09-04-2025,Oils & Ghee,Coconut oil 500 ml,9,220,200,20,1
09-04-2025,Oils & Ghee,Groundnut oil 1 L,9,360,330,30,1
09-04-2025,Pooja & Spiritual Items,SOSR GATTI DEEPAM VATTULU 125PICS,12,30,30,0,1
09-04-2025,Snacks & Ready-to-Eat,VD GUMMADI VADIYAM,14,75,75,0,1
09-04-2025,Snacks & Ready-to-Eat,BD LITTLE MILLET NOODLES 200G,14,75,75,0,1
09-04-2025,Personal Care & Cosmetics,HERBAL BATH POWDER,10,160,160,0,1
09-04-2025,"Dry Fruits, Nuts & Seeds",Groundnuts 500 gms,2,95,85,10,1
09-04-2025,Snacks & Ready-to-Eat,ELITE MILK RUSK 200GM,14,35,35,0,1
09-04-2025,"Grains, Flours & Dals",MAA TEJA RICE BAG 26KG,4,2210,"1,750.00",460,1
09-04-2025,Sweeteners,NATURAL HONEY 1KG,16,560,480,80,1
09-04-2025,Milk & Dairy,BROWN EGGS TRAY 30P,7,360,330,30,1
09-04-2025,Snacks & Ready-to-Eat,VD MINAPA VADIYAM,14,65,65,0,1
09-04-2025,Baking & Cooking Aids,GONDKATIRA Ag,0,85,75,10,1
09-04-2025,Oils & Ghee,Safflower oil 1 L,9,440,400,40,1
09-04-2025,"Grains, Flours & Dals",Wheat Flour 1 kg,4,70,60,10,1
09-04-2025,"Grains, Flours & Dals",SRILATHA RICE RAVVA 500GM,4,35,35,0,1
09-04-2025,Spices & Seasonings,Masala Karam 250 gms,15,130,120,10,1
09-04-2025,"Health, Wellness & Ayurvedic Products",MD Fenugreek Choornam 100GM,5,80,80,0,1
09-04-2025,Milk & Dairy,SANGAM TONED MILK 500ML,7,30,30,0,1
09-04-2025,"Grains, Flours & Dals",AISHWARYA SP 1KG,4,160,140,20,2
09-04-2025,"Grains, Flours & Dals",BARLY POWDER,4,40,40,0,1
09-04-2025,"Grains, Flours & Dals",chana flour 500 gms,4,60,54,6,1
09-04-2025,"Grains, Flours & Dals",SAMALU (Little millet) 500 gms,4,85,65,20,1
09-04-2025,"Grains, Flours & Dals",UDALU (Barnyard millet) 500 gms,4,70,60,10,1
09-04-2025,"Grains, Flours & Dals",Brown RICE 1KG,4,210,195,15,3
09-04-2025,Milk & Dairy,BROWN EGGS TRAY 30P,7,360,330,30,1
09-04-2025,"Grains, Flours & Dals",Bombay Rava 500GM,4,35,30,5,1
09-04-2025,"Grains, Flours & Dals",DH URAD GOTA 1KG,4,215,190,25,1
09-04-2025,Snacks & Ready-to-Eat,VD MANGO JELLY 250GRMS,14,80,80,0,1
09-04-2025,Spices & Seasonings,AVALU 100GM,15,50,40,10,2
09-04-2025,"Grains, Flours & Dals",VGR rice 1 kg,4,350,325,25,5
09-04-2025,"Grains, Flours & Dals",AISHWARYA SP 1KG,4,480,420,60,6
09-04-2025,Oils & Ghee,Groundnut oil 1 L,9,720,660,60,2
09-04-2025,"Grains, Flours & Dals",turdal 1kg,4,440,340,100,2
09-04-2025,"Grains, Flours & Dals",Multigrain 1 kg,4,100,85,15,1
09-04-2025,Spices & Seasonings,Jeera 100GM,15,50,45,5,1
09-04-2025,"Grains, Flours & Dals",SRILATHA RICE RAVVA 500GM,4,105,105,0,3
09-04-2025,Spices & Seasonings,Gasagasalu 50GM,15,130,110,20,1
09-04-2025,"Dry Fruits, Nuts & Seeds",Groundnuts 500 gms,2,95,85,10,1
09-04-2025,"Dry Fruits, Nuts & Seeds",PUTNALU 500GMS,2,90,76,14,1
09-04-2025,Spices & Seasonings,SATHVI ANASAPUVUU 25GM,15,180,130,50,2
09-04-2025,"Grains, Flours & Dals",BASMATHI RICE 1KG,4,150,135,15,1
09-04-2025,"Grains, Flours & Dals",Urad dall 1 Kg,4,185,170,15,1
09-04-2025,"Grains, Flours & Dals",turdal 500 gms,4,220,170,50,2
09-04-2025,Spices & Seasonings,BIRYANI LEAF 10GM,15,30,20,10,1
09-04-2025,"Grains, Flours & Dals",Bombay Rava 500GM,4,35,30,5,1
09-04-2025,Spices & Seasonings,Lavangam 50GM,15,60,50,10,1
09-04-2025,Personal Care & Cosmetics,SVE KHADI CARROT GEL 100GM,10,145,145,0,1
09-04-2025,Spices & Seasonings,dalchin chekka,15,50,40,10,1
09-04-2025,Oils & Ghee,Groundnut oil 1 L,9,720,660,60,2
09-04-2025,"Grains, Flours & Dals",Multigrain 1 kg,4,200,170,30,2
09-04-2025,Sweeteners,YB JAGGERY POWDER 500GMS,16,75,75,0,1
09-04-2025,"Dry Fruits, Nuts & Seeds",YELLOW KISHMISH 250GM,2,130,110,20,1
09-04-2025,Spices & Seasonings,Menthulu 250 gms,15,50,45,5,1
09-04-2025,"Dry Fruits, Nuts & Seeds",PUMPKIN SEEDS 250GM,2,200,160,40,1
09-04-2025,"Dry Fruits, Nuts & Seeds",wallnuts,2,380,320,60,1
09-04-2025,"Dry Fruits, Nuts & Seeds",SUNFLOWER SEEDS 250GRM,2,150,130,20,1
09-04-2025,"Grains, Flours & Dals",Wheat Flour 1 kg,4,70,60,10,1
09-04-2025,"Grains, Flours & Dals",Em jowar idly R 500G,4,150,150,0,2
09-04-2025,"Dry Fruits, Nuts & Seeds",SATHVI CHIA SEEDS 100GM,2,100,80,20,1
09-04-2025,"Grains, Flours & Dals",Wheat Flour 1 kg,4,70,60,10,1
09-04-2025,Snacks & Ready-to-Eat,BD PEARL MILLET NOODLES 200G,14,140,140,0,2
09-04-2025,Oils & Ghee,Groundnut oil 5 L,9,1800,"1,600.00",200,1
09-04-2025,"Grains, Flours & Dals",ULAVALU RED,4,90,75,15,1
09-04-2025,"Grains, Flours & Dals",AISHWARYA SP 1KG,4,240,210,30,3
09-04-2025,Snacks & Ready-to-Eat,VD ATUKULU MIXTURE 175GM,14,60,60,0,1
09-04-2025,"Grains, Flours & Dals",Multigrain 1 kg,4,100,85,15,1
09-04-2025,Snacks & Ready-to-Eat,VD DASA DINUSULU,14,199,199,0,1
09-04-2025,Personal Care & Cosmetics,HEART SHAPE LOOFAH,10,79,79,0,1
09-04-2025,Snacks & Ready-to-Eat,VD MANGO JELLY 250GRMS,14,80,80,0,1
09-04-2025,"Grains, Flours & Dals",RICE FLOUR 500 GM,4,35,28,7,1
09-04-2025,Snacks & Ready-to-Eat,VD MULTI CHAKKA,14,220,220,0,2
09-04-2025,"Grains, Flours & Dals",Urad dall 1 Kg,4,185,170,15,1
09-04-2025,Milk & Dairy,BROWN EGGS 1P,7,168,144,24,12
09-04-2025,"Grains, Flours & Dals",RAGI FLOUR 500GRMS,4,40,35,5,1
09-04-2025,Snacks & Ready-to-Eat,VD KOBARI LADDU,14,80,80,0,1
09-04-2025,"Health, Wellness & Ayurvedic Products",MAX PROTEIN,5,50,50,0,1
09-04-2025,Snacks & Ready-to-Eat,VD Pappu Chekkalu 190gm,14,60,60,0,1
09-04-2025,Snacks & Ready-to-Eat,MILLET PANCAKE CHOCOLATE,14,199,199,0,1
09-04-2025,"Grains, Flours & Dals",AISHWARYA SP 1KG,4,400,350,50,5
09-04-2025,Snacks & Ready-to-Eat,VD MURMURA LADDU,14,50,50,0,1
09-04-2025,Snacks & Ready-to-Eat,VD PAPPU CHEGODI 200GM,14,60,60,0,1
09-04-2025,"Grains, Flours & Dals",EM Ragi idli R 500G,4,75,75,0,1
09-04-2025,"Grains, Flours & Dals",Wheat Flour 1 kg,4,210,180,30,3
09-04-2025,"Grains, Flours & Dals",Em jowar idly R 500G,4,150,150,0,2
09-04-2025,"Grains, Flours & Dals",Multigrain 1 kg,4,200,170,30,2
09-04-2025,"Grains, Flours & Dals",Arikalu (kodo),4,140,130,10,2
09-04-2025,"Grains, Flours & Dals",Em Multimillet idli r 500g,4,258,258,0,2
09-04-2025,Pooja & Spiritual Items,GD Dhoop Sticks 26GM,12,80,80,0,4
09-04-2025,"Grains, Flours & Dals",ANDU KORRALU (Browntop.m) 1 kg,4,260,220,40,1
09-04-2025,"Grains, Flours & Dals",UDALU (Barnyard millet) 1 kg,4,140,115,25,1
09-04-2025,"Grains, Flours & Dals",SAMALU (Little millet) 1 kg,4,170,130,40,1
09-04-2025,"Grains, Flours & Dals",idly rava 1kg,4,120,100,20,2
09-04-2025,Snacks & Ready-to-Eat,VD PALLI CHIKKI,14,80,80,0,1
09-04-2025,Oils & Ghee,Groundnut oil 1 L,9,360,330,30,1
09-04-2025,Oils & Ghee,Coconut oil 500 ml,9,220,200,20,1
09-04-2025,Oils & Ghee,Safflower oil 1 L,9,880,800,80,2
09-04-2025,"Grains, Flours & Dals",Wheat Flour 1 kg,4,140,120,20,2
09-04-2025,"Grains, Flours & Dals",Multigrain 1 kg,4,100,85,15,1
09-04-2025,Oils & Ghee,Sesame oil 1 L,9,590,560,30,1
09-04-2025,Spices & Seasonings,Chilli powder 500 gms,15,290,210,80,1
09-04-2025,Snacks & Ready-to-Eat,VD ATUKULU MIXTURE 175GM,14,60,60,0,1
09-04-2025,"Grains, Flours & Dals",MELMEKER 250GMS,4,60,45,15,1
09-04-2025,Spices & Seasonings,SWEET SOUNF,15,20,20,0,1
09-04-2025,"Grains, Flours & Dals",AISHWARYA SP 1KG,4,720,630,90,9
09-04-2025,"Grains, Flours & Dals",AISHWARYA SP 25KG,4,3998,"3,380.00",618,2
09-04-2025,"Grains, Flours & Dals",DOCTOR RICE DIABETIC SFR 1KG,4,1200,"1,200.00",0,10
09-04-2025,Spices & Seasonings,RED COPRA 500GM,15,170,148,22,1
09-04-2025,"Grains, Flours & Dals",idly rava 1kg,4,120,100,20,2
09-04-2025,"Dry Fruits, Nuts & Seeds",Groundnuts 1 kg,2,190,165,25,1
09-04-2025,"Grains, Flours & Dals",Urad dall 1 Kg,4,370,340,30,2
09-04-2025,"Grains, Flours & Dals",White jowar.F 1 kg,4,200,160,40,2
09-04-2025,"Grains, Flours & Dals",AISHWARYA SP 25KG,4,1999,"1,690.00",309,1
09-04-2025,"Grains, Flours & Dals",Wheat Flour 1 kg,4,70,60,10,1
09-04-2025,Milk & Dairy,BROWN EGGS 1P,7,140,120,20,10
09-04-2025,Oils & Ghee,Groundnut oil 1 L,9,720,660,60,2
09-04-2025,Pooja & Spiritual Items,divya deeparadhana oil,12,190,190,0,1
09-04-2025,Oils & Ghee,Sesame oil 1 L,9,590,560,30,1
09-04-2025,Milk & Dairy,BROWN EGGS TRAY 30P,7,360,330,30,1
09-04-2025,Oils & Ghee,Groundnut oil 1 L,9,720,660,60,2
09-04-2025,Oils & Ghee,A2 BUFFALO GHEE 250ML,9,299,299,0,1
09-04-2025,"Dry Fruits, Nuts & Seeds",cashew,2,340,310,30,1
09-04-2025,"Dry Fruits, Nuts & Seeds",Groundnuts 500 gms,2,95,85,10,1
09-04-2025,Spices & Seasonings,ROYAL SAFFRON 400GRMS,15,65,65,0,1
09-04-2025,"Grains, Flours & Dals",White jowar.F 1 kg,4,100,80,20,1
09-04-2025,Oils & Ghee,rice bran oil f,9,388,338,50,2
09-04-2025,Sweeteners,NATURAL HONEY 250GM,16,150,130,20,1
09-04-2025,"Grains, Flours & Dals",Wheat Flour 1 kg,4,70,60,10,1
09-04-2025,Household & Cleaning,bathroom cleaner,6,165,165,0,1
09-04-2025,Personal Care & Cosmetics,GAYATHRI KUMKUDUKAYA,10,150,150,0,1
09-04-2025,Milk & Dairy,SANGAM CURD 450GM,7,38,38,0,1
09-04-2025,Oils & Ghee,Coconut oil 500 ml,9,220,200,20,1
09-04-2025,"Grains, Flours & Dals",Wheat Flour 1 kg,4,70,60,10,1
09-04-2025,Personal Care & Cosmetics,GAYATHRI KUMKUDUKAYA,10,300,300,0,2
09-04-2025,"Dry Fruits, Nuts & Seeds",cashew,2,340,310,30,1
09-04-2025,"Grains, Flours & Dals",SABDANA,4,40,35,5,1
09-04-2025,"Grains, Flours & Dals",RAGI FLOUR 500GRMS,4,40,35,5,1
09-04-2025,Misc,md b8908006217045,8,99,99,0,1
09-04-2025,Snacks & Ready-to-Eat,MB LITTLE MILLET NOODLES 180G,14,95,95,0,1
09-04-2025,"Health, Wellness & Ayurvedic Products",MD Mandara Leaf Powder 50GM,5,100,100,0,1
09-04-2025,Oils & Ghee,Sesame oil 1 L,9,590,560,30,1
09-04-2025,"Grains, Flours & Dals",Wheat Flour 1 kg,4,210,180,30,3
09-04-2025,"Dry Fruits, Nuts & Seeds",PUTNALU 500GMS,2,90,76,14,1
09-04-2025,"Grains, Flours & Dals",Chana Flour 500 gms,4,120,108,12,1
09-04-2025,Oils & Ghee,Groundnut oil 1 L,9,360,330,30,1
09-04-2025,"Grains, Flours & Dals",SA Multi Grain Mix 500GM,4,159,159,0,1
09-04-2025,"Grains, Flours & Dals",Multigrain 1 kg,4,100,85,15,1
09-04-2025,"Grains, Flours & Dals",RAGI FLOUR 500GRMS,4,80,70,10,2
09-04-2025,Snacks & Ready-to-Eat,VD PAPPU CHEGODI 200GM,14,60,60,0,1
09-04-2025,"Grains, Flours & Dals",turdal 1kg,4,220,170,50,1
09-04-2025,Spices & Seasonings,ROYAL SAFFRON,15,125,125,0,1
09-04-2025,"Grains, Flours & Dals",turdal 500 gms,4,110,85,25,1
09-04-2025,Snacks & Ready-to-Eat,VD PALLI LADDU,14,80,80,0,1
09-04-2025,Spices & Seasonings,AVALU 100GM,15,25,20,5,1
09-04-2025,Snacks & Ready-to-Eat,VD Pappu Chekkalu 190gm,14,60,60,0,1
09-04-2025,Spices & Seasonings,Turmeric powder 250 gms,15,100,75,25,1
09-04-2025,Oils & Ghee,Safflower oil 1 L,9,440,400,40,1
09-04-2025,Oils & Ghee,Groundnut oil 1 L,9,360,330,30,1
09-04-2025,"Grains, Flours & Dals",Urad dall 1 Kg,4,185,170,15,1
09-04-2025,Milk & Dairy,SANGAM TONED MILK 500ML,7,30,30,0,1
09-04-2025,Milk & Dairy,SANGAM FULL CREAM MILK 500ML,7,76,76,0,2
09-04-2025,"Dry Fruits, Nuts & Seeds",SUNFLOWER SEEDS 250GRM,2,150,130,20,1
09-04-2025,"Grains, Flours & Dals",THICK POHA 1KG,4,80,70,10,1
09-04-2025,"Dry Fruits, Nuts & Seeds",SATHVI CHIA SEEDS 100GM,2,100,80,20,1
09-04-2025,Spices & Seasonings,NUVVULU 250GM,15,100,85,15,1
09-04-2025,Beverages,BISLERI SODA 750ML,1,40,40,0,2
09-04-2025,"Grains, Flours & Dals",ANDU KORRALU (Brown top .mlt) 500,4,130,110,20,1
09-04-2025,Misc,VD00014,8,100,90,10,1
09-04-2025,Spices & Seasonings,DRY MIECHI 200GM,15,80,60,20,1
09-04-2025,Snacks & Ready-to-Eat,VD SAGOPAPAD 150GM,14,55,55,0,1
09-04-2025,Oils & Ghee,Groundnut oil 1 L,9,360,330,30,1
09-04-2025,"Grains, Flours & Dals",RAGI FLOUR 500GRMS,4,40,35,5,1
09-04-2025,Oils & Ghee,Coconut oil 500 ml,9,220,200,20,1
09-04-2025,Pickles & Cooking Pastes,SD RED CHILLI MESTA,11,110,110,0,1
09-04-2025,"Grains, Flours & Dals",idly rava 1kg,4,60,50,10,1
09-04-2025,Spices & Seasonings,Turmeric powder 250 gms,15,10,7.5,2.5,0.1
09-04-2025,"Dry Fruits, Nuts & Seeds",Groundnuts 500 gms,2,95,85,10,1
09-04-2025,"Grains, Flours & Dals",Red Chana 250GM,4,35,30,5,1
09-04-2025,"Dry Fruits, Nuts & Seeds",D kimia,2,310,180,130,1
09-04-2025,"Grains, Flours & Dals",SRILALITHA MAIDA FLOUR 500G,4,32,32,0,1
09-04-2025,"Grains, Flours & Dals",rice ravva sri,4,35,35,0,1
09-04-2025,Snacks & Ready-to-Eat,MILK BREAD,14,55,55,0,1
09-04-2025,Snacks & Ready-to-Eat,PEANUT CHILLI,14,180,180,0,36
09-04-2025,Snacks & Ready-to-Eat,RAJGIRA PEANUT CHIKKI,14,30,30,0,6
09-04-2025,Milk & Dairy,BROWN EGGS TRAY 30P,7,360,330,30,1
09-04-2025,"Grains, Flours & Dals",RICE FLOUR 500 GM,4,35,28,7,1
09-04-2025,"Grains, Flours & Dals",IG B B RICE,4,187,168,19,1
09-04-2025,Sweeteners,YB Brown Sugar 500GM,16,75,75,0,1
09-04-2025,"Grains, Flours & Dals",RAGI FLOUR 500GRMS,4,40,35,5,1
09-04-2025,Oils & Ghee,Groundnut oil 1 L,9,720,660,60,2
09-04-2025,Milk & Dairy,HERITAGE TOTAL CURD 500GM,7,50,50,0,1
09-04-2025,Milk & Dairy,HERITAGE TONED MILK 500ML,7,31,31,0,1
09-04-2025,Snacks & Ready-to-Eat,VD ATUKULU MIXTURE 175GM,14,60,60,0,1
09-04-2025,Oils & Ghee,Groundnut oil 1 L,9,360,330,30,1
09-04-2025,Milk & Dairy,HERITAGE TONED MILK 500ML,7,62,62,0,2
09-04-2025,Milk & Dairy,HERTG FULL CREAM M,7,41,41,0,1
09-04-2025,Snacks & Ready-to-Eat,DOSA BATTER 1KG,14,60,60,0,1
09-04-2025,Milk & Dairy,SANGAM TONED MILK 500ML,7,60,60,0,2
09-04-2025,Milk & Dairy,SANGAM FULL CREAM MILK 500ML,7,38,38,0,1
09-04-2025,"Grains, Flours & Dals",UDALU (Barnyard millet) 500 gms,4,70,60,10,1
09-04-2025,"Grains, Flours & Dals",Bajra Flour 500 gms,4,35,30,5,1
09-04-2025,"Grains, Flours & Dals",Arikalu (kodo),4,70,65,5,1
09-04-2025,"Grains, Flours & Dals",KORRALU (FOXTAIL M) 500GM,4,65,55,10,1
09-04-2025,"Grains, Flours & Dals",WHEAT 1 KG,4,120,100,20,2
09-04-2025,"Grains, Flours & Dals",DH URAD GOTA 1KG,4,215,190,25,1
08-04-2025,"Grains, Flours & Dals",jowar flakes,4,299,299,0,1
08-04-2025,"Grains, Flours & Dals",MAAGAANI W RICE 5KGS,4,899,535,364,1
08-04-2025,Oils & Ghee,Sesame oil 1 L,9,590,560,30,1
08-04-2025,"Dry Fruits, Nuts & Seeds",PULMAKHANA 100 GM,2,180,170,10,1
08-04-2025,"Grains, Flours & Dals",JOWAR UPMA RAVA,4,65,65,0,1
08-04-2025,"Grains, Flours & Dals",HS MULTI UPMA RAVA,4,65,65,0,1
08-04-2025,"Dry Fruits, Nuts & Seeds",FLAX SEEDS 250GM,2,60,50,10,1
08-04-2025,"Grains, Flours & Dals",Em kodo idli R 500G,4,129,129,0,1
08-04-2025,Snacks & Ready-to-Eat,VD PAPPU CHEGODI 200GM,14,60,60,0,1
08-04-2025,Snacks & Ready-to-Eat,VD Pappu Chekkalu 190gm,14,60,60,0,1
08-04-2025,"Grains, Flours & Dals",Red Chana 250GM,4,35,30,5,1
08-04-2025,"Dry Fruits, Nuts & Seeds",PUTNALU 500GMS,2,90,76,14,1
08-04-2025,"Grains, Flours & Dals",KORRALU (FOXTAIL M) 500GM,4,65,55,10,1
08-04-2025,"Grains, Flours & Dals",VYS.SP RICE 1 KG,4,700,650,50,10
08-04-2025,Sweeteners,GS Organic Jaggery Powder 600GM,16,99,99,0,1
08-04-2025,"Grains, Flours & Dals",KORRALU (FOXTAIL M) 500GM,4,130,110,20,2
08-04-2025,"Grains, Flours & Dals",KORRALU (FOXTAIL M) 500GM,4,65,55,10,1
08-04-2025,Oils & Ghee,Groundnut oil 1 L,9,360,330,30,1
08-04-2025,Snacks & Ready-to-Eat,HS Ragi biscuits,14,50,50,0,1
08-04-2025,"Grains, Flours & Dals",yellow jowar flour 1kg,4,100,92,8,1
08-04-2025,Sweeteners,YB JAGGERY POWDER 500GMS,16,75,75,0,1
08-04-2025,Sweeteners,YB N FOREST HONEY 700 GM,16,400,400,0,1
08-04-2025,"Dry Fruits, Nuts & Seeds",SUNFLOWER SEEDS 250GRM,2,150,130,20,1
08-04-2025,"Grains, Flours & Dals",MULTIMILLET IDLY RAVVA,4,65,65,0,1
08-04-2025,"Grains, Flours & Dals",JOWAR UPMA RAVA,4,65,65,0,1
08-04-2025,Snacks & Ready-to-Eat,RINGS 200GM,14,30,30,0,1
08-04-2025,Snacks & Ready-to-Eat,DOSA BATTER 1KG,14,60,60,0,1
08-04-2025,Snacks & Ready-to-Eat,PEANUT CHILLI,14,5,5,0,1
08-04-2025,Snacks & Ready-to-Eat,GB SALT COOKIES,14,60,55,5,1
08-04-2025,Snacks & Ready-to-Eat,VD ATUKULU MIXTURE 175GM,14,60,60,0,1
08-04-2025,"Dry Fruits, Nuts & Seeds",SH GROUNDNUT 250GM,2,85,85,0,1
08-04-2025,Oils & Ghee,Groundnut oil 1 L,9,360,330,30,1
08-04-2025,Pooja & Spiritual Items,bilwa patra,12,60,60,0,1
08-04-2025,"Grains, Flours & Dals",VYS.SP RICE 1 KG,4,700,650,50,10
08-04-2025,"Grains, Flours & Dals",chana flour 500 gms,4,60,54,6,1
08-04-2025,"Grains, Flours & Dals",JOWAR UPMA RAVA,4,75,75,0,1
08-04-2025,"Grains, Flours & Dals",Em Foxtail upma r 500 g,4,109,109,0,1
08-04-2025,Snacks & Ready-to-Eat,VD GUMMADI VADIYAM,14,75,75,0,1
08-04-2025,"Grains, Flours & Dals",SA YELLOW JOWAR RAVA 500GM,4,95,95,0,1
08-04-2025,"Dry Fruits, Nuts & Seeds",PULMAKHANA 100 GM,2,180,170,10,1
08-04-2025,"Grains, Flours & Dals",SABDANA,4,40,35,5,1
08-04-2025,Snacks & Ready-to-Eat,VD MINAPA VADIYAM,14,65,65,0,1
08-04-2025,"Grains, Flours & Dals",Wheat Rava S 1KG,4,65,55,10,1
08-04-2025,Baking & Cooking Aids,GONDKATIRA Ag,0,85,75,10,1
08-04-2025,Spices & Seasonings,LG 50GM,15,92,92,0,1
08-04-2025,Spices & Seasonings,LG 50GM,15,92,92,0,1
08-04-2025,Oils & Ghee,Groundnut oil 1 L,9,360,330,30,1
08-04-2025,Beverages,REFRESH SHARBATH NORMAL,1,199,190,9,1
08-04-2025,Pooja & Spiritual Items,GD Sree Chandan 50GM,12,50,50,0,1
08-04-2025,Sweeteners,GS Organic Jaggery Powder 600GM,16,198,198,0,2
08-04-2025,"Grains, Flours & Dals",Multigrain 1 kg,4,200,170,30,2
08-04-2025,"Grains, Flours & Dals",Sathya Javva Wheat Rava 500GM,4,90,90,0,1
08-04-2025,Snacks & Ready-to-Eat,VD NUVULU CHEGODI 175GM,14,60,60,0,1
08-04-2025,Milk & Dairy,SANGAM TONED MILK 500ML,7,31,31,0,1
08-04-2025,Snacks & Ready-to-Eat,ANNAPURNA APPALAM,14,35,35,0,1
08-04-2025,Snacks & Ready-to-Eat,VD Minapa papad 200gm,14,60,60,0,1
08-04-2025,Snacks & Ready-to-Eat,VD Pappu Chekkalu 190gm,14,60,60,0,1
08-04-2025,Snacks & Ready-to-Eat,RSC ORANGE 100GMS,14,20,20,0,1
08-04-2025,"Health, Wellness & Ayurvedic Products",RB Max Protein PERI PERI 60gm,5,45,45,0,1
08-04-2025,"Grains, Flours & Dals",Multigrain 1 kg,4,200,170,30,2
08-04-2025,Sweeteners,ACHU BELLAM 1KG,16,100,80,20,1
08-04-2025,"Grains, Flours & Dals",HS MULTI UPMA RAVA,4,65,65,0,1
08-04-2025,"Health, Wellness & Ayurvedic Products",DWI MANDARA TAILAM 100ML,5,160,160,0,1
08-04-2025,Snacks & Ready-to-Eat,VD MANGO JELLY 250GRMS,14,80,80,0,1
08-04-2025,"Grains, Flours & Dals",chana flour 500 gms,4,60,54,6,1
08-04-2025,Sweeteners,NATURAL HONEY 250GM,16,150,130,20,1
08-04-2025,Spices & Seasonings,ROYAL SAFFRON,15,125,125,0,1
08-04-2025,Pooja & Spiritual Items,GD Aiswarya Deepam 700ML,12,195,195,0,1
08-04-2025,"Health, Wellness & Ayurvedic Products",MD Ashwagandha Choornam 100GM,5,340,340,0,2
08-04-2025,"Health, Wellness & Ayurvedic Products",MD Aamlaki Choornam 100GM,5,160,160,0,2
08-04-2025,Personal Care & Cosmetics,MD Bath Powder 100GM,10,40,40,0,1
08-04-2025,Personal Care & Cosmetics,UVIS MULTANI MITTI PW 100GM,10,49,49,0,1
08-04-2025,"Grains, Flours & Dals",SAMALU (Little millet) 500 gms,4,85,65,20,1
08-04-2025,Oils & Ghee,Safflower oil 1 L,9,440,400,40,1
08-04-2025,"Grains, Flours & Dals",ANDU KORRALU (Brown top .mlt) 500,4,130,110,20,1
08-04-2025,"Grains, Flours & Dals",UDALU (Barnyard millet) 500 gms,4,70,60,10,1
08-04-2025,"Grains, Flours & Dals",PESARA PAPPU 500GMS,4,85,75,10,1
08-04-2025,"Dry Fruits, Nuts & Seeds",FLAX SEEDS 250GM,2,60,50,10,1
08-04-2025,General Household & Kitchenware,MATCH BOX,3,20,20,0,1
08-04-2025,"Grains, Flours & Dals",SL Idly Rava 1KG,4,65,55,10,1
08-04-2025,Oils & Ghee,Groundnut oil 1 L,9,360,330,30,1
08-04-2025,Snacks & Ready-to-Eat,PN ORGANIC PUFFED RICE 200GM,14,55,55,0,1
08-04-2025,Spices & Seasonings,SATHVI ANASAPUVUU 25GM,15,90,65,25,1
08-04-2025,Spices & Seasonings,Coriander seeds 200 gms,15,48,40,8,1
08-04-2025,"Grains, Flours & Dals",Arikalu (kodo),4,70,65,5,1
08-04-2025,"Grains, Flours & Dals",yellow jowar .f 500g,4,50,50,0,1
08-04-2025,"Grains, Flours & Dals",MULTIMILLET IDLY RAVVA,4,65,65,0,1
08-04-2025,"Grains, Flours & Dals",KORRALU (FOXTAIL M) 500GM,4,65,55,10,1
08-04-2025,"Grains, Flours & Dals",split green gram 500 gms,4,75,70,5,1
08-04-2025,"Dry Fruits, Nuts & Seeds",Groundnuts 1 kg,2,190,165,25,1
08-04-2025,Spices & Seasonings,PRO HIMALAYAN PINK SALT 500GM,15,68,68,0,1
08-04-2025,Spices & Seasonings,ROYAL SAFFRON 400GRMS,15,130,130,0,2
08-04-2025,Milk & Dairy,BROWN EGGS 1P,7,140,120,20,10
08-04-2025,"Grains, Flours & Dals",THICK POHA 1KG,4,80,70,10,1
08-04-2025,"Grains, Flours & Dals",Wheat Flour 1 kg,4,140,120,20,2
08-04-2025,"Grains, Flours & Dals",Multigrain 1 kg,4,100,85,15,1
08-04-2025,"Grains, Flours & Dals",multi mllit umpa ravva,4,129,129,0,1
08-04-2025,Milk & Dairy,BROWN EGGS 1P,7,112,96,16,8
08-04-2025,Snacks & Ready-to-Eat,PN ORGANIC PUFFED RICE 200GM,14,55,55,0,1
08-04-2025,"Grains, Flours & Dals",Kandulu 250GM,4,40,35,5,1
08-04-2025,Snacks & Ready-to-Eat,VD MINAPA VADIYAM,14,65,65,0,1
08-04-2025,Oils & Ghee,Groundnut oil 1 L,9,720,660,60,2
08-04-2025,"Grains, Flours & Dals",SL Idly Rava 1KG,4,65,55,10,1
08-04-2025,Snacks & Ready-to-Eat,VD NUVULU CHEGODI 175GM,14,60,60,0,1
08-04-2025,"Grains, Flours & Dals",Bombay Rava 500GM,4,35,30,5,1
08-04-2025,Beverages,3ROSES,1,90,90,0,1
08-04-2025,"Grains, Flours & Dals",Multigrain 1 kg,4,100,85,15,1
08-04-2025,"Grains, Flours & Dals",Quinova 500 gms,4,110,100,10,1
08-04-2025,Spices & Seasonings,Menthulu 250 gms,15,50,45,5,1
08-04-2025,Spices & Seasonings,Turmeric powder 250 gms,15,100,75,25,1
08-04-2025,"Grains, Flours & Dals",MAAGAANI W RICE 5KGS,4,899,535,364,1
08-04-2025,Pooja & Spiritual Items,SWAATHI GATTI DEEPAM VATTULU,12,120,120,0,4
08-04-2025,Pooja & Spiritual Items,GD Aiswarya Deepam 700ML,12,390,390,0,2
08-04-2025,Pooja & Spiritual Items,PACHAKARPURAM,12,60,50,10,1
08-04-2025,Pooja & Spiritual Items,GD Bhagavatha Mallika 75GM,12,120,120,0,2
08-04-2025,Pooja & Spiritual Items,bilwa patra,12,120,120,0,2
08-04-2025,Pooja & Spiritual Items,GB Bharatha Woods 75GM,12,120,120,0,2
08-04-2025,Pooja & Spiritual Items,SWASTIK CAMPHORE,12,180,180,0,2
08-04-2025,"Dry Fruits, Nuts & Seeds",BLACK KISMIS 250GM,2,175,140,35,1
08-04-2025,"Health, Wellness & Ayurvedic Products",RB Max Protein Cheese&amp;,5,45,45,0,1
08-04-2025,Snacks & Ready-to-Eat,RITEBITE BLUEBERRY BLAST,14,50,50,0,1
08-04-2025,"Dry Fruits, Nuts & Seeds",YB GRANMA NUTS,2,90,90,0,1
08-04-2025,Snacks & Ready-to-Eat,SF COOKIES BANANA OATS,14,99,99,0,1
08-04-2025,Pooja & Spiritual Items,GD Ramayana Sandal 75GM,12,180,180,0,3
08-04-2025,Oils & Ghee,Groundnut oil 1 L,9,1440,"1,320.00",120,4
08-04-2025,"Grains, Flours & Dals",White jowar.F 1 kg,4,100,80,20,1
08-04-2025,Pooja & Spiritual Items,GD TULASI 75GM,12,60,60,0,1
08-04-2025,Oils & Ghee,Coconut oil 500 ml,9,220,200,20,1
08-04-2025,Oils & Ghee,Coconut oil 500 ml,9,220,200,20,1
08-04-2025,"Grains, Flours & Dals",BOMBAY RAVA,4,70,55,15,1
08-04-2025,"Grains, Flours & Dals",Wheat Flour 1 kg,4,70,60,10,1
08-04-2025,"Dry Fruits, Nuts & Seeds",Putnalu 250GM,2,45,38,7,1
08-04-2025,"Dry Fruits, Nuts & Seeds",FLAX SEEDS 250GM,2,60,50,10,1
08-04-2025,"Grains, Flours & Dals",SRILALITHA MAIDA FLOUR 500G,4,32,32,0,1
08-04-2025,Milk & Dairy,HERITAGE TONED MILK 500ML,7,31,31,0,1
08-04-2025,"Grains, Flours & Dals",Red Chana 500 GM,4,75,60,15,1
08-04-2025,"Dry Fruits, Nuts & Seeds",Groundnuts 500 gms,2,95,85,10,1
08-04-2025,"Grains, Flours & Dals",URAD DALL,4,95,85,10,1
08-04-2025,"Grains, Flours & Dals",RAGI FLOUR 500GRMS,4,40,35,5,1
08-04-2025,"Dry Fruits, Nuts & Seeds",ALMONDS 250GM,2,280,260,20,1
08-04-2025,Spices & Seasonings,NUVVULU 250GM,15,100,85,15,1
08-04-2025,Spices & Seasonings,Masala Karam 250 gms,15,130,120,10,1
08-04-2025,Oils & Ghee,Groundnut oil 1 L,9,360,330,30,1
08-04-2025,Oils & Ghee,Sesame oil 500ml,9,295,280,15,1
08-04-2025,Snacks & Ready-to-Eat,VD PALLI CHIKKI,14,80,80,0,1
08-04-2025,"Grains, Flours & Dals",RAGI FLOUR 500GRMS,4,40,35,5,1
08-04-2025,Snacks & Ready-to-Eat,VD NUVULLU CHIKKI,14,80,80,0,1
08-04-2025,Oils & Ghee,Safflower oil 1 L,9,440,400,40,1
08-04-2025,"Grains, Flours & Dals",Wheat Flour 1 kg,4,70,60,10,1
08-04-2025,Oils & Ghee,Coconut oil 500 ml,9,440,400,40,2
08-04-2025,"Grains, Flours & Dals",chana flour 500 gms,4,60,54,6,1
08-04-2025,Snacks & Ready-to-Eat,sannakarampusa,14,60,60,0,1
08-04-2025,Milk & Dairy,BROWN EGGS 1P,7,168,144,24,12
08-04-2025,Oils & Ghee,Coconut oil 1 L,9,440,400,40,1
08-04-2025,Spices & Seasonings,LG 50GM,15,92,92,0,1
08-04-2025,Oils & Ghee,Sesame oil 1 L,9,1180,"1,120.00",60,2
08-04-2025,"Grains, Flours & Dals",PRO ORG RED POHA 500GM,4,89,89,0,1
08-04-2025,Oils & Ghee,Mustard oil 1 L,9,440,400,40,1
08-04-2025,"Grains, Flours & Dals",BARLEY SEEDS 500 GM,4,90,70,20,1
08-04-2025,Personal Care & Cosmetics,MADDI BATH POWDER 400GM,10,150,150,0,1
08-04-2025,Personal Care & Cosmetics,KHADI COCONUT,10,90,90,0,1
08-04-2025,"Grains, Flours & Dals",MELMEKER 250GMS,4,60,45,15,1
08-04-2025,Personal Care & Cosmetics,MD Soapnut Choornam 100GM,10,80,80,0,1
08-04-2025,"Grains, Flours & Dals",Green gram 1 kg,4,150,130,20,1
08-04-2025,Spices & Seasonings,Coriander seeds 200 gms,15,48,40,8,1
08-04-2025,"Grains, Flours & Dals",Chana Flour 500 gms,4,120,108,12,1
08-04-2025,Oils & Ghee,Safflower oil 1 L,9,440,400,40,1
08-04-2025,"Grains, Flours & Dals",Em jowar idly R 500G,4,75,75,0,1
08-04-2025,Oils & Ghee,Groundnut oil 1 L,9,360,330,30,1
08-04-2025,Oils & Ghee,Groundnut oil 1 L,9,720,660,60,2
08-04-2025,Oils & Ghee,BUFFALLO GHEE 500ML,9,410,370,40,1
08-04-2025,"Grains, Flours & Dals",Wheat Flour 1 kg,4,140,120,20,2
08-04-2025,"Grains, Flours & Dals",RAJMA 500GM,4,200,180,20,2
08-04-2025,"Grains, Flours & Dals",Black RICE 1 KG,4,680,620,60,2
08-04-2025,"Grains, Flours & Dals",RAGI FLOUR 1KG,4,160,140,20,2
08-04-2025,"Grains, Flours & Dals",RAGI FLOUR 1KG,4,160,140,20,2
08-04-2025,"Grains, Flours & Dals",YB BLACK RICE 500GM,4,300,300,0,2
08-04-2025,"Grains, Flours & Dals",RAJMA 500GM,4,200,180,20,2
08-04-2025,Snacks & Ready-to-Eat,JUNNU POWDER 100GM,14,420,420,0,6
08-04-2025,Spices & Seasonings,NUVVULU 500GM,15,400,340,60,2
08-04-2025,Sweeteners,SUGAR 1KG,16,120,100,20,2
08-04-2025,"Dry Fruits, Nuts & Seeds",Groundnuts 1 kg,2,190,165,25,1
08-04-2025,"Dry Fruits, Nuts & Seeds",PUTNALU 500GMS,2,90,76,14,1
08-04-2025,Snacks & Ready-to-Eat,RI SPORTS BAR 40G,14,90,90,0,2
08-04-2025,Oils & Ghee,Sesame oil 1 L,9,590,560,30,1
08-04-2025,"Grains, Flours & Dals",split black gram 1 kg,4,360,340,20,2
08-04-2025,Spices & Seasonings,MASALA KAR 500GMS,15,260,240,20,1
08-04-2025,"Grains, Flours & Dals",yellow jowar flour 1kg,4,200,184,16,2
08-04-2025,Snacks & Ready-to-Eat,BROWN BREAD,14,55,55,0,1
08-04-2025,Milk & Dairy,ID PANEER,7,135,135,0,1
08-04-2025,Household & Cleaning,comfort lily fresh,6,58,58,0,1
08-04-2025,"Grains, Flours & Dals",Bombay Rava 500GM,4,35,30,5,1
08-04-2025,Pooja & Spiritual Items,GD Aiswarya Deepam 700ML,12,195,195,0,1
08-04-2025,Snacks & Ready-to-Eat,VD MULTI CHAKKA,14,110,110,0,1
08-04-2025,General Household & Kitchenware,RED LINE 20GM,3,75,75,0,1
08-04-2025,Sweeteners,YB JAGGERY POWDER 500GMS,16,75,75,0,1
08-04-2025,"Dry Fruits, Nuts & Seeds",Groundnuts 500 gms,2,95,85,10,1
08-04-2025,Personal Care & Cosmetics,MYSORE SANDAL SOAP 75G,10,84,84,0,2
08-04-2025,Snacks & Ready-to-Eat,DOSA BATTER 1KG,14,60,60,0,1
08-04-2025,Beverages,BRU GREEN LABEL 1.2G,1,48,48,0,24
08-04-2025,Spices & Seasonings,RED COPRA 250GMS,15,85,74,11,1
08-04-2025,Oils & Ghee,Sesame oil 500ml,9,295,280,15,1
08-04-2025,Oils & Ghee,Groundnut oil 500ml,9,180,165,15,1
08-04-2025,Oils & Ghee,Castor oil 200 ml,9,100,80,20,1
08-04-2025,Oils & Ghee,Groundnut oil 500ml,9,180,165,15,1
08-04-2025,"Grains, Flours & Dals",Wheat Rava M 1KG,4,65,55,10,1
08-04-2025,Pooja & Spiritual Items,SWASTIK CAMPHORE,12,180,180,0,2
08-04-2025,Oils & Ghee,Sesame oil 500ml,9,295,280,15,1
08-04-2025,Snacks & Ready-to-Eat,VD MINAPA VADIYAM,14,65,65,0,1
08-04-2025,Oils & Ghee,Safflower oil 500 ml,9,220,200,20,1
08-04-2025,Snacks & Ready-to-Eat,ONION RINGS,14,50,50,0,1
08-04-2025,Oils & Ghee,Coconut oil 500 ml,9,220,200,20,1
08-04-2025,Snacks & Ready-to-Eat,VD MANGO JELLY 250GRMS,14,80,80,0,1
08-04-2025,"Grains, Flours & Dals",PESARA PAPPU 500GMS,4,85,75,10,1
08-04-2025,"Grains, Flours & Dals",Wheat Flour 1 kg,4,70,60,10,1
08-04-2025,Spices & Seasonings,Jeera 100GM,15,50,45,5,1
08-04-2025,"Grains, Flours & Dals",Multigrain 1 kg,4,100,85,15,1
08-04-2025,Pooja & Spiritual Items,GD Bhagavatha Mallika 75GM,12,60,60,0,1
08-04-2025,Pooja & Spiritual Items,PACHAKARPURAM,12,60,50,10,1
08-04-2025,Pooja & Spiritual Items,VRP APOORVA JAVADHU POW,12,35,35,0,1
08-04-2025,Snacks & Ready-to-Eat,VD MURMURA LADDU,14,50,50,0,1
08-04-2025,Personal Care & Cosmetics,MYSORE SANDAL SOAP 75G,10,42,42,0,1
08-04-2025,Snacks & Ready-to-Eat,RSC ORANGE 100GMS,14,20,20,0,1
08-04-2025,"Grains, Flours & Dals",turdal 500 gms,4,110,85,25,1
08-04-2025,Snacks & Ready-to-Eat,VD MINAPA VADIYAM,14,65,65,0,1
08-04-2025,Snacks & Ready-to-Eat,Popcorn Seeds 250GM,14,45,40,5,1
08-04-2025,Spices & Seasonings,AVALU 100GM,15,25,20,5,1
08-04-2025,Snacks & Ready-to-Eat,VD GUMMADI VADIYAM,14,75,75,0,1
08-04-2025,Pooja & Spiritual Items,GD TULASI 75GM,12,60,60,0,1
08-04-2025,Pooja & Spiritual Items,bilwa patra,12,60,60,0,1
08-04-2025,Pooja & Spiritual Items,GD Dhoop Sticks 26GM,12,40,40,0,2
08-04-2025,Snacks & Ready-to-Eat,PEANUT CHILLI,14,10,10,0,2
08-04-2025,Sweeteners,YB JAGGERY POWDER 500GMS,16,75,75,0,1
08-04-2025,Pooja & Spiritual Items,GD Kumkum 50GM,12,60,60,0,2
08-04-2025,"Grains, Flours & Dals",Arikadu ( kodo),4,140,130,10,1
08-04-2025,Baking & Cooking Aids,GONDKATIRA Ag,0,85,75,10,1
08-04-2025,"Grains, Flours & Dals",Sathya Javva Wheat Rava 500GM,4,90,90,0,1
08-04-2025,"Dry Fruits, Nuts & Seeds",SD SUNFLOWER SEEDS WITH DATES,2,135,135,0,1
08-04-2025,Pooja & Spiritual Items,GD Aiswarya Deepam 700ML,12,195,195,0,1
08-04-2025,"Grains, Flours & Dals",UDALU (Barnyard millet) 1 kg,4,140,115,25,1
08-04-2025,Snacks & Ready-to-Eat,MAAGAANI JOWAR M COOKIES 120GM,14,149,149,0,1
08-04-2025,"Grains, Flours & Dals",HS JOWAR FLAKES 250GM 1+1,4,119,119,0,1
08-04-2025,Oils & Ghee,Groundnut oil 5 L,9,1800,"1,600.00",200,1
08-04-2025,Snacks & Ready-to-Eat,SD High Protein Laddu 175gm,14,190,190,0,1
08-04-2025,"Grains, Flours & Dals",KORRALU (FOXTAIL M) 1KG,4,150,110,40,1
08-04-2025,Pooja & Spiritual Items,GD Ramayana Sandal 75GM,12,60,60,0,1
08-04-2025,Oils & Ghee,Groundnut oil 1 L,9,360,330,30,1
08-04-2025,Snacks & Ready-to-Eat,GS Instant Raagi Dosa Mix 400GM,14,297,297,0,3
08-04-2025,Snacks & Ready-to-Eat,VD Pappu Chekkalu 190gm,14,60,60,0,1
08-04-2025,"Dry Fruits, Nuts & Seeds",SD Mango cubes 100gm,2,45,45,0,1
08-04-2025,Snacks & Ready-to-Eat,GS INSTANT KORRA DOSA MIX 400GM,14,120,120,0,1
08-04-2025,Snacks & Ready-to-Eat,VD PALLI CHIKKI,14,80,80,0,1
08-04-2025,Oils & Ghee,Safflower oil 1 L,9,440,400,40,1
08-04-2025,"Grains, Flours & Dals",VYS.SP RICE 1 KG,4,700,650,50,10
08-04-2025,"Grains, Flours & Dals",chana flour 500 gms,4,60,54,6,1
08-04-2025,Oils & Ghee,Groundnut oil 1 L,9,360,330,30,1
08-04-2025,Pooja & Spiritual Items,GD TULASI 75GM,12,60,60,0,1
08-04-2025,"Dry Fruits, Nuts & Seeds",SUNFLOWER SEEDS 250GRM,2,150,130,20,1
08-04-2025,"Dry Fruits, Nuts & Seeds",PLAIN PISTA 250GM,2,660,550,110,1
08-04-2025,"Dry Fruits, Nuts & Seeds",PUMPKIN SEEDS 250GM,2,200,160,40,1
08-04-2025,"Dry Fruits, Nuts & Seeds",WATERMELON SEEDS 250GRM,2,320,280,40,1
08-04-2025,"Dry Fruits, Nuts & Seeds",cashew,2,340,310,30,1
08-04-2025,Oils & Ghee,Safflower oil 5 L,9,2200,"1,950.00",250,1
08-04-2025,"Dry Fruits, Nuts & Seeds",ALMONDS 250GM,2,280,260,20,1
08-04-2025,"Dry Fruits, Nuts & Seeds",FLAX SEEDS 250GM,2,60,50,10,1
08-04-2025,Snacks & Ready-to-Eat,DISANO VERMICELLI 425 GM,14,50,50,0,1
08-04-2025,Spices & Seasonings,Vamu 100GM,15,60,50,10,1
08-04-2025,"Dry Fruits, Nuts & Seeds",SABJA SEEDS 100GM,2,80,70,10,1
08-04-2025,"Grains, Flours & Dals",idly rava 1kg,4,60,50,10,1
08-04-2025,"Grains, Flours & Dals",Wheat Flour 1 kg,4,70,60,10,1
08-04-2025,"Grains, Flours & Dals",SPLIT URAD DAL,4,45,45,0,1
08-04-2025,"Grains, Flours & Dals",turdal 1kg,4,440,340,100,2
08-04-2025,Snacks & Ready-to-Eat,VD BELLAM GAVVALU 200GM,14,60,60,0,1
08-04-2025,"Grains, Flours & Dals",SRILATHA RICE RAVVA 500GM,4,70,70,0,2
08-04-2025,"Grains, Flours & Dals",BOMBAY RAVA,4,70,55,15,1
08-04-2025,"Grains, Flours & Dals",chana flour 500 gms,4,60,54,6,1
08-04-2025,"Health, Wellness & Ayurvedic Products",RB Max Protein DESI MASALA 60gm,5,45,45,0,1
08-04-2025,Spices & Seasonings,Jeera 100GM,15,50,45,5,1
08-04-2025,Spices & Seasonings,AVALU 100GM,15,25,20,5,1
08-04-2025,"Health, Wellness & Ayurvedic Products",MXP CREAM ONION,5,45,45,0,1
08-04-2025,Spices & Seasonings,ROYAL SAFFRON 400GRMS,15,65,65,0,1
08-04-2025,Beverages,BRU GREEN LABEL 1.2G,1,2.01,2.01,0,1.005
08-04-2025,"Grains, Flours & Dals",CHANA DAL 500GM,4,56,48,8,1
08-04-2025,Sweeteners,SUGAR 500 GM,16,120,100,20,4
08-04-2025,"Grains, Flours & Dals",CORN FOUR 250GM,4,40,35,5,1
08-04-2025,"Grains, Flours & Dals",SABDANA,4,40,35,5,1
08-04-2025,"Grains, Flours & Dals",Urad dall 1 Kg,4,370,340,30,2
08-04-2025,Pooja & Spiritual Items,GD Dhoop Sticks 26GM,12,20,20,0,1
08-04-2025,"Dry Fruits, Nuts & Seeds",YELLOW KISHMISH 250GM,2,130,110,20,1
08-04-2025,"Dry Fruits, Nuts & Seeds",Groundnuts 1 kg,2,190,165,25,1
08-04-2025,Snacks & Ready-to-Eat,ANNAPURNA APPALAM,14,35,35,0,1
08-04-2025,Snacks & Ready-to-Eat,VD PALLI CHIKKI,14,80,80,0,1
08-04-2025,Pooja & Spiritual Items,SWASTIK CAMPHORE,12,90,90,0,1
08-04-2025,Snacks & Ready-to-Eat,VD GUMMADI VADIYAM,14,75,75,0,1
08-04-2025,"Grains, Flours & Dals",maida 500grms,4,35,30,5,1
08-04-2025,"Grains, Flours & Dals",RICE FLOUR 500 GM,4,35,28,7,1
08-04-2025,Snacks & Ready-to-Eat,VD MURMURA LADDU,14,50,50,0,1
08-04-2025,Pooja & Spiritual Items,BALAJI KASTURI DHOOP STICKS,12,70,70,0,1
08-04-2025,Spices & Seasonings,AV Iodized Salt 1KG,15,56,50,6,2
08-04-2025,Oils & Ghee,Groundnut oil 1 L,9,360,330,30,1
08-04-2025,Household & Cleaning,VIM MAHA BAR,6,50,50,0,5
08-04-2025,Household & Cleaning,VIM EXTRA 110GM,6,50,50,0,5
08-04-2025,Personal Care & Cosmetics,MD Bath Powder 100GM,10,40,40,0,1
08-04-2025,"Grains, Flours & Dals",PRO ORG RED POHA 500GM,4,89,89,0,1
08-04-2025,"Grains, Flours & Dals",MAAGAANI W RICE 5KGS,4,899,535,364,1
08-04-2025,Spices & Seasonings,NUVVULU 250GM,15,80,65,15,1
08-04-2025,"Grains, Flours & Dals",Red Bobarlu 500 gms,4,95,85,10,1
08-04-2025,"Grains, Flours & Dals",Multigrain 1 kg,4,300,255,45,3
08-04-2025,Snacks & Ready-to-Eat,BB VERMICELLI 1KG,14,95,90,5,1
08-04-2025,"Grains, Flours & Dals",Green gram 1 kg,4,150,130,20,1
08-04-2025,Snacks & Ready-to-Eat,SD Groundnut with palm jaggery 250gm,14,135,135,0,1
08-04-2025,Oils & Ghee,Sesame oil 500ml,9,295,280,15,1
08-04-2025,Snacks & Ready-to-Eat,FOXTAIL BIS,14,135,135,0,1
08-04-2025,Snacks & Ready-to-Eat,VD JAGGERY GHEE 250GM,14,80,80,0,1
08-04-2025,Snacks & Ready-to-Eat,SD Vamu with palm jaggery 250gm,14,135,135,0,1
08-04-2025,Snacks & Ready-to-Eat,VD MANGO JELLY 250GRMS,14,80,80,0,1
08-04-2025,Oils & Ghee,Groundnut oil 500ml,9,180,165,15,1
08-04-2025,Snacks & Ready-to-Eat,VD MURMURA LADDU,14,50,50,0,1
08-04-2025,Oils & Ghee,A2 BUFFALO GHEE 250ML,9,299,299,0,1
08-04-2025,Oils & Ghee,Safflower oil 500 ml,9,220,200,20,1
08-04-2025,Spices & Seasonings,RED COPRA 250GMS,15,85,74,11,1
08-04-2025,"Grains, Flours & Dals",BASMATHI RICE 1KG,4,150,135,15,1
08-04-2025,Oils & Ghee,Groundnut oil 1 L,9,360,330,30,1
08-04-2025,"Health, Wellness & Ayurvedic Products",HARITHAKI CHOORNAM,5,60,60,0,1
08-04-2025,Household & Cleaning,HERBAL LIQ DISH WASH 500ML,6,170,170,0,1
08-04-2025,"Grains, Flours & Dals",chana flour 500 gms,4,60,54,6,1
08-04-2025,"Health, Wellness & Ayurvedic Products",MD Aamlaki Choornam 100GM,5,80,80,0,1
08-04-2025,Spices & Seasonings,PRO ORG AJWAIN 100G,15,105,105,0,1
08-04-2025,Snacks & Ready-to-Eat,SATHVI REGIVADA 200GM,14,80,60,20,1
08-04-2025,"Dry Fruits, Nuts & Seeds",SATHVI CHIA SEEDS 100GM,2,200,160,40,2
08-04-2025,General Household & Kitchenware,chalk piece 1b,3,30,20,10,2
08-04-2025,Snacks & Ready-to-Eat,VD Minapa papad 200gm,14,60,60,0,1
08-04-2025,Spices & Seasonings,Black Till 250GM,15,90,75,15,1
08-04-2025,Spices & Seasonings,PRO ORG FENUGREEK 200GM,15,86,86,0,1
08-04-2025,Snacks & Ready-to-Eat,VD GUMMADI VADIYAM,14,75,75,0,1
08-04-2025,"Dry Fruits, Nuts & Seeds",YELLOW KISHMISH 250GM,2,130,110,20,1
08-04-2025,General Household & Kitchenware,GOOD HOME,3,15,15,0,1
08-04-2025,Snacks & Ready-to-Eat,VD DAHI MIRCHI(SALTED) 100GM,14,45,45,0,1
08-04-2025,"Grains, Flours & Dals",CHANA DAL 500GM,4,56,48,8,1
08-04-2025,"Dry Fruits, Nuts & Seeds",Groundnuts 1 kg,2,190,165,25,1
08-04-2025,Snacks & Ready-to-Eat,ANNAPURNA APPALAM,14,35,35,0,1
08-04-2025,"Grains, Flours & Dals",Green gram 500 gms,4,75,70,5,1
08-04-2025,"Dry Fruits, Nuts & Seeds",Putnalu 250GM,2,45,38,7,1
08-04-2025,"Grains, Flours & Dals",BOMBAY RAVA,4,70,55,15,1
08-04-2025,"Grains, Flours & Dals",Multigrain 1 kg,4,100,85,15,1
08-04-2025,"Grains, Flours & Dals",SRILATHA RICE RAVVA 500GM,4,70,70,0,2
08-04-2025,"Grains, Flours & Dals",THICK POHA 1KG,4,80,70,10,1
08-04-2025,Spices & Seasonings,idli karam powdwer,15,195,195,0,3
08-04-2025,"Grains, Flours & Dals",RICE FLOUR 500 GM,4,210,168,42,6
08-04-2025,"Grains, Flours & Dals",SB Javva Wheat Ravva 500GM,4,190,190,0,2
08-04-2025,"Grains, Flours & Dals",Green Batani 500GM,4,110,90,20,1
08-04-2025,"Grains, Flours & Dals",Urad dall 1 Kg,4,370,340,30,2
08-04-2025,"Grains, Flours & Dals",RED TUDAL 1KG,4,150,140,10,1
08-04-2025,"Grains, Flours & Dals",CHANA DAL 500GM,4,56,48,8,1
08-04-2025,"Dry Fruits, Nuts & Seeds",Groundnuts 1 kg,2,190,165,25,1
08-04-2025,Snacks & Ready-to-Eat,VD NUVULLU CHIKKI,14,80,80,0,1
08-04-2025,"Grains, Flours & Dals",chana flour 500 gms,4,60,54,6,1
08-04-2025,"Grains, Flours & Dals",BOMBAY RAVA,4,140,110,30,2
08-04-2025,Snacks & Ready-to-Eat,NGT CHATPATTA CHANA 90GM,14,25,25,0,1
08-04-2025,"Grains, Flours & Dals",RICE FLOUR 1KG,4,70,55,15,1
08-04-2025,Pooja & Spiritual Items,GD Aiswarya Deepam 700ML,12,195,195,0,1
08-04-2025,"Grains, Flours & Dals",BARLY POWDER,4,40,40,0,1
08-04-2025,"Dry Fruits, Nuts & Seeds",PN ORGANIC MAKHANA 50GM,2,125,125,0,1
08-04-2025,"Grains, Flours & Dals",VGR rice 1 kg,4,70,65,5,1
08-04-2025,Personal Care & Cosmetics,Soapnut 250GM,10,60,45,15,1
08-04-2025,Snacks & Ready-to-Eat,VD ATUKULU MIXTURE 175GM,14,60,60,0,1
08-04-2025,Snacks & Ready-to-Eat,BIKANERI PAPAD,14,170,160,10,1
08-04-2025,Household & Cleaning,vim dish liquid,6,55,55,0,1
08-04-2025,"Grains, Flours & Dals",VYS.SP RICE 1 KG,4,140,130,10,2
08-04-2025,Oils & Ghee,Sesame oil 1 L,9,1770,"1,680.00",90,3
08-04-2025,Oils & Ghee,Groundnut oil 1 L,9,360,330,30,1
08-04-2025,Pooja & Spiritual Items,GD Bhagavatha Mallika 75GM,12,60,60,0,1
08-04-2025,Pooja & Spiritual Items,divya deeparadhana oil,12,190,190,0,1
08-04-2025,"Grains, Flours & Dals",AISHWARYA SP 1KG,4,800,700,100,10
08-04-2025,Milk & Dairy,BROWN EGGS 1P,7,168,144,24,12
08-04-2025,"Grains, Flours & Dals",Wheat Flour 1 kg,4,70,60,10,1
08-04-2025,Snacks & Ready-to-Eat,VD BELLAM GAVVALU 200GM,14,60,60,0,1
08-04-2025,Personal Care & Cosmetics,OVAL BODY LOOFAH,10,55,55,0,1
08-04-2025,General Household & Kitchenware,chalk piece 1b,3,60,40,20,4
08-04-2025,Milk & Dairy,BROWN EGGS TRAY 30P,7,360,330,30,1
08-04-2025,Snacks & Ready-to-Eat,VD NUVVULU LADDU,14,80,80,0,1
08-04-2025,"Grains, Flours & Dals",Wheat Flour 1 kg,4,70,60,10,1
08-04-2025,Personal Care & Cosmetics,OVAL BODY LOOFAH,10,55,55,0,1
08-04-2025,"Grains, Flours & Dals",Wheat Flour 1 kg,4,70,60,10,1
08-04-2025,"Grains, Flours & Dals",SABDANA 500GM,4,90,70,20,1
08-04-2025,Personal Care & Cosmetics,Soapnut 500GM,10,120,90,30,1
08-04-2025,Spices & Seasonings,Menthulu 250 gms,15,50,45,5,1
08-04-2025,Spices & Seasonings,ROYAL SAFFRON 400GRMS,15,65,65,0,1
08-04-2025,Oils & Ghee,mustard oil,9,195,195,0,1
08-04-2025,Snacks & Ready-to-Eat,PEANUT CHIKKI 450GM,14,125,125,0,1
08-04-2025,"Grains, Flours & Dals",Red Chana 500 GM,4,75,60,15,1
08-04-2025,"Grains, Flours & Dals",White Chana 500GM,4,120,100,20,1
08-04-2025,"Grains, Flours & Dals",Multigrain 1 kg,4,100,85,15,1
08-04-2025,"Grains, Flours & Dals",chana flour 500 gms,4,60,54,6,1
08-04-2025,Milk & Dairy,HERTG FULL CREAM M,7,41,41,0,1
08-04-2025,Milk & Dairy,SANGAM TONED MILK 500ML,7,30,30,0,1
08-04-2025,"Grains, Flours & Dals",JOWAR UPMA RAVA,4,65,65,0,1
08-04-2025,"Grains, Flours & Dals",RAGI FLOUR 500GRMS,4,40,35,5,1
08-04-2025,Milk & Dairy,BROWN EGGS 1P,7,56,48,8,4
08-04-2025,Sweeteners,YB JAGGERY POWDER 500GMS,16,75,75,0,1
08-04-2025,Milk & Dairy,BROWN EGGS 1P,7,84,72,12,6
08-04-2025,Oils & Ghee,Sesame oil 500ml,9,295,280,15,1
08-04-2025,"Grains, Flours & Dals",rice ravva sri,4,35,35,0,1
08-04-2025,Snacks & Ready-to-Eat,HS Ragi biscuits,14,50,50,0,1
08-04-2025,"Grains, Flours & Dals",UDALU (Barnyard millet) 1 kg,4,280,230,50,2
08-04-2025,"Grains, Flours & Dals",SAMALU,4,170,130,40,1
08-04-2025,"Grains, Flours & Dals",HS MULTI UPMA RAVA,4,65,65,0,1
08-04-2025,Personal Care & Cosmetics,ORAL B KIDS,10,25,25,0,1
08-04-2025,"Grains, Flours & Dals",SAMALU,4,170,130,40,1
08-04-2025,"Grains, Flours & Dals",Arikadu ( kodo),4,140,130,10,1
08-04-2025,"Grains, Flours & Dals",Wheat Flour 1 kg,4,70,60,10,1
08-04-2025,Milk & Dairy,HERITAGE TOTAL CURD 500GM,7,50,50,0,1
08-04-2025,"Grains, Flours & Dals",SINGLE POLISH 1KG,4,325,325,0,5
08-04-2025,Spices & Seasonings,NUVVULU 500GM,15,400,340,60,2
08-04-2025,"Dry Fruits, Nuts & Seeds",Groundnuts 1 kg,2,190,165,25,1
08-04-2025,"Dry Fruits, Nuts & Seeds",PUTNALU 500GMS,2,90,76,14,1
08-04-2025,Sweeteners,SUGAR 1KG,16,120,100,20,2
08-04-2025,Snacks & Ready-to-Eat,JUNNU POWDER 100GM,14,350,350,0,5
07-04-2025,Oils & Ghee,Coconut oil 500 ml,9,220,200,20,1
07-04-2025,"Grains, Flours & Dals",Multigrain 1 kg,4,100,85,15,1
07-04-2025,Snacks & Ready-to-Eat,CHOCO BROWINE,14,20,20,0,1
07-04-2025,"Dry Fruits, Nuts & Seeds",PULMAKHANA 100 GM,2,180,170,10,1
07-04-2025,"Grains, Flours & Dals",Chana Flour 500 gms,4,120,108,12,1
07-04-2025,Personal Care & Cosmetics,MADDI HIBISCUS HAIR SHAMPOO 500ML,10,300,300,0,1
07-04-2025,Oils & Ghee,Groundnut oil 1 L,9,720,660,60,2
07-04-2025,Snacks & Ready-to-Eat,SATHVI REGIVADA 200GM,14,80,60,20,1
07-04-2025,Snacks & Ready-to-Eat,PUMPKIN CHIKKI 200GM,14,140,120,20,1
07-04-2025,"Dry Fruits, Nuts & Seeds",PLAIN PISTA 250GM,2,660,550,110,1
07-04-2025,"Dry Fruits, Nuts & Seeds",SUNFLOWER SEEDS 250GRM,2,150,130,20,1
07-04-2025,"Grains, Flours & Dals",MELMEKER 250GMS,4,60,45,15,1
07-04-2025,"Dry Fruits, Nuts & Seeds",Groundnuts 1 kg,2,190,165,25,1
07-04-2025,"Dry Fruits, Nuts & Seeds",wallnuts,2,380,320,60,1
07-04-2025,"Dry Fruits, Nuts & Seeds",PUMPKIN SEEDS 250GM,2,200,160,40,1
07-04-2025,Snacks & Ready-to-Eat,HS Ragi biscuits,14,50,50,0,1
07-04-2025,"Grains, Flours & Dals",Wheat Rava M 1KG,4,65,55,10,1
07-04-2025,Oils & Ghee,Sesame oil 1 L,9,590,560,30,1
07-04-2025,Oils & Ghee,Safflower oil 1 L,9,440,400,40,1
07-04-2025,"Grains, Flours & Dals",RAGI FLOUR 500GRMS,4,40,35,5,1
07-04-2025,Snacks & Ready-to-Eat,GREEN FRIED batana,14,40,40,0,2
07-04-2025,Snacks & Ready-to-Eat,VD Pappu Chekkalu 190gm,14,60,60,0,1
07-04-2025,Snacks & Ready-to-Eat,Popcorn Seeds 250GM,14,45,40,5,1
07-04-2025,"Grains, Flours & Dals",MELMEKER 250GMS,4,60,45,15,1
07-04-2025,"Grains, Flours & Dals",White jowar.F 1 kg,4,100,80,20,1
07-04-2025,"Dry Fruits, Nuts & Seeds",DRYDATES 250GM,2,150,120,30,1
07-04-2025,"Dry Fruits, Nuts & Seeds",ALMONDS 250GM,2,280,260,20,1
07-04-2025,"Grains, Flours & Dals",Wheat Flour 1 kg,4,70,60,10,1
07-04-2025,Snacks & Ready-to-Eat,SATHVI REGIVADA 200GM,14,160,120,40,2
07-04-2025,Snacks & Ready-to-Eat,NGT CHATPATTA CHANA 90GM,14,25,25,0,1
07-04-2025,"Dry Fruits, Nuts & Seeds",SATHVI CHIA SEEDS 100GM,2,100,80,20,1
07-04-2025,"Dry Fruits, Nuts & Seeds",SUNFLOWER SEEDS 250GRM,2,150,130,20,1
07-04-2025,Spices & Seasonings,KALONJI SEEDS,15,90,80,10,1
07-04-2025,Personal Care & Cosmetics,OVAL BODY LOOFAH,10,55,55,0,1
07-04-2025,"Dry Fruits, Nuts & Seeds",FLAX SEEDS 250GM,2,60,50,10,1
07-04-2025,"Dry Fruits, Nuts & Seeds",YB GRANMA NUTS,2,90,90,0,1
07-04-2025,Snacks & Ready-to-Eat,VD NUVVULU LADDU,14,160,160,0,2
07-04-2025,"Dry Fruits, Nuts & Seeds",WATERMELON SEEDS 250GRM,2,320,280,40,1
07-04-2025,Snacks & Ready-to-Eat,HS JOWAR BISCUITS,14,50,50,0,1
07-04-2025,Snacks & Ready-to-Eat,HS Ragi biscuits,14,150,150,0,3
07-04-2025,"Dry Fruits, Nuts & Seeds",PUMPKIN SEEDS 250GM,2,200,160,40,1
07-04-2025,Oils & Ghee,Groundnut oil 1 L,9,720,660,60,2
07-04-2025,"Grains, Flours & Dals",SL Idly Rava 1KG,4,65,55,10,1
07-04-2025,"Grains, Flours & Dals",SRILATHA RICE RAVVA 500GM,4,35,35,0,1
07-04-2025,Snacks & Ready-to-Eat,VD NUVULLU CHIKKI,14,80,80,0,1
07-04-2025,"Grains, Flours & Dals",SRILATHA RICE RAVVA 500GM,4,35,35,0,1
07-04-2025,"Grains, Flours & Dals",Arikadu ( kodo),4,140,130,10,1
07-04-2025,Snacks & Ready-to-Eat,PUMPKIN CHIKKI 200GM,14,280,240,40,2
07-04-2025,"Dry Fruits, Nuts & Seeds",SUNFLOWER SEEDS 250GRM,2,150,130,20,1
07-04-2025,Snacks & Ready-to-Eat,NGT CHATPATTA CHANA 90GM,14,25,25,0,1
07-04-2025,Snacks & Ready-to-Eat,SD Moringa with plam jaggery 250gm,14,135,135,0,1
07-04-2025,"Grains, Flours & Dals",RAGI FLOUR 1KG,4,80,70,10,1
07-04-2025,"Grains, Flours & Dals",UDALU (Barnyard millet) 1 kg,4,140,115,25,1
07-04-2025,"Grains, Flours & Dals",SAMALU,4,170,130,40,1
07-04-2025,Pickles & Cooking Pastes,SD GINGER PICKLE 250GM,11,110,110,0,1
07-04-2025,"Dry Fruits, Nuts & Seeds",PUMPKIN SEEDS 250GM,2,200,160,40,1
07-04-2025,"Grains, Flours & Dals",KORRALU (FOXTAIL M) 1KG,4,150,110,40,1
07-04-2025,Snacks & Ready-to-Eat,VD RICE PAPAD 150GM,14,50,50,0,1
07-04-2025,"Dry Fruits, Nuts & Seeds",PULMAKHANA 100 GM,2,180,170,10,1
07-04-2025,Milk & Dairy,HERITAGE TONED MILK 500ML,7,31,31,0,1
07-04-2025,Milk & Dairy,SANGAM TONED MILK 500ML,7,93,93,0,3
07-04-2025,Spices & Seasonings,Vamu 100GM,15,60,50,10,1
07-04-2025,Beverages,REFRESH SHARBATH SUGAR FREE,1,299,285,14,1
07-04-2025,"Dry Fruits, Nuts & Seeds",D kimia,2,310,180,130,1
07-04-2025,Oils & Ghee,Groundnut oil 1 L,9,360,330,30,1
07-04-2025,Oils & Ghee,Safflower oil 1 L,9,440,400,40,1
07-04-2025,"Grains, Flours & Dals",turdal 1kg,4,220,170,50,1
07-04-2025,Oils & Ghee,Safflower oil 1 L,9,880,800,80,2
07-04-2025,Oils & Ghee,Groundnut oil 1 L,9,360,330,30,1
07-04-2025,Snacks & Ready-to-Eat,VD RED CHILLI RICEPAPAD 150GM,14,50,50,0,1
07-04-2025,Spices & Seasonings,DURGA SALT CRYSTAL 1KG,15,25,25,0,1
07-04-2025,"Grains, Flours & Dals",BASMATHI RICE 1KG,4,150,135,15,1
07-04-2025,"Grains, Flours & Dals",Brown RICE 1KG,4,350,325,25,5
07-04-2025,Oils & Ghee,GANTASALA A2 COW GHEE 250ML,9,299,299,0,1
07-04-2025,Oils & Ghee,Safflower oil 1 L,9,440,400,40,1
07-04-2025,"Grains, Flours & Dals",Wheat Flour 1 kg,4,70,60,10,1
07-04-2025,"Grains, Flours & Dals",BOMBAY RAVA,4,70,55,15,1
07-04-2025,"Grains, Flours & Dals",turdal 1kg,4,220,170,50,1
07-04-2025,"Grains, Flours & Dals",Arikadu ( kodo),4,140,130,10,1
07-04-2025,"Grains, Flours & Dals",THICK POHA 500GM,4,40,35,5,1
07-04-2025,Snacks & Ready-to-Eat,Corn Chips 250GM,14,40,35,5,1
07-04-2025,"Dry Fruits, Nuts & Seeds",WATERMELON SEEDS 250GRM,2,320,280,40,1
07-04-2025,"Grains, Flours & Dals",KORRALU (FOXTAIL M) 1KG,4,150,110,40,1
07-04-2025,"Dry Fruits, Nuts & Seeds",PUMPKIN SEEDS 250GM,2,200,160,40,1
07-04-2025,"Grains, Flours & Dals",UDALU (Barnyard millet) 1 kg,4,280,230,50,2
07-04-2025,"Grains, Flours & Dals",Em little upma R 500g,4,129,129,0,1
07-04-2025,"Grains, Flours & Dals",Urad dall 1 Kg,4,185,170,15,1
07-04-2025,"Grains, Flours & Dals",Idly Rava L 1KG,4,60,50,10,1
07-04-2025,"Grains, Flours & Dals",ANDU KORRALU (Browntop.m) 1 kg,4,260,220,40,1
07-04-2025,"Grains, Flours & Dals",Em Foxtail upma r 500 g,4,109,109,0,1
07-04-2025,"Grains, Flours & Dals",Brown RICE 1KG,4,140,130,10,2
07-04-2025,"Grains, Flours & Dals",VYS.SP RICE 1 KG,4,350,325,25,5
07-04-2025,Snacks & Ready-to-Eat,GREEN FRIED BATANA,14,20,20,0,1
07-04-2025,Spices & Seasonings,KARAKAYA,15,50,30,20,1
07-04-2025,Beverages,BRU GREEN LABEL 1.2G,1,96,96,0,48
07-04-2025,Snacks & Ready-to-Eat,PEANUT CHILLI,14,15,15,0,3
07-04-2025,Snacks & Ready-to-Eat,VD BOONDI 175GM,14,60,60,0,1
07-04-2025,"Grains, Flours & Dals",Wheat Flour 1 kg,4,70,60,10,1
07-04-2025,Snacks & Ready-to-Eat,VD MANGO JELLY 250GRMS,14,180,180,0,1
07-04-2025,Snacks & Ready-to-Eat,VD CORNFLAKES MIXTURE 175GM,14,60,60,0,1
07-04-2025,Oils & Ghee,Groundnut oil 1 L,9,720,660,60,2
07-04-2025,Snacks & Ready-to-Eat,SD Atreyapuram DRY Fruit ghee,14,150,150,0,1
07-04-2025,Spices & Seasonings,Masala Karam 250 gms,15,130,120,10,1
07-04-2025,"Grains, Flours & Dals",Wheat Rava M 500GM,4,33,30,3,1
07-04-2025,"Grains, Flours & Dals",Bombay Rava 500GM,4,35,30,5,1
07-04-2025,Milk & Dairy,SANGAM TONED MILK 500ML,7,30,30,0,1
07-04-2025,"Grains, Flours & Dals",Arikalu (kodo),4,70,65,5,1
07-04-2025,"Grains, Flours & Dals",Idly Rava L 1KG,4,60,50,10,1
07-04-2025,"Grains, Flours & Dals",Urad dall 1 Kg,4,185,170,15,1
07-04-2025,"Dry Fruits, Nuts & Seeds",Groundnuts 500 gms,2,95,85,10,1
07-04-2025,Oils & Ghee,Groundnut oil 1 L,9,720,660,60,2
07-04-2025,Snacks & Ready-to-Eat,VD VAMUPUSA 175GM,14,180,180,0,3
07-04-2025,"Grains, Flours & Dals",turdal 1kg,4,220,170,50,1
07-04-2025,"Grains, Flours & Dals",Wheat Rava S 1KG,4,65,55,10,1
07-04-2025,"Dry Fruits, Nuts & Seeds",PLAIN PISTA 250GM,2,660,550,110,1
07-04-2025,"Grains, Flours & Dals",BARLEY SEEDS 250GMS,4,40,35,5,1
07-04-2025,"Dry Fruits, Nuts & Seeds",ALMONDS 250GM,2,280,260,20,1
07-04-2025,"Grains, Flours & Dals",RAGI FLOUR 1KG,4,80,70,10,1
07-04-2025,"Grains, Flours & Dals",SAMALU,4,170,130,40,1
07-04-2025,Snacks & Ready-to-Eat,MILK BREAD,14,30,30,0,1
07-04-2025,"Grains, Flours & Dals",SAMALU (Little millet) 1 kg,4,170,130,40,1
07-04-2025,Sweeteners,YB JAGGERY POWDER 500GMS,16,150,150,0,2
07-04-2025,"Grains, Flours & Dals",BOMBAY RAVA,4,70,55,15,1
07-04-2025,Spices & Seasonings,DRY MIECHI 200GM,15,80,60,20,1
07-04-2025,"Grains, Flours & Dals",Urad dall 1 Kg,4,185,170,15,1
07-04-2025,"Grains, Flours & Dals",MELMEKER 250GMS,4,60,45,15,1
07-04-2025,"Grains, Flours & Dals",white Bobarlu 500 gms,4,80,75,5,1
07-04-2025,Sweeteners,MISHRI 250 GM,16,35,30,5,1
07-04-2025,Spices & Seasonings,Turmeric powder 250 gms,15,100,75,25,1
07-04-2025,"Grains, Flours & Dals",Red Chana 500 GM,4,75,60,15,1
07-04-2025,Spices & Seasonings,Gasagasalu 50GM,15,130,110,20,1
07-04-2025,"Dry Fruits, Nuts & Seeds",Groundnuts 1 kg,2,190,165,25,1
07-04-2025,Spices & Seasonings,DHANIYA POWDER 200GM,15,100,85,15,1
07-04-2025,Spices & Seasonings,KARAKAYA,15,50,30,20,1
07-04-2025,Milk & Dairy,SANGAM TONED MILK 500ML,7,30,30,0,1
07-04-2025,Snacks & Ready-to-Eat,RSC ORANGE 100GMS,14,20,20,0,1
07-04-2025,Oils & Ghee,Groundnut oil 1 L,9,360,330,30,1
07-04-2025,"Grains, Flours & Dals",RAGI FLOUR 1KG,4,80,70,10,1
07-04-2025,Spices & Seasonings,LG 50GM,15,92,92,0,1
07-04-2025,Spices & Seasonings,Marati Magga 50GM,15,130,110,20,1
07-04-2025,"Grains, Flours & Dals",SABDANA 500GM,4,90,70,20,1
07-04-2025,Snacks & Ready-to-Eat,GREEN FRIED BATANA,14,40,40,0,2
07-04-2025,Baking & Cooking Aids,GONDKATIRA Ag,0,85,75,10,1
07-04-2025,Personal Care & Cosmetics,GAYATHRI KUMKUDUKAYA,10,150,150,0,1
07-04-2025,"Grains, Flours & Dals",RAGI FLOUR 500GRMS,4,40,35,5,1
07-04-2025,Snacks & Ready-to-Eat,CHOCO BROWINE,14,20,20,0,1
07-04-2025,"Grains, Flours & Dals",SRILATHA RICE RAVVA 500GM,4,70,70,0,2
07-04-2025,"Grains, Flours & Dals",Wheat Flour 1 kg,4,140,120,20,2
07-04-2025,Milk & Dairy,BROWN EGGS 1P,7,168,144,24,12
07-04-2025,Snacks & Ready-to-Eat,TILLI CHIKKI,14,5,5,0,1
07-04-2025,Baking & Cooking Aids,MTR GULAB JAMUN MIX 190GM,0,80,80,0,1
07-04-2025,Snacks & Ready-to-Eat,Popcorn Seeds 250GM,14,45,40,5,1
07-04-2025,"Grains, Flours & Dals",White jowar.F 1 kg,4,100,80,20,1
07-04-2025,Spices & Seasonings,Masala Karam 250 gms,15,130,120,10,1
07-04-2025,Oils & Ghee,Groundnut oil 1 L,9,720,660,60,2
07-04-2025,"Grains, Flours & Dals",Bajra Flour 1 kg,4,70,60,10,1
07-04-2025,"Grains, Flours & Dals",RAGI FLOUR 1KG,4,80,70,10,1
07-04-2025,"Grains, Flours & Dals",Wheat Flour 1 kg,4,140,120,20,2
07-04-2025,"Grains, Flours & Dals",White jowar.F 1 kg,4,100,80,20,1
07-04-2025,"Grains, Flours & Dals",Chana Flour 500 gms,4,70,65,5,1
07-04-2025,General Household & Kitchenware,GOOD HOME,3,15,15,0,1
07-04-2025,Milk & Dairy,SANGAM TONED MILK 500ML,7,31,31,0,1
07-04-2025,Milk & Dairy,HERITAGE TONED MILK 500ML,7,31,31,0,1
07-04-2025,"Grains, Flours & Dals",BOMBAY RAVA,4,70,55,15,1
07-04-2025,Snacks & Ready-to-Eat,JUNNU POWDER 100GM,14,420,420,0,6
07-04-2025,Oils & Ghee,Groundnut oil 1 L,9,360,330,30,1
07-04-2025,Pooja & Spiritual Items,GD TULASI 75GM,12,60,60,0,1
07-04-2025,Snacks & Ready-to-Eat,VD PALLI LADDU,14,80,80,0,1
07-04-2025,Spices & Seasonings,AVALU 100GM,15,25,20,5,1
07-04-2025,Beverages,BRU GREEN LABEL 1.2G,1,96,96,0,48
07-04-2025,"Grains, Flours & Dals",Urad dall 1 Kg,4,185,170,15,1
07-04-2025,"Dry Fruits, Nuts & Seeds",Groundnuts 500 gms,2,95,85,10,1
07-04-2025,"Grains, Flours & Dals",THICK POHA 1KG,4,80,70,10,1
07-04-2025,Sweeteners,YB JAGGERY POWDER 500GMS,16,75,75,0,1
07-04-2025,"Grains, Flours & Dals",Multigrain 1 kg,4,100,85,15,1
07-04-2025,Snacks & Ready-to-Eat,Corn Chips 250GM,14,40,35,5,1
07-04-2025,"Dry Fruits, Nuts & Seeds",SABJA SEEDS 100GM,2,80,70,10,1
07-04-2025,Spices & Seasonings,BIRYANI LEAF 10GM,15,30,20,10,1
07-04-2025,"Grains, Flours & Dals",HS MULTI UPMA RAVA,4,65,65,0,1
07-04-2025,Snacks & Ready-to-Eat,SS IDLY BATTER 1KG,14,60,60,0,1
07-04-2025,"Grains, Flours & Dals",Wheat Rava S 500GM,4,33,30,3,1
07-04-2025,"Grains, Flours & Dals",ragi umpa ravva,4,70,70,0,1
07-04-2025,"Grains, Flours & Dals",Em Foxtail upma r 500 g,4,109,109,0,1
07-04-2025,"Grains, Flours & Dals",JOWAR UPMA RAVA,4,75,75,0,1
07-04-2025,"Grains, Flours & Dals",Multigrain 1 kg,4,100,85,15,1
07-04-2025,Milk & Dairy,HRITAGE TOTAL CURD 130GM,7,20,20,0,2
07-04-2025,Snacks & Ready-to-Eat,COPRA LADDU 200GM,14,100,80,20,1
07-04-2025,Spices & Seasonings,SAJEERA,15,60,40,20,1
07-04-2025,Oils & Ghee,cow ghee 500 ml,9,430,390,40,1
07-04-2025,Oils & Ghee,Groundnut oil 1 L,9,360,330,30,1
07-04-2025,Oils & Ghee,Groundnut oil 1 L,9,720,660,60,2
07-04-2025,Spices & Seasonings,AV Iodized Salt 1KG,15,28,25,3,1
07-04-2025,Snacks & Ready-to-Eat,VD MULTI CHAKKA,14,110,110,0,1
07-04-2025,Snacks & Ready-to-Eat,KURNOOL MARMURA,14,70,55,15,1
07-04-2025,Oils & Ghee,Coconut oil 500 ml,9,440,400,40,2
07-04-2025,Snacks & Ready-to-Eat,NGT CHATPATTA CHANA 90GM,14,25,25,0,1
07-04-2025,"Grains, Flours & Dals",split green gram 1 kg,4,150,140,10,1
07-04-2025,"Grains, Flours & Dals",CHANA DAL 1KG,4,140,120,20,1
07-04-2025,Spices & Seasonings,Turmeric powder 250 gms,15,100,75,25,1
07-04-2025,Spices & Seasonings,EVEREST MEAT MASALA 50GM,15,48,48,0,1
07-04-2025,Household & Cleaning,VIM SOAP,6,30,30,0,6
07-04-2025,Snacks & Ready-to-Eat,VD BOONDI 175GM,14,60,60,0,1
07-04-2025,"Grains, Flours & Dals",SRILATHA RICE RAVVA 500GM,4,35,35,0,1
07-04-2025,Snacks & Ready-to-Eat,VD MURUKU 175GM,14,60,60,0,1
07-04-2025,Personal Care & Cosmetics,UVIS MULTANI MITTI PW 100GM,10,49,49,0,1
07-04-2025,Milk & Dairy,BROWN EGGS 1P,7,210,180,30,15
07-04-2025,Oils & Ghee,Coconut oil 500 ml,9,220,200,20,1
07-04-2025,Snacks & Ready-to-Eat,VD VAMUPUSA 175GM,14,60,60,0,1
07-04-2025,"Grains, Flours & Dals",RAGI FLOUR 500GRMS,4,80,70,10,2
07-04-2025,"Grains, Flours & Dals",SL Idly Rava 1KG,4,65,55,10,1
07-04-2025,Household & Cleaning,VIM MAHA BAR,6,20,20,0,2
07-04-2025,Personal Care & Cosmetics,ORAL B KIDS,10,25,25,0,1
07-04-2025,Snacks & Ready-to-Eat,VD NUVULU CHEGODI 175GM,14,60,60,0,1
07-04-2025,"Dry Fruits, Nuts & Seeds",D kimia,2,310,180,130,1
07-04-2025,"Dry Fruits, Nuts & Seeds",sabja seeds,2,80,70,10,1
07-04-2025,"Grains, Flours & Dals",Multigrain 1 kg,4,200,170,30,2
07-04-2025,"Grains, Flours & Dals",VYS.SP RICE 1 KG,4,350,325,25,5
07-04-2025,"Dry Fruits, Nuts & Seeds",ALMONDS 250GM,2,280,260,20,1
07-04-2025,"Dry Fruits, Nuts & Seeds",FLAX SEEDS 250GM,2,60,50,10,1
07-04-2025,"Dry Fruits, Nuts & Seeds",D kimia,2,310,180,130,1
07-04-2025,"Grains, Flours & Dals",DISANO ROLED OATS,4,395,395,0,1
07-04-2025,"Dry Fruits, Nuts & Seeds",sabja seeds,2,80,70,10,1
07-04-2025,Snacks & Ready-to-Eat,GB SALT COOKIES,14,120,110,10,2
07-04-2025,"Grains, Flours & Dals",RAGI FLOUR 500GRMS,4,40,35,5,1
07-04-2025,Spices & Seasonings,DHANIYA POWDER 200GM,15,100,85,15,1
07-04-2025,Oils & Ghee,castor oil,9,80,80,0,1
07-04-2025,"Health, Wellness & Ayurvedic Products",VAMU WATER,5,99,99,0,1
07-04-2025,Spices & Seasonings,BIRYANI LEAF 10GM,15,30,20,10,1
07-04-2025,"Grains, Flours & Dals",DISANO ROLED OATS,4,143,143,0,1
07-04-2025,Snacks & Ready-to-Eat,VD MULTI CHAKKA,14,110,110,0,1
07-04-2025,"Grains, Flours & Dals",turdal 1kg,4,220,170,50,1
07-04-2025,"Grains, Flours & Dals",THICK POHA 500GM,4,40,35,5,1
07-04-2025,Milk & Dairy,HERTG FULL CREAM M,7,82,82,0,2
07-04-2025,Snacks & Ready-to-Eat,SATHVI REGIVADA 200GM,14,80,60,20,1
07-04-2025,Snacks & Ready-to-Eat,VD ATUKULU MIXTURE 175GM,14,60,60,0,1
07-04-2025,Snacks & Ready-to-Eat,NGT CHATPATTA CHANA 90GM,14,25,25,0,1
07-04-2025,Snacks & Ready-to-Eat,VD MIXTURE 175 GM,14,60,60,0,1
07-04-2025,"Health, Wellness & Ayurvedic Products",MD Ashwagandha Choornam 100GM,5,170,170,0,1
07-04-2025,Snacks & Ready-to-Eat,VD Pappu Chekkalu 190gm,14,60,60,0,1
07-04-2025,Milk & Dairy,SANGAM TONED MILK 500ML,7,90,90,0,3
07-04-2025,Snacks & Ready-to-Eat,CHOCO BROWINE,14,20,20,0,1
07-04-2025,"Health, Wellness & Ayurvedic Products",RB Max Protein Cheese&amp;,5,45,45,0,1
07-04-2025,Oils & Ghee,Groundnut oil 1 L,9,360,330,30,1
07-04-2025,Spices & Seasonings,AV Iodized Salt 1KG,15,28,25,3,1
07-04-2025,Oils & Ghee,Groundnut oil 1 L,9,360,330,30,1
07-04-2025,"Grains, Flours & Dals",Chana Flour 500 gms,4,70,65,5,1
07-04-2025,Spices & Seasonings,AVALU 100GM,15,75,60,15,3
07-04-2025,Spices & Seasonings,Menthulu 250 gms,15,50,45,5,1
07-04-2025,Spices & Seasonings,Jeera 100GM,15,50,45,5,1
07-04-2025,Spices & Seasonings,Chilli powder 500 gms,15,290,210,80,1
07-04-2025,Oils & Ghee,Safflower oil 1 L,9,440,400,40,1
07-04-2025,Oils & Ghee,Coconut oil 1 L,9,440,400,40,1
07-04-2025,"Grains, Flours & Dals",Wheat Flour 1 kg,4,70,60,10,1
07-04-2025,Snacks & Ready-to-Eat,JUNNU POWDER 100GM,14,70,70,0,1
07-04-2025,"Grains, Flours & Dals",VGR rice 1 kg,4,140,130,10,2
07-04-2025,"Grains, Flours & Dals",White jowar.F 1 kg,4,100,80,20,1
07-04-2025,Oils & Ghee,Sesame oil 1 L,9,590,560,30,1
07-04-2025,Oils & Ghee,Coconut oil 1 L,9,880,800,80,2
07-04-2025,"Grains, Flours & Dals",Multigrain 1 kg,4,100,85,15,1
07-04-2025,Sweeteners,YB Brown Sugar 500GM,16,150,150,0,2
07-04-2025,"Grains, Flours & Dals",PESARA PAPPU 1 KG,4,170,145,25,1
07-04-2025,"Grains, Flours & Dals",Wheat Flour 1 kg,4,140,120,20,2
07-04-2025,Oils & Ghee,Coconut oil 500 ml,9,220,200,20,1
07-04-2025,"Grains, Flours & Dals",VYS.SP RICE 1 KG,4,350,325,25,5
07-04-2025,Oils & Ghee,Safflower oil 1 L,9,440,400,40,1
07-04-2025,Oils & Ghee,Groundnut oil 1 L,9,360,330,30,1
07-04-2025,"Dry Fruits, Nuts & Seeds",SD Mango cubes 200gm,2,180,180,0,2
07-04-2025,"Dry Fruits, Nuts & Seeds",ALMONDS 250GM,2,280,260,20,1
07-04-2025,"Grains, Flours & Dals",WHEAT 1 KG,4,180,150,30,3
07-04-2025,Baking & Cooking Aids,GONDKATIRA Ag,0,85,75,10,1
07-04-2025,"Grains, Flours & Dals",MIXED FLOUR,4,36,36,0,1
07-04-2025,"Grains, Flours & Dals",BASMATHI RICE 1KG,4,300,270,30,2
07-04-2025,"Grains, Flours & Dals",Chana Flour 500 gms,4,70,65,5,1
07-04-2025,Pooja & Spiritual Items,GD Dhoop Sticks 26GM,12,20,20,0,1
07-04-2025,"Dry Fruits, Nuts & Seeds",sabja seeds,2,80,70,10,1
07-04-2025,Snacks & Ready-to-Eat,MB PEARL MILLET NOODLES 180GM,14,95,95,0,1
07-04-2025,"Dry Fruits, Nuts & Seeds",PULMAKHANA 100 GM,2,360,340,20,2
07-04-2025,Personal Care & Cosmetics,DWIBHASHI GULABA ARKA ROSA WATER,10,60,60,0,1
07-04-2025,"Grains, Flours & Dals",ANDU KORRALU (Browntop.m) 1 kg,4,260,220,40,1
07-04-2025,Snacks & Ready-to-Eat,GB SALT COOKIES,14,60,55,5,1
07-04-2025,General Household & Kitchenware,BLADE,3,48,48,0,4
07-04-2025,Snacks & Ready-to-Eat,SF MILLET NOODLES MILD MASALA 192GM,14,129,129,0,1
07-04-2025,Spices & Seasonings,MTR SAMBAR POW 100GM,15,76,76,0,1
07-04-2025,Spices & Seasonings,Japatri 25GM,15,100,80,20,1
07-04-2025,Snacks & Ready-to-Eat,VD DAHI MIRCHI(SALTED) 100GM,14,45,45,0,1
07-04-2025,Spices & Seasonings,SAJEERA,15,60,40,20,1
07-04-2025,"Grains, Flours & Dals",MELMEKER 250GMS,4,60,45,15,1
07-04-2025,"Grains, Flours & Dals",SAMALU,4,170,130,40,1
07-04-2025,Sweeteners,GS JAGGERY NUGGETS 500GM,16,120,120,0,1
07-04-2025,"Grains, Flours & Dals",Bombay Rava 500GM,4,35,30,5,1
07-04-2025,General Household & Kitchenware,MATCH BOX,3,20,20,0,1
07-04-2025,"Grains, Flours & Dals",UDALU (Barnyard millet) 1 kg,4,140,115,25,1
07-04-2025,Pooja & Spiritual Items,KASHI ASHTAGANDHA CHANDHANA,12,20,20,0,1
07-04-2025,"Health, Wellness & Ayurvedic Products",MD Ashwagandha Choornam 100GM,5,170,170,0,1
07-04-2025,Snacks & Ready-to-Eat,VD PANIPURI 100GM,14,60,60,0,2
07-04-2025,Pooja & Spiritual Items,VRP APOORVA JAVADHU POW,12,35,35,0,1
07-04-2025,"Grains, Flours & Dals",HS BARLEY FLAKES 250GM 1+1,4,119,119,0,1
07-04-2025,"Grains, Flours & Dals",RICE FLOUR 1KG,4,70,55,15,1
07-04-2025,"Grains, Flours & Dals",KORRALU (FOXTAIL M) 1KG,4,150,110,40,1
07-04-2025,Personal Care & Cosmetics,nivya,10,225,225,0,1
07-04-2025,"Health, Wellness & Ayurvedic Products",RB Max Protein Chinese Manchurian,5,180,180,0,4
07-04-2025,Snacks & Ready-to-Eat,MILLET NOODLES CURRY MASALA,14,129,129,0,1
07-04-2025,Personal Care & Cosmetics,UVIS MULTANI MITTI 200GM,10,90,90,0,1
07-04-2025,Snacks & Ready-to-Eat,MB MULTIMILLET NOODLES 180GM,14,95,95,0,1
07-04-2025,Snacks & Ready-to-Eat,ELITE MILK RUSK 200GM,14,35,35,0,1
07-04-2025,Snacks & Ready-to-Eat,CHOCO BROWINE,14,40,40,0,2
07-04-2025,"Grains, Flours & Dals",Red Bobarlu 500 gms,4,95,85,10,1
07-04-2025,Snacks & Ready-to-Eat,MB LITTLE MILLET NOODLES 180G,14,95,95,0,1
07-04-2025,Snacks & Ready-to-Eat,jungle pasta,14,249,249,0,1
07-04-2025,Milk & Dairy,BUTTER MILK,7,40,40,0,4
07-04-2025,"Grains, Flours & Dals",Arikadu ( kodo),4,140,130,10,1
07-04-2025,Snacks & Ready-to-Eat,VD ATUKULU MIXTURE 175GM,14,60,60,0,1
07-04-2025,Spices & Seasonings,EVEREST PANI PURI MASALA 50GM,15,40,40,0,1
07-04-2025,"Grains, Flours & Dals",Wheat Flour 1 kg,4,70,60,10,1
07-04-2025,Oils & Ghee,Sesame oil 1 L,9,590,560,30,1
07-04-2025,Oils & Ghee,Safflower oil 1 L,9,440,400,40,1
07-04-2025,Snacks & Ready-to-Eat,RINGS 200GM,14,30,30,0,1
07-04-2025,Oils & Ghee,Groundnut oil 1 L,9,360,330,30,1
07-04-2025,Snacks & Ready-to-Eat,VD RED CHILLI RICEPAPAD 150GM,14,50,50,0,1
07-04-2025,"Grains, Flours & Dals",RAGI FLOUR 1KG,4,80,70,10,1
07-04-2025,Snacks & Ready-to-Eat,BLACK PEPPER RICEPAPAD VD,14,50,50,0,1
07-04-2025,Snacks & Ready-to-Eat,BIKANERI PAPAD,14,170,160,10,1
07-04-2025,Snacks & Ready-to-Eat,VD CORNFLAKES MIXTURE 175GM,14,60,60,0,1
07-04-2025,Pooja & Spiritual Items,GD Yagnadhara 31PC,12,140,140,0,2
07-04-2025,Snacks & Ready-to-Eat,SD Ginger Candy 100g,14,120,120,0,2
07-04-2025,"Grains, Flours & Dals",turdal 500 gms,4,110,85,25,1
07-04-2025,Snacks & Ready-to-Eat,VD PALLI LADDU,14,80,80,0,1
07-04-2025,Sweeteners,SUGAR 500 GM,16,30,25,5,1
07-04-2025,Spices & Seasonings,DHANIYA POWDER 200GM,15,100,85,15,1
07-04-2025,Oils & Ghee,Sesame oil 5 L,9,2950,"2,750.00",200,1
07-04-2025,Spices & Seasonings,ROYAL SAFFRON 400GRMS,15,65,65,0,1
07-04-2025,Spices & Seasonings,Tamarind 500GM,15,160,130,30,1
07-04-2025,Sweeteners,SUGAR 1KG,16,60,50,10,1
07-04-2025,"Grains, Flours & Dals",Brown RICE 1KG,4,700,650,50,10
07-04-2025,"Grains, Flours & Dals",Urad dall 1 Kg,4,925,850,75,5
07-04-2025,"Dry Fruits, Nuts & Seeds",Groundnuts 1 kg,2,190,165,25,1
07-04-2025,Spices & Seasonings,DRY MIECHI 200GM,15,240,180,60,3
07-04-2025,"Dry Fruits, Nuts & Seeds",Groundnuts 500 gms,2,95,85,10,1
07-04-2025,"Grains, Flours & Dals",Idly Rava L 1KG,4,120,100,20,2
07-04-2025,"Dry Fruits, Nuts & Seeds",PUTNALU 500GMS,2,180,152,28,2
07-04-2025,"Grains, Flours & Dals",split green gram 500 gms,4,75,70,5,1
07-04-2025,Snacks & Ready-to-Eat,DISANO VERMICELLI 425 GM,14,50,50,0,1
07-04-2025,"Grains, Flours & Dals",Wheat Rava S 1KG,4,65,55,10,1
07-04-2025,"Grains, Flours & Dals",RAGULU 1 KG,4,15,15,0,1
07-04-2025,"Grains, Flours & Dals",Green gram 500 gms,4,75,70,5,1
07-04-2025,"Grains, Flours & Dals",turdal 1kg,4,220,170,50,1
07-04-2025,"Grains, Flours & Dals",SABDANA 500GM,4,90,70,20,1
07-04-2025,"Grains, Flours & Dals",Bombay Rava 500GM,4,35,30,5,1
07-04-2025,"Grains, Flours & Dals",MAATEJA rice 5 kg,4,360,345,15,1
07-04-2025,"Dry Fruits, Nuts & Seeds",PUMPKIN SEEDS 250GM,2,400,320,80,2
07-04-2025,"Dry Fruits, Nuts & Seeds",FLAX SEEDS 250GM,2,120,100,20,2
07-04-2025,"Dry Fruits, Nuts & Seeds",WATERMELON SEEDS 250GRM,2,640,560,80,2
07-04-2025,"Dry Fruits, Nuts & Seeds",ALMONDS 250GM,2,280,260,20,1
07-04-2025,Spices & Seasonings,NUVVULU 500GM,15,200,170,30,1
07-04-2025,Snacks & Ready-to-Eat,VD NUVULU CHEGODI 175GM,14,60,60,0,1
07-04-2025,"Dry Fruits, Nuts & Seeds",wallnuts,2,380,320,60,1
07-04-2025,Snacks & Ready-to-Eat,VD Pappu Chekkalu 190gm,14,120,120,0,2
07-04-2025,Spices & Seasonings,DURGA SALT CRYSTAL 1KG,15,50,50,0,2
07-04-2025,Sweeteners,GS A2 Buffalo Ghee 500ML,16,550,550,0,1
07-04-2025,Snacks & Ready-to-Eat,RINGS 200GM,14,30,30,0,1
07-04-2025,"Grains, Flours & Dals",Idly Rava L 1KG,4,120,100,20,2
07-04-2025,"Health, Wellness & Ayurvedic Products",RB Max Protein Chinese Manchurian,5,45,45,0,1
07-04-2025,"Dry Fruits, Nuts & Seeds",SUNFLOWER SEEDS 250GRM,2,150,130,20,1
07-04-2025,Snacks & Ready-to-Eat,CHOCO BROWINE,14,20,20,0,1
07-04-2025,Snacks & Ready-to-Eat,VD BELLAM GAVVALU 200GM,14,60,60,0,1
07-04-2025,"Dry Fruits, Nuts & Seeds",SALTED PISTA 250GM,2,400,350,50,1
07-04-2025,Oils & Ghee,Safflower oil 1 L,9,440,400,40,1
07-04-2025,Household & Cleaning,vim dish liquid,6,110,110,0,2
07-04-2025,"Grains, Flours & Dals",DH URAD GOTA 1KG,4,215,190,25,1
07-04-2025,Spices & Seasonings,Jeera 100GM,15,50,45,5,1
07-04-2025,"Grains, Flours & Dals",turdal 1kg,4,440,340,100,2
07-04-2025,Spices & Seasonings,3M.MIRCHI POWDER,15,145,115,30,1
07-04-2025,"Grains, Flours & Dals",Wheat Flour 1 kg,4,140,120,20,2
07-04-2025,"Grains, Flours & Dals",Multigrain 1 kg,4,100,85,15,1
07-04-2025,"Health, Wellness & Ayurvedic Products",MD Bringaraj Choornam 100GM,5,80,80,0,1
07-04-2025,Beverages,TAJ MAHAL 250GM,1,235,235,0,1
07-04-2025,"Grains, Flours & Dals",RICE FLOUR 1KG,4,70,55,15,1
07-04-2025,Snacks & Ready-to-Eat,BB ROASTED VERMICELLY 850GM,14,117,117,0,1
07-04-2025,Pooja & Spiritual Items,GD WOODS 150GM,12,110,110,0,1
07-04-2025,Spices & Seasonings,AV Iodized Salt 1KG,15,28,25,3,1
07-04-2025,Oils & Ghee,Black Sesame oil 500 ml,9,1100,950,150,5
07-04-2025,Pooja & Spiritual Items,BALAJI KASTURI DHOOP STICKS,12,70,70,0,1
07-04-2025,Spices & Seasonings,beetroot powder,15,149,149,0,1
07-04-2025,Household & Cleaning,lizol,6,123,123,0,1
07-04-2025,"Grains, Flours & Dals",CHANA DAL 500GM,4,70,60,10,1
07-04-2025,"Dry Fruits, Nuts & Seeds",Groundnuts 500 gms,2,95,85,10,1
07-04-2025,"Grains, Flours & Dals",Urad dall 1 Kg,4,555,510,45,3
07-04-2025,Pooja & Spiritual Items,GD Dhoop Sticks 26GM,12,20,20,0,1
07-04-2025,Sweeteners,GS A2 Buffalo Ghee 500ML,16,550,550,0,1
07-04-2025,General Household & Kitchenware,GOOD HOME,3,15,15,0,1
07-04-2025,"Grains, Flours & Dals",Idly Rava L 1KG,4,180,150,30,3
07-04-2025,"Dry Fruits, Nuts & Seeds",Groundnuts 1 kg,2,190,165,25,1
07-04-2025,Pooja & Spiritual Items,SWASTIK CAMPHORE,12,90,90,0,1
07-04-2025,Spices & Seasonings,AVALU 100GM,15,25,20,5,1
07-04-2025,"Health, Wellness & Ayurvedic Products",DWI MANDARA TAILAM 100ML,5,160,160,0,1
07-04-2025,Personal Care & Cosmetics,smara,10,225,225,0,3
07-04-2025,Personal Care & Cosmetics,dettol,10,0,0,0,1
07-04-2025,Sweeteners,MISHRI 250 GM,16,35,30,5,1
07-04-2025,Pooja & Spiritual Items,GD KUMKUM 50GM,12,30,30,0,1
07-04-2025,Spices & Seasonings,PN ORGANIC PINK SALT 1KG,15,124,124,0,1
07-04-2025,"Grains, Flours & Dals",Green gram 1 kg,4,150,130,20,1
07-04-2025,Snacks & Ready-to-Eat,VD BOONDI 175GM,14,60,60,0,1
07-04-2025,Snacks & Ready-to-Eat,VD PALLI LADDU,14,80,80,0,1
07-04-2025,Oils & Ghee,Groundnut oil 500ml,9,360,330,30,2
07-04-2025,"Grains, Flours & Dals",Wheat Flour 1 kg,4,210,180,30,3
07-04-2025,"Dry Fruits, Nuts & Seeds",Putnalu 250GM,2,45,38,7,1
07-04-2025,Personal Care & Cosmetics,black naturals,10,45,45,0,1
07-04-2025,"Grains, Flours & Dals",Urad dall 1 Kg,4,185,170,15,1
07-04-2025,Sweeteners,MISHRI 250 GM,16,35,30,5,1
07-04-2025,Snacks & Ready-to-Eat,VD Minapa papad 200gm,14,60,60,0,1
07-04-2025,Snacks & Ready-to-Eat,BB VERMICELLI 1KG,14,95,90,5,1
07-04-2025,Oils & Ghee,Groundnut oil 1 L,9,720,660,60,2
07-04-2025,General Household & Kitchenware,MATCH BOX,3,40,40,0,2
07-04-2025,Sweeteners,GS Palm Jaggery Powder 400GM,16,180,180,0,1
07-04-2025,"Grains, Flours & Dals",turdal 1kg,4,220,170,50,1
07-04-2025,Misc,ROLL D C,8,70,45,25,1
07-04-2025,Oils & Ghee,Coconut oil 1 L,9,880,800,80,2
07-04-2025,"Grains, Flours & Dals",Idly Rava L 1KG,4,60,50,10,1
07-04-2025,"Grains, Flours & Dals",VYS HMT 26KG,4,1750,"1,750.00",0,1
07-04-2025,Oils & Ghee,Groundnut oil 1 L,9,720,660,60,2
07-04-2025,Milk & Dairy,BROWN EGGS TRAY 30P,7,720,660,60,2
07-04-2025,Snacks & Ready-to-Eat,VD BELLAM GAVVALU 200GM,14,60,60,0,1
07-04-2025,Snacks & Ready-to-Eat,VD VAMUPUSA 175GM,14,60,60,0,1
07-04-2025,"Grains, Flours & Dals",HS RAGI FLAKES 250GM 1+1,4,238,238,0,2
07-04-2025,"Grains, Flours & Dals",SH RED POHA 500GM,4,85,85,0,1
07-04-2025,Sweeteners,SH JAGGERY POWDER 500GM,16,80,68,12,1
07-04-2025,"Grains, Flours & Dals",JOWAR UPMA RAVA,4,65,65,0,1
07-04-2025,Sweeteners,SUGAR 1KG,16,180,150,30,3
07-04-2025,"Grains, Flours & Dals",CHANA DAL 1KG,4,280,240,40,2
07-04-2025,"Grains, Flours & Dals",SPLIT URAD DAL,4,40,40,0,1
07-04-2025,Household & Cleaning,SRFR EXCEL,6,10,10,0,1
07-04-2025,Sweeteners,SUGAR 500 GM,16,60,50,10,2
07-04-2025,Milk & Dairy,SANGAM TONED MILK 500ML,7,30,30,0,1
07-04-2025,Snacks & Ready-to-Eat,MILK BREAD,14,55,55,0,1
07-04-2025,"Grains, Flours & Dals",Idly Rava L 1KG,4,60,50,10,1
07-04-2025,Milk & Dairy,HERITAGE TOTAL CURD 500GM,7,50,50,0,1
07-04-2025,Oils & Ghee,Groundnut oil 1 L,9,360,330,30,1
07-04-2025,"Grains, Flours & Dals",SF BESAN 500GM,4,100,100,0,1
07-04-2025,Snacks & Ready-to-Eat,PEANUT CHIKKI,14,66,66,0,3
07-04-2025,Pooja & Spiritual Items,SWAATHI GATTI DEEPAM VATTULU,12,60,60,0,2
07-04-2025,"Grains, Flours & Dals",RAGI FLOUR 500GRMS,4,40,35,5,1
07-04-2025,Milk & Dairy,SANGAM TONED MILK 500ML,7,30,30,0,1
07-04-2025,Spices & Seasonings,NUVVULU 250GM,15,80,65,15,1
07-04-2025,Oils & Ghee,Groundnut oil 1 L,9,720,660,60,2
07-04-2025,"Grains, Flours & Dals",Wheat Rava M 1KG,4,65,55,10,1
07-04-2025,Spices & Seasonings,PN ORGANIC PINK SALT 1KG,15,124,124,0,1
06-04-2025,"Dry Fruits, Nuts & Seeds",YELLOW KISHMISH 250GM,2,260,220,40,2
06-04-2025,Snacks & Ready-to-Eat,SD JOWAR WITH PALM JAGGERY 250GM,14,135,135,0,1
06-04-2025,Oils & Ghee,Groundnut oil 1 L,9,1080,990,90,3
06-04-2025,Snacks & Ready-to-Eat,SD FINGER Millet with palm Jaggery 250gm,14,135,135,0,1
06-04-2025,Oils & Ghee,Groundnut oil 1 L,9,360,330,30,1
06-04-2025,"Grains, Flours & Dals",RAGI FLOUR 500GRMS,4,80,70,10,2
06-04-2025,"Grains, Flours & Dals",VYS.SP RICE 1 KG,4,70,65,5,1
06-04-2025,"Grains, Flours & Dals",Green gram 500 gms,4,75,70,5,1
06-04-2025,"Grains, Flours & Dals",Yellow jowar .F1 kg,4,110,100,10,1
06-04-2025,Pooja & Spiritual Items,GD Dhoop Sticks 26GM,12,20,20,0,1
06-04-2025,"Grains, Flours & Dals",JOWAR UPMA RAVA,4,65,65,0,1
06-04-2025,"Health, Wellness & Ayurvedic Products",MD Fenugreek Choornam 100GM,5,80,80,0,1
06-04-2025,Snacks & Ready-to-Eat,BD LITTLE MILLET NOODLES 200G,14,75,75,0,1
06-04-2025,Misc,ROLL D C,8,70,45,25,1
06-04-2025,"Grains, Flours & Dals",Wheat Flour 1 kg,4,140,120,20,2
06-04-2025,Snacks & Ready-to-Eat,VD MURUKU 175GM,14,60,60,0,1
06-04-2025,Snacks & Ready-to-Eat,GREEN FRIED BATANA,14,20,20,0,1
06-04-2025,Pooja & Spiritual Items,divya deeparadhana oil,12,190,190,0,1
06-04-2025,Spices & Seasonings,SONTI 50GM,15,30,20,10,1
06-04-2025,"Grains, Flours & Dals",MULTIMILLET IDLY RAVVA,4,65,65,0,1
06-04-2025,General Household & Kitchenware,MATCH BOX,3,20,20,0,1
06-04-2025,Beverages,MUA COFFEE EXT STRONG 250GM,1,140,140,0,1
06-04-2025,Snacks & Ready-to-Eat,VD NUVULU CHEGODI 175GM,14,60,60,0,1
06-04-2025,"Grains, Flours & Dals",HS MULTI UPMA RAVA,4,65,65,0,1
06-04-2025,Personal Care & Cosmetics,GAYATHRI KUMKUDUKAYA,10,150,150,0,1
06-04-2025,"Grains, Flours & Dals",Multigrain 1 kg,4,200,170,30,2
06-04-2025,"Grains, Flours & Dals",Brown RICE 1KG,4,140,130,10,2
06-04-2025,Oils & Ghee,Safflower oil 500 ml,9,220,200,20,1
06-04-2025,Beverages,BRU GREEN LABEL 1.2G,1,48,48,0,24
06-04-2025,Pooja & Spiritual Items,divya deeparadhana oil,12,190,190,0,1
06-04-2025,"Grains, Flours & Dals",THICK POHA 500GM,4,40,35,5,1
06-04-2025,"Grains, Flours & Dals",Sathya Javva Wheat Rava 500GM,4,90,90,0,1
06-04-2025,Spices & Seasonings,Tamarind 250GMS,15,80,65,15,1
06-04-2025,"Grains, Flours & Dals",Wheat Flour 1 kg,4,70,60,10,1
06-04-2025,"Grains, Flours & Dals",Red Bobarlu 500 gms,4,95,85,10,1
06-04-2025,Sweeteners,NATURAL HONEY 1KG,16,560,480,80,1
06-04-2025,Oils & Ghee,Groundnut oil 1 L,9,720,660,60,2
06-04-2025,Spices & Seasonings,DURGA SALT CRYSTAL 1KG,15,50,50,0,2
06-04-2025,"Dry Fruits, Nuts & Seeds",PUTNALU 500GMS,2,90,76,14,1
06-04-2025,"Dry Fruits, Nuts & Seeds",PULMAKHANA 100 GM,2,180,170,10,1
06-04-2025,Pooja & Spiritual Items,GD KUMKUM 50GM,12,30,30,0,1
06-04-2025,"Grains, Flours & Dals",VGR rice 1 kg,4,350,325,25,5
06-04-2025,"Dry Fruits, Nuts & Seeds",SD Mango cubes 100gm,2,45,45,0,1
06-04-2025,"Dry Fruits, Nuts & Seeds",PULMAKHANA 100 GM,2,180,170,10,1
06-04-2025,Snacks & Ready-to-Eat,SD black sesme laddu with dates 175gm,14,135,135,0,1
06-04-2025,Personal Care & Cosmetics,Soapnut 500GM,10,240,180,60,2
06-04-2025,"Dry Fruits, Nuts & Seeds",FLAX SEEDS 250GM,2,60,50,10,1
06-04-2025,Snacks & Ready-to-Eat,DOSA BATTER 1KG,14,60,60,0,1
06-04-2025,"Grains, Flours & Dals",MAAGAANI W RICE 5KGS,4,899,535,364,1
06-04-2025,"Dry Fruits, Nuts & Seeds",PUMPKIN SEEDS 250GM,2,200,160,40,1
06-04-2025,"Grains, Flours & Dals",HS MULTI UPMA RAVA,4,65,65,0,1
06-04-2025,"Grains, Flours & Dals",JOWAR UPMA RAVA,4,65,65,0,1
06-04-2025,Snacks & Ready-to-Eat,RINGS 200GM,14,60,60,0,2
06-04-2025,"Grains, Flours & Dals",VGR rice 1 kg,4,420,390,30,6
06-04-2025,Spices & Seasonings,DRY MIECHI 200GM,15,80,60,20,1
06-04-2025,Spices & Seasonings,Coriander seeds 200 gms,15,48,40,8,1
06-04-2025,"Dry Fruits, Nuts & Seeds",Groundnuts 500 gms,2,95,85,10,1
06-04-2025,"Grains, Flours & Dals",VYS.SP RICE 1 KG,4,420,390,30,6
06-04-2025,Oils & Ghee,Groundnut oil 1 L,9,720,660,60,2
06-04-2025,"Grains, Flours & Dals",VGR rice 1 kg,4,490,455,35,7
06-04-2025,"Grains, Flours & Dals",Wheat Rava S 1KG,4,65,55,10,1
06-04-2025,"Grains, Flours & Dals",VYS.SP RICE 1 KG,4,420,390,30,6
06-04-2025,Snacks & Ready-to-Eat,CHOCO BROWINE,14,40,40,0,2
06-04-2025,"Grains, Flours & Dals",RAJMA 250GM,4,55,45,10,1
06-04-2025,Snacks & Ready-to-Eat,VD RICE MURUKU 150GM,14,50,50,0,1
06-04-2025,Snacks & Ready-to-Eat,CHOCO BROWINE,14,40,40,0,2
06-04-2025,Pickles & Cooking Pastes,SD MANGO TOKKU,11,110,110,0,1
06-04-2025,Snacks & Ready-to-Eat,VD DAHI MIRCHI(SALTED) 100GM,14,45,45,0,1
06-04-2025,"Dry Fruits, Nuts & Seeds",SD Mango cubes 100gm,2,45,45,0,1
06-04-2025,"Grains, Flours & Dals",WHITE BATANI,4,40,30,10,1
06-04-2025,Oils & Ghee,Sesame oil 500ml,9,295,280,15,1
06-04-2025,Spices & Seasonings,Turmeric powder 250 gms,15,100,75,25,1
06-04-2025,Oils & Ghee,Safflower oil 1 L,9,440,400,40,1
06-04-2025,"Grains, Flours & Dals",Bajra Flour 500 gms,4,35,30,5,1
06-04-2025,"Grains, Flours & Dals",RAGI FLOUR 1KG,4,80,70,10,1
06-04-2025,"Grains, Flours & Dals",DISANO ROLED OATS,4,143,143,0,1
06-04-2025,"Grains, Flours & Dals",JOWAR YELLOW 1 K,4,250,225,25,2.5
06-04-2025,Spices & Seasonings,RED COPRA 250GMS,15,85,74,11,1
06-04-2025,Oils & Ghee,BUFFALLO GHEE 500ML,9,2050,"1,850.00",200,5
06-04-2025,Snacks & Ready-to-Eat,RINGS 200GM,14,30,30,0,1
06-04-2025,"Dry Fruits, Nuts & Seeds",Groundnuts 1 kg,2,190,165,25,1
06-04-2025,"Grains, Flours & Dals",DH URAD GOTA 1KG,4,215,190,25,1
06-04-2025,"Grains, Flours & Dals",UNPOLISHED TURDALL 1KG,4,240,210,30,1
06-04-2025,"Grains, Flours & Dals",Wheat Rava S 1KG,4,65,55,10,1
06-04-2025,"Grains, Flours & Dals",multi mllit umpa ravva,4,129,129,0,1
06-04-2025,"Grains, Flours & Dals",RAGI FLOUR 500GRMS,4,80,70,10,2
06-04-2025,"Grains, Flours & Dals",BOMBAY RAVA,4,70,55,15,1
06-04-2025,Misc,386627138,8,0,0,0,1
06-04-2025,Spices & Seasonings,SH CASSIA STICKS 50GM,15,75,75,0,1
06-04-2025,"Grains, Flours & Dals",BARLEY SEEDS 250GMS,4,40,35,5,1
06-04-2025,"Grains, Flours & Dals",PESARA PAPPU 1 KG,4,170,145,25,1
06-04-2025,Snacks & Ready-to-Eat,RINGS 200GM,14,30,30,0,1
06-04-2025,"Dry Fruits, Nuts & Seeds",PULMAKHANA 100 GM,2,540,510,30,3
06-04-2025,"Dry Fruits, Nuts & Seeds",Groundnuts 1 kg,2,190,165,25,1
06-04-2025,"Grains, Flours & Dals",Urad dall 1 Kg,4,185,170,15,1
06-04-2025,"Grains, Flours & Dals",BARLEY SEEDS 500 GM,4,90,70,20,1
06-04-2025,Snacks & Ready-to-Eat,VD NUVVULU LADDU,14,80,80,0,1
06-04-2025,"Grains, Flours & Dals",RICE FLOUR 500 GM,4,35,28,7,1
06-04-2025,Pooja & Spiritual Items,KASHI ASHTAGANDHA CHANDHANA,12,20,20,0,1
06-04-2025,"Dry Fruits, Nuts & Seeds",YB GRANMA NUTS,2,90,90,0,1
06-04-2025,Oils & Ghee,cow ghee 500 ml,9,2150,"1,950.00",200,5
06-04-2025,"Grains, Flours & Dals",unpolished turdall500grms,4,120,110,10,1
06-04-2025,"Dry Fruits, Nuts & Seeds",Groundnuts 1 kg,2,190,165,25,1
06-04-2025,"Grains, Flours & Dals",SA WHITE JOWAR RAVA 500GM,4,69,69,0,1
06-04-2025,"Grains, Flours & Dals",Em little upma R 500g,4,129,129,0,1
06-04-2025,"Grains, Flours & Dals",RAGI FLOUR 1KG,4,80,70,10,1
06-04-2025,"Grains, Flours & Dals",Arikadu ( kodo),4,140,130,10,1
06-04-2025,"Grains, Flours & Dals",Em jowar idly R 500G,4,75,75,0,1
06-04-2025,"Grains, Flours & Dals",Multigrain 1 kg,4,100,85,15,1
06-04-2025,"Grains, Flours & Dals",Wheat Flour 1 kg,4,70,60,10,1
06-04-2025,"Grains, Flours & Dals",RAGULU 1 KG,4,15,15,0,1
06-04-2025,"Grains, Flours & Dals",JOWAR WHITE 1 KG,4,18,18,0,1
06-04-2025,Oils & Ghee,Groundnut oil 1 L,9,360,330,30,1
06-04-2025,Snacks & Ready-to-Eat,BROWN BREAD,14,55,55,0,1
06-04-2025,Sweeteners,ACHUBELLAM 500GM,16,50,40,10,1
06-04-2025,"Grains, Flours & Dals",SH ORGANIC MOONG YELLOW 500GM,4,158,158,0,1
06-04-2025,Spices & Seasonings,Elaichi 25GM,15,145,120,25,1
06-04-2025,"Grains, Flours & Dals",MAAGAANI W RICE 1KG,4,139,110,29,1
06-04-2025,General Household & Kitchenware,WOODEN SPATULA 11,3,22,22,0,1
06-04-2025,Sweeteners,PN ORGANIC BROWN SUGAR 500GM,16,78,78,0,1
06-04-2025,Snacks & Ready-to-Eat,VD BOONDI 175GM,14,120,120,0,2
06-04-2025,"Grains, Flours & Dals",KORRALU (FOXTAIL M) 1KG,4,150,110,40,1
06-04-2025,"Grains, Flours & Dals",UDALU (Barnyard millet) 1 kg,4,140,115,25,1
06-04-2025,"Grains, Flours & Dals",SAMALU,4,170,130,40,1
06-04-2025,Oils & Ghee,Safflower oil 1 L,9,440,400,40,1
06-04-2025,Spices & Seasonings,LG 50GM,15,92,92,0,1
06-04-2025,"Grains, Flours & Dals",turdal 1kg,4,220,170,50,1
06-04-2025,"Grains, Flours & Dals",Arikadu ( kodo),4,140,130,10,1
06-04-2025,Spices & Seasonings,Telaga Pindi 250 GM,15,40,35,5,1
06-04-2025,Spices & Seasonings,Tamarind 250GMS,15,80,65,15,1
06-04-2025,"Grains, Flours & Dals",unpolished turdall500grms,4,120,110,10,1
06-04-2025,"Dry Fruits, Nuts & Seeds",Groundnuts 500 gms,2,95,85,10,1
06-04-2025,"Grains, Flours & Dals",MELMEKER 250GMS,4,60,45,15,1
06-04-2025,"Grains, Flours & Dals",BARLY POWDER,4,40,40,0,1
06-04-2025,"Grains, Flours & Dals",SPLIT URAD DHAL,4,80,80,0,1
06-04-2025,"Grains, Flours & Dals",Red Chana 500 GM,4,75,60,15,1
06-04-2025,"Grains, Flours & Dals",Green gram 1 kg,4,150,130,20,1
06-04-2025,"Dry Fruits, Nuts & Seeds",PUTNALU 500GMS,2,90,76,14,1
06-04-2025,"Grains, Flours & Dals",CHANA DAL 500GM,4,70,60,10,1
06-04-2025,Snacks & Ready-to-Eat,VD Minapa papad 200gm,14,60,60,0,1
06-04-2025,"Dry Fruits, Nuts & Seeds",Groundnuts 1 kg,2,190,165,25,1
06-04-2025,"Grains, Flours & Dals",white Bobarlu 500 gms,4,80,75,5,1
06-04-2025,Household & Cleaning,VIM SOAP,6,20,20,0,4
06-04-2025,"Grains, Flours & Dals",MULTIMILLET IDLY RAVVA,4,130,130,0,2
06-04-2025,Snacks & Ready-to-Eat,KURNOOL MARMURA,14,70,55,15,1
06-04-2025,"Dry Fruits, Nuts & Seeds",sabja seeds,2,80,70,10,1
06-04-2025,"Grains, Flours & Dals",SPLIT BLACK GRAM 500 GM,4,180,170,10,2
06-04-2025,"Grains, Flours & Dals",Wheat Flour 1 kg,4,70,60,10,1
06-04-2025,Spices & Seasonings,Chilli powder 500 gms,15,290,210,80,1
06-04-2025,"Grains, Flours & Dals",Multigrain 1 kg,4,200,170,30,2
06-04-2025,"Grains, Flours & Dals",Wheat Rava S 1KG,4,65,55,10,1
06-04-2025,"Grains, Flours & Dals",turdal 1kg,4,220,170,50,1
06-04-2025,Snacks & Ready-to-Eat,BLACK PEPPER RICE PAPAD,14,50,50,0,1
06-04-2025,"Grains, Flours & Dals",SRILATHA RICE RAVVA 500GM,4,35,35,0,1
06-04-2025,"Grains, Flours & Dals",BOMBAY RAVA,4,70,55,15,1
06-04-2025,Oils & Ghee,Groundnut oil 1 L,9,360,330,30,1
06-04-2025,Snacks & Ready-to-Eat,VD PANIPURI 100GM,14,30,30,0,1
06-04-2025,General Household & Kitchenware,GOODHOME S,3,10,10,0,1
06-04-2025,"Dry Fruits, Nuts & Seeds",SD Mango cubes 200gm,2,90,90,0,1
06-04-2025,"Grains, Flours & Dals",BARLEY SEEDS 250GMS,4,40,35,5,1
06-04-2025,"Grains, Flours & Dals",ANDU KORRALU (Browntop.m) 1 kg,4,260,220,40,1
06-04-2025,"Grains, Flours & Dals",SA WHITE JOWAR RAVA 500GM,4,69,69,0,1
06-04-2025,"Grains, Flours & Dals",Quinova 500 gms,4,110,100,10,1
06-04-2025,"Dry Fruits, Nuts & Seeds",PUTNALU 500GMS,2,90,76,14,1
06-04-2025,"Dry Fruits, Nuts & Seeds",sabja seeds,2,80,70,10,1
06-04-2025,"Grains, Flours & Dals",THICK POHA 500GM,4,40,35,5,1
06-04-2025,Spices & Seasonings,Jeera 100GM,15,50,45,5,1
06-04-2025,"Dry Fruits, Nuts & Seeds",SATHVI CHIA SEEDS 100GM,2,100,80,20,1
06-04-2025,"Dry Fruits, Nuts & Seeds",SH GROUNDNUT 500GM,2,163,130,33,1
06-04-2025,Beverages,BRU GREEN LABEL 1.2G,1,48,48,0,24
06-04-2025,Oils & Ghee,Safflower oil 1 L,9,880,800,80,2
06-04-2025,"Grains, Flours & Dals",Multigrain 1 kg,4,200,170,30,2
06-04-2025,"Grains, Flours & Dals",Wheat Flour 1 kg,4,140,120,20,2
06-04-2025,"Grains, Flours & Dals",RICE FLOUR 1KG,4,70,55,15,1
06-04-2025,Snacks & Ready-to-Eat,BB ROASTED VERMICELLY 850GM,14,117,117,0,1
06-04-2025,Spices & Seasonings,MASALA KAR 500GMS,15,260,240,20,1
06-04-2025,Spices & Seasonings,SAJEERA,15,60,40,20,1
06-04-2025,"Grains, Flours & Dals",Chana Flour 500 gms,4,70,65,5,1
06-04-2025,"Grains, Flours & Dals",Idly Rava L 1KG,4,60,50,10,1
06-04-2025,"Health, Wellness & Ayurvedic Products",RB Max Protein PERI PERI 60gm,5,45,45,0,1
06-04-2025,"Grains, Flours & Dals",maida 500grms,4,70,60,10,2
06-04-2025,"Dry Fruits, Nuts & Seeds",PULMAKHANA 100 GM,2,180,170,10,1
06-04-2025,"Grains, Flours & Dals",PESARA PAPPU 1 KG,4,170,145,25,1
06-04-2025,"Grains, Flours & Dals",Urad dall 1 Kg,4,185,170,15,1
06-04-2025,"Grains, Flours & Dals",SPLIT BLACK GRAM 500 GM,4,90,85,5,1
06-04-2025,Sweeteners,SUGAR 500 GM,16,30,25,5,1
06-04-2025,"Grains, Flours & Dals",unpolished turdall500grms,4,120,110,10,1
06-04-2025,Spices & Seasonings,DHANIYA POWDER 200GM,15,100,85,15,1
06-04-2025,Spices & Seasonings,Turmeric powder 250 gms,15,100,75,25,1
06-04-2025,Snacks & Ready-to-Eat,DISANO PASTA,14,175,175,0,1
06-04-2025,Spices & Seasonings,Chilli powder 500 gms,15,290,210,80,1
06-04-2025,Personal Care & Cosmetics,SANTOOR,10,120,100,20,1
06-04-2025,Household & Cleaning,VIM MAHA BAR,6,20,20,0,2
06-04-2025,Personal Care & Cosmetics,COLGATE ACTIVE SALT,10,20,20,0,1
06-04-2025,"Dry Fruits, Nuts & Seeds",Groundnuts 500 gms,2,95,85,10,1
06-04-2025,Snacks & Ready-to-Eat,VD ATUKULU MIXTURE 175GM,14,60,60,0,1
06-04-2025,Snacks & Ready-to-Eat,NGT CHATPATTA CHANA 90GM,14,25,25,0,1
06-04-2025,Snacks & Ready-to-Eat,VD BELLAM GAVVALU 200GM,14,60,60,0,1
06-04-2025,Beverages,REFRESH SHARBATH SUGAR FREE,1,299,285,14,1
06-04-2025,Pooja & Spiritual Items,KASHI ASHTAGANDHA CHANDHANA,12,20,20,0,1
06-04-2025,"Dry Fruits, Nuts & Seeds",sabja seeds,2,80,70,10,1
06-04-2025,Snacks & Ready-to-Eat,BB VERMICELLY 500GM,14,53,53,0,1
06-04-2025,"Dry Fruits, Nuts & Seeds",PUTNALU 500GMS,2,90,76,14,1
06-04-2025,"Dry Fruits, Nuts & Seeds",Groundnuts 1 kg,2,190,165,25,1
06-04-2025,Snacks & Ready-to-Eat,GB SALT COOKIES,14,60,55,5,1
06-04-2025,"Grains, Flours & Dals",ANDU KORRALU (Browntop.m) 1 kg,4,260,220,40,1
06-04-2025,"Grains, Flours & Dals",MELMEKER 250GMS,4,60,45,15,1
06-04-2025,Pooja & Spiritual Items,GD JASMINE 75GM,12,60,60,0,1
06-04-2025,"Grains, Flours & Dals",Arikadu ( kodo),4,140,130,10,1
06-04-2025,Pooja & Spiritual Items,GD Aiswarya Deepam 700ML,12,195,195,0,1
06-04-2025,"Dry Fruits, Nuts & Seeds",FLAX SEEDS 250GM,2,60,50,10,1
06-04-2025,"Dry Fruits, Nuts & Seeds",cashew,2,340,310,30,1
06-04-2025,"Dry Fruits, Nuts & Seeds",wallnuts,2,380,320,60,1
06-04-2025,"Dry Fruits, Nuts & Seeds",PUMPKIN SEEDS 250GM,2,200,160,40,1
06-04-2025,"Dry Fruits, Nuts & Seeds",ALMONDS 250GM,2,280,260,20,1
06-04-2025,"Dry Fruits, Nuts & Seeds",WATERMELON SEEDS 250GRM,2,320,280,40,1
06-04-2025,Snacks & Ready-to-Eat,SD MASALA GAVVALU 200GM,14,95,95,0,1
06-04-2025,Snacks & Ready-to-Eat,VD PALLI LADDU,14,80,80,0,1
06-04-2025,Snacks & Ready-to-Eat,RSC ORANGE 100GMS,14,20,20,0,1
06-04-2025,Snacks & Ready-to-Eat,VD Pappu Chekkalu 190gm,14,60,60,0,1
06-04-2025,"Dry Fruits, Nuts & Seeds",SALTED PISTA 250GM,2,400,350,50,1
06-04-2025,"Dry Fruits, Nuts & Seeds",SUNFLOWER SEEDS 250GRM,2,150,130,20,1
06-04-2025,"Grains, Flours & Dals",RAGI FLOUR 500GRMS,4,40,35,5,1
06-04-2025,Pooja & Spiritual Items,KASHI ASHTAGANDHA CHANDHANA,12,20,20,0,1
06-04-2025,"Grains, Flours & Dals",DISANO ROLED OATS,4,143,143,0,1
06-04-2025,"Dry Fruits, Nuts & Seeds",sabja seeds,2,80,70,10,1
06-04-2025,"Grains, Flours & Dals",Idly Rava L 1KG,4,60,50,10,1
06-04-2025,"Grains, Flours & Dals",Em jowar idly R 500G,4,75,75,0,1
06-04-2025,"Dry Fruits, Nuts & Seeds",PUMPKIN SEEDS 250GM,2,200,160,40,1
06-04-2025,"Dry Fruits, Nuts & Seeds",ALMONDS 250GM,2,280,260,20,1
06-04-2025,Snacks & Ready-to-Eat,Pani Poori Chips 250GM,14,100,80,20,2
06-04-2025,Snacks & Ready-to-Eat,SD Vamu with palm jaggery 250gm,14,135,135,0,1
06-04-2025,Oils & Ghee,Safflower oil 1 L,9,880,800,80,2
06-04-2025,Snacks & Ready-to-Eat,SATHVI REGIVADA 200GM,14,80,60,20,1
06-04-2025,Snacks & Ready-to-Eat,NGT CHATPATTA CHANA 90GM,14,25,25,0,1
06-04-2025,Oils & Ghee,Groundnut oil 1 L,9,360,330,30,1
06-04-2025,Pooja & Spiritual Items,GD Ramayana Sandal 75GM,12,60,60,0,1
06-04-2025,Spices & Seasonings,KALONJI SEEDS,15,90,80,10,1
06-04-2025,"Grains, Flours & Dals",Wheat Flour 1 kg,4,280,240,40,4
06-04-2025,"Grains, Flours & Dals",CHANA DAL 500GM,4,70,60,10,1
06-04-2025,Oils & Ghee,Sesame oil 500ml,9,295,280,15,1
06-04-2025,"Dry Fruits, Nuts & Seeds",PULMAKHANA 100 GM,2,180,170,10,1
06-04-2025,"Grains, Flours & Dals",CORN FOUR 250GM,4,40,35,5,1
06-04-2025,"Grains, Flours & Dals",Idly Rava L 1KG,4,60,50,10,1
06-04-2025,Snacks & Ready-to-Eat,DINNER PAPAD,14,80,80,0,1
06-04-2025,"Grains, Flours & Dals",HS JOWAR IDLY RAWA,4,65,65,0,1
06-04-2025,"Grains, Flours & Dals",Wheat Flour 1 kg,4,350,300,50,5
06-04-2025,Oils & Ghee,Sesame oil 1 L,9,590,560,30,1
06-04-2025,Spices & Seasonings,Telaga Pindi 250 GM,15,40,35,5,1
06-04-2025,Snacks & Ready-to-Eat,SUNNUNDALU,14,120,120,0,1
06-04-2025,"Grains, Flours & Dals",SA WHITE JOWAR RAVA 500GM,4,69,69,0,1
06-04-2025,Spices & Seasonings,PRO HIMALAYAN PINK SALT 500GM,15,136,136,0,2
06-04-2025,"Grains, Flours & Dals",RAGI FLOUR 1KG,4,80,70,10,1
06-04-2025,"Grains, Flours & Dals",Wheat Rava M 1KG,4,65,55,10,1
06-04-2025,Snacks & Ready-to-Eat,SS IDLY BATTER 1KG,14,60,60,0,1
06-04-2025,Oils & Ghee,Black Sesame oil 1 L,9,440,380,60,1
06-04-2025,Snacks & Ready-to-Eat,SANNAKARAMPUSA,14,60,60,0,1
06-04-2025,Personal Care & Cosmetics,UVIS LACTO TAN SOAP 100GM,10,99,99,0,1
06-04-2025,Oils & Ghee,Groundnut oil 1 L,9,360,330,30,1
06-04-2025,Oils & Ghee,Sesame oil 1 L,9,590,560,30,1
06-04-2025,"Grains, Flours & Dals",THICK POHA 1KG,4,80,70,10,1
06-04-2025,"Grains, Flours & Dals",RAGI FLOUR 500GRMS,4,40,35,5,1
06-04-2025,Oils & Ghee,Coconut oil 500 ml,9,440,400,40,2
06-04-2025,"Grains, Flours & Dals",HS JOWAR IDLY RAWA,4,130,130,0,2
06-04-2025,Snacks & Ready-to-Eat,KURNOOL MARMURA,14,80,65,15,1
06-04-2025,"Health, Wellness & Ayurvedic Products",DWI BHRINGARAJA TAILAM 100ML,5,150,150,0,1
06-04-2025,Snacks & Ready-to-Eat,RAJGIRA PEANUT CHIKKI 450GM,14,125,125,0,1
06-04-2025,Oils & Ghee,rice bran oil f,9,194,169,25,1
06-04-2025,"Grains, Flours & Dals",turdal 500 gms,4,110,85,25,1
06-04-2025,"Health, Wellness & Ayurvedic Products",RB Nuts& Seeds cashews 35g,5,45,45,0,1
06-04-2025,"Grains, Flours & Dals",MIXED FLOUR,4,36,36,0,1
06-04-2025,Snacks & Ready-to-Eat,VD MINAPA MIRCHI PAPAD 195GM,14,70,70,0,1
06-04-2025,"Dry Fruits, Nuts & Seeds",sabja seeds,2,80,70,10,1
06-04-2025,Snacks & Ready-to-Eat,ANNAPURNA APPALAM,14,35,35,0,1
06-04-2025,General Household & Kitchenware,GOODHOME S,3,30,30,0,3
06-04-2025,Beverages,REFRESH SHARBATH NORMAL,1,199,190,9,1
06-04-2025,"Dry Fruits, Nuts & Seeds",DRYDATES 250GM,2,150,120,30,1
06-04-2025,Household & Cleaning,VIM EXTRA 110GM,6,50,50,0,5
06-04-2025,Snacks & Ready-to-Eat,VD RICE MURUKU 150GM,14,50,50,0,1
06-04-2025,Oils & Ghee,Sesame oil 1 L,9,590,560,30,1
06-04-2025,Snacks & Ready-to-Eat,Corn Chips 250GM,14,40,35,5,1
06-04-2025,"Grains, Flours & Dals",split black gram 1 kg,4,180,170,10,1
06-04-2025,Sweeteners,MISHRI 250 GM,16,35,30,5,1
06-04-2025,"Dry Fruits, Nuts & Seeds",PULMAKHANA 100 GM,2,360,340,20,2
06-04-2025,"Grains, Flours & Dals",PESARA PAPPU 1 KG,4,170,145,25,1
06-04-2025,"Grains, Flours & Dals",turdal 500 gms,4,110,85,25,1
06-04-2025,Oils & Ghee,Groundnut oil 1 L,9,720,660,60,2
06-04-2025,"Dry Fruits, Nuts & Seeds",ALMONDS 250GM,2,280,260,20,1
06-04-2025,"Dry Fruits, Nuts & Seeds",cashew,2,340,310,30,1
06-04-2025,Pooja & Spiritual Items,GD Camphor 50GM,12,115,115,0,1
06-04-2025,"Grains, Flours & Dals",UDALU (Barnyard millet) 500 gms,4,70,60,10,1
06-04-2025,"Dry Fruits, Nuts & Seeds",PLAIN PISTA 250GM,2,660,550,110,1
06-04-2025,"Grains, Flours & Dals",Arikalu (kodo),4,70,65,5,1
06-04-2025,"Grains, Flours & Dals",KORRALU (FOXTAIL M) 500GM,4,65,55,10,1
06-04-2025,"Grains, Flours & Dals",MULTIMILLET IDLY RAVVA,4,130,130,0,2
06-04-2025,"Grains, Flours & Dals",MELMEKER 250GMS,4,60,45,15,1
06-04-2025,Snacks & Ready-to-Eat,MB SORGHUM NOODLES 180GM,14,190,190,0,2
06-04-2025,"Grains, Flours & Dals",Green Batani 250GM,4,55,45,10,1
06-04-2025,"Dry Fruits, Nuts & Seeds",sabja seeds,2,80,70,10,1
06-04-2025,"Grains, Flours & Dals",RAJMA 250GM,4,110,90,20,2
06-04-2025,Spices & Seasonings,kasturi methi,15,60,60,0,1
06-04-2025,"Grains, Flours & Dals",SH RED POHA 500GM,4,85,85,0,1
06-04-2025,"Grains, Flours & Dals",SAMALU,4,170,130,40,1
06-04-2025,"Grains, Flours & Dals",Wheat Rava M 500GM,4,33,30,3,1
06-04-2025,"Grains, Flours & Dals",HS MULTI UPMA RAVA,4,65,65,0,1
06-04-2025,Snacks & Ready-to-Eat,PEANUT CHIKKI,14,264,264,0,12
06-04-2025,"Grains, Flours & Dals",BLACKGRAM,4,70,70,0,1
06-04-2025,Oils & Ghee,Sesame oil 1 L,9,2360,"2,240.00",120,4
06-04-2025,"Dry Fruits, Nuts & Seeds",SATHVI CHIA SEEDS 100GM,2,100,80,20,1
06-04-2025,Snacks & Ready-to-Eat,VD MURUKU 175GM,14,120,120,0,2
06-04-2025,"Grains, Flours & Dals",Multigrain 1 kg,4,100,85,15,1
06-04-2025,"Grains, Flours & Dals",Wheat Flour 1 kg,4,70,60,10,1
06-04-2025,Spices & Seasonings,Jeera 100GM,15,50,45,5,1
06-04-2025,"Grains, Flours & Dals",HEALTH JOWAR RAWA,4,99,99,0,1
06-04-2025,"Grains, Flours & Dals",RED TURDAL 500GM,4,75,70,5,1
06-04-2025,Personal Care & Cosmetics,UVIS SANDALWOOD POWDR 100gm,10,0,0,0,1
06-04-2025,Spices & Seasonings,DHANIYA POWDER 200GM,15,100,85,15,1
06-04-2025,"Dry Fruits, Nuts & Seeds",ROASTED FLAXSEED,2,75,75,0,1
06-04-2025,"Grains, Flours & Dals",POORI ATTA 500GM,4,70,60,10,2
06-04-2025,Spices & Seasonings,AVALU 100GM,15,25,20,5,1
06-04-2025,"Grains, Flours & Dals",MULTIMILLET IDLY RAVVA,4,65,65,0,1
06-04-2025,"Grains, Flours & Dals",HS MULTI UPMA RAVA,4,65,65,0,1
06-04-2025,Spices & Seasonings,GARAM MASALA 200GM,15,120,95,25,1
06-04-2025,"Grains, Flours & Dals",SA Multi Grain Mix 500GM,4,159,159,0,1
06-04-2025,Spices & Seasonings,PUTNALA KARAM POWDER 100GM,15,65,65,0,1
06-04-2025,Spices & Seasonings,idli karam powdwer,15,65,65,0,1
06-04-2025,Spices & Seasonings,GROUNDNUT KARAM POWDER,15,65,65,0,1
06-04-2025,"Grains, Flours & Dals",RICE FLOUR 500 GM,4,35,28,7,1
06-04-2025,Spices & Seasonings,MASALA KAR 500GMS,15,260,240,20,1
06-04-2025,Household & Cleaning,VIM MAHA BAR,6,30,30,0,3
06-04-2025,"Grains, Flours & Dals",SPLIT URAD DAL,4,45,45,0,1
06-04-2025,"Grains, Flours & Dals",URAD DALL,4,95,85,10,1
06-04-2025,Pooja & Spiritual Items,GD TULASI 75GM,12,120,120,0,2
06-04-2025,Spices & Seasonings,ROYAL SAFFRON 400GRMS,15,65,65,0,1
06-04-2025,"Grains, Flours & Dals",PESARA PAPPU 1 KG,4,170,145,25,1
06-04-2025,"Grains, Flours & Dals",CHANA DAL 500GM,4,70,60,10,1
06-04-2025,Spices & Seasonings,JEERA 250 gms,15,125,105,20,1
06-04-2025,"Dry Fruits, Nuts & Seeds",Groundnuts 500 gms,2,95,85,10,1
06-04-2025,"Grains, Flours & Dals",CHANA DAL 500GM,4,70,60,10,1
06-04-2025,"Grains, Flours & Dals",Green Batani 250GM,4,55,45,10,1
06-04-2025,"Grains, Flours & Dals",DOCTOR RICE DIABETIC SFR 1KG,4,600,600,0,5
06-04-2025,Oils & Ghee,Black Sesame oil 1 L,9,440,380,60,1
06-04-2025,Pooja & Spiritual Items,divya deeparadhana oil,12,190,190,0,1
06-04-2025,Spices & Seasonings,Black Till 250GM,15,90,75,15,1
06-04-2025,"Grains, Flours & Dals",JOWAR WHITE 1 KG,4,80,70,10,1
06-04-2025,Pooja & Spiritual Items,BALAJI GOLDEN SPIRIT 100G,12,85,85,0,1
06-04-2025,Spices & Seasonings,menthulu,15,90,90,0,1
06-04-2025,Pooja & Spiritual Items,BALAJI KASTURI DHOOP STICKS,12,70,70,0,1
06-04-2025,"Grains, Flours & Dals",URAD DALL,4,95,85,10,1
06-04-2025,"Grains, Flours & Dals",RAGULU 1 KG,4,105,90,15,1.5
06-04-2025,Spices & Seasonings,Chilli powder 500 gms,15,290,210,80,1
06-04-2025,"Grains, Flours & Dals",RAGI FLOUR 500GRMS,4,80,70,10,2
06-04-2025,Snacks & Ready-to-Eat,PALLI LADDU 200GMS,14,90,70,20,1
06-04-2025,Snacks & Ready-to-Eat,VD BELLAM GAVVALU 200GM,14,120,120,0,2
06-04-2025,Snacks & Ready-to-Eat,VD BOONDI 175GM,14,120,120,0,2
06-04-2025,"Grains, Flours & Dals",AISHWARYA SP 1KG,4,80,70,10,1
06-04-2025,Snacks & Ready-to-Eat,BELLAM MINAPA SUNADULLU,14,180,180,0,1
06-04-2025,Oils & Ghee,Groundnut oil 1 L,9,720,660,60,2
06-04-2025,Oils & Ghee,Groundnut oil 1 L,9,360,330,30,1
06-04-2025,Spices & Seasonings,Chilli powder 500 gms,15,290,210,80,1
06-04-2025,Oils & Ghee,Sesame oil 500ml,9,295,280,15,1
06-04-2025,Spices & Seasonings,ROYAL SAFFRON 400GRMS,15,65,65,0,1
06-04-2025,Pooja & Spiritual Items,divya deeparadhana oil,12,190,190,0,1
06-04-2025,"Grains, Flours & Dals",JOWAR WHITE 1 KG,4,80,70,10,1
05-04-2025,"Grains, Flours & Dals",Quinova 500 gms,4,550,500,50,5
05-04-2025,"Grains, Flours & Dals",ANDU KORRALU (Browntop.m) 1 kg,4,260,220,40,1
05-04-2025,Sweeteners,ACHU BELLAM 1KG,16,100,80,20,1
05-04-2025,"Grains, Flours & Dals",KORRALU (FOXTAIL M) 1KG,4,150,110,40,1
05-04-2025,"Dry Fruits, Nuts & Seeds",WATERMELON SEEDS 250GRM,2,1280,"1,120.00",160,4
05-04-2025,"Grains, Flours & Dals",UDALU (Barnyard millet) 1 kg,4,140,115,25,1
05-04-2025,"Dry Fruits, Nuts & Seeds",PUMPKIN SEEDS 250GM,2,800,640,160,4
05-04-2025,"Grains, Flours & Dals",SAMALU,4,170,130,40,1
05-04-2025,Snacks & Ready-to-Eat,NGT CHATPATTA CHANA 90GM,14,50,50,0,2
05-04-2025,"Grains, Flours & Dals",Quinova 1 kg,4,1320,"1,170.00",150,6
05-04-2025,Snacks & Ready-to-Eat,GREEN FRIED BATANA,14,40,40,0,2
05-04-2025,Spices & Seasonings,Chilli powder 1 kg,15,580,420,160,1
05-04-2025,"Dry Fruits, Nuts & Seeds",SUNFLOWER SEEDS 250GRM,2,600,520,80,4
05-04-2025,"Grains, Flours & Dals",Arikadu ( kodo),4,140,130,10,1
05-04-2025,"Grains, Flours & Dals",UNPOLISHED TURDALL 1KG,4,1680,"1,470.00",210,7
05-04-2025,Oils & Ghee,Coconut oil 1 L,9,440,400,40,1
05-04-2025,Oils & Ghee,rice bran oil f,9,194,169,25,1
05-04-2025,Spices & Seasonings,SWEET SOUNF,15,20,20,0,1
05-04-2025,Snacks & Ready-to-Eat,VD RED CHILLI RICEPAPAD 150GM,14,50,50,0,1
05-04-2025,Oils & Ghee,Black Sesame oil 1 L,9,440,380,60,1
05-04-2025,Spices & Seasonings,ROYAL SAFFRON,15,250,250,0,2
05-04-2025,"Dry Fruits, Nuts & Seeds",FLAX SEEDS 250GM,2,120,100,20,2
05-04-2025,Spices & Seasonings,MASALA KAR 500GMS,15,260,240,20,1
05-04-2025,"Grains, Flours & Dals",Sathya Javva Wheat Rava 500GM,4,180,180,0,2
05-04-2025,"Grains, Flours & Dals",BOMBAY RAVA,4,140,110,30,2
05-04-2025,"Grains, Flours & Dals",PESARA PAPPU 500GMS,4,85,75,10,1
05-04-2025,"Grains, Flours & Dals",UDALU (Barnyard millet) 500 gms,4,70,60,10,1
05-04-2025,Milk & Dairy,HERITAGE BUTTERMILK,7,10,10,0,1
05-04-2025,"Grains, Flours & Dals",BARLEY SEEDS 250GMS,4,40,35,5,1
05-04-2025,"Dry Fruits, Nuts & Seeds",Groundnuts 500 gms,2,95,85,10,1
05-04-2025,"Grains, Flours & Dals",White jowar.F 1 kg,4,100,80,20,1
05-04-2025,"Grains, Flours & Dals",Wheat Flour 1 kg,4,70,60,10,1
05-04-2025,"Grains, Flours & Dals",Wheat Rava S 1KG,4,65,55,10,1
05-04-2025,"Grains, Flours & Dals",RAGULU 1 KG,4,140,120,20,2
05-04-2025,"Grains, Flours & Dals",UNPOLISHED TURDALL 1KG,4,240,210,30,1
05-04-2025,Snacks & Ready-to-Eat,SD barnyard Millet with palm jaggery,14,135,135,0,1
05-04-2025,Personal Care & Cosmetics,SVE TURMERIC SOAP 100GM,10,90,90,0,1
05-04-2025,Personal Care & Cosmetics,DWI NEEM TULSI SOAP 100GM,10,75,75,0,1
05-04-2025,Personal Care & Cosmetics,KAIPO SANDALWOOD SOAP 100GM,10,60,60,0,1
05-04-2025,"Dry Fruits, Nuts & Seeds",D kimia,2,310,180,130,1
05-04-2025,Oils & Ghee,Groundnut oil 5 L,9,1800,"1,600.00",200,1
05-04-2025,Personal Care & Cosmetics,UVIS RED SANDAL SOAP 100GM,10,85,85,0,1
05-04-2025,Personal Care & Cosmetics,SVE HIBISCUS SOAP,10,90,90,0,1
05-04-2025,Snacks & Ready-to-Eat,VD SAGOPAPAD 150GM,14,55,55,0,1
05-04-2025,"Grains, Flours & Dals",BASMATHI RICE 1KG,4,150,135,15,1
05-04-2025,"Dry Fruits, Nuts & Seeds",PUTNALU 500GMS,2,90,76,14,1
05-04-2025,Spices & Seasonings,AVALU 100GM,15,50,40,10,2
05-04-2025,"Dry Fruits, Nuts & Seeds",sabja seeds,2,80,70,10,1
05-04-2025,Spices & Seasonings,JEERA 250 gms,15,125,105,20,1
05-04-2025,"Dry Fruits, Nuts & Seeds",Groundnuts 1 kg,2,380,330,50,2
05-04-2025,Spices & Seasonings,BLACK JEERA 50 GM,15,45,30,15,1
05-04-2025,Snacks & Ready-to-Eat,ANNAPURNA APPALAM,14,70,70,0,2
05-04-2025,Spices & Seasonings,Menthulu 250 gms,15,50,45,5,1
05-04-2025,"Grains, Flours & Dals",MULTIMILLET IDLY RAVVA,4,65,65,0,1
05-04-2025,Snacks & Ready-to-Eat,MB LITTLE MILLET NOODLES 180G,14,95,95,0,1
05-04-2025,Snacks & Ready-to-Eat,MB MULTIMILLET NOODLES 180GM,14,95,95,0,1
05-04-2025,Personal Care & Cosmetics,GAYATHRI KUMKUDUKAYA,10,150,150,0,1
05-04-2025,"Grains, Flours & Dals",UNPOLISHED TURDALL 1KG,4,240,210,30,1
05-04-2025,"Dry Fruits, Nuts & Seeds",SATHVI CHIA SEEDS 100GM,2,100,80,20,1
05-04-2025,Oils & Ghee,Safflower oil 1 L,9,440,400,40,1
05-04-2025,"Grains, Flours & Dals",Wheat Flour 1 kg,4,70,60,10,1
05-04-2025,"Dry Fruits, Nuts & Seeds",PUMPKIN SEEDS 250GM,2,200,160,40,1
05-04-2025,Snacks & Ready-to-Eat,PEANUT CHIKKI,14,22,22,0,1
05-04-2025,Oils & Ghee,Groundnut oil 1 L,9,360,330,30,1
05-04-2025,Sweeteners,NATURAL HONEY 1KG,16,560,480,80,1
05-04-2025,Snacks & Ready-to-Eat,SD RAGI GAVVALU,14,95,95,0,1
05-04-2025,Pooja & Spiritual Items,javadhu,12,60,60,0,2
05-04-2025,"Health, Wellness & Ayurvedic Products",MD Sugandhi Pala Churnam 30GM,5,90,90,0,1
05-04-2025,Snacks & Ready-to-Eat,NGT CHATPATTA CHANA 90GM,14,25,25,0,1
05-04-2025,"Health, Wellness & Ayurvedic Products",RB FRUITS &amp;seeds Cranberries,5,45,45,0,1
05-04-2025,Snacks & Ready-to-Eat,GREEN FRIED BATANA,14,20,20,0,1
05-04-2025,Personal Care & Cosmetics,GAYATHRI KUMKUDUKAYA,10,150,150,0,1
05-04-2025,"Grains, Flours & Dals",HS MULTI UPMA RAVA,4,65,65,0,1
05-04-2025,"Health, Wellness & Ayurvedic Products",RB Max Protein Oats &Raisins 55gm,5,50,50,0,1
05-04-2025,Spices & Seasonings,AV Iodized Salt 1KG,15,28,25,3,1
05-04-2025,"Dry Fruits, Nuts & Seeds",cashew,2,340,310,30,1
05-04-2025,Sweeteners,ACHU BELLAM 1KG,16,100,80,20,1
05-04-2025,Snacks & Ready-to-Eat,VD MURMURA LADDU,14,50,50,0,1
05-04-2025,Snacks & Ready-to-Eat,SD Ginger Candy 100g,14,60,60,0,1
05-04-2025,"Grains, Flours & Dals",RICE FLOUR 500 GM,4,35,28,7,1
05-04-2025,Snacks & Ready-to-Eat,GROUNDNUT LADDU WITH DATES,14,135,135,0,1
05-04-2025,"Grains, Flours & Dals",CHANA DAL 500GM,4,70,60,10,1
05-04-2025,Snacks & Ready-to-Eat,ELITE ELAICHI RUSK 200GM,14,35,35,0,1
05-04-2025,Snacks & Ready-to-Eat,SATHVI REGIVADA 200GM,14,80,60,20,1
05-04-2025,"Grains, Flours & Dals",Multigrain 1 kg,4,100,85,15,1
05-04-2025,"Grains, Flours & Dals",AISHWARYA LOW GI RICE 5KG,4,700,525,175,1
05-04-2025,"Grains, Flours & Dals",MAATEJA rice 1 kg,4,360,345,15,5
05-04-2025,Snacks & Ready-to-Eat,SD Little Millet WITH PLAM JAGGERY,14,135,135,0,1
05-04-2025,"Grains, Flours & Dals",UNPOLISHED TURDALL 1KG,4,240,210,30,1
05-04-2025,Sweeteners,NATURAL HONEY 250GM,16,150,130,20,1
05-04-2025,"Grains, Flours & Dals",SABDANA 500GM,4,90,70,20,1
05-04-2025,"Grains, Flours & Dals",YELLOW JOWER 1KG,4,90,90,0,1
05-04-2025,"Grains, Flours & Dals",Wheat Rava M 500GM,4,33,30,3,1
05-04-2025,Oils & Ghee,Groundnut oil 1 L,9,360,330,30,1
05-04-2025,"Grains, Flours & Dals",Idly Rava L 1KG,4,60,50,10,1
05-04-2025,Oils & Ghee,Safflower oil 500 ml,9,220,200,20,1
05-04-2025,Spices & Seasonings,SAMBAR POWDER 200GM,15,130,110,20,1
05-04-2025,Spices & Seasonings,SD Redgram Karam Powder 100GM,15,65,65,0,1
05-04-2025,"Grains, Flours & Dals",Wheat Rava M 500GM,4,33,30,3,1
05-04-2025,"Dry Fruits, Nuts & Seeds",DRYDATES YELLOW 250GM,2,135,120,15,1
05-04-2025,Spices & Seasonings,GS GARLIC KARAM 100GM,15,75,75,0,1
05-04-2025,Spices & Seasonings,Turmeric powder 250 gms,15,100,75,25,1
05-04-2025,Snacks & Ready-to-Eat,SUNNUNDALU,14,120,120,0,1
05-04-2025,Personal Care & Cosmetics,OVAL BODY LOOFAH,10,55,55,0,1
05-04-2025,Snacks & Ready-to-Eat,GANTASALA GINGER CANDY 200GM,14,105,105,0,1
05-04-2025,Snacks & Ready-to-Eat,SD Flax seeds with dates 250gm,14,135,135,0,1
05-04-2025,Spices & Seasonings,Chilli powder 500 gms,15,290,210,80,1
05-04-2025,Oils & Ghee,Groundnut oil 1 L,9,360,330,30,1
05-04-2025,Snacks & Ready-to-Eat,VD Minapa papad 200gm,14,60,60,0,1
05-04-2025,Pooja & Spiritual Items,divya deeparadhana oil,12,190,190,0,1
05-04-2025,"Grains, Flours & Dals",split green gram 500 gms,4,75,70,5,1
05-04-2025,"Dry Fruits, Nuts & Seeds",PULMAKHANA 100 GM,2,180,170,10,1
05-04-2025,"Grains, Flours & Dals",BARLEY SEEDS 250GMS,4,40,35,5,1
05-04-2025,Spices & Seasonings,AVALU 100GM,15,25,20,5,1
05-04-2025,Snacks & Ready-to-Eat,VD PALLI LADDU,14,160,160,0,2
05-04-2025,"Grains, Flours & Dals",KORRALU (FOXTAIL M) 500GM,4,65,55,10,1
05-04-2025,"Grains, Flours & Dals",RAGI FLOUR 500GRMS,4,40,35,5,1
05-04-2025,"Grains, Flours & Dals",SH RED POHA 500GM,4,85,85,0,1
05-04-2025,"Grains, Flours & Dals",Wheat Rava M 1KG,4,65,55,10,1
05-04-2025,Milk & Dairy,HERITAGE TOTAL CURD 500GM,7,50,50,0,1
05-04-2025,Oils & Ghee,Groundnut oil 1 L,9,360,330,30,1
05-04-2025,Milk & Dairy,SANGAM TONED MILK 500ML,7,31,31,0,1
05-04-2025,"Health, Wellness & Ayurvedic Products",RB Nuts& Seeds cashews 35g,5,45,45,0,1
05-04-2025,"Dry Fruits, Nuts & Seeds",PULMAKHANA 100 GM,2,180,170,10,1
05-04-2025,Snacks & Ready-to-Eat,CHOCO BROWINE,14,20,20,0,1
05-04-2025,Snacks & Ready-to-Eat,RI SPORTS BAR 40G,14,45,45,0,1
05-04-2025,"Grains, Flours & Dals",UDALU (Barnyard millet) 500 gms,4,70,60,10,1
05-04-2025,"Grains, Flours & Dals",SAMALU,4,170,130,40,1
05-04-2025,Snacks & Ready-to-Eat,VD NUVVULU LADDU,14,80,80,0,1
05-04-2025,Pooja & Spiritual Items,GD Dhoop Cones 40GM,12,30,30,0,1
05-04-2025,"Dry Fruits, Nuts & Seeds",YELLOW KISHMISH 250GM,2,130,110,20,1
05-04-2025,Spices & Seasonings,PRO HIMALAYAN PINK SALT 500GM,15,68,68,0,1
05-04-2025,"Grains, Flours & Dals",Arikalu (kodo),4,70,65,5,1
05-04-2025,Personal Care & Cosmetics,OVAL BODY LOOFAH,10,55,55,0,1
05-04-2025,"Grains, Flours & Dals",KORRALU (FOXTAIL M) 500GM,4,65,55,10,1
05-04-2025,Snacks & Ready-to-Eat,PEANUT CHILLI,14,10,10,0,2
05-04-2025,"Dry Fruits, Nuts & Seeds",SD Mango cubes 100gm,2,45,45,0,1
05-04-2025,"Grains, Flours & Dals",Idly Rava L 1KG,4,120,100,20,2
05-04-2025,"Grains, Flours & Dals",Wheat Flour 1 kg,4,420,360,60,6
05-04-2025,"Grains, Flours & Dals",BOMBAY RAVA,4,70,55,15,1
05-04-2025,"Grains, Flours & Dals",RAGI FLOUR 1KG,4,160,140,20,2
05-04-2025,Oils & Ghee,Groundnut oil 1 L,9,360,330,30,1
05-04-2025,Oils & Ghee,Groundnut oil 1 L,9,360,330,30,1
05-04-2025,Oils & Ghee,Safflower oil 1 L,9,880,800,80,2
05-04-2025,Sweeteners,GS Palm Jaggery Powder 400GM,16,360,360,0,2
05-04-2025,Snacks & Ready-to-Eat,SD Moringa with plam jaggery 250gm,14,135,135,0,1
05-04-2025,Snacks & Ready-to-Eat,SD Aswagandha with palm Jaggery250Gm,14,135,135,0,1
05-04-2025,Spices & Seasonings,GS GARLIC KARAM 100GM,15,75,75,0,1
05-04-2025,Snacks & Ready-to-Eat,CHOCO BROWINE,14,20,20,0,1
05-04-2025,"Grains, Flours & Dals",Multigrain 1 kg,4,100,85,15,1
05-04-2025,Spices & Seasonings,Coriander seeds 200 gms,15,48,40,8,1
05-04-2025,Snacks & Ready-to-Eat,BB VERMICELLY 500GM,14,53,53,0,1
05-04-2025,"Dry Fruits, Nuts & Seeds",SD Mango cubes 100gm,2,45,45,0,1
05-04-2025,Spices & Seasonings,ROYAL SAFFRON 400GRMS,15,65,65,0,1
05-04-2025,"Grains, Flours & Dals",PRO ORG MEDIUM POHA 500G,4,78,78,0,1
05-04-2025,Spices & Seasonings,SH BAY LEAF / TEJ PATTA 30GM,15,35,35,0,1
05-04-2025,Snacks & Ready-to-Eat,GREEN FRIED BATANA,14,20,20,0,1
05-04-2025,"Grains, Flours & Dals",Multigrain 1 kg,4,100,85,15,1
05-04-2025,Spices & Seasonings,Gasagasalu 50GM,15,130,110,20,1
05-04-2025,"Grains, Flours & Dals",Chana Flour 500 gms,4,70,65,5,1
05-04-2025,Snacks & Ready-to-Eat,BD KODO MILLET NOODLES 200GM,14,75,75,0,1
05-04-2025,Snacks & Ready-to-Eat,RAJGIRA PEANUT CHIKKI 450GM,14,125,125,0,1
05-04-2025,Snacks & Ready-to-Eat,HS Ragi biscuits,14,50,50,0,1
05-04-2025,Sweeteners,SD PALM JAGGERY 500GM,16,200,200,0,1
05-04-2025,General Household & Kitchenware,SABEENA,3,15,15,0,1
05-04-2025,"Grains, Flours & Dals",YELLOW JOWER 1KG,4,90,90,0,1
05-04-2025,Snacks & Ready-to-Eat,VD MIXTURE 175 GM,14,60,60,0,1
05-04-2025,"Grains, Flours & Dals",Bajra Flour 1 kg,4,70,60,10,1
05-04-2025,Oils & Ghee,Coconut oil 1 L,9,440,400,40,1
05-04-2025,Snacks & Ready-to-Eat,VD MYSOREPAK 6PIC,14,100,100,0,1
05-04-2025,Snacks & Ready-to-Eat,VD BOONDI 175GM,14,60,60,0,1
05-04-2025,Spices & Seasonings,PN ORGANIC PINK SALT 1KG,15,124,124,0,1
05-04-2025,Misc,VD00206,8,60,60,0,1
05-04-2025,Spices & Seasonings,PRO HIMALAYAN PINK SALT 500GM,15,68,68,0,1
05-04-2025,Spices & Seasonings,AVALU 100GM,15,25,20,5,1
05-04-2025,"Grains, Flours & Dals",Chana Flour 500 gms,4,70,65,5,1
05-04-2025,Spices & Seasonings,JEERA 250 gms,15,125,105,20,1
05-04-2025,Snacks & Ready-to-Eat,RSC ORANGE 100GMS,14,20,20,0,1
05-04-2025,Misc,C123,8,80,80,0,1
05-04-2025,"Grains, Flours & Dals",HS MULTI UPMA RAVA,4,65,65,0,1
05-04-2025,"Grains, Flours & Dals",RAGI FLOUR 500GRMS,4,80,70,10,2
05-04-2025,"Grains, Flours & Dals",SPLIT URAD DAL,4,45,45,0,1
05-04-2025,"Grains, Flours & Dals",Wheat Flour 1 kg,4,70,60,10,1
05-04-2025,Snacks & Ready-to-Eat,RAJGIRA PEANUT CHIKKI,14,10,10,0,2
05-04-2025,Oils & Ghee,Safflower oil 1 L,9,440,400,40,1
05-04-2025,Oils & Ghee,Groundnut oil 1 L,9,360,330,30,1
05-04-2025,Snacks & Ready-to-Eat,BD RAGI NOODLES,14,75,75,0,1
05-04-2025,"Grains, Flours & Dals",MAATEJA rice 1 kg,4,72,69,3,1
05-04-2025,"Grains, Flours & Dals",SL Idly Rava 1KG,4,65,55,10,1
05-04-2025,Beverages,BRU GREEN LABEL 1.2G,1,12,12,0,6
05-04-2025,"Grains, Flours & Dals",Yellow jowar .F1 kg,4,110,100,10,1
05-04-2025,"Grains, Flours & Dals",PESARA PAPPU 500GMS,4,85,75,10,1
05-04-2025,"Dry Fruits, Nuts & Seeds",YB GRANMA NUTS,2,180,180,0,2
05-04-2025,"Grains, Flours & Dals",Black gram 500 gms,4,150,140,10,2
05-04-2025,"Grains, Flours & Dals",White jowar.F 1 kg,4,100,80,20,1
05-04-2025,Oils & Ghee,rice bran oil f,9,194,169,25,1
05-04-2025,Misc,386627138,8,130,130,0,1
05-04-2025,Spices & Seasonings,Tamarind 250GMS,15,80,65,15,1
05-04-2025,"Grains, Flours & Dals",PESARA PAPPU 500GMS,4,85,75,10,1
05-04-2025,"Grains, Flours & Dals",Wheat Flour 1 kg,4,70,60,10,1
05-04-2025,"Grains, Flours & Dals",RICE FLOUR 1KG,4,140,110,30,2
05-04-2025,"Grains, Flours & Dals",White jowar.F 1 kg,4,100,80,20,1
05-04-2025,"Grains, Flours & Dals",Wheat Flour 1 kg,4,140,120,20,2
05-04-2025,Oils & Ghee,Coconut oil 500 ml,9,220,200,20,1
05-04-2025,Oils & Ghee,Coconut oil 1 L,9,440,400,40,1
05-04-2025,Oils & Ghee,Sesame oil 1 L,9,590,560,30,1
05-04-2025,"Grains, Flours & Dals",Quinova 1 kg,4,220,195,25,1
05-04-2025,Snacks & Ready-to-Eat,FOXTAIL BIS,14,135,135,0,1
05-04-2025,"Grains, Flours & Dals",maida 500grms,4,70,60,10,2
05-04-2025,"Grains, Flours & Dals",RAGI FLOUR 500GRMS,4,40,35,5,1
05-04-2025,Sweeteners,YB JAGGERY POWDER 500GMS,16,150,150,0,2
05-04-2025,Snacks & Ready-to-Eat,Corn Chips 250GM,14,80,70,10,2
05-04-2025,Spices & Seasonings,MIRYALU 50 GRMS,15,100,80,20,1
05-04-2025,"Grains, Flours & Dals",Quinova 1 kg,4,220,195,25,1
05-04-2025,"Grains, Flours & Dals",Wheat Flour 1 kg,4,70,60,10,1
05-04-2025,"Grains, Flours & Dals",BASMATHI RICE 1KG,4,150,135,15,1
05-04-2025,"Dry Fruits, Nuts & Seeds",KAJU HALF 250GM,2,310,290,20,1
05-04-2025,Spices & Seasonings,Turmeric powder 250 gms,15,100,75,25,1
05-04-2025,Spices & Seasonings,Coriander seeds 200 gms,15,48,40,8,1
05-04-2025,"Grains, Flours & Dals",Wheat Flour 1 kg,4,140,120,20,2
05-04-2025,"Grains, Flours & Dals",RAGI FLOUR 1KG,4,80,70,10,1
05-04-2025,"Grains, Flours & Dals",White jowar.F 1 kg,4,200,160,40,2
05-04-2025,Spices & Seasonings,SWEET SOUNF,15,20,20,0,1
05-04-2025,Snacks & Ready-to-Eat,SD Aswagandha with palm Jaggery250Gm,14,135,135,0,1
05-04-2025,Snacks & Ready-to-Eat,BELLAM MINAPA SUNADULLU,14,180,180,0,1
05-04-2025,Snacks & Ready-to-Eat,VD RED CHILLI RICEPAPAD 150GM,14,50,50,0,1
05-04-2025,Snacks & Ready-to-Eat,VD RICE MURUKU 150GM,14,50,50,0,1
05-04-2025,Snacks & Ready-to-Eat,SAGUPAPAD GREEN CHILLI,14,55,55,0,1
05-04-2025,Personal Care & Cosmetics,MD Soapnut Choornam 100GM,10,80,80,0,1
05-04-2025,Snacks & Ready-to-Eat,VD MINAPA VADIYAM,14,65,65,0,1
05-04-2025,Snacks & Ready-to-Eat,VD SAGOPAPAD 150GM,14,55,55,0,1
05-04-2025,Snacks & Ready-to-Eat,KURNOOL MARMURA,14,70,55,15,1
05-04-2025,"Grains, Flours & Dals",White jowar.F 1 kg,4,100,80,20,1
05-04-2025,Spices & Seasonings,Coriander seeds 200 gms,15,48,40,8,1
05-04-2025,"Grains, Flours & Dals",turdal 500 gms,4,110,85,25,1
05-04-2025,Spices & Seasonings,JEERA 250 gms,15,125,105,20,1
05-04-2025,"Dry Fruits, Nuts & Seeds",Groundnuts 1 kg,2,190,165,25,1
05-04-2025,Sweeteners,SUGAR 1KG,16,60,50,10,1
05-04-2025,"Grains, Flours & Dals",BOMBAY RAVA,4,70,55,15,1
05-04-2025,"Grains, Flours & Dals",DH URAD GOTA 1KG,4,215,190,25,1
05-04-2025,"Grains, Flours & Dals",RAGI FLOUR 500GRMS,4,40,35,5,1
05-04-2025,"Grains, Flours & Dals",Wheat Rava M 500GM,4,33,30,3,1
05-04-2025,"Grains, Flours & Dals",KORRALU (FOXTAIL M) 500GM,4,65,55,10,1
05-04-2025,"Grains, Flours & Dals",Arikalu (kodo),4,70,65,5,1
05-04-2025,"Grains, Flours & Dals",White jowar.F 1 kg,4,100,80,20,1
05-04-2025,"Grains, Flours & Dals",split green gram 500 gms,4,75,70,5,1
05-04-2025,Sweeteners,YB JAGGERY POWDER 500GMS,16,75,75,0,1
05-04-2025,"Dry Fruits, Nuts & Seeds",SUNFLOWER SEEDS 250GRM,2,150,130,20,1
05-04-2025,"Dry Fruits, Nuts & Seeds",PUMPKIN SEEDS 250GM,2,200,160,40,1
05-04-2025,"Dry Fruits, Nuts & Seeds",WATERMELON SEEDS 250GRM,2,320,280,40,1
05-04-2025,"Dry Fruits, Nuts & Seeds",FLAX SEEDS 250GM,2,60,50,10,1
05-04-2025,Oils & Ghee,Groundnut oil 500ml,9,180,165,15,1
05-04-2025,Oils & Ghee,Sesame oil 500ml,9,295,280,15,1
05-04-2025,"Grains, Flours & Dals",HS JOWAR IDLY RAWA,4,65,65,0,1
05-04-2025,"Grains, Flours & Dals",turdal 1kg,4,220,170,50,1
05-04-2025,"Grains, Flours & Dals",Wheat Flour 1 kg,4,70,60,10,1
05-04-2025,"Grains, Flours & Dals",Wheat Rava M 1KG,4,130,110,20,2
05-04-2025,Sweeteners,ACHU BELLAM 1KG,16,100,80,20,1
05-04-2025,"Grains, Flours & Dals",CHANA DAL 1KG,4,140,120,20,1
05-04-2025,Pooja & Spiritual Items,KASHI ASHTAGANDHA CHANDHANA,12,20,20,0,1
05-04-2025,"Grains, Flours & Dals",White jowar.F 1 kg,4,100,80,20,1
05-04-2025,Spices & Seasonings,Turmeric powder 250 gms,15,100,75,25,1
05-04-2025,Pooja & Spiritual Items,GD KUMKUM 50GM,12,30,30,0,1
05-04-2025,Spices & Seasonings,JEERA 250 gms,15,125,105,20,1
05-04-2025,"Grains, Flours & Dals",white Bobarlu 500 gms,4,80,75,5,1
05-04-2025,"Grains, Flours & Dals",AISHWARYA SP 25KG,4,1999,"1,690.00",309,1
05-04-2025,Snacks & Ready-to-Eat,DOSA BATTER 1KG,14,120,120,0,2
05-04-2025,Milk & Dairy,HERITAGE TONED MILK 500ML,7,31,31,0,1
05-04-2025,Beverages,BRU GREEN LABEL 1.2G,1,48,48,0,24
05-04-2025,"Grains, Flours & Dals",AISHWARYA SP 1KG,4,400,350,50,5
05-04-2025,Snacks & Ready-to-Eat,VD PALLI LADDU,14,80,80,0,1
05-04-2025,Snacks & Ready-to-Eat,GREEN FRIED BATANA,14,20,20,0,1
05-04-2025,Snacks & Ready-to-Eat,NGT CHATPATTA CHANA 90GM,14,25,25,0,1
05-04-2025,Milk & Dairy,BROWN EGGS TRAY 30P,7,360,330,30,1
05-04-2025,Household & Cleaning,ROOPERI PITAMBARI SILVER 50ML,6,110,110,0,1
05-04-2025,"Dry Fruits, Nuts & Seeds",PUMPKIN SEEDS 250GM,2,200,160,40,1
05-04-2025,"Grains, Flours & Dals",SL Idly Rava 1KG,4,65,55,10,1
05-04-2025,"Grains, Flours & Dals",White jowar.F 1 kg,4,100,80,20,1
05-04-2025,"Dry Fruits, Nuts & Seeds",BLACK KISMIS 250GM,2,175,140,35,1
05-04-2025,Pooja & Spiritual Items,GD Kumkum 50GM,12,30,30,0,1
05-04-2025,"Grains, Flours & Dals",Wheat Flour 1 kg,4,210,180,30,3
05-04-2025,Spices & Seasonings,GD Turmeric 50GM,15,25,25,0,1
05-04-2025,Snacks & Ready-to-Eat,NGT CHATPATTA CHANA 90GM,14,25,25,0,1
05-04-2025,Snacks & Ready-to-Eat,GREEN FRIED BATANA,14,20,20,0,1
05-04-2025,Pooja & Spiritual Items,GD Aiswarya Deepam 700ML,12,975,975,0,5
05-04-2025,Milk & Dairy,BROWN EGGS TRAY 30P,7,360,330,30,1
05-04-2025,Snacks & Ready-to-Eat,VD PALLI LADDU,14,80,80,0,1
05-04-2025,"Grains, Flours & Dals",split black gram 1 kg,4,180,170,10,1
05-04-2025,"Grains, Flours & Dals",KORRALU (FOXTAIL M) 500GM,4,65,55,10,1
05-04-2025,Oils & Ghee,Groundnut oil 1 L,9,360,330,30,1
05-04-2025,Household & Cleaning,VIM MAHA BAR,6,20,20,0,2
05-04-2025,Personal Care & Cosmetics,dabur red 200 grms,10,136,136,0,1
05-04-2025,"Grains, Flours & Dals",Wheat Rava S 500GM,4,33,30,3,1
05-04-2025,Household & Cleaning,SURFEXCEL BAR 80G,6,20,20,0,2
05-04-2025,"Dry Fruits, Nuts & Seeds",Putnalu 250GM,2,45,38,7,1
05-04-2025,"Grains, Flours & Dals",Multigrain 1 kg,4,100,85,15,1
05-04-2025,"Grains, Flours & Dals",RAGI FLOUR 500GRMS,4,40,35,5,1
05-04-2025,"Grains, Flours & Dals",Idly Rava L 1KG,4,60,50,10,1
05-04-2025,Pooja & Spiritual Items,SWASTIK CAMPHOR 10GM,12,20,20,0,1
05-04-2025,Pooja & Spiritual Items,BALAJI GOLDEN SPIRIT 100G,12,85,85,0,1
05-04-2025,"Grains, Flours & Dals",turdal 500 gms,4,110,85,25,1
05-04-2025,Pooja & Spiritual Items,divya deeparadhana oil,12,190,190,0,1
05-04-2025,Snacks & Ready-to-Eat,SD JOWAR WITH PALM JAGGERY 250GM,14,135,135,0,1
05-04-2025,Snacks & Ready-to-Eat,VD PAPPU CHEGODI 200GM,14,60,60,0,1
05-04-2025,Oils & Ghee,Coconut oil 500 ml,9,220,200,20,1
05-04-2025,Snacks & Ready-to-Eat,VD MYSOREPAK 6PIC,14,100,100,0,1
05-04-2025,Snacks & Ready-to-Eat,ELITE ELAICHI RUSK 200GM,14,35,35,0,1
05-04-2025,Oils & Ghee,Coconut oil 500 ml,9,220,200,20,1
05-04-2025,Snacks & Ready-to-Eat,ELITE ELAICHI RUSK 200GM,14,35,35,0,1
05-04-2025,"Grains, Flours & Dals",RAGULU 1 KG,4,140,120,20,2
05-04-2025,Sweeteners,YB Brown Sugar 1KG,16,140,140,0,1
05-04-2025,Spices & Seasonings,ROYAL SAFFRON,15,125,125,0,1
05-04-2025,Sweeteners,SD PALM JAGGERY 500GM,16,400,400,0,2
05-04-2025,Sweeteners,YB Brown Sugar 500GM,16,225,225,0,3
05-04-2025,"Grains, Flours & Dals",BAJRA 1 KG,4,60,50,10,1
05-04-2025,"Grains, Flours & Dals",MELMEKER 250GMS,4,60,45,15,1
05-04-2025,"Grains, Flours & Dals",JOWAR YELLOW 1 K,4,100,90,10,1
05-04-2025,Snacks & Ready-to-Eat,SD Bajra with palm Jaggery 250gm,14,135,135,0,1
05-04-2025,Beverages,REFRESH SHARBATH SUGAR FREE,1,299,285,14,1
05-04-2025,"Health, Wellness & Ayurvedic Products",RB FRUITS &amp;seeds Cranberries,5,45,45,0,1
05-04-2025,"Grains, Flours & Dals",Multigrain 1 kg,4,300,255,45,3
05-04-2025,"Grains, Flours & Dals",AISHWARYA SP 25KG,4,1999,"1,690.00",309,1
05-04-2025,Pooja & Spiritual Items,GD JASMINE 75GM,12,60,60,0,1
05-04-2025,"Grains, Flours & Dals",SRILATHA RICE RAVVA 500GM,4,35,35,0,1
05-04-2025,Personal Care & Cosmetics,GAYATHRI KUMKUDUKAYA,10,150,150,0,1
05-04-2025,Personal Care & Cosmetics,GOW DURBAR NAVA 100GM SOAP,10,40,40,0,1
05-04-2025,Oils & Ghee,Groundnut oil 1 L,9,720,660,60,2
05-04-2025,Personal Care & Cosmetics,SVE PREMIUM WILD TURMEIC 100GM,10,220,220,0,2
05-04-2025,Snacks & Ready-to-Eat,PEANUT CHIKKI,14,22,22,0,1
05-04-2025,"Grains, Flours & Dals",RAGI FLOUR 1KG,4,80,70,10,1
05-04-2025,"Grains, Flours & Dals",RICE FLOUR 500 GM,4,35,28,7,1
05-04-2025,"Health, Wellness & Ayurvedic Products",MD Kasturi Pasupu Choornam 50GM,5,160,160,0,2
05-04-2025,Personal Care & Cosmetics,SVE NALAPAMARAM SOAP 100GM,10,100,100,0,1
05-04-2025,Personal Care & Cosmetics,SVE TURMERIC SOAP 100GM,10,180,180,0,2
05-04-2025,"Dry Fruits, Nuts & Seeds",SD Mango cubes 200gm,2,90,90,0,1
05-04-2025,Personal Care & Cosmetics,SVE SUNNI PINDI SCRUBSOAP 100GM,10,200,200,0,2
05-04-2025,Personal Care & Cosmetics,SEV TULASI SOAP 100GM,10,360,360,0,4
05-04-2025,"Grains, Flours & Dals",SH WHITE POHA 500GM,4,150,150,0,2
05-04-2025,Snacks & Ready-to-Eat,RSC ORANGE 100GMS,14,20,20,0,1
05-04-2025,Personal Care & Cosmetics,VETIVER SOAP 100GM,10,100,100,0,1
05-04-2025,Personal Care & Cosmetics,SVE RED SANDAL SOAP 100GM,10,360,360,0,4
05-04-2025,Personal Care & Cosmetics,ALOE VERA SOAP,10,100,100,0,1
05-04-2025,Personal Care & Cosmetics,UVIS MULTANI MITTI 200GM,10,90,90,0,1
05-04-2025,Snacks & Ready-to-Eat,JUNNU POWDER 100GM,14,70,70,0,1
05-04-2025,"Grains, Flours & Dals",Wheat Flour 1 kg,4,210,180,30,3
05-04-2025,Personal Care & Cosmetics,SVE PREMIUM PAPAYA SOAP 100GM,10,220,220,0,2
05-04-2025,"Dry Fruits, Nuts & Seeds",SH GROUNDNUT 500GM,2,163,130,33,1
05-04-2025,"Grains, Flours & Dals",PESARA PAPPU 500GMS,4,85,75,10,1
05-04-2025,Snacks & Ready-to-Eat,NGT CHATPATTA CHANA 90GM,14,25,25,0,1
05-04-2025,"Grains, Flours & Dals",Green gram 500 gms,4,75,70,5,1
05-04-2025,Snacks & Ready-to-Eat,VD PAPPU CHEGODI 200GM,14,60,60,0,1
05-04-2025,"Grains, Flours & Dals",Wheat Flour 1 kg,4,70,60,10,1
05-04-2025,"Dry Fruits, Nuts & Seeds",cashew,2,340,310,30,1
05-04-2025,Snacks & Ready-to-Eat,VD PALLI LADDU,14,80,80,0,1
05-04-2025,"Dry Fruits, Nuts & Seeds",Groundnuts 1 kg,2,190,165,25,1
05-04-2025,Spices & Seasonings,DRY MIECHI 200GM,15,80,60,20,1
05-04-2025,Spices & Seasonings,Coriander seeds 200 gms,15,48,40,8,1
05-04-2025,Sweeteners,SUGAR 1KG,16,60,50,10,1
05-04-2025,Sweeteners,YB FOREST HONEY 250GM,16,180,180,0,1
05-04-2025,"Grains, Flours & Dals",Idly Rava L 1KG,4,120,100,20,2
05-04-2025,Sweeteners,SUGAR 1KG,16,60,50,10,1
05-04-2025,"Grains, Flours & Dals",Black gram 500 gms,4,150,140,10,2
05-04-2025,"Dry Fruits, Nuts & Seeds",Groundnuts 1 kg,2,190,165,25,1
05-04-2025,"Grains, Flours & Dals",Idly Rava L 1KG,4,180,150,30,3
05-04-2025,Pooja & Spiritual Items,divya deeparadhana oil,12,190,190,0,1
05-04-2025,"Grains, Flours & Dals",Green gram 1 kg,4,150,130,20,1
05-04-2025,"Dry Fruits, Nuts & Seeds",Groundnuts 500 gms,2,95,85,10,1
05-04-2025,Snacks & Ready-to-Eat,BB VERMICELLI 1KG,14,95,90,5,1
05-04-2025,Pooja & Spiritual Items,SWASTIK CAMPHORE,12,90,90,0,1
05-04-2025,Snacks & Ready-to-Eat,VD PALLI LADDU,14,160,160,0,2
05-04-2025,Spices & Seasonings,JEERA 250 gms,15,125,105,20,1
05-04-2025,Spices & Seasonings,Tamarind 500GM,15,160,130,30,1
05-04-2025,"Dry Fruits, Nuts & Seeds",PUTNALU 500GMS,2,180,152,28,2
05-04-2025,General Household & Kitchenware,GOOD HOME,3,15,15,0,1
05-04-2025,"Grains, Flours & Dals",CHANA DAL 500GM,4,70,60,10,1
05-04-2025,Household & Cleaning,surfexcel 500,6,198,198,0,1
05-04-2025,"Grains, Flours & Dals",PESARA PAPPU 500GMS,4,85,75,10,1
05-04-2025,"Grains, Flours & Dals",URAD DALL,4,190,170,20,2
05-04-2025,"Grains, Flours & Dals",THICK POHA 1KG,4,80,70,10,1
05-04-2025,"Grains, Flours & Dals",BOMBAY RAVA,4,140,110,30,2
05-04-2025,Sweeteners,YB JAGGERY POWDER 500GMS,16,75,75,0,1
05-04-2025,"Grains, Flours & Dals",Wheat Rava S 1KG,4,195,165,30,3
05-04-2025,Household & Cleaning,SURFEXCEL BAR 80G,6,50,50,0,5
05-04-2025,"Grains, Flours & Dals",turdal 1kg,4,440,340,100,2
05-04-2025,Spices & Seasonings,NUVVULU 250GM,15,80,65,15,1
05-04-2025,"Grains, Flours & Dals",RAGI FLOUR 1KG,4,160,140,20,2
05-04-2025,Household & Cleaning,vim small,6,45,45,0,3
05-04-2025,"Dry Fruits, Nuts & Seeds",FLAX SEEDS 250GM,2,60,50,10,1
05-04-2025,Spices & Seasonings,THREE MANGO RAI 200G,15,42,42,0,1
05-04-2025,Spices & Seasonings,AVALU 250grms,15,60,60,0,1
05-04-2025,Pooja & Spiritual Items,GD Dhoop Cones 40GM,12,30,30,0,1
05-04-2025,Spices & Seasonings,AV Iodized Salt 1KG,15,28,25,3,1
05-04-2025,Snacks & Ready-to-Eat,VD MIXTURE 175 GM,14,60,60,0,1
05-04-2025,Snacks & Ready-to-Eat,GB SALT COOKIES,14,60,55,5,1
05-04-2025,Snacks & Ready-to-Eat,FOXTAIL BIS,14,135,135,0,1
05-04-2025,Snacks & Ready-to-Eat,VD PALLI CHIKKI,14,80,80,0,1
05-04-2025,Sweeteners,YB FOREST HONEY 250GM,16,180,180,0,1
05-04-2025,Snacks & Ready-to-Eat,VD MULTI CHAKKA,14,110,110,0,1
05-04-2025,Snacks & Ready-to-Eat,VD NUVULU CHEGODI 175GM,14,60,60,0,1
05-04-2025,Milk & Dairy,BROWN EGGS 1P,7,168,144,24,12
05-04-2025,Snacks & Ready-to-Eat,VD PAPPU CHEGODI 200GM,14,60,60,0,1
05-04-2025,"Grains, Flours & Dals",Multigrain 1 kg,4,200,170,30,2
05-04-2025,Oils & Ghee,Sesame oil 1 L,9,1180,"1,120.00",60,2
05-04-2025,"Grains, Flours & Dals",Wheat Flour 1 kg,4,140,120,20,2
05-04-2025,"Grains, Flours & Dals",CHANA DAL 500GM,4,70,60,10,1
05-04-2025,Oils & Ghee,Groundnut oil 1 L,9,360,330,30,1
05-04-2025,Oils & Ghee,Groundnut oil 1 L,9,720,660,60,2
05-04-2025,"Dry Fruits, Nuts & Seeds",wallnuts,2,380,320,60,1
05-04-2025,"Dry Fruits, Nuts & Seeds",WATERMELON SEEDS 250GRM,2,320,280,40,1
05-04-2025,"Dry Fruits, Nuts & Seeds",ALMONDS 250GM,2,280,260,20,1
05-04-2025,Snacks & Ready-to-Eat,Corn Chips 250GM,14,40,35,5,1
05-04-2025,"Dry Fruits, Nuts & Seeds",PLAIN PISTA 250GM,2,660,550,110,1
05-04-2025,"Dry Fruits, Nuts & Seeds",SUNFLOWER SEEDS 250GRM,2,150,130,20,1
05-04-2025,"Grains, Flours & Dals",THICK POHA 500GM,4,40,35,5,1
05-04-2025,"Dry Fruits, Nuts & Seeds",SALTED PISTA 250GM,2,400,350,50,1
05-04-2025,Snacks & Ready-to-Eat,VD MYSOREPAK 6PIC,14,300,300,0,3
05-04-2025,Snacks & Ready-to-Eat,VD NUVULU CHEGODI 175GM,14,60,60,0,1
05-04-2025,Oils & Ghee,Groundnut oil 1 L,9,720,660,60,2
05-04-2025,"Grains, Flours & Dals",White jowar.F 1 kg,4,100,80,20,1
05-04-2025,"Grains, Flours & Dals",Yellow jowar .F1 kg,4,220,200,20,2
05-04-2025,Snacks & Ready-to-Eat,RSC ORANGE 100GMS,14,40,40,0,2
05-04-2025,"Grains, Flours & Dals",White jowar.F 1 kg,4,100,80,20,1
05-04-2025,"Dry Fruits, Nuts & Seeds",SD Mango cubes 100gm,2,45,45,0,1
05-04-2025,Spices & Seasonings,SWEET SOUNF,15,20,20,0,1
05-04-2025,Snacks & Ready-to-Eat,VD DRY FRUIT PUTHAREKULU,14,120,120,0,1
05-04-2025,Oils & Ghee,Black Sesame oil 500 ml,9,220,190,30,1
05-04-2025,Spices & Seasonings,AVALU 250grms,15,60,60,0,1
05-04-2025,Snacks & Ready-to-Eat,RI SPORTS BAR 40G,14,45,45,0,1
05-04-2025,Spices & Seasonings,Jeera 100GM,15,50,45,5,1
05-04-2025,"Grains, Flours & Dals",BOMBAY RAVA,4,70,55,15,1
05-04-2025,"Grains, Flours & Dals",THICK POHA 1KG,4,80,70,10,1
05-04-2025,"Dry Fruits, Nuts & Seeds",PUTNALU 500GMS,2,90,76,14,1
05-04-2025,"Grains, Flours & Dals",Idly Rava L 1KG,4,120,100,20,2
05-04-2025,"Grains, Flours & Dals",MIXED FLOUR,4,274,274,0,1
05-04-2025,"Dry Fruits, Nuts & Seeds",Groundnuts 1 kg,2,190,165,25,1
05-04-2025,"Grains, Flours & Dals",Green gram 1 kg,4,150,130,20,1
05-04-2025,"Grains, Flours & Dals",CHANA DAL 500GM,4,70,60,10,1
05-04-2025,"Grains, Flours & Dals",split black gram 1 kg,4,360,340,20,2
05-04-2025,"Grains, Flours & Dals",VGR RICE 5 KGS,4,350,325,25,1
05-04-2025,"Grains, Flours & Dals",Bombay Rava 500GM,4,35,30,5,1
05-04-2025,Spices & Seasonings,ROYAL SAFFRON,15,125,125,0,1
05-04-2025,Beverages,3ROSES,1,90,90,0,1
05-04-2025,Oils & Ghee,Groundnut oil 1 L,9,1080,990,90,3
05-04-2025,Spices & Seasonings,Tamarind 500GM,15,160,130,30,1
05-04-2025,Spices & Seasonings,ROYAL SAFFRON 400GRMS,15,65,65,0,1
05-04-2025,Spices & Seasonings,TATA SALT 1KG,15,30,30,0,1
05-04-2025,Sweeteners,SUGAR 1KG,16,180,150,30,3
05-04-2025,Spices & Seasonings,Turmeric powder 250 gms,15,100,75,25,1
05-04-2025,Spices & Seasonings,MIRYALU 50 GRMS,15,100,80,20,1
05-04-2025,"Grains, Flours & Dals",Wheat Flour 1 kg,4,70,60,10,1
05-04-2025,"Grains, Flours & Dals",PESARA PAPPU 500GMS,4,85,75,10,1
05-04-2025,Snacks & Ready-to-Eat,DISANO VERMICELLI 425 GM,14,50,50,0,1
05-04-2025,Sweeteners,ACHUBELLAM 500GM,16,50,40,10,1
05-04-2025,"Grains, Flours & Dals",SABDANA,4,40,35,5,1
05-04-2025,Snacks & Ready-to-Eat,NGT CHATPATTA CHANA 90GM,14,75,75,0,3
05-04-2025,"Grains, Flours & Dals",Wheat Flour 1 kg,4,140,120,20,2
05-04-2025,"Grains, Flours & Dals",RICE FLOUR 500 GM,4,70,56,14,2
05-04-2025,"Grains, Flours & Dals",DOCTOR RICE DIABETIC SFR 1KG,4,120,120,0,1
05-04-2025,Sweeteners,NATURAL HONEY 1KG,16,560,480,80,1
05-04-2025,"Dry Fruits, Nuts & Seeds",WATERMELON SEEDS 250GRM,2,320,280,40,1
05-04-2025,"Dry Fruits, Nuts & Seeds",PUMPKIN SEEDS 250GM,2,200,160,40,1
05-04-2025,"Dry Fruits, Nuts & Seeds",SUNFLOWER SEEDS 250GRM,2,150,130,20,1
05-04-2025,Misc,VD0009,8,100,100,0,1
05-04-2025,Oils & Ghee,Safflower oil 500 ml,9,220,200,20,1
05-04-2025,Oils & Ghee,Coconut oil 500 ml,9,220,200,20,1
05-04-2025,"Grains, Flours & Dals",Multigrain 1 kg,4,200,170,30,2
05-04-2025,"Grains, Flours & Dals",PRO SABUDHANA 500GM,4,89,89,0,1
05-04-2025,"Dry Fruits, Nuts & Seeds",SALTED PISTA 250GM,2,400,350,50,1
05-04-2025,Spices & Seasonings,3M.MIRCHI POWDER,15,145,115,30,1
05-04-2025,Sweeteners,GS Palm Jaggery Powder 400GM,16,180,180,0,1
05-04-2025,Snacks & Ready-to-Eat,VD NUVULLU CHIKKI,14,80,80,0,1
05-04-2025,Oils & Ghee,Groundnut oil 1 L,9,360,330,30,1
05-04-2025,"Health, Wellness & Ayurvedic Products",MH Millets Malt 1KG,5,400,380,20,1
05-04-2025,"Grains, Flours & Dals",AISHWARYA SP 1KG,4,160,140,20,2
05-04-2025,"Dry Fruits, Nuts & Seeds",KAJU HALF 250GM,2,310,290,20,1
05-04-2025,"Dry Fruits, Nuts & Seeds",Groundnuts 1 kg,2,190,165,25,1
05-04-2025,"Grains, Flours & Dals",VGR rice 1 kg,4,700,650,50,10
05-04-2025,Snacks & Ready-to-Eat,RITEBITE BLUEBERRY BLAST,14,50,50,0,1
05-04-2025,Sweeteners,Natural Honey 500 gms,16,280,240,40,1
05-04-2025,Pooja & Spiritual Items,PACHAKARPURAM,12,60,50,10,1
05-04-2025,Oils & Ghee,Groundnut oil 1 L,9,360,330,30,1
05-04-2025,Sweeteners,MISHRI D,16,40,30,10,1
05-04-2025,"Grains, Flours & Dals",Wheat Rava M 1KG,4,65,55,10,1
05-04-2025,"Dry Fruits, Nuts & Seeds",cashew,2,340,310,30,1
05-04-2025,"Grains, Flours & Dals",PRO ORG KABULI CHANNA 500GM,4,196,196,0,1
05-04-2025,"Grains, Flours & Dals",turdal 1kg,4,440,340,100,2
05-04-2025,Snacks & Ready-to-Eat,Corn Chips 250GM,14,40,35,5,1
05-04-2025,Snacks & Ready-to-Eat,GOLDEN SALT COOKIES,14,120,120,0,2
05-04-2025,"Grains, Flours & Dals",URAD DALL,4,95,85,10,1
05-04-2025,Misc,ROLL D C,8,70,45,25,1
05-04-2025,"Grains, Flours & Dals",THICK POHA 500GM,4,40,35,5,1
05-04-2025,Oils & Ghee,cow ghee 500 ml,9,430,390,40,1
05-04-2025,Spices & Seasonings,GREEN SOUNF,15,60,40,20,1
05-04-2025,"Grains, Flours & Dals",Multigrain 1 kg,4,100,85,15,1
05-04-2025,Spices & Seasonings,Turmeric powder 250 gms,15,100,75,25,1
05-04-2025,Spices & Seasonings,PN ORGANIC PINK SALT 1KG,15,124,124,0,1
05-04-2025,"Grains, Flours & Dals",MELMEKER 250GMS,4,60,45,15,1
05-04-2025,"Grains, Flours & Dals",BASMATHI RICE 1KG,4,150,135,15,1
05-04-2025,Spices & Seasonings,SONTI 50GM,15,30,20,10,1
05-04-2025,Snacks & Ready-to-Eat,VD Minapa papad 200gm,14,60,60,0,1
05-04-2025,"Grains, Flours & Dals",Green gram 1 kg,4,150,130,20,1
05-04-2025,Spices & Seasonings,THOKA MIRYALU 50GM,15,100,70,30,1
05-04-2025,"Dry Fruits, Nuts & Seeds",BLACK KISMIS 250GM,2,175,140,35,1
05-04-2025,Spices & Seasonings,WHITE SESAME,15,75,75,0,1
05-04-2025,"Grains, Flours & Dals",HEALTH JOWAR RAWA,4,99,99,0,1
05-04-2025,"Grains, Flours & Dals",Em Multimillet idli r 500g,4,387,387,0,3
05-04-2025,Snacks & Ready-to-Eat,MIX MILLET NOODLES,14,75,75,0,1
05-04-2025,"Grains, Flours & Dals",SH RED POHA 500GM,4,85,85,0,1
05-04-2025,"Grains, Flours & Dals",UDALU (Barnyard millet) 1 kg,4,140,115,25,1
05-04-2025,"Grains, Flours & Dals",RAGI FLOUR 1KG,4,80,70,10,1
05-04-2025,"Dry Fruits, Nuts & Seeds",ALMONDS 250GM,2,280,260,20,1
05-04-2025,"Grains, Flours & Dals",Arikadu ( kodo),4,140,130,10,1
05-04-2025,"Dry Fruits, Nuts & Seeds",SATHVI CHIA SEEDS 100GM,2,100,80,20,1
05-04-2025,Snacks & Ready-to-Eat,BD BARELY NOODLES 200G,14,70,70,0,1
05-04-2025,"Grains, Flours & Dals",Wheat Flour 1 kg,4,70,60,10,1
04-04-2025,Spices & Seasonings,3M.MIRCHI POWDER,15,290,230,60,2
04-04-2025,Spices & Seasonings,Tamarind 500GM,15,160,130,30,1
04-04-2025,Spices & Seasonings,ROYAL SAFFRON,15,125,125,0,1
04-04-2025,Snacks & Ready-to-Eat,BD RAGI NOODLES,14,75,75,0,1
04-04-2025,Oils & Ghee,Groundnut oil 1 L,9,720,660,60,2
04-04-2025,Sweeteners,GS JAGGERY NUGGETS 500GM,16,120,120,0,1
04-04-2025,Snacks & Ready-to-Eat,BD BARELY NOODLES 200G,14,70,70,0,1
04-04-2025,Snacks & Ready-to-Eat,MIX MILLET NOODLES,14,75,75,0,1
04-04-2025,"Grains, Flours & Dals",BARLEY SEEDS 250GMS,4,40,35,5,1
04-04-2025,Spices & Seasonings,AVALU 100GM,15,25,20,5,1
04-04-2025,"Dry Fruits, Nuts & Seeds",PUTNALU 500GMS,2,180,152,28,2
04-04-2025,"Dry Fruits, Nuts & Seeds",Groundnuts 1 kg,2,190,165,25,1
04-04-2025,"Grains, Flours & Dals",KORRALU (FOXTAIL M) 1KG,4,150,110,40,1
04-04-2025,"Grains, Flours & Dals",RICE FLOUR 1KG,4,70,55,15,1
04-04-2025,"Grains, Flours & Dals",UDALU (Barnyard millet) 1 kg,4,140,115,25,1
04-04-2025,"Grains, Flours & Dals",SAMALU,4,170,130,40,1
04-04-2025,"Grains, Flours & Dals",RICE FLOUR 500 GM,4,140,112,28,4
04-04-2025,"Grains, Flours & Dals",turdal 1kg,4,220,170,50,1
04-04-2025,"Grains, Flours & Dals",RAGI FLOUR 500GRMS,4,40,35,5,1
04-04-2025,"Grains, Flours & Dals",Green gram 500 gms,4,75,70,5,1
04-04-2025,Snacks & Ready-to-Eat,RAJGIRA PEANUT CHIKKI,14,5,5,0,1
04-04-2025,"Grains, Flours & Dals",Quinova 1 kg,4,220,195,25,1
04-04-2025,Spices & Seasonings,Jeera 100GM,15,50,45,5,1
04-04-2025,"Grains, Flours & Dals",Wheat Flour 1 kg,4,140,120,20,2
04-04-2025,Misc,VD00014,8,100,90,10,1
04-04-2025,Spices & Seasonings,telaga pindi,15,70,70,0,1
04-04-2025,Snacks & Ready-to-Eat,SUNNUNDALU,14,120,120,0,1
04-04-2025,Snacks & Ready-to-Eat,VD PALLI LADDU,14,80,80,0,1
04-04-2025,Oils & Ghee,Groundnut oil 1 L,9,360,330,30,1
04-04-2025,"Grains, Flours & Dals",RAGI FLOUR 500GRMS,4,40,35,5,1
04-04-2025,"Grains, Flours & Dals",Wheat Rava S 1KG,4,65,55,10,1
04-04-2025,"Grains, Flours & Dals",split black gram 1 kg,4,180,170,10,1
04-04-2025,"Grains, Flours & Dals",JOWAR YELLOW 1 K,4,100,90,10,1
04-04-2025,"Grains, Flours & Dals",SA YELLOW JOWAR RAVA 500GM,4,190,190,0,2
04-04-2025,"Dry Fruits, Nuts & Seeds",FLAX SEEDS 250GM,2,60,50,10,1
04-04-2025,"Grains, Flours & Dals",HS JOWAR IDLY RAWA,4,195,195,0,3
04-04-2025,"Grains, Flours & Dals",VYS.SP.RICE BAG 1,4,1800,"1,650.00",150,1
04-04-2025,"Grains, Flours & Dals",Multigrain 1 kg,4,100,85,15,1
04-04-2025,"Grains, Flours & Dals",Wheat Flour 1 kg,4,70,60,10,1
04-04-2025,Spices & Seasonings,SAJEERA,15,60,40,20,1
04-04-2025,"Grains, Flours & Dals",SABDANA,4,40,35,5,1
04-04-2025,Spices & Seasonings,ROYAL SAFFRON,15,250,250,0,2
04-04-2025,Personal Care & Cosmetics,HERBAL BATH POWDER 200GM,10,80,80,0,1
04-04-2025,"Dry Fruits, Nuts & Seeds",DRYDATES YELLOW 250GM,2,135,120,15,1
04-04-2025,"Grains, Flours & Dals",Wheat Rava S 500GM,4,33,30,3,1
04-04-2025,Oils & Ghee,Groundnut oil 1 L,9,360,330,30,1
04-04-2025,Oils & Ghee,Sesame oil 500ml,9,295,280,15,1
04-04-2025,"Grains, Flours & Dals",turdal 500 gms,4,110,85,25,1
04-04-2025,Snacks & Ready-to-Eat,VD PALLI LADDU,14,80,80,0,1
04-04-2025,Oils & Ghee,Sesame oil 1 L,9,590,560,30,1
04-04-2025,Oils & Ghee,Groundnut oil 1 L,9,720,660,60,2
04-04-2025,Spices & Seasonings,ROYAL SAFFRON,15,250,250,0,2
04-04-2025,"Grains, Flours & Dals",SL Idly Rava 1KG,4,65,55,10,1
04-04-2025,Pooja & Spiritual Items,GD Ramayana Sandal 75GM,12,60,60,0,1
04-04-2025,"Grains, Flours & Dals",Wheat Flour 1 kg,4,280,240,40,4
04-04-2025,Oils & Ghee,Coconut oil 1 L,9,440,400,40,1
04-04-2025,Oils & Ghee,Sesame oil 1 L,9,1180,"1,120.00",60,2
04-04-2025,Spices & Seasonings,DURGA SALT CRYSTAL 1KG,15,75,75,0,3
04-04-2025,Spices & Seasonings,AV Iodized Salt 1KG,15,28,25,3,1
04-04-2025,Oils & Ghee,Groundnut oil 1 L,9,360,330,30,1
04-04-2025,"Grains, Flours & Dals",UDALU (Barnyard millet) 1 kg,4,140,115,25,1
04-04-2025,"Grains, Flours & Dals",RICE FLOUR 1KG,4,70,55,15,1
04-04-2025,"Grains, Flours & Dals",SAMALU,4,170,130,40,1
04-04-2025,"Grains, Flours & Dals",Wheat Rava S 500GM,4,33,30,3,1
04-04-2025,Pooja & Spiritual Items,GD Aiswarya Deepam 700ML,12,390,390,0,2
04-04-2025,General Household & Kitchenware,RED LINE 20GM,3,75,75,0,1
04-04-2025,"Grains, Flours & Dals",KORRALU (FOXTAIL M) 1KG,4,150,110,40,1
04-04-2025,"Grains, Flours & Dals",turdal 1kg,4,220,170,50,1
04-04-2025,"Grains, Flours & Dals",Wheat Flour 1 kg,4,210,180,30,3
04-04-2025,Spices & Seasonings,ROYAL SAFFRON 400GRMS,15,65,65,0,1
04-04-2025,Spices & Seasonings,DRY MIECHI 200GM,15,80,60,20,1
04-04-2025,"Grains, Flours & Dals",Idly Rava L 1KG,4,60,50,10,1
04-04-2025,"Grains, Flours & Dals",Urad dall 1 Kg,4,185,170,15,1
04-04-2025,Spices & Seasonings,Coriander seeds 200 gms,15,48,40,8,1
04-04-2025,"Dry Fruits, Nuts & Seeds",Groundnuts 1 kg,2,190,165,25,1
04-04-2025,Pooja & Spiritual Items,GD Dhoop Sticks 26GM,12,40,40,0,2
04-04-2025,Snacks & Ready-to-Eat,DOSA BATTER 1KG,14,60,60,0,1
04-04-2025,"Grains, Flours & Dals",SA Sprouted Ragi Flour 500GM,4,69,69,0,1
04-04-2025,Pooja & Spiritual Items,GD Aiswarya Deepam 700ML,12,195,195,0,1
04-04-2025,"Dry Fruits, Nuts & Seeds",wallnuts,2,380,320,60,1
04-04-2025,Spices & Seasonings,DRY MIECHI 200GM,15,320,240,80,4
04-04-2025,"Grains, Flours & Dals",Chana Flour 500 gms,4,70,65,5,1
04-04-2025,Snacks & Ready-to-Eat,BD KODO MILLET NOODLES 200GM,14,75,75,0,1
04-04-2025,Snacks & Ready-to-Eat,Popcorn Seeds 250GM,14,45,40,5,1
04-04-2025,Snacks & Ready-to-Eat,BD PEARL MILLET NOODLES 200G,14,70,70,0,1
04-04-2025,Spices & Seasonings,SAMBAR POWDER 200GM,15,260,220,40,2
04-04-2025,Spices & Seasonings,DRY MIECHI 200GM,15,80,60,20,1
04-04-2025,Snacks & Ready-to-Eat,BD BARELY NOODLES 200G,14,70,70,0,1
04-04-2025,Snacks & Ready-to-Eat,Corn Chips 250GM,14,40,35,5,1
04-04-2025,Personal Care & Cosmetics,GAYATHRI KUMKUDUKAYA,10,300,300,0,2
04-04-2025,"Grains, Flours & Dals",SRILATHA RICE RAVVA 500GM,4,35,35,0,1
04-04-2025,"Grains, Flours & Dals",Wheat Flour 1 kg,4,70,60,10,1
04-04-2025,Oils & Ghee,Black Sesame oil 1 L,9,440,380,60,1
04-04-2025,Oils & Ghee,Groundnut oil 1 L,9,360,330,30,1
04-04-2025,Snacks & Ready-to-Eat,FOXTAIL NOODLES,14,75,75,0,1
04-04-2025,Personal Care & Cosmetics,GOW DURBAR NAVA 100GM SOAP,10,80,80,0,2
04-04-2025,"Grains, Flours & Dals",JOWAR YELLOW 1 K,4,100,90,10,1
04-04-2025,"Grains, Flours & Dals",BAJRA 1 KG,4,120,100,20,2
04-04-2025,Oils & Ghee,Coconut oil 500 ml,9,220,200,20,1
04-04-2025,Spices & Seasonings,GD Turmeric 50GM,15,25,25,0,1
04-04-2025,Pooja & Spiritual Items,GD Kumkum 50GM,12,30,30,0,1
04-04-2025,Snacks & Ready-to-Eat,RAJGIRA PEANUT CHIKKI,14,30,30,0,6
04-04-2025,Pooja & Spiritual Items,GD Dhoop Cones 40GM,12,30,30,0,1
04-04-2025,"Grains, Flours & Dals",POORI ATTA 1KG,4,70,60,10,1
04-04-2025,"Grains, Flours & Dals",SABDANA,4,40,35,5,1
04-04-2025,Spices & Seasonings,NUVVULU 500GM,15,160,130,30,1
04-04-2025,Oils & Ghee,Groundnut oil 1 L,9,360,330,30,1
04-04-2025,Oils & Ghee,Groundnut oil 1 L,9,360,330,30,1
04-04-2025,Oils & Ghee,Sesame oil 1 L,9,590,560,30,1
04-04-2025,Oils & Ghee,cow ghee 500 ml,9,430,390,40,1
04-04-2025,"Grains, Flours & Dals",Wheat Flour 1 kg,4,140,120,20,2
04-04-2025,"Grains, Flours & Dals",split greengram,4,140,140,0,1
04-04-2025,Snacks & Ready-to-Eat,VD PALLI LADDU,14,80,80,0,1
04-04-2025,Snacks & Ready-to-Eat,VD NUVVULU LADDU,14,80,80,0,1
04-04-2025,"Grains, Flours & Dals",SL Idly Rava 1KG,4,65,55,10,1
04-04-2025,"Grains, Flours & Dals",MAATEJA rice 10 kgs,4,720,690,30,1
04-04-2025,"Health, Wellness & Ayurvedic Products",MD Bringaraj Choornam 100GM,5,80,80,0,1
04-04-2025,Spices & Seasonings,PUTNALA KARAM POWDER 100GM,15,65,65,0,1
04-04-2025,Snacks & Ready-to-Eat,VD MIXTURE 175 GM,14,60,60,0,1
04-04-2025,Snacks & Ready-to-Eat,VD Pappu Chekkalu 190gm,14,60,60,0,1
04-04-2025,"Grains, Flours & Dals",PESARA PAPPU 1 KG,4,170,145,25,1
04-04-2025,Milk & Dairy,SANGAM TONED MILK 500ML,7,60,60,0,2
04-04-2025,Household & Cleaning,VIM SOAP,6,10,10,0,2
04-04-2025,"Dry Fruits, Nuts & Seeds",Groundnuts 500 gms,2,95,85,10,1
04-04-2025,Spices & Seasonings,Jeera 100GM,15,50,45,5,1
04-04-2025,"Grains, Flours & Dals",RAGI FLOUR 1KG,4,80,70,10,1
04-04-2025,Spices & Seasonings,lavangam,15,50,50,0,1
04-04-2025,Oils & Ghee,Groundnut oil 1 L,9,360,330,30,1
04-04-2025,"Dry Fruits, Nuts & Seeds",RAW FLAXSEEDS SH,2,115,115,0,1
04-04-2025,Sweeteners,YB FOREST HONEY 250GM,16,180,180,0,1
04-04-2025,"Grains, Flours & Dals",Multigrain 1 kg,4,100,85,15,1
04-04-2025,Snacks & Ready-to-Eat,VD DASA DINUSULU,14,199,199,0,1
04-04-2025,"Grains, Flours & Dals",White Chana 250 GM,4,60,50,10,1
04-04-2025,Snacks & Ready-to-Eat,VD MURUKU 175GM,14,60,60,0,1
04-04-2025,"Grains, Flours & Dals",Multigrain 1 kg,4,200,170,30,2
04-04-2025,Snacks & Ready-to-Eat,VD MULTI CHAKKA,14,110,110,0,1
04-04-2025,Snacks & Ready-to-Eat,VD NUVVULU LADDU,14,80,80,0,1
04-04-2025,Snacks & Ready-to-Eat,Popcorn Seeds 250GM,14,45,40,5,1
04-04-2025,"Grains, Flours & Dals",Green Batani 250GM,4,55,45,10,1
04-04-2025,"Dry Fruits, Nuts & Seeds",sabja seeds,2,80,70,10,1
04-04-2025,"Grains, Flours & Dals",Chana Flour 500 gms,4,70,65,5,1
04-04-2025,Oils & Ghee,Sesame oil 500ml,9,295,280,15,1
04-04-2025,Oils & Ghee,mustard oil,9,195,195,0,1
04-04-2025,Milk & Dairy,BROWN EGGS 1P,7,84,72,12,6
04-04-2025,Snacks & Ready-to-Eat,cereal,14,299,299,0,1
04-04-2025,"Grains, Flours & Dals",HS RAGI FLAKES 250GM 1+1,4,119,119,0,1
04-04-2025,Snacks & Ready-to-Eat,TILLI CHIKKI,14,125,125,0,1
04-04-2025,Snacks & Ready-to-Eat,PEANUT CHIKKI 450GM,14,125,125,0,1
04-04-2025,Snacks & Ready-to-Eat,SF PUFFED RICE,14,55,55,0,1
04-04-2025,"Grains, Flours & Dals",SA Multi Grain Mix 500GM,4,159,159,0,1
04-04-2025,"Dry Fruits, Nuts & Seeds",PUMPKIN SEEDS 250GM,2,200,160,40,1
04-04-2025,"Dry Fruits, Nuts & Seeds",FLAX SEEDS 250GM,2,120,100,20,2
04-04-2025,"Dry Fruits, Nuts & Seeds",DRYDATES YELLOW 250GM,2,135,120,15,1
04-04-2025,"Dry Fruits, Nuts & Seeds",WATERMELON SEEDS 250GRM,2,320,280,40,1
04-04-2025,Spices & Seasonings,NUVVULU 250GM,15,100,85,15,1
04-04-2025,"Dry Fruits, Nuts & Seeds",SUNFLOWER SEEDS 250GRM,2,150,130,20,1
04-04-2025,Spices & Seasonings,RED COPRA 250GMS,15,85,74,11,1
04-04-2025,"Grains, Flours & Dals",BASMATHI RICE 1KG,4,150,135,15,1
04-04-2025,Snacks & Ready-to-Eat,BB VERMICELLY 500GM,14,53,53,0,1
04-04-2025,"Dry Fruits, Nuts & Seeds",Groundnuts 500 gms,2,95,85,10,1
04-04-2025,"Grains, Flours & Dals",VGR rice 1 kg,4,700,650,50,10
04-04-2025,"Dry Fruits, Nuts & Seeds",sabja seeds,2,80,70,10,1
04-04-2025,Sweeteners,SUGAR 1KG,16,60,50,10,1
04-04-2025,"Grains, Flours & Dals",Urad dall 1 Kg,4,185,170,15,1
04-04-2025,Oils & Ghee,rice bran oil f,9,194,169,25,1
04-04-2025,Snacks & Ready-to-Eat,VD MIXTURE 175 GM,14,60,60,0,1
04-04-2025,Household & Cleaning,vim small,6,30,30,0,2
04-04-2025,Spices & Seasonings,ROYAL SAFFRON,15,125,125,0,1
04-04-2025,"Grains, Flours & Dals",RICE FLOUR 1KG,4,70,55,15,1
04-04-2025,Oils & Ghee,Coconut oil 1 L,9,440,400,40,1
04-04-2025,"Health, Wellness & Ayurvedic Products",RB Max Protein Cheese&amp;,5,45,45,0,1
04-04-2025,Spices & Seasonings,Jeera 100GM,15,50,45,5,1
04-04-2025,"Health, Wellness & Ayurvedic Products",RB Max Protein DESI MASALA 60gm,5,45,45,0,1
04-04-2025,Snacks & Ready-to-Eat,VD ATUKULU MIXTURE 175GM,14,60,60,0,1
04-04-2025,Oils & Ghee,Coconut oil 500 ml,9,220,200,20,1
04-04-2025,Snacks & Ready-to-Eat,SATHVI REGIVADA 200GM,14,80,60,20,1
04-04-2025,Snacks & Ready-to-Eat,GB SALT COOKIES,14,60,55,5,1
04-04-2025,Snacks & Ready-to-Eat,RB Choco Delite Almonds Raisins 40g,14,45,45,0,1
04-04-2025,"Grains, Flours & Dals",ANDU KORRALU (Browntop.m) 1 kg,4,260,220,40,1
04-04-2025,"Grains, Flours & Dals",Arikadu ( kodo),4,140,130,10,1
04-04-2025,"Grains, Flours & Dals",UDALU (Barnyard millet) 1 kg,4,140,115,25,1
04-04-2025,"Grains, Flours & Dals",SAMALU,4,170,130,40,1
04-04-2025,"Grains, Flours & Dals",KORRALU (FOXTAIL M) 1KG,4,150,110,40,1
04-04-2025,Oils & Ghee,A2 BUFFALO GHEE 250ML,9,299,299,0,1
04-04-2025,Sweeteners,YB Palm Jaggery 250GM,16,200,200,0,1
04-04-2025,Snacks & Ready-to-Eat,VD PAPPU CHEGODI 200GM,14,60,60,0,1
04-04-2025,Snacks & Ready-to-Eat,VD CORNFLAKES MIXTURE 175GM,14,60,60,0,1
04-04-2025,"Dry Fruits, Nuts & Seeds",SATHVI CHIA SEEDS 100GM,2,100,80,20,1
04-04-2025,Oils & Ghee,cow ghee 500 ml,9,430,390,40,1
04-04-2025,"Dry Fruits, Nuts & Seeds",Groundnuts 1 kg,2,190,165,25,1
04-04-2025,"Dry Fruits, Nuts & Seeds",sabja seeds,2,80,70,10,1
04-04-2025,"Grains, Flours & Dals",HS JOWAR FLAKES 250GM 1+1,4,119,119,0,1
04-04-2025,Snacks & Ready-to-Eat,BD RAGI NOODLES,14,75,75,0,1
04-04-2025,"Grains, Flours & Dals",Wheat Flour 1 kg,4,70,60,10,1
04-04-2025,"Grains, Flours & Dals",Wheat Flour 1 kg,4,210,180,30,3
04-04-2025,"Grains, Flours & Dals",VYS.SP RICE 1 KG,4,140,130,10,2
04-04-2025,Oils & Ghee,Groundnut oil 500ml,9,180,165,15,1
04-04-2025,"Grains, Flours & Dals",split green gram 500 gms,4,75,70,5,1
04-04-2025,"Grains, Flours & Dals",Brown RICE 1KG,4,140,130,10,2
04-04-2025,Sweeteners,YB Brown Sugar 500GM,16,75,75,0,1
04-04-2025,Snacks & Ready-to-Eat,VD Pappu Chekkalu 190gm,14,60,60,0,1
04-04-2025,"Grains, Flours & Dals",RAGI FLOUR 500GRMS,4,40,35,5,1
04-04-2025,"Grains, Flours & Dals",VL Sabdana 500GM,4,77,77,0,1
04-04-2025,Oils & Ghee,Sesame oil 1 L,9,590,560,30,1
04-04-2025,Spices & Seasonings,NUVVULU 500GM,15,400,340,60,2
04-04-2025,Milk & Dairy,HERITAGE TONED MILK 500ML,7,62,62,0,2
04-04-2025,Snacks & Ready-to-Eat,CHOCO BROWINE,14,20,20,0,1
04-04-2025,Spices & Seasonings,Chilli powder 500 gms,15,290,210,80,1
04-04-2025,"Grains, Flours & Dals",EM Ragi idli R 500G,4,75,75,0,1
04-04-2025,Oils & Ghee,Sesame oil 1 L,9,590,560,30,1
04-04-2025,"Grains, Flours & Dals",HS JOWAR IDLY RAWA,4,130,130,0,2
04-04-2025,"Grains, Flours & Dals",Em kodo idli R 500G,4,258,258,0,2
04-04-2025,Oils & Ghee,Safflower oil 1 L,9,440,400,40,1
04-04-2025,Spices & Seasonings,fenugreek seeds,15,225,225,0,3
04-04-2025,Spices & Seasonings,MASALA KAR 500GMS,15,260,240,20,1
04-04-2025,Oils & Ghee,Groundnut oil 1 L,9,720,660,60,2
04-04-2025,"Grains, Flours & Dals",Em Little idli R 500g,4,258,258,0,2
04-04-2025,"Dry Fruits, Nuts & Seeds",Groundnuts 1 kg,2,380,330,50,2
04-04-2025,Sweeteners,PN ORGANIC BROWN SUGAR 500GM,16,156,156,0,2
04-04-2025,"Grains, Flours & Dals",Em Foxtail upma r 500 g,4,109,109,0,1
04-04-2025,"Grains, Flours & Dals",CHANA DAL 500GM,4,70,60,10,1
04-04-2025,"Grains, Flours & Dals",Urad dall 1 Kg,4,185,170,15,1
04-04-2025,"Grains, Flours & Dals",White jowar.F 1 kg,4,300,240,60,3
04-04-2025,"Grains, Flours & Dals",Arikalu (kodo),4,70,65,5,1
04-04-2025,"Grains, Flours & Dals",KORRALU (FOXTAIL M) 500GM,4,65,55,10,1
04-04-2025,"Grains, Flours & Dals",UDALU (Barnyard millet) 500 gms,4,70,60,10,1
04-04-2025,Oils & Ghee,Safflower oil 1 L,9,440,400,40,1
04-04-2025,"Grains, Flours & Dals",Wheat Flour 1 kg,4,210,180,30,3
04-04-2025,"Grains, Flours & Dals",THICK POHA 1KG,4,80,70,10,1
04-04-2025,"Grains, Flours & Dals",Multigrain 1 kg,4,100,85,15,1
04-04-2025,"Grains, Flours & Dals",Wheat Rava S 1KG,4,65,55,10,1
04-04-2025,"Grains, Flours & Dals",SABDANA 500GM,4,90,70,20,1
04-04-2025,Snacks & Ready-to-Eat,MB LITTLE MILLET NOODLES 180G,14,190,190,0,2
04-04-2025,"Grains, Flours & Dals",RAGI FLOUR 1KG,4,80,70,10,1
04-04-2025,Oils & Ghee,Groundnut oil 1 L,9,1080,990,90,3
04-04-2025,Spices & Seasonings,BIRYANI LEAF 10GM,15,30,20,10,1
04-04-2025,Snacks & Ready-to-Eat,VD MURMURA LADDU,14,50,50,0,1
04-04-2025,"Dry Fruits, Nuts & Seeds",SD Mango cubes 100gm,2,45,45,0,1
04-04-2025,Spices & Seasonings,DRY MIECHI 200GM,15,80,60,20,1
04-04-2025,Snacks & Ready-to-Eat,BD LITTLE MILLET NOODLES 200G,14,75,75,0,1
04-04-2025,"Dry Fruits, Nuts & Seeds",Groundnuts 500 gms,2,95,85,10,1
04-04-2025,"Grains, Flours & Dals",Chana Flour 500 gms,4,70,65,5,1
04-04-2025,Spices & Seasonings,SAJEERA,15,60,40,20,1
04-04-2025,Spices & Seasonings,Jeera 100GM,15,50,45,5,1
04-04-2025,"Grains, Flours & Dals",Multigrain 1 kg,4,100,85,15,1
04-04-2025,Beverages,REFRESH SHARBATH SUGAR FREE,1,299,285,14,1
04-04-2025,"Dry Fruits, Nuts & Seeds",sabja seeds,2,80,70,10,1
04-04-2025,Sweeteners,MISHRI 250 GM,16,35,30,5,1
04-04-2025,Spices & Seasonings,Miriyalu 50GM,15,100,80,20,1
04-04-2025,"Grains, Flours & Dals",Yellow jowar .F1 kg,4,110,100,10,1
04-04-2025,"Dry Fruits, Nuts & Seeds",PN ORGANIC MAKHANA 50GM,2,250,250,0,2
04-04-2025,Oils & Ghee,Safflower oil 5 L,9,2200,"1,950.00",250,1
04-04-2025,"Dry Fruits, Nuts & Seeds",pn makhana 100 gms,2,288,288,0,1
04-04-2025,"Grains, Flours & Dals",RAGI FLOUR 500GRMS,4,160,140,20,4
04-04-2025,Snacks & Ready-to-Eat,CHOCO BROWINE,14,40,40,0,2
04-04-2025,"Grains, Flours & Dals",Sathya Javva Wheat Rava 500GM,4,95,95,0,1
04-04-2025,"Dry Fruits, Nuts & Seeds",Groundnuts 1 kg,2,190,165,25,1
04-04-2025,"Dry Fruits, Nuts & Seeds",PUTNALU 500GMS,2,90,76,14,1
04-04-2025,"Grains, Flours & Dals",White jowar.F 1 kg,4,100,80,20,1
04-04-2025,Oils & Ghee,Groundnut oil 1 L,9,720,660,60,2
04-04-2025,Oils & Ghee,Groundnut oil 1 L,9,720,660,60,2
04-04-2025,"Dry Fruits, Nuts & Seeds",SD Mango cubes 100gm,2,45,45,0,1
04-04-2025,"Grains, Flours & Dals",AISHWARYA SP 25KG,4,1999,"1,690.00",309,1
04-04-2025,Spices & Seasonings,DURGA SALT CRYSTAL 1KG,15,25,25,0,1
04-04-2025,Snacks & Ready-to-Eat,VD PALLI CHIKKI,14,80,80,0,1
04-04-2025,Snacks & Ready-to-Eat,PUMPKIN CHIKKI 200GM,14,140,120,20,1
04-04-2025,Oils & Ghee,Sesame oil 1 L,9,590,560,30,1
04-04-2025,Snacks & Ready-to-Eat,VD MULTI CHAKKA,14,110,110,0,1
04-04-2025,Spices & Seasonings,GARAM MASALA 200GM,15,120,95,25,1
04-04-2025,Spices & Seasonings,GROUNDNUT KARAM POWDER,15,65,65,0,1
04-04-2025,Personal Care & Cosmetics,OVAL BODY LOOFAH,10,55,55,0,1
04-04-2025,Snacks & Ready-to-Eat,VD Minapa papad 200gm,14,60,60,0,1
04-04-2025,Snacks & Ready-to-Eat,PN ORGANIC PUFFED RICE 200GM,14,55,55,0,1
04-04-2025,Snacks & Ready-to-Eat,RB Choco Delite Almonds Raisins 40g,14,90,90,0,2
04-04-2025,Snacks & Ready-to-Eat,RI SPORTS BAR 40G,14,45,45,0,1
04-04-2025,Spices & Seasonings,SD Redgram Karam Powder 100GM,15,65,65,0,1
04-04-2025,Sweeteners,YB JAGGERY POWDER 500GMS,16,75,75,0,1
04-04-2025,"Grains, Flours & Dals",Wheat Flour 1 kg,4,70,60,10,1
04-04-2025,Snacks & Ready-to-Eat,VD CORNFLAKES MIXTURE 175GM,14,60,60,0,1
04-04-2025,Snacks & Ready-to-Eat,VD PAPPU CHEGODI 200GM,14,60,60,0,1
04-04-2025,Snacks & Ready-to-Eat,cocnut laddu,14,135,135,0,1
04-04-2025,Snacks & Ready-to-Eat,VD CORNFLAKES MIXTURE 175GM,14,60,60,0,1
04-04-2025,Snacks & Ready-to-Eat,VD MULTI CHAKKA,14,110,110,0,1
04-04-2025,Snacks & Ready-to-Eat,SD Little Millet WITH PLAM JAGGERY,14,135,135,0,1
04-04-2025,Snacks & Ready-to-Eat,COPRA LADDU 200GM,14,100,80,20,1
04-04-2025,Oils & Ghee,Groundnut oil 1 L,9,1080,990,90,3
04-04-2025,"Grains, Flours & Dals",Wheat Rava M 500GM,4,33,30,3,1
04-04-2025,Sweeteners,MISHRI D,16,40,30,10,1
04-04-2025,Oils & Ghee,Groundnut oil 500ml,9,180,165,15,1
04-04-2025,"Grains, Flours & Dals",SRILATHA RICE RAVVA 500GM,4,35,35,0,1
04-04-2025,Snacks & Ready-to-Eat,PEANUT CHIKKI 450GM,14,125,125,0,1
04-04-2025,Spices & Seasonings,DURGA SALT CRYSTAL 1KG,15,25,25,0,1
04-04-2025,"Grains, Flours & Dals",White jowar.F 500 Gms,4,50,40,10,1
04-04-2025,"Grains, Flours & Dals",AISHWARYA SP 1KG,4,960,840,120,12
04-04-2025,Snacks & Ready-to-Eat,VD MINAPA VADIYAM,14,65,65,0,1
04-04-2025,"Health, Wellness & Ayurvedic Products",MD Triphala Chorrnam 100GM,5,80,80,0,1
04-04-2025,"Grains, Flours & Dals",Multigrain 1 kg,4,200,170,30,2
04-04-2025,"Dry Fruits, Nuts & Seeds",SUNFLOWER SEEDS 250GRM,2,150,130,20,1
04-04-2025,"Grains, Flours & Dals",VYS HMT 26KG,4,1750,"1,750.00",0,1
04-04-2025,Snacks & Ready-to-Eat,VD PAPPU CHEGODI 200GM,14,60,60,0,1
04-04-2025,"Grains, Flours & Dals",RAGI FLOUR 1KG,4,80,70,10,1
04-04-2025,Milk & Dairy,HERITAGE BUTTERMILK,7,10,10,0,1
04-04-2025,"Grains, Flours & Dals",JOWAR WHITE 1 KG,4,80,70,10,1
04-04-2025,Milk & Dairy,BROWN EGGS 1P,7,140,120,20,10
04-04-2025,"Grains, Flours & Dals",RAGULU 1 KG,4,70,60,10,1
04-04-2025,"Grains, Flours & Dals",VYS.SP RICE 1 KG,4,70,65,5,1
04-04-2025,Snacks & Ready-to-Eat,SATHVI REGIVADA 200GM,14,80,60,20,1
04-04-2025,Snacks & Ready-to-Eat,sannakarampusa,14,60,60,0,1
04-04-2025,Milk & Dairy,HERITAGE BUTTERMILK,7,10,10,0,1
04-04-2025,Snacks & Ready-to-Eat,VD MURMURA LADDU,14,50,50,0,1
04-04-2025,"Health, Wellness & Ayurvedic Products",gyan thyapobhumi,5,60,60,0,1
04-04-2025,Snacks & Ready-to-Eat,MB SORGHUM NOODLES 180GM,14,95,95,0,1
04-04-2025,"Grains, Flours & Dals",BASMATHI RICE 1KG,4,150,135,15,1
04-04-2025,"Grains, Flours & Dals",VGR rice 1 kg,4,70,65,5,1
04-04-2025,Milk & Dairy,SANGAM TONED MILK 500ML,7,60,60,0,2
04-04-2025,"Grains, Flours & Dals",turdal 500 gms,4,110,85,25,1
04-04-2025,Snacks & Ready-to-Eat,SD Moringa with plam jaggery 250gm,14,135,135,0,1
04-04-2025,Sweeteners,SD PALM JAGGERY 500GM,16,200,200,0,1
04-04-2025,Pooja & Spiritual Items,GD Aiswarya Deepam 700ML,12,390,390,0,2
04-04-2025,Pooja & Spiritual Items,GD Camphor 50GM,12,115,115,0,1
04-04-2025,Oils & Ghee,Sesame oil 1 L,9,590,560,30,1
04-04-2025,Oils & Ghee,Sesame oil 1 L,9,590,560,30,1
04-04-2025,Milk & Dairy,BROWN EGGS 1P,7,168,144,24,12
04-04-2025,"Health, Wellness & Ayurvedic Products",MH Millets Malt 500GM,5,400,380,20,2
04-04-2025,Spices & Seasonings,PN ORGANIC PINK SALT 1KG,15,124,124,0,1
04-04-2025,"Grains, Flours & Dals",White jowar.F 1 kg,4,100,80,20,1
04-04-2025,"Dry Fruits, Nuts & Seeds",YELLOW KISHMISH 250GM,2,130,110,20,1
04-04-2025,Personal Care & Cosmetics,OVAL BODY LOOFAH,10,55,55,0,1
04-04-2025,Personal Care & Cosmetics,ORGANIC SPONGE LOOFAH,10,70,70,0,1
04-04-2025,Oils & Ghee,Coconut oil 500 ml,9,220,200,20,1
04-04-2025,Oils & Ghee,Groundnut oil 1 L,9,360,330,30,1
04-04-2025,"Health, Wellness & Ayurvedic Products",MH Millets Malt 1KG,5,400,380,20,1
04-04-2025,"Grains, Flours & Dals",MIXED FLOUR,4,423,423,0,1
04-04-2025,Pooja & Spiritual Items,bilwa patra,12,60,60,0,1
04-04-2025,Snacks & Ready-to-Eat,SF MILLET NOODLES MILD MASALA 192GM,14,129,129,0,1
04-04-2025,Pooja & Spiritual Items,BALAJI SANDAL DHOOP STICKS 10STK,12,125,125,0,1
04-04-2025,Oils & Ghee,Groundnut oil 1 L,9,360,330,30,1
04-04-2025,Personal Care & Cosmetics,GOW DURBAR 75G,10,60,60,0,1
04-04-2025,Pooja & Spiritual Items,BALAJI BEL PHOOL STICKS 90GM,12,60,60,0,1
04-04-2025,"Grains, Flours & Dals",Wheat Rava S 1KG,4,65,55,10,1
04-04-2025,Oils & Ghee,Groundnut oil 1 L,9,360,330,30,1
04-04-2025,"Grains, Flours & Dals",RAGI FLOUR 1KG,4,160,140,20,2
04-04-2025,Snacks & Ready-to-Eat,VD RICE PAPAD 150GM,14,50,50,0,1
04-04-2025,Spices & Seasonings,RED COPRA 250GMS,15,85,74,11,1
04-04-2025,Household & Cleaning,comfort morning fresh,6,58,58,0,1
04-04-2025,Household & Cleaning,SURFEXCEL BAR 80G,6,30,30,0,3
04-04-2025,Household & Cleaning,SRFR EXCEL,6,40,40,0,4
04-04-2025,"Grains, Flours & Dals",RICE FLOUR 500 GM,4,35,28,7,1
04-04-2025,Spices & Seasonings,PRO HIMALAYAN PINK SALT 500GM,15,68,68,0,1
04-04-2025,"Dry Fruits, Nuts & Seeds",sabja seeds,2,80,70,10,1
04-04-2025,"Grains, Flours & Dals",Green gram 1 kg,4,150,130,20,1
04-04-2025,"Dry Fruits, Nuts & Seeds",Groundnuts 1 kg,2,190,165,25,1
04-04-2025,"Dry Fruits, Nuts & Seeds",PULMAKHANA 100 GM,2,180,170,10,1
04-04-2025,Spices & Seasonings,Chilli powder 500 gms,15,290,210,80,1
04-04-2025,"Grains, Flours & Dals",Sathya Javva Wheat Rava 500GM,4,90,90,0,1
04-04-2025,"Grains, Flours & Dals",Arikadu ( kodo),4,140,130,10,1
04-04-2025,Spices & Seasonings,Tamarind 250GMS,15,80,65,15,1
04-04-2025,"Grains, Flours & Dals",DH URAD GOTA 1KG,4,215,190,25,1
04-04-2025,"Grains, Flours & Dals",UNPOLISHED TURDALL 1KG,4,240,210,30,1
04-04-2025,"Grains, Flours & Dals",white Bobarlu 1 KG,4,170,150,20,1
04-04-2025,"Grains, Flours & Dals",KORRALU (FOXTAIL M) 1KG,4,150,110,40,1
04-04-2025,"Grains, Flours & Dals",VGR RICE 5 KGS,4,350,325,25,1
04-04-2025,Milk & Dairy,HERITAGE BUTTERMILK,7,10,10,0,1
04-04-2025,Oils & Ghee,Sesame oil 500ml,9,295,280,15,1
03-04-2025,"Grains, Flours & Dals",CORN FOUR 250GM,4,40,35,5,1
03-04-2025,"Grains, Flours & Dals",SH WHITE POHA 500GM,4,75,75,0,1
03-04-2025,Household & Cleaning,vim small,6,105,105,0,7
03-04-2025,Snacks & Ready-to-Eat,sf berry crunch,14,299,299,0,1
03-04-2025,"Grains, Flours & Dals",Bombay Rava 500GM,4,35,30,5,1
03-04-2025,Oils & Ghee,Sesame oil 1 L,9,590,560,30,1
03-04-2025,"Health, Wellness & Ayurvedic Products",MD Aamlaki Choornam 100GM,5,100,100,0,1
03-04-2025,Personal Care & Cosmetics,GAYATHRI KUMKUDUKAYA,10,150,150,0,1
03-04-2025,Oils & Ghee,castor oil,9,80,80,0,1
03-04-2025,Spices & Seasonings,SD Curry Leaves Karam Powder 100GM,15,65,65,0,1
03-04-2025,"Dry Fruits, Nuts & Seeds",PUMPKIN SEEDS 250GM,2,200,160,40,1
03-04-2025,"Dry Fruits, Nuts & Seeds",WATERMELON SEEDS 250GRM,2,320,280,40,1
03-04-2025,Sweeteners,GS Palm Jaggery Powder 400GM,16,180,180,0,1
03-04-2025,"Dry Fruits, Nuts & Seeds",SUNFLOWER SEEDS 250GRM,2,150,130,20,1
03-04-2025,Sweeteners,YB JAGGERY POWDER 500GMS,16,75,75,0,1
03-04-2025,"Dry Fruits, Nuts & Seeds",sabja seeds,2,80,70,10,1
03-04-2025,"Grains, Flours & Dals",RED TURDAL 500GM,4,75,70,5,1
03-04-2025,"Grains, Flours & Dals",Chana Flour 500 gms,4,70,65,5,1
03-04-2025,Oils & Ghee,rice bran oil f,9,194,169,25,1
03-04-2025,Sweeteners,SUGAR 500 GM,16,30,25,5,1
03-04-2025,Milk & Dairy,HRITAGE TOTAL CURD 130GM,7,20,20,0,2
03-04-2025,Spices & Seasonings,Turmeric powder 250 gms,15,100,75,25,1
03-04-2025,"Grains, Flours & Dals",Chana Flour 500 gms,4,70,65,5,1
03-04-2025,"Grains, Flours & Dals",PESARA PAPPU 1 KG,4,170,145,25,1
03-04-2025,"Grains, Flours & Dals",Red Chana 250GM,4,35,30,5,1
03-04-2025,"Grains, Flours & Dals",JOWAR YELLOW 1 K,4,250,225,25,2.5
03-04-2025,Snacks & Ready-to-Eat,TILLI CHIKKI,14,5,5,0,1
03-04-2025,"Grains, Flours & Dals",KORRALU (FOXTAIL M) 1KG,4,150,110,40,1
03-04-2025,"Grains, Flours & Dals",Wheat Rava S 1KG,4,65,55,10,1
03-04-2025,Milk & Dairy,SANGAM CURD 450GM,7,38,38,0,1
03-04-2025,Oils & Ghee,Groundnut oil 1 L,9,360,330,30,1
03-04-2025,Snacks & Ready-to-Eat,CHOCO BROWINE,14,20,20,0,1
03-04-2025,"Grains, Flours & Dals",Wheat Flour 1 kg,4,70,60,10,1
03-04-2025,Milk & Dairy,BROWN EGGS 1P,7,42,36,6,3
03-04-2025,Personal Care & Cosmetics,UVIS HENNA 100GM,10,75,75,0,1
03-04-2025,"Grains, Flours & Dals",Wheat Flour 1 kg,4,70,60,10,1
03-04-2025,Snacks & Ready-to-Eat,GB SALT COOKIES,14,60,55,5,1
03-04-2025,Snacks & Ready-to-Eat,RINGS 200GM,14,30,30,0,1
03-04-2025,Spices & Seasonings,Miriyalu 50GM,15,100,80,20,1
03-04-2025,Sweeteners,SUGAR 1KG,16,60,50,10,1
03-04-2025,"Grains, Flours & Dals",VGR RICE 5 KGS,4,350,325,25,1
03-04-2025,Snacks & Ready-to-Eat,VD MURMURA LADDU,14,50,50,0,1
03-04-2025,"Grains, Flours & Dals",RAGI FLOUR 1KG,4,80,70,10,1
03-04-2025,Snacks & Ready-to-Eat,VD DAHI MIRCHI(SALTED) 100GM,14,45,45,0,1
03-04-2025,"Grains, Flours & Dals",Yellow jowar .F1 kg,4,110,100,10,1
03-04-2025,Snacks & Ready-to-Eat,VD GUMMADI VADIYAM,14,75,75,0,1
03-04-2025,Milk & Dairy,SANGAM TONED MILK 500ML,7,60,60,0,2
03-04-2025,"Grains, Flours & Dals",White jowar.F 1 kg,4,200,160,40,2
03-04-2025,Snacks & Ready-to-Eat,VD JAGGERY GHEE 250GM,14,120,120,0,1
03-04-2025,Snacks & Ready-to-Eat,VD SAGOPAPAD 150GM,14,165,165,0,3
03-04-2025,Oils & Ghee,Groundnut oil 5 L,9,1800,"1,600.00",200,1
03-04-2025,"Dry Fruits, Nuts & Seeds",SH GROUNDNUT 250GM,2,85,85,0,1
03-04-2025,"Grains, Flours & Dals",RAGI FLOUR 1KG,4,80,70,10,1
03-04-2025,Spices & Seasonings,Chilli powder 500 gms,15,290,210,80,1
03-04-2025,Oils & Ghee,cow ghee 500 ml,9,1290,"1,170.00",120,3
03-04-2025,"Grains, Flours & Dals",Bajra Flour 500 gms,4,35,30,5,1
03-04-2025,"Grains, Flours & Dals",White jowar.F 1 kg,4,100,80,20,1
03-04-2025,"Grains, Flours & Dals",SATHVI BARELY SEEDS 500GMS,4,90,70,20,1
03-04-2025,"Grains, Flours & Dals",turdal 500 gms,4,110,85,25,1
03-04-2025,Snacks & Ready-to-Eat,COPRA LADDU 200GM,14,100,80,20,1
03-04-2025,Oils & Ghee,Groundnut oil 1 L,9,360,330,30,1
03-04-2025,Snacks & Ready-to-Eat,VD MURMURA LADDU,14,50,50,0,1
03-04-2025,Snacks & Ready-to-Eat,RI SPORTS BAR 40G,14,45,45,0,1
03-04-2025,Snacks & Ready-to-Eat,VD VAMUPUSA 175GM,14,60,60,0,1
03-04-2025,"Grains, Flours & Dals",THICK POHA 500GM,4,40,35,5,1
03-04-2025,Spices & Seasonings,SD Redgram Karam Powder 100GM,15,65,65,0,1
03-04-2025,Snacks & Ready-to-Eat,VD GUMMADI CHAKKA,14,130,130,0,1
03-04-2025,"Grains, Flours & Dals",PESARA PAPPU 500GMS,4,85,75,10,1
03-04-2025,Snacks & Ready-to-Eat,SD Vamu with palm jaggery 250gm,14,135,135,0,1
03-04-2025,Snacks & Ready-to-Eat,FOXTAIL BIS,14,135,135,0,1
03-04-2025,Pooja & Spiritual Items,divya deeparadhana oil,12,190,190,0,1
03-04-2025,Snacks & Ready-to-Eat,SUNNUNDALU,14,120,120,0,1
03-04-2025,Snacks & Ready-to-Eat,BB VERMICELLY 500GM,14,53,53,0,1
03-04-2025,Spices & Seasonings,Turmeric powder 250 gms,15,100,75,25,1
03-04-2025,Snacks & Ready-to-Eat,VD PALLI CHIKKI,14,80,80,0,1
03-04-2025,"Grains, Flours & Dals",Chana Flour 500 gms,4,70,65,5,1
03-04-2025,"Grains, Flours & Dals",RED TURDAL 500GM,4,75,70,5,1
03-04-2025,"Grains, Flours & Dals",Bajra Flour 1 kg,4,70,60,10,1
03-04-2025,Snacks & Ready-to-Eat,SD KODO MILLET WITH PALM JAGGERY,14,135,135,0,1
03-04-2025,"Grains, Flours & Dals",PRO SOYA CHUNKS 200G,4,79,79,0,1
03-04-2025,Snacks & Ready-to-Eat,SD barnyard Millet with palm jaggery,14,135,135,0,1
03-04-2025,Misc,ROLL D C,8,70,45,25,1
03-04-2025,Snacks & Ready-to-Eat,NGT CHATPATTA CHANA 90GM,14,25,25,0,1
03-04-2025,Spices & Seasonings,Japatri 25GM,15,100,80,20,1
03-04-2025,Snacks & Ready-to-Eat,FOXTAIL BIS,14,135,135,0,1
03-04-2025,Snacks & Ready-to-Eat,instant millet dosa,14,110,110,0,1
03-04-2025,"Grains, Flours & Dals",Arikalu (kodo),4,70,65,5,1
03-04-2025,"Grains, Flours & Dals",HS MULTI UPMA RAVA,4,65,65,0,1
03-04-2025,"Grains, Flours & Dals",SL Idly Rava 1KG,4,65,55,10,1
03-04-2025,"Grains, Flours & Dals",UDALU (Barnyard millet) 500 gms,4,70,60,10,1
03-04-2025,Spices & Seasonings,Chilli powder 500 gms,15,290,210,80,1
03-04-2025,Spices & Seasonings,Masala Karam 250 gms,15,130,120,10,1
03-04-2025,Spices & Seasonings,SD Curry Leaves Karam Powder 100GM,15,65,65,0,1
03-04-2025,Oils & Ghee,Groundnut oil 1 L,9,360,330,30,1
03-04-2025,Milk & Dairy,HERITAGE TOTAL CURD 500GM,7,50,50,0,1
03-04-2025,"Grains, Flours & Dals",Wheat Flour 1 kg,4,210,180,30,3
03-04-2025,Oils & Ghee,cow ghee 500 ml,9,430,390,40,1
03-04-2025,Snacks & Ready-to-Eat,VD NUVULLU CHIKKI,14,80,80,0,1
03-04-2025,Sweeteners,NATURAL HONEY 250GM,16,150,130,20,1
03-04-2025,"Grains, Flours & Dals",Wheat Flour 1 kg,4,140,120,20,2
03-04-2025,"Grains, Flours & Dals",White jowar.F 1 kg,4,100,80,20,1
03-04-2025,Spices & Seasonings,Black Till 250GM,15,180,150,30,2
03-04-2025,Snacks & Ready-to-Eat,VD CORNFLAKES MIXTURE 175GM,14,60,60,0,1
03-04-2025,Snacks & Ready-to-Eat,NGT CHATPATTA CHANA 90GM,14,25,25,0,1
03-04-2025,Snacks & Ready-to-Eat,SATHVI REGIVADA 200GM,14,80,60,20,1
03-04-2025,Snacks & Ready-to-Eat,VD ATUKULU MIXTURE 175GM,14,60,60,0,1
03-04-2025,Snacks & Ready-to-Eat,VD NUVVULU LADDU,14,80,80,0,1
03-04-2025,Pickles & Cooking Pastes,PALLY CHUTNEY,11,55,55,0,1
03-04-2025,Snacks & Ready-to-Eat,HS JOWAR BISCUITS,14,50,50,0,1
03-04-2025,Snacks & Ready-to-Eat,SD KODO MILLET WITH PALM JAGGERY,14,135,135,0,1
03-04-2025,"Grains, Flours & Dals",RAGI FLOUR 1KG,4,80,70,10,1
03-04-2025,Snacks & Ready-to-Eat,HS Ragi biscuits,14,50,50,0,1
03-04-2025,"Grains, Flours & Dals",turdal 500 gms,4,110,85,25,1
03-04-2025,"Dry Fruits, Nuts & Seeds",PULMAKHANA 100 GM,2,180,170,10,1
03-04-2025,"Grains, Flours & Dals",HS JOWAR FLAKES 250GM 1+1,4,119,119,0,1
03-04-2025,"Grains, Flours & Dals",Em jowar idly R 500G,4,150,150,0,2
03-04-2025,Baking & Cooking Aids,GONDKATIRA Ag,0,85,75,10,1
03-04-2025,Oils & Ghee,Sesame oil 500ml,9,295,280,15,1
03-04-2025,Milk & Dairy,SANGAM CURD 450GM,7,38,38,0,1
03-04-2025,Oils & Ghee,Groundnut oil 500ml,9,180,165,15,1
03-04-2025,Spices & Seasonings,AV Iodized Salt 1KG,15,28,25,3,1
03-04-2025,Oils & Ghee,Groundnut oil 1 L,9,360,330,30,1
03-04-2025,"Grains, Flours & Dals",RAGI FLOUR 1KG,4,160,140,20,2
03-04-2025,Spices & Seasonings,SAJEERA,15,60,40,20,1
03-04-2025,"Grains, Flours & Dals",White jowar.F 1 kg,4,100,80,20,1
03-04-2025,Spices & Seasonings,Coriander seeds 200 gms,15,48,40,8,1
03-04-2025,Oils & Ghee,Sesame oil 500ml,9,295,280,15,1
03-04-2025,Sweeteners,Mishri 500GM,16,70,60,10,1
03-04-2025,Spices & Seasonings,LG 50GM,15,92,92,0,1
03-04-2025,Oils & Ghee,Coconut oil 500 ml,9,220,200,20,1
03-04-2025,"Grains, Flours & Dals",Multigrain 1 kg,4,200,170,30,2
03-04-2025,Pooja & Spiritual Items,BANDA PUVVU 25GM 25GM,12,80,60,20,1
03-04-2025,Oils & Ghee,Safflower oil 1 L,9,440,400,40,1
03-04-2025,Spices & Seasonings,Vamu 100GM,15,60,50,10,1
03-04-2025,"Dry Fruits, Nuts & Seeds",SALTED PISTA 250GM,2,400,350,50,1
03-04-2025,Oils & Ghee,Flaxseed oil 500 ml,9,300,270,30,1
03-04-2025,"Grains, Flours & Dals",PESARA PAPPU 500GMS,4,85,75,10,1
03-04-2025,Spices & Seasonings,Elaichi 25GM,15,145,120,25,1
03-04-2025,"Grains, Flours & Dals",Wheat Flour 1 kg,4,140,120,20,2
03-04-2025,Spices & Seasonings,GREEN SOUNF,15,60,40,20,1
03-04-2025,Milk & Dairy,BROWN EGGS 1P,7,140,120,20,10
03-04-2025,Oils & Ghee,Coconut oil 500 ml,9,220,200,20,1
03-04-2025,General Household & Kitchenware,MATCH BOX,3,20,20,0,1
03-04-2025,"Grains, Flours & Dals",Bombay Rava 500GM,4,35,30,5,1
03-04-2025,"Grains, Flours & Dals",RICE FLOUR 500 GM,4,35,28,7,1
03-04-2025,Oils & Ghee,castor oil,9,80,80,0,1
03-04-2025,Pooja & Spiritual Items,dhoop batti,12,45,45,0,1
03-04-2025,"Grains, Flours & Dals",CHANA DAL 500GM,4,70,60,10,1
03-04-2025,Snacks & Ready-to-Eat,VD MINAPA VADIYAM,14,65,65,0,1
03-04-2025,"Grains, Flours & Dals",CORN FOUR 250GM,4,40,35,5,1
03-04-2025,Snacks & Ready-to-Eat,Popcorn Seeds 250GM,14,45,40,5,1
03-04-2025,Snacks & Ready-to-Eat,RAJGIRA PEANUT CHIKKI 450GM,14,125,125,0,1
03-04-2025,Oils & Ghee,Sesame oil 500ml,9,295,280,15,1
03-04-2025,Oils & Ghee,Safflower oil 500 ml,9,220,200,20,1
03-04-2025,"Grains, Flours & Dals",Red Bobarlu 500 gms,4,95,85,10,1
03-04-2025,Oils & Ghee,Groundnut oil 500ml,9,180,165,15,1
03-04-2025,"Grains, Flours & Dals",WHEAT 1 KG,4,120,100,20,2
03-04-2025,Snacks & Ready-to-Eat,Popcorn Seeds 250GM,14,45,40,5,1
03-04-2025,"Grains, Flours & Dals",Yellow jowar.F 500 gms,4,55,50,5,1
03-04-2025,Spices & Seasonings,DURGA SALT CRYSTAL 1KG,15,25,25,0,1
03-04-2025,"Grains, Flours & Dals",RAGULU 1 KG,4,70,60,10,1
03-04-2025,Snacks & Ready-to-Eat,Sprouted Ragi Biscuits 450GM,14,150,150,0,1
03-04-2025,Snacks & Ready-to-Eat,SD KODO MILLET WITH PALM JAGGERY,14,135,135,0,1
03-04-2025,Snacks & Ready-to-Eat,VD PALLI CHIKKI,14,80,80,0,1
03-04-2025,"Grains, Flours & Dals",ANDU KORRALU (Browntop.m) 1 kg,4,260,220,40,1
03-04-2025,"Grains, Flours & Dals",KORRALU (FOXTAIL M) 500GM,4,65,55,10,1
03-04-2025,Spices & Seasonings,Turmeric powder 250 gms,15,600,450,150,6
03-04-2025,Personal Care & Cosmetics,MD Henna Choornam 100GM,10,160,160,0,2
03-04-2025,Personal Care & Cosmetics,MD Soapnut Choornam 100GM,10,80,80,0,1
03-04-2025,"Health, Wellness & Ayurvedic Products",MD Mandara Leaf Powder 50GM,5,100,100,0,1
03-04-2025,"Health, Wellness & Ayurvedic Products",MD Aamlaki Choornam 100GM,5,80,80,0,1
03-04-2025,"Grains, Flours & Dals",EM Ragi idli R 500G,4,75,75,0,1
03-04-2025,Spices & Seasonings,DURGA SALT CRYSTAL 1KG,15,25,25,0,1
03-04-2025,"Grains, Flours & Dals",POORI ATTA 500GM,4,35,30,5,1
03-04-2025,"Grains, Flours & Dals",Yellow jowar .F1 kg,4,110,100,10,1
03-04-2025,Spices & Seasonings,PN ORGANIC PINK SALT 1KG,15,124,124,0,1
03-04-2025,"Grains, Flours & Dals",Wheat Flour 1 kg,4,70,60,10,1
03-04-2025,Baking & Cooking Aids,WEIKFIELD CUSTARD POWDER,0,43,43,0,1
03-04-2025,"Dry Fruits, Nuts & Seeds",ALMONDS 250GM,2,280,260,20,1
03-04-2025,"Dry Fruits, Nuts & Seeds",WALLNUTS 250GM,2,380,360,20,1
03-04-2025,"Dry Fruits, Nuts & Seeds",YELLOW KISHMISH 250GM,2,130,110,20,1
03-04-2025,Spices & Seasonings,SONTI 50GM,15,30,20,10,1
03-04-2025,Sweeteners,MISHRI 250 GM,16,35,30,5,1
03-04-2025,Spices & Seasonings,KARAKAYA,15,50,30,20,1
03-04-2025,"Health, Wellness & Ayurvedic Products",MXP CREAM ONION,5,45,45,0,1
03-04-2025,Oils & Ghee,Sesame oil 500ml,9,295,280,15,1
03-04-2025,"Health, Wellness & Ayurvedic Products",KONDAPINDI CHOORNAM,5,100,100,0,1
03-04-2025,"Dry Fruits, Nuts & Seeds",pn makhana 100 gms,2,288,288,0,1
03-04-2025,"Health, Wellness & Ayurvedic Products",RB Max Protein Chinese Manchurian,5,45,45,0,1
03-04-2025,Milk & Dairy,SANGAM TONED MILK 500ML,7,60,60,0,2
03-04-2025,Snacks & Ready-to-Eat,SD Little Millet WITH PLAM JAGGERY,14,135,135,0,1
03-04-2025,Oils & Ghee,Groundnut oil 5 L,9,1800,"1,600.00",200,1
03-04-2025,Oils & Ghee,Groundnut oil 5 L,9,1800,"1,600.00",200,1
03-04-2025,Oils & Ghee,Groundnut oil 1 L,9,720,660,60,2
03-04-2025,"Grains, Flours & Dals",Wheat Rava S 1KG,4,65,55,10,1
03-04-2025,"Grains, Flours & Dals",turdal 1kg,4,220,170,50,1
03-04-2025,Spices & Seasonings,telaga pindi,15,70,70,0,1
03-04-2025,"Grains, Flours & Dals",CHANA DAL 500GM,4,70,60,10,1
03-04-2025,"Grains, Flours & Dals",aishwarya rice,4,450,450,0,1
03-04-2025,Oils & Ghee,Sesame oil 500ml,9,295,280,15,1
03-04-2025,Snacks & Ready-to-Eat,RSC ORANGE 100GMS,14,20,20,0,1
03-04-2025,"Grains, Flours & Dals",DOCTOR RICE DIABETIC SFR 1KG,4,120,120,0,1
03-04-2025,Snacks & Ready-to-Eat,VD PAPPU CHEGODI 200GM,14,120,120,0,2
03-04-2025,Oils & Ghee,Groundnut oil 1 L,9,360,330,30,1
03-04-2025,Personal Care & Cosmetics,Soapnut 500GM,10,120,90,30,1
03-04-2025,"Dry Fruits, Nuts & Seeds",FLAX SEEDS 250GM,2,60,50,10,1
03-04-2025,"Grains, Flours & Dals",RICE FLOUR 500 GM,4,35,28,7,1
03-04-2025,Oils & Ghee,Safflower oil 1 L,9,440,400,40,1
03-04-2025,Spices & Seasonings,NUVVULU 250GM,15,80,65,15,1
03-04-2025,Sweeteners,YB JAGGERY POWDER 500GMS,16,150,150,0,2
03-04-2025,Personal Care & Cosmetics,black khadi 1,10,560,532,28,1
03-04-2025,Oils & Ghee,Safflower oil 1 L,9,440,400,40,1
03-04-2025,"Grains, Flours & Dals",AISHWARYA LOW GI RICE 5KG,4,700,525,175,1
03-04-2025,General Household & Kitchenware,CLAY JUG J1,3,265,250,15,1
03-04-2025,Spices & Seasonings,SATHVI ANASAPUVUU 25GM,15,90,65,25,1
03-04-2025,"Grains, Flours & Dals",SABDANA,4,40,35,5,1
03-04-2025,"Dry Fruits, Nuts & Seeds",PULMAKHANA 100 GM,2,180,170,10,1
03-04-2025,Snacks & Ready-to-Eat,ANNAPURNA APPALAM,14,70,70,0,2
03-04-2025,Spices & Seasonings,PN ORGANIC PINK SALT 1KG,15,124,124,0,1
03-04-2025,Spices & Seasonings,Japatri 25GM,15,100,80,20,1
03-04-2025,Oils & Ghee,Groundnut oil 1 L,9,360,330,30,1
03-04-2025,"Grains, Flours & Dals",SL Idly Rava 1KG,4,65,55,10,1
03-04-2025,Sweeteners,GS JAGGERY NUGGETS 500GM,16,120,120,0,1
03-04-2025,"Grains, Flours & Dals",Chana Flour 1 kg,4,140,130,10,1
03-04-2025,Snacks & Ready-to-Eat,VD PAPPU CHEGODI 200GM,14,60,60,0,1
03-04-2025,Snacks & Ready-to-Eat,VD PALLI CHIKKI,14,80,80,0,1
03-04-2025,Snacks & Ready-to-Eat,VD MINAPA VADIYAM,14,65,65,0,1
03-04-2025,"Grains, Flours & Dals",Chana Flour 500 gms,4,70,65,5,1
03-04-2025,"Grains, Flours & Dals",MELMEKER 250GMS,4,180,135,45,3
03-04-2025,"Grains, Flours & Dals",HS JOWAR IDLY RAWA,4,260,260,0,4
03-04-2025,Sweeteners,GS Palm Jaggery Powder 400GM,16,180,180,0,1
03-04-2025,Sweeteners,YB Brown Sugar 1KG,16,140,140,0,1
03-04-2025,"Grains, Flours & Dals",MAAGAANI LOW GI SP L 1KG,4,120,105,15,1
03-04-2025,"Grains, Flours & Dals",Em Little idli R 500g,4,129,129,0,1
03-04-2025,"Grains, Flours & Dals",AISHWARYA SP IDLY RAVA 1KG,4,120,66,54,1
03-04-2025,"Grains, Flours & Dals",yellow jowar 500 gms,4,50,45,5,1
03-04-2025,Oils & Ghee,Groundnut oil 5 L,9,1800,"1,600.00",200,1
03-04-2025,Oils & Ghee,Black Sesame oil 500 ml,9,440,380,60,2
03-04-2025,"Health, Wellness & Ayurvedic Products",j s pnature,5,136,136,0,1
03-04-2025,Snacks & Ready-to-Eat,VD MULTI CHAKKA,14,110,110,0,1
03-04-2025,Personal Care & Cosmetics,HERBAL LAVENDER 250ML,10,225,225,0,1
03-04-2025,Spices & Seasonings,NUVVULU 250GM,15,80,65,15,1
03-04-2025,"Grains, Flours & Dals",Multigrain 1 kg,4,100,85,15,1
03-04-2025,"Grains, Flours & Dals",Wheat Flour 1 kg,4,70,60,10,1
03-04-2025,Snacks & Ready-to-Eat,VD PALLI CHIKKI,14,80,80,0,1
03-04-2025,"Dry Fruits, Nuts & Seeds",PULMAKHANA 100 GM,2,180,170,10,1
03-04-2025,"Dry Fruits, Nuts & Seeds",YELLOW KISHMISH 250GM,2,130,110,20,1
03-04-2025,"Grains, Flours & Dals",SABDANA,4,40,35,5,1
03-04-2025,"Grains, Flours & Dals",JOWAR YELLOW 1 K,4,200,180,20,2
03-04-2025,"Grains, Flours & Dals",bajra 500 gms,4,30,25,5,1
03-04-2025,"Grains, Flours & Dals",KORRALU (FOXTAIL M) 500GM,4,65,55,10,1
03-04-2025,"Grains, Flours & Dals",ULAVALU RED,4,90,75,15,1
03-04-2025,Spices & Seasonings,RED COPRA 500GM,15,170,148,22,1
03-04-2025,"Grains, Flours & Dals",Red Chana 250GM,4,35,30,5,1
03-04-2025,"Grains, Flours & Dals",Urad dall 1 Kg,4,185,170,15,1
03-04-2025,"Grains, Flours & Dals",Arikalu (kodo),4,70,65,5,1
03-04-2025,"Grains, Flours & Dals",BAJRA 1 KG,4,60,50,10,1
03-04-2025,"Grains, Flours & Dals",JOWAR YELLOW 1 K,4,100,90,10,1
03-04-2025,"Grains, Flours & Dals",Red Bobarlu 1 kg,4,190,170,20,1
03-04-2025,"Grains, Flours & Dals",Red uluvalu 250 gms,4,45,40,5,1
03-04-2025,Snacks & Ready-to-Eat,VD BELLAM GAVVALU 200GM,14,60,60,0,1
03-04-2025,Spices & Seasonings,ROYAL SAFFRON,15,125,125,0,1
03-04-2025,Snacks & Ready-to-Eat,RSC ORANGE 100GMS,14,20,20,0,1
03-04-2025,"Grains, Flours & Dals",Black gram 500 gms,4,75,70,5,1
03-04-2025,Spices & Seasonings,Black Till 250GM,15,90,75,15,1
03-04-2025,"Grains, Flours & Dals",Black uluvalu 250 gms,4,45,35,10,1
03-04-2025,Spices & Seasonings,SWEET SOUNF,15,20,20,0,1
03-04-2025,"Grains, Flours & Dals",VYS.SP.RICE BAG 1,4,1800,"1,650.00",150,1
02-04-2025,"Grains, Flours & Dals",GROUNDNUT CAKE,4,50,45,5,1
02-04-2025,"Dry Fruits, Nuts & Seeds",YB GRANMA NUTS,2,90,90,0,1
02-04-2025,"Grains, Flours & Dals",VGR rice 1 kg,4,140,130,10,2
02-04-2025,Snacks & Ready-to-Eat,SUNNUNDALU,14,120,120,0,1
02-04-2025,"Dry Fruits, Nuts & Seeds",Groundnuts 500 gms,2,95,85,10,1
02-04-2025,Snacks & Ready-to-Eat,VD PALLI LADDU,14,80,80,0,1
02-04-2025,"Grains, Flours & Dals",URAD DALL,4,95,85,10,1
02-04-2025,"Grains, Flours & Dals",VYS.SP RICE 1 KG,4,350,325,25,5
02-04-2025,Snacks & Ready-to-Eat,VD PAPPU CHEGODI 200GM,14,60,60,0,1
02-04-2025,"Grains, Flours & Dals",Wheat Flour 1 kg,4,70,60,10,1
02-04-2025,Oils & Ghee,Groundnut oil 1 L,9,360,330,30,1
02-04-2025,Snacks & Ready-to-Eat,VD MURMURA LADDU,14,50,50,0,1
02-04-2025,"Dry Fruits, Nuts & Seeds",Groundnuts 1 kg,2,190,165,25,1
02-04-2025,"Dry Fruits, Nuts & Seeds",PUTNALU 500GMS,2,90,76,14,1
02-04-2025,"Grains, Flours & Dals",Urad dall 1 Kg,4,370,340,30,2
02-04-2025,"Grains, Flours & Dals",Idly Rava L 1KG,4,180,150,30,3
02-04-2025,"Dry Fruits, Nuts & Seeds",sabja seeds,2,80,70,10,1
02-04-2025,Baking & Cooking Aids,GONDKATIRA Ag,0,170,150,20,2
02-04-2025,"Grains, Flours & Dals",UNPOLISHED TURDALL 1KG,4,240,210,30,1
02-04-2025,"Grains, Flours & Dals",Bombay Rava 500GM,4,70,60,10,2
02-04-2025,"Grains, Flours & Dals",Wheat Rava M 500GM,4,33,30,3,1
02-04-2025,Spices & Seasonings,NUVVULU 500GM,15,200,170,30,1
02-04-2025,Oils & Ghee,Groundnut oil 1 L,9,360,330,30,1
02-04-2025,"Grains, Flours & Dals",turdal 500 gms,4,110,85,25,1
02-04-2025,Milk & Dairy,HRITAGE TOTAL CURD 130GM,7,10,10,0,1
02-04-2025,"Grains, Flours & Dals",PESARA PAPPU 500GMS,4,85,75,10,1
02-04-2025,Household & Cleaning,GOOD KNIGHT SMALL,6,85,85,0,1
02-04-2025,Snacks & Ready-to-Eat,MB LITTLE MILLET NOODLES 180G,14,95,95,0,1
02-04-2025,Snacks & Ready-to-Eat,Corn Chips 250GM,14,40,35,5,1
02-04-2025,"Grains, Flours & Dals",RAGI FLOUR 500GRMS,4,40,35,5,1
02-04-2025,Personal Care & Cosmetics,COW DURBAR 7 HERBS SHAMPOO,10,125,125,0,1
02-04-2025,Snacks & Ready-to-Eat,GS Moongdal Dosa Mix 400GM,14,140,140,0,1
02-04-2025,Snacks & Ready-to-Eat,PEANUT CHIKKI,14,22,22,0,1
02-04-2025,Snacks & Ready-to-Eat,VD SANNAPUSA 175GM,14,60,60,0,1
02-04-2025,"Health, Wellness & Ayurvedic Products",DWI MANDARA TAILAM 100ML,5,160,160,0,1
02-04-2025,Snacks & Ready-to-Eat,ANNAPURNA APPALAM,14,35,35,0,1
02-04-2025,"Dry Fruits, Nuts & Seeds",PULMAKHANA 100 GM,2,180,170,10,1
02-04-2025,"Grains, Flours & Dals",MELMEKER 250GMS,4,60,45,15,1
02-04-2025,Oils & Ghee,MUSTARD OIL 100ML,9,100,100,0,1
02-04-2025,Spices & Seasonings,ROYAL SAFFRON 400GRMS,15,65,65,0,1
02-04-2025,Oils & Ghee,Sesame oil 500ml,9,295,280,15,1
02-04-2025,"Grains, Flours & Dals",Urad dall 1 Kg,4,185,170,15,1
02-04-2025,"Grains, Flours & Dals",maida 500grms,4,35,30,5,1
02-04-2025,Sweeteners,Mishri 500GM,16,70,60,10,1
02-04-2025,Spices & Seasonings,DURGA SALT CRYSTAL 1KG,15,25,25,0,1
02-04-2025,"Grains, Flours & Dals",WHITE BATANI,4,80,60,20,2
02-04-2025,Spices & Seasonings,PRO HIMALAYAN PINK SALT 500GM,15,68,68,0,1
02-04-2025,"Grains, Flours & Dals",turdal 1kg,4,220,170,50,1
02-04-2025,Milk & Dairy,BROWN EGGS 1P,7,84,72,12,6
02-04-2025,Spices & Seasonings,GREEN SOUNF,15,60,40,20,1
02-04-2025,"Grains, Flours & Dals",PESARA PAPPU 500GMS,4,85,75,10,1
02-04-2025,"Grains, Flours & Dals",Wheat Flour 1 kg,4,70,60,10,1
02-04-2025,Household & Cleaning,SRFR EXCEL,6,20,20,0,2
02-04-2025,Spices & Seasonings,Jeera 100GM,15,70,60,10,1
02-04-2025,Spices & Seasonings,MIRYALU 50 GRMS,15,100,80,20,1
02-04-2025,Household & Cleaning,vim small,6,30,30,0,2
02-04-2025,Oils & Ghee,Groundnut oil 1 L,9,720,660,60,2
02-04-2025,"Grains, Flours & Dals",Em Foxtail upma r 500 g,4,109,109,0,1
02-04-2025,"Dry Fruits, Nuts & Seeds",PULMAKHANA 100 GM,2,360,340,20,2
02-04-2025,Oils & Ghee,Sesame oil 1 L,9,590,560,30,1
02-04-2025,Sweeteners,YB JAGGERY POWDER 500GMS,16,75,75,0,1
02-04-2025,Oils & Ghee,Safflower oil 1 L,9,440,400,40,1
02-04-2025,"Grains, Flours & Dals",RAGI FLOUR 500GRMS,4,80,70,10,2
02-04-2025,Snacks & Ready-to-Eat,VD ATUKULU MIXTURE 175GM,14,60,60,0,1
02-04-2025,Oils & Ghee,Coconut oil 500 ml,9,220,200,20,1
02-04-2025,"Grains, Flours & Dals",Sathya Javva Wheat Rava 500GM,4,95,95,0,1
02-04-2025,Oils & Ghee,Groundnut oil 5 L,9,1800,"1,600.00",200,1
02-04-2025,Pooja & Spiritual Items,999 SINGAPORE DHOOP POW 50GM,12,35,35,0,1
02-04-2025,Spices & Seasonings,BLACK JEERA 50 GM,15,45,30,15,1
02-04-2025,"Grains, Flours & Dals",Quinova 500 gms,4,110,100,10,1
02-04-2025,Snacks & Ready-to-Eat,PN ORGANIC PUFFED RICE 200GM,14,55,55,0,1
02-04-2025,Pooja & Spiritual Items,SRI HARI KRISHNA DOOM 12PIC,12,80,80,0,1
02-04-2025,"Grains, Flours & Dals",Green gram 1 kg,4,150,130,20,1
02-04-2025,"Grains, Flours & Dals",KORRALU (FOXTAIL M) 500GM,4,65,55,10,1
02-04-2025,"Grains, Flours & Dals",Quinova 500 gms,4,110,100,10,1
02-04-2025,"Grains, Flours & Dals",Arikalu (kodo),4,70,65,5,1
02-04-2025,"Dry Fruits, Nuts & Seeds",sabja seeds,2,80,70,10,1
02-04-2025,"Grains, Flours & Dals",Wheat Flour 1 kg,4,70,60,10,1
02-04-2025,"Grains, Flours & Dals",ANDU KORRALU (Brown top .mlt) 500,4,130,110,20,1
02-04-2025,"Grains, Flours & Dals",UDALU (Barnyard millet) 500 gms,4,70,60,10,1
02-04-2025,"Grains, Flours & Dals",Multigrain 1 kg,4,200,170,30,2
02-04-2025,"Grains, Flours & Dals",Chana Flour 1 kg,4,140,130,10,1
02-04-2025,"Grains, Flours & Dals",RAGI FLOUR 1KG,4,80,70,10,1
02-04-2025,"Grains, Flours & Dals",Bajra Flour 1 kg,4,70,60,10,1
02-04-2025,Oils & Ghee,Groundnut oil 1 L,9,360,330,30,1
02-04-2025,"Grains, Flours & Dals",White jowar.F 1 kg,4,100,80,20,1
02-04-2025,"Grains, Flours & Dals",Yellow jowar .F1 kg,4,110,100,10,1
02-04-2025,"Grains, Flours & Dals",POORI ATTA 500GM,4,35,30,5,1
02-04-2025,Oils & Ghee,Safflower oil 1 L,9,440,400,40,1
02-04-2025,"Grains, Flours & Dals",RAGI FLOUR 500GRMS,4,40,35,5,1
02-04-2025,"Grains, Flours & Dals",SA Multi Grain Mix 500GM,4,159,159,0,1
02-04-2025,Beverages,BISLERI 100ml,1,10,10,0,1
02-04-2025,Milk & Dairy,HERITAGE BUTTERMILK,7,40,40,0,4
02-04-2025,"Health, Wellness & Ayurvedic Products",RB Max Protein Spanish Tomato,5,45,45,0,1
02-04-2025,"Health, Wellness & Ayurvedic Products",VAMU WATER,5,99,99,0,1
02-04-2025,Baking & Cooking Aids,GONDKATIRA Ag,0,85,75,10,1
02-04-2025,Snacks & Ready-to-Eat,CHOCO BROWINE,14,60,60,0,3
02-04-2025,"Grains, Flours & Dals",BARLEY SEEDS 250GMS,4,40,35,5,1
02-04-2025,"Dry Fruits, Nuts & Seeds",sabja seeds,2,80,70,10,1
02-04-2025,Spices & Seasonings,DB SAFRON,15,180,180,0,1
02-04-2025,Oils & Ghee,rice bran oil f,9,194,169,25,1
02-04-2025,Pooja & Spiritual Items,javadhu,12,60,60,0,1
02-04-2025,"Dry Fruits, Nuts & Seeds",KAJU HALF 250GM,2,310,290,20,1
02-04-2025,"Grains, Flours & Dals",Yellow jowar .F1 kg,4,220,200,20,2
02-04-2025,"Grains, Flours & Dals",Green gram 1 kg,4,150,130,20,1
02-04-2025,"Dry Fruits, Nuts & Seeds",Groundnuts 1 kg,2,380,330,50,2
02-04-2025,"Grains, Flours & Dals",Green Batani 250GM,4,55,45,10,1
02-04-2025,Spices & Seasonings,JEERA 250 gms,15,125,105,20,1
02-04-2025,"Dry Fruits, Nuts & Seeds",YELLOW KISHMISH 250GM,2,130,110,20,1
02-04-2025,Pooja & Spiritual Items,NAGA SINDHURAM,12,40,40,0,1
02-04-2025,Snacks & Ready-to-Eat,VD PANIPURI 100GM,14,30,30,0,1
02-04-2025,Sweeteners,MISHRI D,16,40,30,10,1
02-04-2025,Sweeteners,ACHU BELLAM 1KG,16,100,80,20,1
02-04-2025,Milk & Dairy,BROWN EGGS TRAY 30P,7,360,330,30,1
02-04-2025,"Dry Fruits, Nuts & Seeds",SATHVI CHIA SEEDS 100GM,2,100,80,20,1
02-04-2025,Pooja & Spiritual Items,SWAATHI GATTI DEEPAM VATTULU,12,60,60,0,2
02-04-2025,"Grains, Flours & Dals",SA Sprouted Ragi Flour 500GM,4,138,138,0,2
02-04-2025,Misc,VD00014,8,100,90,10,1
02-04-2025,Milk & Dairy,HERTG FULL CREAM M,7,41,41,0,1
02-04-2025,Beverages,BRU GREEN LABEL 1.2G,1,48,48,0,24
02-04-2025,Snacks & Ready-to-Eat,VD MURMURA LADDU,14,50,50,0,1
02-04-2025,"Grains, Flours & Dals",RICE FLOUR 1KG,4,70,55,15,1
02-04-2025,Snacks & Ready-to-Eat,BELAM MENIPA SUNADULLU,14,180,180,0,1
02-04-2025,"Grains, Flours & Dals",SRILATHA RICE RAVVA 500GM,4,35,35,0,1
02-04-2025,Pooja & Spiritual Items,GD Kumkum 50GM,12,30,30,0,1
02-04-2025,Spices & Seasonings,Turmeric powder 250 gms,15,100,75,25,1
02-04-2025,"Grains, Flours & Dals",JOWAR UPMA RAVA,4,65,65,0,1
02-04-2025,Pooja & Spiritual Items,SWASTIK CAMPHORE,12,90,90,0,1
02-04-2025,"Dry Fruits, Nuts & Seeds",FLAX SEEDS 250GM,2,60,50,10,1
02-04-2025,Snacks & Ready-to-Eat,HS JOWAR BISCUITS,14,50,50,0,1
02-04-2025,Spices & Seasonings,ROYAL SAFFRON,15,125,125,0,1
02-04-2025,Oils & Ghee,Groundnut oil 500ml,9,180,165,15,1
02-04-2025,"Grains, Flours & Dals",SA WHITE JOWAR RAVA 500GM,4,69,69,0,1
02-04-2025,"Grains, Flours & Dals",Multigrain 1 kg,4,100,85,15,1
02-04-2025,Oils & Ghee,cow ghee 500 ml,9,430,390,40,1
02-04-2025,"Grains, Flours & Dals",Multigrain 1 kg,4,100,85,15,1
02-04-2025,"Grains, Flours & Dals",Em kodo idli R 500G,4,129,129,0,1
02-04-2025,"Grains, Flours & Dals",RAGI FLOUR 1KG,4,80,70,10,1
02-04-2025,"Dry Fruits, Nuts & Seeds",ALMONDS 250GM,2,280,260,20,1
02-04-2025,"Dry Fruits, Nuts & Seeds",D kimia,2,310,180,130,1
02-04-2025,Spices & Seasonings,PRO HIMALAYAN PINK SALT 500GM,15,68,68,0,1
02-04-2025,"Grains, Flours & Dals",Yellow jowar .F1 kg,4,110,100,10,1
02-04-2025,Snacks & Ready-to-Eat,GANTASALA GINGER CANDY 200GM,14,105,105,0,1
02-04-2025,"Grains, Flours & Dals",Arikalu (kodo),4,70,65,5,1
02-04-2025,"Grains, Flours & Dals",SAMALU (Little millet) 500 gms,4,85,65,20,1
02-04-2025,"Grains, Flours & Dals",UDALU (Barnyard millet) 500 gms,4,70,60,10,1
02-04-2025,Snacks & Ready-to-Eat,VD GUMMADI CHAKKA,14,130,130,0,1
02-04-2025,Snacks & Ready-to-Eat,SATHVI REGIVADA 200GM,14,160,120,40,2
02-04-2025,"Grains, Flours & Dals",RAGI FLOUR 500GRMS,4,80,70,10,2
02-04-2025,Snacks & Ready-to-Eat,VD NUVULLU CHIKKI,14,80,80,0,1
02-04-2025,Snacks & Ready-to-Eat,SD DrybFruit LADDU WITH DATES 175GM,14,170,170,0,1
02-04-2025,Snacks & Ready-to-Eat,VD NUVULU LADDU 9PIC,14,100,100,0,1
02-04-2025,Oils & Ghee,Castor oil 200 ml,9,100,80,20,1
02-04-2025,"Grains, Flours & Dals",split green gram 1 kg,4,300,280,20,2
02-04-2025,"Grains, Flours & Dals",Red uluvalu 250 gms,4,45,40,5,1
02-04-2025,"Grains, Flours & Dals",RAGI FLOUR 500GRMS,4,40,35,5,1
02-04-2025,"Grains, Flours & Dals",PESARA PAPPU 500GMS,4,85,75,10,1
02-04-2025,"Grains, Flours & Dals",White jowar.F 1 kg,4,200,160,40,2
02-04-2025,"Grains, Flours & Dals",Chana Flour 500 gms,4,70,65,5,1
02-04-2025,Snacks & Ready-to-Eat,VD SANNAPUSA 175GM,14,60,60,0,1
02-04-2025,Snacks & Ready-to-Eat,GREEN FRIED batana,14,100,100,0,5
02-04-2025,"Grains, Flours & Dals",White jowar.F 1 kg,4,300,240,60,3
02-04-2025,"Grains, Flours & Dals",Multigrain 1 kg,4,100,85,15,1
02-04-2025,Spices & Seasonings,KALONJI SEEDS,15,90,80,10,1
02-04-2025,Snacks & Ready-to-Eat,CHOCO BROWINE,14,40,40,0,2
02-04-2025,"Grains, Flours & Dals",Wheat Flour 1 kg,4,210,180,30,3
02-04-2025,Oils & Ghee,Mustard oil 500 ml,9,220,195,25,1
02-04-2025,Oils & Ghee,Coconut oil 500 ml,9,220,200,20,1
02-04-2025,Pooja & Spiritual Items,SWASTIK CAMPHORE,12,90,90,0,1
02-04-2025,"Grains, Flours & Dals",Black uluvalu 250 gms,4,90,70,20,2
02-04-2025,"Dry Fruits, Nuts & Seeds",PULMAKHANA 100 GM,2,180,170,10,1
02-04-2025,Sweeteners,SD PALM JAGGERY 500GM,16,200,200,0,1
02-04-2025,Snacks & Ready-to-Eat,VD NUVVULU LADDU,14,80,80,0,1
02-04-2025,Snacks & Ready-to-Eat,VD PAPPU CHEGODI 200GM,14,60,60,0,1
02-04-2025,Milk & Dairy,BROWN EGGS 1P,7,210,180,30,15
02-04-2025,"Grains, Flours & Dals",UNPOLISHED TURDALL 1KG,4,240,210,30,1
02-04-2025,Oils & Ghee,Sesame oil 1 L,9,590,560,30,1
02-04-2025,Oils & Ghee,Groundnut oil 1 L,9,360,330,30,1
02-04-2025,"Dry Fruits, Nuts & Seeds",SD Mango cubes 200gm,2,90,90,0,1
02-04-2025,Snacks & Ready-to-Eat,VD MURMURA LADDU,14,50,50,0,1
02-04-2025,"Grains, Flours & Dals",Multigrain 1 kg,4,400,340,60,4
02-04-2025,"Grains, Flours & Dals",RAGI FLOUR 500GRMS,4,40,35,5,1
02-04-2025,Sweeteners,GS Palm Jaggery Powder 400GM,16,180,180,0,1
02-04-2025,Snacks & Ready-to-Eat,Corn Chips 250GM,14,40,35,5,1
02-04-2025,Spices & Seasonings,GREEN SOUNF,15,60,40,20,1
02-04-2025,"Dry Fruits, Nuts & Seeds",PUTNALU 500GMS,2,90,76,14,1
02-04-2025,Snacks & Ready-to-Eat,Pani Poori Chips 250GM,14,100,80,20,2
02-04-2025,Spices & Seasonings,SATHVI ANASAPUVUU 25GM,15,90,65,25,1
02-04-2025,"Dry Fruits, Nuts & Seeds",Groundnuts 1 kg,2,190,165,25,1
02-04-2025,Spices & Seasonings,BIRYANI LEAF 10GM,15,30,20,10,1
02-04-2025,"Grains, Flours & Dals",Chana Flour 1 kg,4,140,130,10,1
02-04-2025,"Grains, Flours & Dals",Multigrain 1 kg,4,200,170,30,2
02-04-2025,"Grains, Flours & Dals",Wheat Flour 1 kg,4,140,120,20,2
02-04-2025,Spices & Seasonings,NUVVULU 250GM,15,80,65,15,1
02-04-2025,"Dry Fruits, Nuts & Seeds",FLAX SEEDS 250GM,2,60,50,10,1
02-04-2025,Snacks & Ready-to-Eat,VD PALLI LADDU,14,80,80,0,1
02-04-2025,Snacks & Ready-to-Eat,SD Flax seeds with dates 250gm,14,135,135,0,1
02-04-2025,Oils & Ghee,Safflower oil 1 L,9,440,400,40,1
02-04-2025,Snacks & Ready-to-Eat,SD DrybFruit LADDU WITH DATES 175GM,14,170,170,0,1
02-04-2025,Oils & Ghee,Sesame oil 1 L,9,590,560,30,1
02-04-2025,Oils & Ghee,Groundnut oil 1 L,9,360,330,30,1
02-04-2025,Spices & Seasonings,sf jeera,15,120,120,0,1
02-04-2025,Spices & Seasonings,menthulu,15,90,90,0,1
02-04-2025,Snacks & Ready-to-Eat,VD PALLI CHIKKI,14,80,80,0,1
02-04-2025,Household & Cleaning,SURF EXCEL MATIC TL 500ML,6,130,130,0,1
02-04-2025,Snacks & Ready-to-Eat,NGT CHATPATTA CHANA 90GM,14,50,50,0,2
02-04-2025,"Grains, Flours & Dals",RAGI FLOUR 500GRMS,4,40,35,5,1
02-04-2025,"Grains, Flours & Dals",Red uluvalu 250 gms,4,45,40,5,1
02-04-2025,Spices & Seasonings,NUVVULU 250GM,15,80,65,15,1
02-04-2025,"Grains, Flours & Dals",RAGULU 1 KG,4,140,120,20,2
02-04-2025,"Grains, Flours & Dals",Sathya Javva Wheat Rava 500GM,4,95,95,0,1
02-04-2025,"Grains, Flours & Dals",KORRALU (FOXTAIL M) 1KG,4,150,110,40,1
02-04-2025,Household & Cleaning,ROOPERI PITAMBARI SILVER 50ML,6,110,110,0,1
02-04-2025,"Grains, Flours & Dals",SL Idly Rava 1KG,4,65,55,10,1
02-04-2025,Spices & Seasonings,AVALU 100GM,15,25,20,5,1
02-04-2025,Spices & Seasonings,PN ORGANIC PINK SALT 1KG,15,124,124,0,1
02-04-2025,Sweeteners,PN ORGANIC BROWN SUGAR 500GM,16,78,78,0,1
02-04-2025,Snacks & Ready-to-Eat,SD Bajra with palm Jaggery 250gm,14,135,135,0,1
02-04-2025,"Grains, Flours & Dals",Urad dall 1 Kg,4,185,170,15,1
02-04-2025,"Grains, Flours & Dals",Chana Flour 500 gms,4,70,65,5,1
02-04-2025,"Dry Fruits, Nuts & Seeds",Groundnuts 1 kg,2,190,165,25,1
02-04-2025,Spices & Seasonings,JEERA 250 gms,15,125,105,20,1
02-04-2025,"Grains, Flours & Dals",split black gram 1 kg,4,180,170,10,1
02-04-2025,"Grains, Flours & Dals",Quinova 500 gms,4,110,100,10,1
02-04-2025,Snacks & Ready-to-Eat,VD Pappu Chekkalu 190gm,14,60,60,0,1
02-04-2025,"Grains, Flours & Dals",split urad dall 250 gms,4,45,40,5,1
02-04-2025,Oils & Ghee,groundnet oil,9,1600,"1,600.00",0,1
02-04-2025,Misc,ROLL D C,8,70,45,25,1
02-04-2025,Snacks & Ready-to-Eat,RSC ORANGE 100GMS,14,20,20,0,1
02-04-2025,"Grains, Flours & Dals",CHANA DAL 500GM,4,70,60,10,1
02-04-2025,"Dry Fruits, Nuts & Seeds",PULMAKHANA 100 GM,2,180,170,10,1
02-04-2025,Sweeteners,YB Brown Sugar 500GM,16,75,75,0,1
02-04-2025,Spices & Seasonings,ROYAL SAFFRON 400GRMS,15,65,65,0,1
02-04-2025,"Grains, Flours & Dals",unpolished turdall500grms,4,120,110,10,1
02-04-2025,"Grains, Flours & Dals",Idly Rava L 1KG,4,60,50,10,1
02-04-2025,Beverages,BRU GREEN LABEL 1.2G,1,48,48,0,24
02-04-2025,Sweeteners,MISHRI 250 GM,16,35,30,5,1
02-04-2025,"Grains, Flours & Dals",RAJMA 250GM,4,55,45,10,1
02-04-2025,"Grains, Flours & Dals",Wheat Rava M 500GM,4,33,30,3,1
02-04-2025,"Grains, Flours & Dals",DH URAD GOTA 1KG,4,215,190,25,1
02-04-2025,Snacks & Ready-to-Eat,JUNNU POWDER 100GM,14,70,70,0,1
02-04-2025,"Grains, Flours & Dals",Wheat Flour 1 kg,4,70,60,10,1
02-04-2025,"Grains, Flours & Dals",BOMBAY RAVA,4,70,55,15,1
02-04-2025,Snacks & Ready-to-Eat,VD RICE MURUKU 150GM,14,50,50,0,1
02-04-2025,"Grains, Flours & Dals",BOMBAY RAVA,4,70,55,15,1
02-04-2025,Snacks & Ready-to-Eat,SATHVI REGIVADA 200GM,14,80,60,20,1
02-04-2025,"Grains, Flours & Dals",PESARA PAPPU 1 KG,4,170,145,25,1
02-04-2025,"Grains, Flours & Dals",Wheat Rava M 500GM,4,33,30,3,1
02-04-2025,Snacks & Ready-to-Eat,VD MURMURA LADDU,14,50,50,0,1
02-04-2025,Spices & Seasonings,GS Moringa Leaves Spicy Powder 100GM,15,90,90,0,1
02-04-2025,Snacks & Ready-to-Eat,RI SPORTS BAR 40G,14,45,45,0,1
02-04-2025,Spices & Seasonings,LG 50GM,15,92,92,0,1
02-04-2025,Snacks & Ready-to-Eat,VD CORNFLAKES MIXTURE 175GM,14,60,60,0,1
02-04-2025,Snacks & Ready-to-Eat,VD Pappu Chekkalu 190gm,14,60,60,0,1
02-04-2025,Personal Care & Cosmetics,UVIS LACTO TAN SOAP 100GM,10,198,198,0,2
02-04-2025,Spices & Seasonings,Coriander seeds 200 gms,15,48,40,8,1
02-04-2025,"Dry Fruits, Nuts & Seeds",YELLOW KISHMISH 250GM,2,130,110,20,1
02-04-2025,"Grains, Flours & Dals",ANDU KORRALU (Browntop.m) 1 kg,4,260,220,40,1
02-04-2025,"Grains, Flours & Dals",Red Chana 500 GM,4,75,60,15,1
02-04-2025,Spices & Seasonings,ROYAL SAFFRON 400GRMS,15,130,130,0,2
02-04-2025,Snacks & Ready-to-Eat,SF NOODLES CLKASSIC MASALA,14,258,258,0,2
02-04-2025,"Grains, Flours & Dals",Chana Flour 500 gms,4,140,130,10,2
02-04-2025,"Grains, Flours & Dals",Green gram 1 kg,4,150,130,20,1
02-04-2025,Oils & Ghee,Groundnut oil 1 L,9,360,330,30,1
02-04-2025,Spices & Seasonings,PUTNALA KARAM POWDER 100GM,15,65,65,0,1
02-04-2025,"Grains, Flours & Dals",SAMALU,4,170,130,40,1
02-04-2025,"Grains, Flours & Dals",Wheat Flour 1 kg,4,350,300,50,5
02-04-2025,Oils & Ghee,Coconut oil 500 ml,9,220,200,20,1
02-04-2025,Oils & Ghee,Safflower oil 1 L,9,440,400,40,1
02-04-2025,"Grains, Flours & Dals",Arikadu ( kodo),4,280,260,20,2
02-04-2025,"Grains, Flours & Dals",Wheat Rava S 1KG,4,65,55,10,1
02-04-2025,Oils & Ghee,Sesame oil 1 L,9,590,560,30,1
02-04-2025,Snacks & Ready-to-Eat,BD BARELY NOODLES 200G,14,70,70,0,1
02-04-2025,Oils & Ghee,Safflower oil 1 L,9,440,400,40,1
02-04-2025,Personal Care & Cosmetics,MYSORE SANDAL SOAP 75G,10,84,84,0,2
02-04-2025,"Grains, Flours & Dals",Quinova 500 gms,4,220,200,20,2
02-04-2025,Sweeteners,YB JAGGERY POWDER 500GMS,16,225,225,0,3
02-04-2025,"Grains, Flours & Dals",turdal 1kg,4,660,510,150,3
02-04-2025,Sweeteners,YB Brown Sugar 1KG,16,140,140,0,1
02-04-2025,Milk & Dairy,BROWN EGGS TRAY 30P,7,360,330,30,1
02-04-2025,"Grains, Flours & Dals",SA WHITE JOWAR RAVA 500GM,4,69,69,0,1
02-04-2025,"Grains, Flours & Dals",Yellow jowar.F 500 gms,4,55,50,5,1
02-04-2025,Snacks & Ready-to-Eat,SAJJA GAVVALU,14,95,95,0,1
02-04-2025,"Grains, Flours & Dals",RAGULU 1 KG,4,70,60,10,1
02-04-2025,Snacks & Ready-to-Eat,JUNNU POWDER 100GM,14,70,70,0,1
02-04-2025,Oils & Ghee,Safflower oil 1 L,9,1320,"1,200.00",120,3
02-04-2025,Snacks & Ready-to-Eat,KURNOOL MARMURA,14,70,55,15,1
02-04-2025,"Grains, Flours & Dals",THICK POHA 1KG,4,80,70,10,1
02-04-2025,"Grains, Flours & Dals",Wheat Flour 1 kg,4,70,60,10,1
02-04-2025,"Grains, Flours & Dals",Multigrain 1 kg,4,100,85,15,1
02-04-2025,"Grains, Flours & Dals",Wheat Flour 1 kg,4,210,180,30,3
02-04-2025,Oils & Ghee,Groundnut oil 1 L,9,1800,"1,650.00",150,5
02-04-2025,"Grains, Flours & Dals",RAGI FLOUR 500GRMS,4,40,35,5,1
02-04-2025,"Grains, Flours & Dals",Yellow jowar .F1 kg,4,110,100,10,1
02-04-2025,"Grains, Flours & Dals",White jowar.F 1 kg,4,100,80,20,1
02-04-2025,"Grains, Flours & Dals",VYS.SP.RICE BAG 1,4,1800,"1,650.00",150,1
02-04-2025,"Grains, Flours & Dals",Wheat Flour 1 kg,4,140,120,20,2
02-04-2025,"Grains, Flours & Dals",SRILATHA RICE RAVVA 500GM,4,35,35,0,1
02-04-2025,"Dry Fruits, Nuts & Seeds",SATHVI CHIA SEEDS 100GM,2,200,160,40,2
02-04-2025,Oils & Ghee,Safflower oil 1 L,9,1320,"1,200.00",120,3
02-04-2025,Spices & Seasonings,KALONJI SEEDS,15,90,80,10,1
02-04-2025,"Grains, Flours & Dals",RAGI FLOUR 1KG,4,80,70,10,1
02-04-2025,"Grains, Flours & Dals",RICE FLOUR 1KG,4,70,55,15,1
02-04-2025,"Grains, Flours & Dals",White jowar.F 1 kg,4,100,80,20,1
02-04-2025,"Dry Fruits, Nuts & Seeds",sabja seeds,2,320,280,40,4
02-04-2025,"Grains, Flours & Dals",MELMEKER 250GMS,4,60,45,15,1
02-04-2025,"Grains, Flours & Dals",white Bobarlu 500 gms,4,80,75,5,1
02-04-2025,"Grains, Flours & Dals",AISHWARYA SP 1KG,4,80,70,10,1
02-04-2025,"Grains, Flours & Dals",Brown RICE 1KG,4,70,65,5,1
02-04-2025,Snacks & Ready-to-Eat,PN ORGANIC PUFFED RICE 200GM,14,55,55,0,1
02-04-2025,Snacks & Ready-to-Eat,Corn Chips 250GM,14,40,35,5,1
02-04-2025,Misc,VD00014,8,100,90,10,1
02-04-2025,"Grains, Flours & Dals",RAGI FLOUR 500GRMS,4,40,35,5,1
02-04-2025,"Grains, Flours & Dals",RICE FLOUR 1KG,4,70,55,15,1
02-04-2025,Personal Care & Cosmetics,SANTOOR,10,120,100,20,1
02-04-2025,Personal Care & Cosmetics,dabur red 200 grms,10,136,136,0,1
02-04-2025,Oils & Ghee,Groundnut oil 1 L,9,720,660,60,2
02-04-2025,Household & Cleaning,VIM MAHA BAR,6,20,20,0,2
02-04-2025,"Grains, Flours & Dals",UDALU (Barnyard millet) 1 kg,4,280,230,50,2
02-04-2025,"Dry Fruits, Nuts & Seeds",FLAX SEEDS 250GM,2,120,100,20,2
02-04-2025,"Grains, Flours & Dals",AISHWARAYA IDLY RAVA 1KG,4,297,198,99,3
02-04-2025,Snacks & Ready-to-Eat,VD PALLI LADDU,14,160,160,0,2
02-04-2025,Spices & Seasonings,DRY MIECHI 200GM,15,80,60,20,1
02-04-2025,"Dry Fruits, Nuts & Seeds",PRO ORG RAW PEANUTS 500GM,2,174,174,0,1
02-04-2025,"Grains, Flours & Dals",Green gram 1 kg,4,150,130,20,1
02-04-2025,"Grains, Flours & Dals",Red Chana 500 GM,4,75,60,15,1
02-04-2025,"Grains, Flours & Dals",split black gram 1 kg,4,540,510,30,3
02-04-2025,Spices & Seasonings,PN ORGANIC PINK SALT 1KG,15,124,124,0,1
02-04-2025,"Grains, Flours & Dals",JOWAR WHITE 1 KG,4,240,210,30,3
02-04-2025,"Grains, Flours & Dals",multi mllit umpa ravva,4,129,129,0,1
02-04-2025,"Grains, Flours & Dals",Wheat Flour 1 kg,4,210,180,30,3
02-04-2025,Snacks & Ready-to-Eat,VD MURUKU 175GM,14,60,60,0,1
02-04-2025,"Dry Fruits, Nuts & Seeds",pn makhana 100 gms,2,288,288,0,1
02-04-2025,"Grains, Flours & Dals",Quinova 1 kg,4,440,390,50,2
02-04-2025,Personal Care & Cosmetics,GAYATHRI KUMKUDUKAYA,10,150,150,0,1
02-04-2025,Sweeteners,GS Palm Jaggery Powder 400GM,16,180,180,0,1
02-04-2025,Spices & Seasonings,ROYAL SAFFRON,15,125,125,0,1
02-04-2025,Snacks & Ready-to-Eat,MAAGAANI M JOWAR PASTA 200GM,14,199,199,0,1
02-04-2025,"Health, Wellness & Ayurvedic Products",BHRINGARAJA,5,280,280,0,1
02-04-2025,Oils & Ghee,Groundnut oil 1 L,9,360,330,30,1
02-04-2025,Household & Cleaning,ROOPERI PITAMBARI SILVER 50ML,6,110,110,0,1
02-04-2025,Sweeteners,ACHU BELLAM 1KG,16,100,80,20,1
02-04-2025,"Grains, Flours & Dals",RICE FLOUR 1KG,4,70,55,15,1
02-04-2025,"Grains, Flours & Dals",THICK POHA 500GM,4,40,35,5,1
02-04-2025,Milk & Dairy,BROWN EGGS 1P,7,84,72,12,6
02-04-2025,"Grains, Flours & Dals",MELMEKER 250GMS,4,60,45,15,1
02-04-2025,Milk & Dairy,SANGAM TONED MILK 500ML,7,60,60,0,2
02-04-2025,Spices & Seasonings,PN ORGANIC PINK SALT 1KG,15,124,124,0,1
02-04-2025,"Dry Fruits, Nuts & Seeds",Groundnuts 500 gms,2,95,85,10,1
02-04-2025,Sweeteners,SUGAR 1KG,16,60,50,10,1
02-04-2025,Spices & Seasonings,Gasagasalu 50GM,15,130,110,20,1
02-04-2025,Spices & Seasonings,DRY MIECHI 200GM,15,80,60,20,1
02-04-2025,Spices & Seasonings,RED COPRA 250GMS,15,85,74,11,1
02-04-2025,"Dry Fruits, Nuts & Seeds",PUTNALU 500GMS,2,90,76,14,1
02-04-2025,Sweeteners,SUGAR 500 GM,16,30,25,5,1
02-04-2025,"Grains, Flours & Dals",BASMATHI RICE 1KG,4,150,135,15,1
02-04-2025,"Grains, Flours & Dals",White jowar.F 1 kg,4,100,80,20,1
02-04-2025,"Grains, Flours & Dals",Green Batani 250GM,4,55,45,10,1
02-04-2025,"Grains, Flours & Dals",Green gram 1 kg,4,150,130,20,1
02-04-2025,Oils & Ghee,Groundnut oil 1 L,9,720,660,60,2
02-04-2025,"Grains, Flours & Dals",SL Idly Rava 1KG,4,65,55,10,1
02-04-2025,"Dry Fruits, Nuts & Seeds",ALMONDS 250GM,2,280,260,20,1
02-04-2025,Spices & Seasonings,AVALU 250grms,15,60,60,0,1
02-04-2025,"Dry Fruits, Nuts & Seeds",DRYDATES YELLOW 250GM,2,135,120,15,1
02-04-2025,"Grains, Flours & Dals",URAD DALL,4,95,85,10,1
02-04-2025,Spices & Seasonings,Tamarind 250GMS,15,80,65,15,1
02-04-2025,Spices & Seasonings,Jeera 100GM,15,50,45,5,1
02-04-2025,Spices & Seasonings,Elaichi 25GM,15,145,120,25,1
02-04-2025,"Grains, Flours & Dals",Wheat Flour 1 kg,4,70,60,10,1
02-04-2025,Spices & Seasonings,MIRYALU 50 GRMS,15,100,80,20,1
02-04-2025,"Grains, Flours & Dals",turdal 1kg,4,220,170,50,1
02-04-2025,Snacks & Ready-to-Eat,VD PAPPU CHEGODI 200GM,14,60,60,0,1
02-04-2025,Snacks & Ready-to-Eat,VD PALLI LADDU,14,80,80,0,1
02-04-2025,Oils & Ghee,Groundnut oil 1 L,9,360,330,30,1
01-04-2025,General Household & Kitchenware,SABEENA,3,15,15,0,1
01-04-2025,Snacks & Ready-to-Eat,VD MURMURA LADDU,14,50,50,0,1
01-04-2025,Milk & Dairy,SANGAM FULL CREAM MILK 500ML,7,39,39,0,1
01-04-2025,Personal Care & Cosmetics,SVE MULTANI MITTI SOAP 100GM,10,180,180,0,2
01-04-2025,Oils & Ghee,Sesame oil 500ml,9,295,280,15,1
01-04-2025,General Household & Kitchenware,clay water bottle 1,3,250,250,0,1
01-04-2025,Snacks & Ready-to-Eat,DOSA BATTER 1KG,14,60,60,0,1
01-04-2025,Pooja & Spiritual Items,SWASTIK CAMPHORE,12,90,90,0,1
01-04-2025,Snacks & Ready-to-Eat,VD Minapa papad 200gm,14,60,60,0,1
01-04-2025,"Grains, Flours & Dals",MELMEKER 250GMS,4,60,45,15,1
01-04-2025,Snacks & Ready-to-Eat,VD MURMURA LADDU,14,50,50,0,1
01-04-2025,Snacks & Ready-to-Eat,VD ATUKULU MIXTURE 175GM,14,60,60,0,1
01-04-2025,"Grains, Flours & Dals",BOMBAY RAVA,4,70,55,15,1
01-04-2025,"Grains, Flours & Dals",Brown RICE 1KG,4,350,325,25,5
01-04-2025,Personal Care & Cosmetics,MD Soapnut Choornam 100GM,10,80,80,0,1
01-04-2025,Snacks & Ready-to-Eat,PEANUT CHIKKI 450GM,14,125,125,0,1
01-04-2025,"Grains, Flours & Dals",EM Foxtail idli r 500 g,4,109,109,0,1
01-04-2025,Snacks & Ready-to-Eat,TILLI CHIKKI,14,125,125,0,1
01-04-2025,Beverages,BRU GREEN LABEL 1.2G,1,24,24,0,12
01-04-2025,"Grains, Flours & Dals",EM Ragi idli R 500G,4,75,75,0,1
01-04-2025,Beverages,REFRESH SHARBATH SUGAR FREE,1,299,285,14,1
01-04-2025,"Grains, Flours & Dals",HS JOWAR IDLY RAWA,4,65,65,0,1
01-04-2025,"Grains, Flours & Dals",Wheat Flour 1 kg,4,70,60,10,1
01-04-2025,"Grains, Flours & Dals",Wheat Rava M 1KG,4,65,55,10,1
01-04-2025,Oils & Ghee,Groundnut oil 1 L,9,720,660,60,2
01-04-2025,Oils & Ghee,Safflower oil 1 L,9,880,800,80,2
01-04-2025,Oils & Ghee,Sesame oil 1 L,9,1180,"1,120.00",60,2
01-04-2025,Oils & Ghee,Safflower oil 1 L,9,440,400,40,1
01-04-2025,"Health, Wellness & Ayurvedic Products",MADDI NEEM OIL 100ML,5,100,100,0,1
01-04-2025,"Grains, Flours & Dals",UNPOLISHED TURDALL 1KG,4,240,210,30,1
01-04-2025,Spices & Seasonings,Jeera 100GM,15,50,45,5,1
01-04-2025,"Grains, Flours & Dals",CHANA DAL 500GM,4,70,60,10,1
01-04-2025,Spices & Seasonings,DRY MIECHI 200GM,15,80,60,20,1
01-04-2025,Personal Care & Cosmetics,REVLON,10,45,45,0,1
01-04-2025,"Dry Fruits, Nuts & Seeds",ALMONDS 250GM,2,280,260,20,1
01-04-2025,Sweeteners,YB JAGGERY POWDER 500GMS,16,75,75,0,1
01-04-2025,"Dry Fruits, Nuts & Seeds",Groundnuts 500 gms,2,95,85,10,1
01-04-2025,"Grains, Flours & Dals",Red Chana 500 GM,4,75,60,15,1
01-04-2025,Spices & Seasonings,PRO HIMALAYAN PINK SALT 500GM,15,68,68,0,1
01-04-2025,"Grains, Flours & Dals",Wheat Rava M 500GM,4,33,30,3,1
01-04-2025,Spices & Seasonings,Jeera 100GM,15,50,45,5,1
01-04-2025,"Grains, Flours & Dals",VYS.SP RICE 1 KG,4,280,260,20,4
01-04-2025,"Grains, Flours & Dals",Green gram 500 gms,4,75,70,5,1
01-04-2025,"Grains, Flours & Dals",THICK POHA 500GM,4,40,35,5,1
01-04-2025,Oils & Ghee,Safflower oil 1 L,9,880,800,80,2
01-04-2025,"Grains, Flours & Dals",SAMALU (Little millet) 500 gms,4,85,65,20,1
01-04-2025,"Grains, Flours & Dals",UDALU (Barnyard millet) 500 gms,4,70,60,10,1
01-04-2025,"Grains, Flours & Dals",MAAGAANI SP RICE 20 KGS,4,2300,"1,960.00",340,1
01-04-2025,"Grains, Flours & Dals",Arikalu (kodo),4,70,65,5,1
01-04-2025,"Grains, Flours & Dals",KORRALU (FOXTAIL M) 500GM,4,65,55,10,1
01-04-2025,Snacks & Ready-to-Eat,SD JOWAR WITH PALM JAGGERY 250GM,14,270,270,0,2
01-04-2025,"Grains, Flours & Dals",POORI ATTA 1KG,4,70,60,10,1
01-04-2025,Spices & Seasonings,RED COPRA 250GMS,15,85,74,11,1
01-04-2025,"Grains, Flours & Dals",SL Idly Rava 1KG,4,65,55,10,1
01-04-2025,"Grains, Flours & Dals",Wheat Rava M 500GM,4,33,30,3,1
01-04-2025,"Grains, Flours & Dals",Bajra Flour 1 kg,4,70,60,10,1
01-04-2025,"Grains, Flours & Dals",Wheat Flour 1 kg,4,350,300,50,5
01-04-2025,"Grains, Flours & Dals",White jowar.F 1 kg,4,100,80,20,1
01-04-2025,"Grains, Flours & Dals",Chana Flour 500 gms,4,70,65,5,1
01-04-2025,"Grains, Flours & Dals",Green gram 1 kg,4,300,260,40,2
01-04-2025,"Grains, Flours & Dals",KORRALU (FOXTAIL M) 1KG,4,150,110,40,1
01-04-2025,"Grains, Flours & Dals",UDALU (Barnyard millet) 1 kg,4,140,115,25,1
01-04-2025,"Grains, Flours & Dals",Arikadu ( kodo),4,280,260,20,2
01-04-2025,Milk & Dairy,SANGAM CURD 450GM,7,38,38,0,1
01-04-2025,"Grains, Flours & Dals",SRILATHA RICE RAVVA 500GM,4,35,35,0,1
01-04-2025,Snacks & Ready-to-Eat,VD CORNFLAKES MIXTURE 175GM,14,60,60,0,1
01-04-2025,"Grains, Flours & Dals",THICK POHA 1KG,4,80,70,10,1
01-04-2025,Snacks & Ready-to-Eat,NGT CHATPATTA CHANA 90GM,14,50,50,0,2
01-04-2025,Snacks & Ready-to-Eat,VD SAGOPAPAD 150GM,14,55,55,0,1
01-04-2025,Snacks & Ready-to-Eat,ANNAPURNA APPALAM,14,35,35,0,1
01-04-2025,"Dry Fruits, Nuts & Seeds",sabja seeds,2,80,70,10,1
01-04-2025,Snacks & Ready-to-Eat,VD PALLI LADDU,14,160,160,0,2
01-04-2025,Snacks & Ready-to-Eat,BELLAM MINAPA SUNADULLU,14,180,180,0,1
01-04-2025,Snacks & Ready-to-Eat,COPRA LADDU 200GM,14,100,80,20,1
01-04-2025,Snacks & Ready-to-Eat,SATHVI REGIVADA 200GM,14,80,60,20,1
01-04-2025,Snacks & Ready-to-Eat,VD PALLI LADDU,14,160,160,0,2
01-04-2025,Snacks & Ready-to-Eat,GANTASALA GINGER CANDY 200GM,14,105,105,0,1
01-04-2025,Snacks & Ready-to-Eat,RINGS 200GM,14,30,30,0,1
01-04-2025,Snacks & Ready-to-Eat,GB SALT COOKIES,14,60,55,5,1
01-04-2025,Snacks & Ready-to-Eat,PN ORGANIC PUFFED RICE 200GM,14,55,55,0,1
01-04-2025,Spices & Seasonings,Japatri 25GM,15,100,80,20,1
01-04-2025,Oils & Ghee,Sesame oil 500ml,9,295,280,15,1
01-04-2025,Snacks & Ready-to-Eat,VD MURMURA LADDU,14,50,50,0,1
01-04-2025,Oils & Ghee,mustard oil,9,195,195,0,1
01-04-2025,Snacks & Ready-to-Eat,VD CORNFLAKES MIXTURE 175GM,14,60,60,0,1
01-04-2025,Milk & Dairy,SANGAM CURD 450GM,7,38,38,0,1
01-04-2025,Oils & Ghee,Safflower oil 1 L,9,440,400,40,1
01-04-2025,Personal Care & Cosmetics,GAYATHRI KUMKUDUKAYA,10,600,600,0,4
01-04-2025,"Grains, Flours & Dals",DH URAD GOTA 1KG,4,430,380,50,2
01-04-2025,Household & Cleaning,comfort morning fresh,6,58,58,0,1
01-04-2025,"Grains, Flours & Dals",BOMBAY RAVA,4,70,55,15,1
01-04-2025,Spices & Seasonings,Elaichi 25GM,15,145,120,25,1
01-04-2025,"Grains, Flours & Dals",HS JOWAR IDLY RAWA,4,130,130,0,2
01-04-2025,"Grains, Flours & Dals",Arikadu ( kodo),4,140,130,10,1
01-04-2025,"Dry Fruits, Nuts & Seeds",SATHVI CHIA SEEDS 100GM,2,100,80,20,1
01-04-2025,"Grains, Flours & Dals",EM Ragi idli R 500G,4,150,150,0,2
01-04-2025,Spices & Seasonings,NUVVULU 250GM,15,80,65,15,1
01-04-2025,Baking & Cooking Aids,MTR GULAB JAMUN MIX 190GM,0,80,80,0,1
01-04-2025,Pooja & Spiritual Items,divya deeparadhana oil,12,190,190,0,1
01-04-2025,Snacks & Ready-to-Eat,BB VERMICELLI 1KG,14,95,90,5,1
01-04-2025,"Dry Fruits, Nuts & Seeds",Groundnuts 1 kg,2,380,330,50,2
01-04-2025,Snacks & Ready-to-Eat,RSC ORANGE 100GMS,14,20,20,0,1
01-04-2025,Spices & Seasonings,DRY MIECHI 200GM,15,80,60,20,1
01-04-2025,"Grains, Flours & Dals",Chana Flour 500 gms,4,70,65,5,1
01-04-2025,Household & Cleaning,HENKO STAIN CARE 1KG,6,168,168,0,1
01-04-2025,"Grains, Flours & Dals",KORRALU (FOXTAIL M) 1KG,4,150,110,40,1
01-04-2025,Spices & Seasonings,coconut powder,15,90,70,20,1
01-04-2025,Household & Cleaning,VIM MAHA BAR,6,40,40,0,4
01-04-2025,"Dry Fruits, Nuts & Seeds",ALMONDS 250GM,2,280,260,20,1
01-04-2025,Personal Care & Cosmetics,SANTOOR,10,240,200,40,2
01-04-2025,Household & Cleaning,harpic 500ml,6,220,220,0,2
01-04-2025,Oils & Ghee,Groundnut oil 1 L,9,360,330,30,1
01-04-2025,Oils & Ghee,Coconut oil 500 ml,9,220,200,20,1
01-04-2025,Spices & Seasonings,PRO ORG CORIANDER WHOLE 100G,15,70,70,0,1
01-04-2025,"Grains, Flours & Dals",Wheat Flour 1 kg,4,210,180,30,3
01-04-2025,Oils & Ghee,Safflower oil 1 L,9,440,400,40,1
01-04-2025,Milk & Dairy,HRITAGE TOTAL CURD 130GM,7,20,20,0,2
01-04-2025,"Grains, Flours & Dals",THICK POHA 500GM,4,40,35,5,1
01-04-2025,"Dry Fruits, Nuts & Seeds",SALTED PISTA 250GM,2,400,350,50,1
01-04-2025,"Grains, Flours & Dals",RAGI FLOUR 500GRMS,4,40,35,5,1
01-04-2025,Household & Cleaning,SURFEXCEL BAR 80G,6,20,20,0,2
01-04-2025,Milk & Dairy,BROWN EGGS 1P,7,168,144,24,12
01-04-2025,"Grains, Flours & Dals",Wheat Flour 1 kg,4,70,60,10,1
01-04-2025,Sweeteners,ACHU BELLAM 1KG,16,100,80,20,1
01-04-2025,"Grains, Flours & Dals",Wheat Rava M 500GM,4,33,30,3,1
01-04-2025,Household & Cleaning,VIM MAHA BAR,6,20,20,0,2
01-04-2025,Snacks & Ready-to-Eat,KURNOOL MARMURA,14,70,55,15,1
01-04-2025,Oils & Ghee,Safflower oil 500 ml,9,220,200,20,1
01-04-2025,"Grains, Flours & Dals",SATHVI BARELY SEEDS 500GMS,4,90,70,20,1
01-04-2025,Oils & Ghee,rice bran oil f,9,194,169,25,1
01-04-2025,"Grains, Flours & Dals",SA WHITE JOWAR RAVA 500GM,4,69,69,0,1
01-04-2025,"Grains, Flours & Dals",Yellow jowar .F1 kg,4,110,100,10,1
01-04-2025,Snacks & Ready-to-Eat,BD KODO MILLET NOODLES 200GM,14,75,75,0,1
01-04-2025,"Grains, Flours & Dals",Multigrain 1 kg,4,100,85,15,1
01-04-2025,Snacks & Ready-to-Eat,VD PAPPU CHEGODI 200GM,14,60,60,0,1
01-04-2025,Pickles & Cooking Pastes,SD MANGO TOKKU,11,110,110,0,1
01-04-2025,Pickles & Cooking Pastes,SD LEMON PICKLE,11,110,110,0,1
01-04-2025,Pickles & Cooking Pastes,SD RED CHILLI PICKLE,11,110,110,0,1
01-04-2025,"Dry Fruits, Nuts & Seeds",Putnalu 250GM,2,45,38,7,1
01-04-2025,Snacks & Ready-to-Eat,VD PAPPU CHEGODI 200GM,14,60,60,0,1
01-04-2025,"Grains, Flours & Dals",THIN POHA 500GM,4,40,35,5,1
01-04-2025,"Grains, Flours & Dals",MAATEJA rice 1 kg,4,360,345,15,5
01-04-2025,Pooja & Spiritual Items,GD Dhoop Sticks 26GM,12,20,20,0,1
01-04-2025,Spices & Seasonings,Menthulu 250 gms,15,50,45,5,1
01-04-2025,Spices & Seasonings,NUVVULU 250GM,15,80,65,15,1
01-04-2025,Oils & Ghee,Coconut oil 500 ml,9,220,200,20,1
01-04-2025,"Grains, Flours & Dals",Wheat Flour 1 kg,4,70,60,10,1
01-04-2025,Spices & Seasonings,Tamarind 250GMS,15,80,65,15,1
01-04-2025,"Grains, Flours & Dals",Sathya Javva Wheat Rava 500GM,4,95,95,0,1
01-04-2025,Oils & Ghee,Safflower oil 1 L,9,440,400,40,1
01-04-2025,Spices & Seasonings,Jeera 100GM,15,50,45,5,1
01-04-2025,"Grains, Flours & Dals",DH URAD GOTA 1KG,4,215,190,25,1
01-04-2025,"Grains, Flours & Dals",turdal 1kg,4,440,340,100,2
01-04-2025,"Grains, Flours & Dals",BOMBAY RAVA,4,70,55,15,1
01-04-2025,Spices & Seasonings,AVALU 100GM,15,25,20,5,1
01-04-2025,Spices & Seasonings,PN ORGANIC PINK SALT 1KG,15,124,124,0,1
01-04-2025,"Dry Fruits, Nuts & Seeds",Groundnuts 1 kg,2,190,165,25,1
01-04-2025,"Grains, Flours & Dals",White Chana 500GM,4,120,100,20,1
01-04-2025,"Dry Fruits, Nuts & Seeds",D kimia,2,310,180,130,1
01-04-2025,"Grains, Flours & Dals",SL Idly Rava 1KG,4,65,55,10,1
01-04-2025,Snacks & Ready-to-Eat,PEANUT CHILLI,14,30,30,0,6
01-04-2025,"Grains, Flours & Dals",BARLEY SEEDS 250GMS,4,40,35,5,1
01-04-2025,"Grains, Flours & Dals",split urad dall 250 gms,4,45,40,5,1
01-04-2025,"Grains, Flours & Dals",KORRALU (FOXTAIL M) 500GM,4,65,55,10,1
01-04-2025,"Grains, Flours & Dals",White jowar.F 500 Gms,4,50,40,10,1
01-04-2025,"Grains, Flours & Dals",Arikalu (kodo),4,70,65,5,1
01-04-2025,Snacks & Ready-to-Eat,SD JOWAR WITH PALM JAGGERY 250GM,14,135,135,0,1
01-04-2025,"Grains, Flours & Dals",UDALU (Barnyard millet) 500 gms,4,70,60,10,1
01-04-2025,"Grains, Flours & Dals",SAMALU (Little millet) 500 gms,4,85,65,20,1
01-04-2025,Milk & Dairy,BROWN EGGS 1P,7,84,72,12,6
01-04-2025,"Grains, Flours & Dals",ANDU KORRALU (Brown top .mlt) 500,4,130,110,20,1
01-04-2025,Sweeteners,YB Brown Sugar 1KG,16,140,140,0,1
01-04-2025,Snacks & Ready-to-Eat,SD FINGER Millet with palm Jaggery 250gm,14,135,135,0,1
01-04-2025,Sweeteners,SD PALM JAGGERY 500GM,16,200,200,0,1
01-04-2025,"Dry Fruits, Nuts & Seeds",SD Mango cubes 200gm,2,90,90,0,1
01-04-2025,Sweeteners,GS A2 Buffalo Ghee 500ML,16,550,550,0,1
01-04-2025,"Grains, Flours & Dals",VYS.SP.RICE BAG 1,4,1800,"1,650.00",150,1
01-04-2025,Oils & Ghee,cow ghee 500 ml,9,430,390,40,1
01-04-2025,"Grains, Flours & Dals",EM Ragi upma R 500g,4,75,75,0,1
01-04-2025,Snacks & Ready-to-Eat,VD Pappu Chekkalu 190gm,14,60,60,0,1
01-04-2025,"Grains, Flours & Dals",Em Foxtail upma r 500 g,4,109,109,0,1
01-04-2025,Snacks & Ready-to-Eat,Pani Poori Chips 250GM,14,50,40,10,1
01-04-2025,"Grains, Flours & Dals",EM kodo upma R 500g,4,129,129,0,1
01-04-2025,Snacks & Ready-to-Eat,GANTASALA GINGER CANDY 200GM,14,105,105,0,1
01-04-2025,"Grains, Flours & Dals",multi mllit umpa ravva,4,129,129,0,1
01-04-2025,Milk & Dairy,BROWN EGGS 1P,7,140,120,20,10
01-04-2025,Snacks & Ready-to-Eat,NGT CHATPATTA CHANA 90GM,14,25,25,0,1
01-04-2025,Oils & Ghee,Coconut oil 500 ml,9,220,200,20,1
01-04-2025,"Grains, Flours & Dals",Em Little idli R 500g,4,129,129,0,1
01-04-2025,"Grains, Flours & Dals",RICE FLOUR 1KG,4,70,55,15,1
01-04-2025,Snacks & Ready-to-Eat,Pani Poori Chips 250GM,14,50,40,10,1
01-04-2025,"Dry Fruits, Nuts & Seeds",WALLNUTS 250GM,2,380,360,20,1
01-04-2025,"Grains, Flours & Dals",Arikalu (kodo),4,70,65,5,1
01-04-2025,"Grains, Flours & Dals",split black gram 1 kg,4,180,170,10,1
01-04-2025,Beverages,REFRESH SHARBATH SUGAR FREE,1,299,285,14,1
01-04-2025,"Grains, Flours & Dals",ANDU KORRALU (Brown top .mlt) 500,4,130,110,20,1
01-04-2025,"Grains, Flours & Dals",UDALU (Barnyard millet) 500 gms,4,70,60,10,1
01-04-2025,"Grains, Flours & Dals",SAMALU (Little millet) 500 gms,4,85,65,20,1
01-04-2025,"Grains, Flours & Dals",Wheat Flour 1 kg,4,70,60,10,1
01-04-2025,Beverages,REFRESH SHARBATH NORMAL,1,199,190,9,1
01-04-2025,General Household & Kitchenware,MATCH BOX,3,20,20,0,1
01-04-2025,Snacks & Ready-to-Eat,GB SALT COOKIES,14,60,55,5,1
01-04-2025,Snacks & Ready-to-Eat,VD MINAPA VADIYAM,14,65,65,0,1
01-04-2025,"Grains, Flours & Dals",JOWAR WHITE 1 KG,4,80,70,10,1
01-04-2025,"Grains, Flours & Dals",VGR rice 1 kg,4,350,325,25,5
01-04-2025,Snacks & Ready-to-Eat,murmura venk,14,50,45,5,1
01-04-2025,Snacks & Ready-to-Eat,SD Atreyapuram DRY Fruit ghee,14,150,150,0,1
01-04-2025,Beverages,BISLERI SODA 750ML,1,20,20,0,1
01-04-2025,"Dry Fruits, Nuts & Seeds",FLAX SEEDS 250GM,2,120,100,20,2
01-04-2025,Spices & Seasonings,Coriander seeds 200 gms,15,48,40,8,1
01-04-2025,"Grains, Flours & Dals",BARLEY SEEDS 250GMS,4,120,105,15,3
01-04-2025,"Dry Fruits, Nuts & Seeds",Groundnuts 500 gms,2,95,85,10,1
01-04-2025,"Grains, Flours & Dals",White jowar.F 1 kg,4,100,80,20,1
01-04-2025,"Grains, Flours & Dals",Idly Rava L 1KG,4,60,50,10,1
01-04-2025,"Dry Fruits, Nuts & Seeds",YELLOW KISHMISH 250GM,2,130,110,20,1
01-04-2025,"Grains, Flours & Dals",maida 500grms,4,35,30,5,1
01-04-2025,Household & Cleaning,ROOPERI PITAMBARI SILVER 50ML,6,110,110,0,1
01-04-2025,Spices & Seasonings,dalchin chekka,15,50,40,10,1
01-04-2025,Pooja & Spiritual Items,GD Ramayana Sandal 75GM,12,60,60,0,1
01-04-2025,"Grains, Flours & Dals",RICE FLOUR 500 GM,4,35,28,7,1
01-04-2025,Baking & Cooking Aids,WEIKFIELD CUSTARD POWDER,0,43,43,0,1
01-04-2025,Spices & Seasonings,Tamarind 250GMS,15,80,65,15,1
01-04-2025,Beverages,redlabel nc teap,1,175,175,0,1
01-04-2025,Spices & Seasonings,Jeera 100GM,15,50,45,5,1
01-04-2025,Snacks & Ready-to-Eat,VD PAPPU CHEGODI 200GM,14,60,60,0,1
01-04-2025,Pooja & Spiritual Items,BALAJI BEL PHOOL STICKS 90GM,12,60,60,0,1
01-04-2025,Snacks & Ready-to-Eat,Sprouted Ragi Biscuits 450GM,14,150,150,0,1
01-04-2025,Oils & Ghee,Safflower oil 1 L,9,880,800,80,2
01-04-2025,Oils & Ghee,Groundnut oil 1 L,9,360,330,30,1
01-04-2025,"Grains, Flours & Dals",SL Idly Rava 1KG,4,65,55,10,1
01-04-2025,"Grains, Flours & Dals",VYS.SP RICE 1 KG,4,350,325,25,5
01-04-2025,"Grains, Flours & Dals",Wheat Flour 1 kg,4,70,60,10,1
01-04-2025,Oils & Ghee,cow ghee 500 ml,9,430,390,40,1
01-04-2025,Oils & Ghee,Safflower oil 1 L,9,440,400,40,1
01-04-2025,Snacks & Ready-to-Eat,RSC ORANGE 100GMS,14,20,20,0,1
01-04-2025,Oils & Ghee,Groundnut oil 1 L,9,360,330,30,1
01-04-2025,"Grains, Flours & Dals",WHEAT 1 KG,4,120,100,20,2
01-04-2025,Snacks & Ready-to-Eat,SD Atreyapuram DRY Fruit ghee,14,150,150,0,1
01-04-2025,Oils & Ghee,Groundnut oil 5 L,9,1800,"1,600.00",200,1
01-04-2025,Spices & Seasonings,Jeera 100GM,15,50,45,5,1
01-04-2025,"Grains, Flours & Dals",VYS.SP RICE 1 KG,4,210,195,15,3
01-04-2025,Oils & Ghee,Sesame oil 1 L,9,1180,"1,120.00",60,2
01-04-2025,Snacks & Ready-to-Eat,VD GUMMADI CHAKKA,14,130,130,0,1
01-04-2025,Spices & Seasonings,AVALU 100GM,15,25,20,5,1
01-04-2025,Spices & Seasonings,Chilli powder 250 gms,15,145,105,40,1
01-04-2025,Snacks & Ready-to-Eat,MB SORGHUM NOODLES 180GM,14,95,95,0,1
01-04-2025,Spices & Seasonings,Vamu 100GM,15,60,50,10,1
01-04-2025,Snacks & Ready-to-Eat,SATHVI REGIVADA 200GM,14,80,60,20,1
01-04-2025,"Grains, Flours & Dals",Wheat Flour 1 kg,4,350,300,50,5
01-04-2025,Snacks & Ready-to-Eat,MB MULTIMILLET NOODLES 180GM,14,95,95,0,1
01-04-2025,Oils & Ghee,Sesame oil 1 L,9,590,560,30,1
01-04-2025,Oils & Ghee,Groundnut oil 1 L,9,360,330,30,1
01-04-2025,Milk & Dairy,HERITAGE TONED MILK 500ML,7,31,31,0,1
01-04-2025,"Grains, Flours & Dals",Chana Flour 500 gms,4,70,65,5,1
01-04-2025,"Grains, Flours & Dals",Idly Rava L 1KG,4,240,200,40,4
01-04-2025,Snacks & Ready-to-Eat,GB SALT COOKIES,14,60,55,5,1
01-04-2025,"Grains, Flours & Dals",Chana Flour 500 gms,4,70,65,5,1
01-04-2025,"Grains, Flours & Dals",RAGI FLOUR 500GRMS,4,40,35,5,1
01-04-2025,Spices & Seasonings,Tamarind 250GMS,15,80,65,15,1
01-04-2025,"Grains, Flours & Dals",Multigrain 1 kg,4,100,85,15,1
01-04-2025,Snacks & Ready-to-Eat,VD NUVULLU CHIKKI,14,80,80,0,1
01-04-2025,"Grains, Flours & Dals",Wheat Flour 1 kg,4,70,60,10,1
01-04-2025,Snacks & Ready-to-Eat,SATHVI REGIVADA 200GM,14,160,120,40,2
01-04-2025,"Grains, Flours & Dals",Yellow jowar .F1 kg,4,110,100,10,1
01-04-2025,"Grains, Flours & Dals",POORI ATTA 500GM,4,70,60,10,2
01-04-2025,Snacks & Ready-to-Eat,GB SALT COOKIES,14,60,55,5,1
01-04-2025,Sweeteners,YB JAGGERY POWDER 1KG,16,140,140,0,1
01-04-2025,"Grains, Flours & Dals",Multigrain 1 kg,4,100,85,15,1
01-04-2025,Oils & Ghee,Groundnut oil 1 L,9,360,330,30,1
01-04-2025,"Grains, Flours & Dals",RAGI FLOUR 1KG,4,80,70,10,1
01-04-2025,"Grains, Flours & Dals",DOCTOR RICE DIABETIC SFR 1KG,4,240,240,0,2
01-04-2025,"Grains, Flours & Dals",Wheat Flour 1 kg,4,70,60,10,1
01-04-2025,Snacks & Ready-to-Eat,NGT CHATPATTA CHANA 90GM,14,75,75,0,3
01-04-2025,"Grains, Flours & Dals",PESARA PAPPU 500GMS,4,85,75,10,1
01-04-2025,Spices & Seasonings,LG 50GM,15,92,92,0,1
01-04-2025,Spices & Seasonings,3M.MIRCHI POWDER,15,145,115,30,1
01-04-2025,Misc,ROLL D C,8,70,45,25,1
01-04-2025,Beverages,redlabel nc teap,1,350,350,0,2
01-04-2025,Spices & Seasonings,GD Turmeric 50GM,15,25,25,0,1
01-04-2025,Spices & Seasonings,Jeera 100GM,15,50,45,5,1
01-04-2025,"Grains, Flours & Dals",Wheat Flour 1 kg,4,210,180,30,3
01-04-2025,Oils & Ghee,cow ghee 500 ml,9,430,390,40,1
01-04-2025,Pooja & Spiritual Items,GD Kumkum 50GM,12,30,30,0,1
01-04-2025,"Grains, Flours & Dals",SRILATHA RICE RAVVA 500GM,4,70,70,0,2
01-04-2025,Spices & Seasonings,Elaichi 25GM,15,145,120,25,1
01-04-2025,"Grains, Flours & Dals",THICK POHA 1KG,4,80,70,10,1
01-04-2025,Baking & Cooking Aids,Baking Soda 50GM,0,20,15,5,1
01-04-2025,"Grains, Flours & Dals",BOMBAY RAVA,4,70,55,15,1
01-04-2025,"Grains, Flours & Dals",turdal 1kg,4,220,170,50,1
01-04-2025,Spices & Seasonings,AVALU 100GM,15,25,20,5,1
01-04-2025,Sweeteners,SUGAR 1KG,16,120,100,20,2
01-04-2025,Snacks & Ready-to-Eat,BB VERMICELLI 1KG,14,95,90,5,1
01-04-2025,"Dry Fruits, Nuts & Seeds",Groundnuts 500 gms,2,95,85,10,1
01-04-2025,Oils & Ghee,Sesame oil 500ml,9,590,560,30,2
01-04-2025,"Grains, Flours & Dals",WHITE BATANI,4,40,30,10,1
01-04-2025,"Grains, Flours & Dals",aishwarya rice,4,450,450,0,1
01-04-2025,"Grains, Flours & Dals",CHANA DAL 500GM,4,70,60,10,1
01-04-2025,Spices & Seasonings,PN ORGANIC PINK SALT 1KG,15,124,124,0,1
01-04-2025,Personal Care & Cosmetics,DETTOL ORIGINAL,10,99,99,0,1
01-04-2025,Spices & Seasonings,Tamarind 500GM,15,160,130,30,1
01-04-2025,Snacks & Ready-to-Eat,VD JAGGERY GHEE 250GM,14,120,120,0,1
01-04-2025,Beverages,BRU GREEN LABEL 1.2G,1,182,182,0,91
01-04-2025,"Grains, Flours & Dals",Urad dall 1 Kg,4,370,340,30,2
01-04-2025,Snacks & Ready-to-Eat,BD KODO MILLET NOODLES 200GM,14,75,75,0,1
01-04-2025,Spices & Seasonings,DB SAFRON,15,180,180,0,1
01-04-2025,"Grains, Flours & Dals",Idly Rava L 1KG,4,120,100,20,2
01-04-2025,Oils & Ghee,rice bran oil f,9,388,338,50,2
01-04-2025,Pooja & Spiritual Items,GD Bhagavatha Mallika 75GM,12,120,120,0,2
01-04-2025,Household & Cleaning,LIZOL 1L,6,246,246,0,1
01-04-2025,Oils & Ghee,Groundnut oil 1 L,9,360,330,30,1
01-04-2025,Sweeteners,SD PALM JAGGERY 500GM,16,200,200,0,1
01-04-2025,"Grains, Flours & Dals",DISANO ROLED OATS,4,395,395,0,1
01-04-2025,Household & Cleaning,VIM EXTRA 110GM,6,40,40,0,4
01-04-2025,"Dry Fruits, Nuts & Seeds",DIANUTS 500GM,2,120,120,0,1
01-04-2025,Spices & Seasonings,Lavangam 50GM,15,60,50,10,1
01-04-2025,"Grains, Flours & Dals",DOCTOR RICE DIABETIC SFR 1KG,4,240,240,0,2
01-04-2025,Milk & Dairy,BROWN EGGS TRAY 30P,7,360,330,30,1
01-04-2025,Oils & Ghee,Groundnut oil 1 L,9,720,660,60,2
01-04-2025,"Health, Wellness & Ayurvedic Products",MD Bringaraj Choornam 100GM,5,80,80,0,1
01-04-2025,"Grains, Flours & Dals",Bombay Rava 500GM,4,35,30,5,1
01-04-2025,Personal Care & Cosmetics,HERBAL BATH POWDER 200GM,10,80,80,0,1
01-04-2025,"Grains, Flours & Dals",Wheat Rava M 500GM,4,33,30,3,1
01-04-2025,Personal Care & Cosmetics,KHADI Amla Bringaraj Shampoo 200ML,10,220,220,0,1
01-04-2025,"Grains, Flours & Dals",nava,4,40,40,0,1
01-04-2025,"Grains, Flours & Dals",Em kodo idli R 500G,4,129,129,0,1
01-04-2025,"Grains, Flours & Dals",HS JOWAR IDLY RAWA,4,65,65,0,1
01-04-2025,Beverages,REFRESH SHARBATH SUGAR FREE,1,299,285,14,1
01-04-2025,"Grains, Flours & Dals",Multigrain 1 kg,4,100,85,15,1
01-04-2025,"Health, Wellness & Ayurvedic Products",MD Bilva Choornam 100GM,5,100,100,0,1
01-04-2025,Spices & Seasonings,BLACK JEERA 50 GM,15,45,30,15,1
01-04-2025,Personal Care & Cosmetics,Soapnut 250GM,10,60,45,15,1
01-04-2025,Snacks & Ready-to-Eat,VD GUMMADI VADIYAM,14,75,75,0,1
01-04-2025,Spices & Seasonings,PRO HIMALAYAN PINK SALT 500GM,15,68,68,0,1
01-04-2025,Oils & Ghee,Safflower oil 500 ml,9,220,200,20,1
01-04-2025,Personal Care & Cosmetics,UVIS LACTO TAN SOAP 100GM,10,99,99,0,1
01-04-2025,Personal Care & Cosmetics,UVIS CHARCOAL SOAP 100GM,10,85,85,0,1
01-04-2025,Personal Care & Cosmetics,MD Henna Choornam 100GM,10,80,80,0,1
01-04-2025,"Dry Fruits, Nuts & Seeds",Groundnuts 1 kg,2,380,330,50,2
01-04-2025,"Grains, Flours & Dals",RAGI FLOUR 1KG,4,160,140,20,2
31-03-2025,Oils & Ghee,Groundnut oil 500ml,9,180,165,15,1
31-03-2025,Oils & Ghee,Sesame oil 500ml,9,295,280,15,1
31-03-2025,Snacks & Ready-to-Eat,RSC ORANGE 100GMS,14,20,20,0,1
31-03-2025,Personal Care & Cosmetics,HERBAL BATH POWDER,10,160,160,0,1
31-03-2025,Snacks & Ready-to-Eat,Sprouted Ragi Biscuits 450GM,14,150,150,0,1
31-03-2025,Snacks & Ready-to-Eat,ELITE ELAICHI RUSK 200GM,14,35,35,0,1
31-03-2025,"Grains, Flours & Dals",Wheat Flour 1 kg,4,70,60,10,1
31-03-2025,Oils & Ghee,Coconut oil 500 ml,9,220,200,20,1
31-03-2025,"Grains, Flours & Dals",White Chana 250 GM,4,60,50,10,1
31-03-2025,"Grains, Flours & Dals",split green gram 500 gms,4,75,70,5,1
31-03-2025,Snacks & Ready-to-Eat,SATHVI REGIVADA 200GM,14,80,60,20,1
31-03-2025,"Grains, Flours & Dals",VYS.SP RICE 1 KG,4,700,650,50,10
31-03-2025,Snacks & Ready-to-Eat,ELITE MILK RUSK 200GM,14,35,35,0,1
31-03-2025,Oils & Ghee,cow ghee 500 ml,9,430,390,40,1
31-03-2025,Snacks & Ready-to-Eat,Corn Chips 250GM,14,80,70,10,2
31-03-2025,General Household & Kitchenware,SABEENA,3,15,15,0,1
31-03-2025,Spices & Seasonings,PRO HIMALAYAN PINK SALT 500GM,15,68,68,0,1
31-03-2025,Snacks & Ready-to-Eat,PN ORGANIC PUFFED RICE 200GM,14,55,55,0,1
31-03-2025,Snacks & Ready-to-Eat,ID CHAPATI,14,79,79,0,1
31-03-2025,"Grains, Flours & Dals",DH URAD GOTA 1KG,4,215,190,25,1
31-03-2025,Pooja & Spiritual Items,BALAJI BEL PHOOL STICKS 90GM,12,60,60,0,1
31-03-2025,"Grains, Flours & Dals",URAD DALL,4,95,85,10,1
31-03-2025,Oils & Ghee,Safflower oil 1 L,9,440,400,40,1
31-03-2025,Oils & Ghee,Groundnut oil 1 L,9,720,660,60,2
31-03-2025,"Grains, Flours & Dals",RAGI FLOUR 1KG,4,80,70,10,1
31-03-2025,Personal Care & Cosmetics,HERBAL BATH POWDER 200GM,10,80,80,0,1
31-03-2025,"Grains, Flours & Dals",RICE FLOUR 500 GM,4,35,28,7,1
31-03-2025,Snacks & Ready-to-Eat,SD Bajra with palm Jaggery 250gm,14,135,135,0,1
31-03-2025,"Grains, Flours & Dals",Multigrain 1 kg,4,100,85,15,1
31-03-2025,"Grains, Flours & Dals",BOMBAY RAVA,4,70,55,15,1
31-03-2025,"Grains, Flours & Dals",Wheat Flour 1 kg,4,70,60,10,1
31-03-2025,Oils & Ghee,Coconut oil 500 ml,9,220,200,20,1
31-03-2025,Spices & Seasonings,PN ORGANIC PINK SALT 1KG,15,124,124,0,1
31-03-2025,Snacks & Ready-to-Eat,SD Atreyapuram DRY Fruit ghee,14,150,150,0,1
31-03-2025,Oils & Ghee,A2 BUFFALO GHEE 250ML,9,299,299,0,1
31-03-2025,Snacks & Ready-to-Eat,VD NUVULU CHEGODI 175GM,14,60,60,0,1
31-03-2025,Misc,VD00014,8,100,90,10,1
31-03-2025,Oils & Ghee,Coconut oil 1 L,9,440,400,40,1
31-03-2025,"Grains, Flours & Dals",AISHWARYA SP 1KG,4,240,210,30,3
31-03-2025,"Grains, Flours & Dals",BASMATHI RICE 1KG,4,150,135,15,1
31-03-2025,Spices & Seasonings,Japatri 25GM,15,100,80,20,1
31-03-2025,"Dry Fruits, Nuts & Seeds",Groundnuts 1 kg,2,380,330,50,2
31-03-2025,"Grains, Flours & Dals",MULTIMILLET IDLY RAVVA,4,260,260,0,4
31-03-2025,"Grains, Flours & Dals",split black gram 1 kg,4,360,340,20,2
31-03-2025,Oils & Ghee,Coconut oil 1 L,9,440,400,40,1
31-03-2025,"Grains, Flours & Dals",RAGULU 1 KG,4,70,60,10,1
31-03-2025,Sweeteners,YB Brown Sugar 1KG,16,140,140,0,1
31-03-2025,Sweeteners,ACHU BELLAM 1KG,16,200,160,40,2
31-03-2025,Beverages,BISLERI 100ml,1,10,10,0,1
31-03-2025,Pooja & Spiritual Items,PACHAKARPURAM,12,60,50,10,1
31-03-2025,"Dry Fruits, Nuts & Seeds",FLAX SEEDS 250GM,2,60,50,10,1
31-03-2025,Snacks & Ready-to-Eat,Popcorn Seeds 250GM,14,45,40,5,1
31-03-2025,General Household & Kitchenware,SIRIDHANYALU BOOK,3,200,180,20,1
31-03-2025,"Grains, Flours & Dals",AISHWARYA SP 1KG,4,400,350,50,5
31-03-2025,Spices & Seasonings,Miriyalu 50GM,15,100,80,20,1
31-03-2025,"Health, Wellness & Ayurvedic Products",RB Max Protein Spanish Tomato,5,45,45,0,1
31-03-2025,"Health, Wellness & Ayurvedic Products",RB Max Protein Cheese&amp;,5,45,45,0,1
31-03-2025,Oils & Ghee,Coconut oil 1 L,9,440,400,40,1
31-03-2025,"Dry Fruits, Nuts & Seeds",WALLNUTS 250GM,2,380,360,20,1
31-03-2025,"Grains, Flours & Dals",Wheat Rava M 1KG,4,65,55,10,1
31-03-2025,Oils & Ghee,Groundnut oil 1 L,9,1080,990,90,3
31-03-2025,"Dry Fruits, Nuts & Seeds",cashew,2,340,310,30,1
31-03-2025,"Grains, Flours & Dals",SL Idly Rava 1KG,4,65,55,10,1
31-03-2025,Sweeteners,YB JAGGERY POWDER 500GMS,16,75,75,0,1
31-03-2025,"Dry Fruits, Nuts & Seeds",SALTED PISTA 250GM,2,400,350,50,1
31-03-2025,"Grains, Flours & Dals",RAGI FLOUR 500GRMS,4,40,35,5,1
31-03-2025,"Grains, Flours & Dals",Wheat Rava S 1KG,4,65,55,10,1
31-03-2025,Snacks & Ready-to-Eat,NGT CHATPATTA CHANA 90GM,14,25,25,0,1
31-03-2025,Spices & Seasonings,Jeera 100GM,15,50,45,5,1
31-03-2025,"Grains, Flours & Dals",Chana Flour 500 gms,4,70,65,5,1
31-03-2025,"Dry Fruits, Nuts & Seeds",PULMAKHANA 100 GM,2,180,170,10,1
31-03-2025,"Grains, Flours & Dals",turdal 500 gms,4,220,170,50,2
31-03-2025,"Grains, Flours & Dals",Urad dall 1 Kg,4,185,170,15,1
31-03-2025,"Dry Fruits, Nuts & Seeds",Groundnuts 500 gms,2,95,85,10,1
31-03-2025,Sweeteners,SUGAR 500 GM,16,30,25,5,1
31-03-2025,"Grains, Flours & Dals",Green gram 1 kg,4,150,130,20,1
31-03-2025,Spices & Seasonings,AVALU 100GM,15,25,20,5,1
31-03-2025,"Grains, Flours & Dals",Chana Flour 500 gms,4,70,65,5,1
31-03-2025,"Grains, Flours & Dals",RICE FLOUR 500 GM,4,35,28,7,1
31-03-2025,Oils & Ghee,Groundnut oil 1 L,9,360,330,30,1
31-03-2025,Oils & Ghee,Safflower oil 1 L,9,440,400,40,1
31-03-2025,"Grains, Flours & Dals",HS JOWAR IDLY RAWA,4,65,65,0,1
31-03-2025,Snacks & Ready-to-Eat,NGT CHATPATTA CHANA 90GM,14,50,50,0,2
31-03-2025,"Grains, Flours & Dals",UNPOLISHED TURDALL 1KG,4,240,210,30,1
31-03-2025,"Grains, Flours & Dals",turdal 1kg,4,220,170,50,1
31-03-2025,"Grains, Flours & Dals",Wheat Flour 1 kg,4,350,300,50,5
31-03-2025,Snacks & Ready-to-Eat,NGT CHATPATTA CHANA 90GM,14,25,25,0,1
31-03-2025,Snacks & Ready-to-Eat,VD DASA DINUSULU,14,199,199,0,1
31-03-2025,General Household & Kitchenware,CLAY JUG J1,3,265,265,0,1
31-03-2025,"Grains, Flours & Dals",White jowar.F 1 kg,4,400,320,80,4
31-03-2025,"Grains, Flours & Dals",Bajra Flour 1 kg,4,70,60,10,1
31-03-2025,"Grains, Flours & Dals",RAGI FLOUR 1KG,4,160,140,20,2
31-03-2025,"Grains, Flours & Dals",Chana Flour 1 kg,4,280,260,20,2
31-03-2025,"Grains, Flours & Dals",RICE FLOUR 1KG,4,70,55,15,1
31-03-2025,Milk & Dairy,BROWN EGGS 1P,7,56,48,8,4
31-03-2025,"Grains, Flours & Dals",SABDANA,4,40,35,5,1
31-03-2025,Snacks & Ready-to-Eat,BB VERMICELLY 500GM,14,53,53,0,1
31-03-2025,Snacks & Ready-to-Eat,GREEN FRIED batana,14,60,60,0,3
31-03-2025,"Dry Fruits, Nuts & Seeds",sabja seeds,2,80,70,10,1
31-03-2025,Personal Care & Cosmetics,MYSORE SANDAL BABY SOAP,10,90,90,0,2
31-03-2025,Sweeteners,YB Palm Jaggery 250GM,16,200,200,0,1
31-03-2025,Oils & Ghee,Sesame oil 1 L,9,1180,"1,120.00",60,2
31-03-2025,"Grains, Flours & Dals",Wheat Flour 1 kg,4,210,180,30,3
31-03-2025,Baking & Cooking Aids,GONDKATIRA Ag,0,85,75,10,1
31-03-2025,"Dry Fruits, Nuts & Seeds",SATHVI CHIA SEEDS 100GM,2,100,80,20,1
31-03-2025,Oils & Ghee,Groundnut oil 1 L,9,720,660,60,2
31-03-2025,Snacks & Ready-to-Eat,SESAME CHIKKI,14,120,100,20,1
31-03-2025,Oils & Ghee,Groundnut oil 1 L,9,360,330,30,1
31-03-2025,"Dry Fruits, Nuts & Seeds",YB GRANMA NUTS,2,90,90,0,1
31-03-2025,Snacks & Ready-to-Eat,VD DASA DINUSULU,14,199,199,0,1
31-03-2025,Oils & Ghee,Flaxseed oil 500 ml,9,300,270,30,1
31-03-2025,Oils & Ghee,Groundnut oil 500ml,9,180,165,15,1
31-03-2025,Oils & Ghee,Safflower oil 500 ml,9,220,200,20,1
31-03-2025,Oils & Ghee,Sesame oil 500ml,9,295,280,15,1
31-03-2025,Spices & Seasonings,Turmeric powder 250 gms,15,100,75,25,1
31-03-2025,"Grains, Flours & Dals",BLACK GRAM 1KG,4,150,140,10,1
31-03-2025,Spices & Seasonings,DB SAFRON,15,180,180,0,1
31-03-2025,Spices & Seasonings,Chilli powder 500 gms,15,290,210,80,1
31-03-2025,Oils & Ghee,Coconut oil 1 L,9,440,400,40,1
31-03-2025,"Health, Wellness & Ayurvedic Products",RB FRUITS &amp;seeds Cranberries,5,45,45,0,1
31-03-2025,"Health, Wellness & Ayurvedic Products",RB Max Protein Choco chips 55gm,5,100,100,0,2
31-03-2025,Spices & Seasonings,Chilli powder 500 gms,15,290,210,80,1
31-03-2025,Spices & Seasonings,GS GARLIC KARAM 100GM,15,75,75,0,1
31-03-2025,Milk & Dairy,HERITAGE TOTAL CURD 500GM,7,50,50,0,1
31-03-2025,Milk & Dairy,HERITAGE BUTTERMILK,7,20,20,0,2
31-03-2025,"Grains, Flours & Dals",RICE FLOUR 1KG,4,280,220,60,4
31-03-2025,Personal Care & Cosmetics,COW DURBAR 7 HERBS SHAMPOO,10,250,250,0,2
31-03-2025,Sweeteners,SUGAR 1KG,16,60,50,10,1
31-03-2025,Household & Cleaning,VIM SOAP,6,10,10,0,2
31-03-2025,Spices & Seasonings,Tamarind 500GM,15,160,130,30,1
31-03-2025,"Grains, Flours & Dals",PESARA PAPPU 500GMS,4,85,75,10,1
31-03-2025,Milk & Dairy,HRITAGE TOTAL CURD 130GM,7,20,20,0,2
31-03-2025,"Grains, Flours & Dals",KORRALU (FOXTAIL M) 1KG,4,300,220,80,2
31-03-2025,"Grains, Flours & Dals",JOWAR WHITE 1 KG,4,160,140,20,2
31-03-2025,"Dry Fruits, Nuts & Seeds",PULMAKHANA 100 GM,2,180,170,10,1
31-03-2025,"Grains, Flours & Dals",EM Foxtail idli r 500 g,4,109,109,0,1
31-03-2025,"Grains, Flours & Dals",RED TURDAL 500GM,4,75,70,5,1
31-03-2025,"Dry Fruits, Nuts & Seeds",ANJEER 250GM,2,400,360,40,1
31-03-2025,"Grains, Flours & Dals",Em kodo idli R 500G,4,129,129,0,1
31-03-2025,Pooja & Spiritual Items,KASHI ASHTAGANDHA CHANDHANA,12,20,20,0,1
31-03-2025,Oils & Ghee,Black Sesame oil 1 L,9,440,380,60,1
31-03-2025,Oils & Ghee,Coconut oil 1 L,9,440,400,40,1
31-03-2025,Oils & Ghee,cow ghee 500 ml,9,430,390,40,1
31-03-2025,Sweeteners,YB JAGGERY POWDER 500GMS,16,75,75,0,1
31-03-2025,"Grains, Flours & Dals",RAGI FLOUR 500GRMS,4,40,35,5,1
31-03-2025,Snacks & Ready-to-Eat,SD Bajra with palm Jaggery 250gm,14,135,135,0,1
31-03-2025,Snacks & Ready-to-Eat,PEANUT CHILLI,14,35,35,0,7
31-03-2025,Spices & Seasonings,coconut powder,15,90,70,20,1
31-03-2025,"Grains, Flours & Dals",RICE FLOUR 500 GM,4,35,28,7,1
31-03-2025,"Grains, Flours & Dals",RAGI FLOUR 500GRMS,4,40,35,5,1
31-03-2025,Spices & Seasonings,Telaga Pindi 250 GM,15,40,35,5,1
31-03-2025,Spices & Seasonings,Chilli powder 500 gms,15,290,210,80,1
31-03-2025,"Grains, Flours & Dals",Wheat Flour 1 kg,4,140,120,20,2
31-03-2025,Snacks & Ready-to-Eat,Pani Poori Chips 250GM,14,50,40,10,1
31-03-2025,Oils & Ghee,Sesame oil 500ml,9,295,280,15,1
31-03-2025,Snacks & Ready-to-Eat,RAJGIRA PEANUT CHIKKI 450GM,14,125,125,0,1
31-03-2025,Snacks & Ready-to-Eat,GREEN FRIED batana,14,40,40,0,2
31-03-2025,General Household & Kitchenware,MATCH BOX,3,20,20,0,1
31-03-2025,"Grains, Flours & Dals",Hs yellow jowar r 500g,4,198,198,0,2
31-03-2025,"Grains, Flours & Dals",Wheat Rava M 1KG,4,65,55,10,1
31-03-2025,General Household & Kitchenware,SABEENA,3,15,15,0,1
31-03-2025,"Grains, Flours & Dals",Multigrain 1 kg,4,200,170,30,2
31-03-2025,Snacks & Ready-to-Eat,SD Flax seeds with dates 250gm,14,135,135,0,1
31-03-2025,Misc,VD00014,8,100,90,10,1
31-03-2025,Snacks & Ready-to-Eat,VD SAGOPAPAD 150GM,14,55,55,0,1
31-03-2025,Snacks & Ready-to-Eat,DOSA BATTER 1KG,14,60,60,0,1
31-03-2025,Snacks & Ready-to-Eat,SD MASALA GAVVALU 200GM,14,95,95,0,1
31-03-2025,"Dry Fruits, Nuts & Seeds",SD Mango cubes 200gm,2,90,90,0,1
31-03-2025,Snacks & Ready-to-Eat,BATANA NGT 70GMS,14,60,60,0,3
31-03-2025,Beverages,REFRESH SHARBATH NORMAL,1,199,190,9,1
31-03-2025,Pooja & Spiritual Items,GD Sree Chandan 50GM,12,100,100,0,2
31-03-2025,Household & Cleaning,ROOPERI PITAMBARI SILVER 50ML,6,220,220,0,2
31-03-2025,Oils & Ghee,Groundnut oil 500ml,9,180,165,15,1
31-03-2025,"Grains, Flours & Dals",SRILATHA RICE RAVVA 500GM,4,35,35,0,1
31-03-2025,Snacks & Ready-to-Eat,JUNNU POWDER 100GM,14,280,280,0,4
31-03-2025,Spices & Seasonings,NUVVULU 250GM,15,80,65,15,1
31-03-2025,"Grains, Flours & Dals",CHANA DAL 500GM,4,70,60,10,1
31-03-2025,Oils & Ghee,Sesame oil 500ml,9,295,280,15,1
31-03-2025,"Health, Wellness & Ayurvedic Products",GS Wheat Grass Powder 100GMS,5,349,349,0,1
31-03-2025,Oils & Ghee,Groundnut oil 1 L,9,1080,990,90,3
31-03-2025,Oils & Ghee,Groundnut oil 1 L,9,360,330,30,1
31-03-2025,Oils & Ghee,Sesame oil 1 L,9,590,560,30,1
31-03-2025,"Grains, Flours & Dals",CHANA DAL 500GM,4,70,60,10,1
31-03-2025,Sweeteners,SUGAR 1KG,16,120,100,20,2
31-03-2025,Snacks & Ready-to-Eat,BB VERMICELLI 1KG,14,95,90,5,1
31-03-2025,"Grains, Flours & Dals",POORI ATTA 1KG,4,70,60,10,1
31-03-2025,"Dry Fruits, Nuts & Seeds",YELLOW KISHMISH 250GM,2,260,220,40,2
31-03-2025,"Grains, Flours & Dals",Idly Rava L 1KG,4,120,100,20,2
31-03-2025,"Grains, Flours & Dals",MELMEKER 250GMS,4,60,45,15,1
31-03-2025,Oils & Ghee,rice bran oil f,9,194,169,25,1
31-03-2025,"Dry Fruits, Nuts & Seeds",cashew,2,680,620,60,2
31-03-2025,Personal Care & Cosmetics,SANTOOR,10,120,100,20,1
31-03-2025,Pooja & Spiritual Items,BALAJI KEWDA STICKS 220GM,12,150,150,0,1
31-03-2025,Household & Cleaning,VIM MAHA BAR,6,30,30,0,3
31-03-2025,"Dry Fruits, Nuts & Seeds",DRYDATES YELLOW 250GM,2,270,240,30,2
31-03-2025,"Grains, Flours & Dals",Bombay Rava 500GM,4,35,30,5,1
31-03-2025,Snacks & Ready-to-Eat,cereal,14,299,299,0,1
31-03-2025,"Grains, Flours & Dals",Green gram 500 gms,4,75,70,5,1
31-03-2025,"Grains, Flours & Dals",CHANA DAL 500GM,4,70,60,10,1
31-03-2025,"Grains, Flours & Dals",Idly Rava L 1KG,4,60,50,10,1
31-03-2025,Spices & Seasonings,Tamarind 250GMS,15,80,65,15,1
31-03-2025,Milk & Dairy,HRITAGE TOTAL CURD 130GM,7,10,10,0,1
31-03-2025,Oils & Ghee,Groundnut oil 1 L,9,360,330,30,1
31-03-2025,Milk & Dairy,BROWN EGGS TRAY 30P,7,360,330,30,1
31-03-2025,"Grains, Flours & Dals",KORRALU (FOXTAIL M) 1KG,4,300,220,80,2
31-03-2025,Snacks & Ready-to-Eat,SH PUFFED RICE 500GM,14,112,112,0,1
31-03-2025,"Grains, Flours & Dals",JOWAR YELLOW 1 K,4,100,90,10,1
31-03-2025,Snacks & Ready-to-Eat,SF NOODLES CLKASSIC MASALA,14,516,516,0,4
31-03-2025,"Dry Fruits, Nuts & Seeds",SD Mango cubes 100gm,2,45,45,0,1
31-03-2025,"Grains, Flours & Dals",CHANA DAL 500GM,4,70,60,10,1
31-03-2025,"Grains, Flours & Dals",Chana Flour 500 gms,4,140,130,10,2
31-03-2025,"Grains, Flours & Dals",SRILALITHA MAIDA FLOUR 500G,4,64,64,0,2
31-03-2025,"Dry Fruits, Nuts & Seeds",Groundnuts 500 gms,2,95,85,10,1
31-03-2025,"Grains, Flours & Dals",THICK POHA 500GM,4,40,35,5,1
31-03-2025,"Grains, Flours & Dals",turdal 1kg,4,220,170,50,1
31-03-2025,Oils & Ghee,mustard oil,9,195,195,0,1
31-03-2025,"Grains, Flours & Dals",PESARA PAPPU 500GMS,4,85,75,10,1
31-03-2025,Snacks & Ready-to-Eat,NGT CHATPATTA CHANA 90GM,14,25,25,0,1
31-03-2025,"Grains, Flours & Dals",Multigrain 1 kg,4,100,85,15,1
31-03-2025,"Grains, Flours & Dals",Bombay Rava 500GM,4,35,30,5,1
31-03-2025,Oils & Ghee,Groundnut oil 1 L,9,1080,990,90,3
31-03-2025,"Grains, Flours & Dals",CHANA DAL 1KG,4,140,120,20,1
31-03-2025,Spices & Seasonings,Coriander seeds 200 gms,15,48,40,8,1
31-03-2025,"Grains, Flours & Dals",SPLIT BLACK GRAM 500 GM,4,90,85,5,1
31-03-2025,Spices & Seasonings,Vamu 100GM,15,120,100,20,2
31-03-2025,Spices & Seasonings,Jeera 100GM,15,50,45,5,1
31-03-2025,"Grains, Flours & Dals",SABDANA 500GM,4,90,70,20,1
31-03-2025,"Grains, Flours & Dals",BOMBAY RAVA,4,70,55,15,1
31-03-2025,"Grains, Flours & Dals",Green gram 500 gms,4,75,70,5,1
31-03-2025,Snacks & Ready-to-Eat,SATHVI REGIVADA 200GM,14,80,60,20,1
31-03-2025,Oils & Ghee,Sesame oil 1 L,9,590,560,30,1
31-03-2025,Oils & Ghee,Groundnut oil 1 L,9,720,660,60,2
31-03-2025,Spices & Seasonings,DURGA SALT CRYSTAL 1KG,15,25,25,0,1
31-03-2025,Snacks & Ready-to-Eat,DINNER PAPAD,14,80,80,0,1
31-03-2025,Snacks & Ready-to-Eat,RSC ORANGE 100GMS,14,20,20,0,1
31-03-2025,"Health, Wellness & Ayurvedic Products",RB Max Protein PERI PERI 60gm,5,45,45,0,1
31-03-2025,"Grains, Flours & Dals",Multigrain 1 kg,4,300,255,45,3
31-03-2025,Oils & Ghee,Sesame oil 1 L,9,1180,"1,120.00",60,2
31-03-2025,"Grains, Flours & Dals",VYS.SP.RICE BAG 1,4,1800,"1,650.00",150,1
31-03-2025,"Grains, Flours & Dals",UNPOLISHED TURDALL 1KG,4,240,210,30,1
31-03-2025,Personal Care & Cosmetics,MADDI HIBISCUS HAIR SHAMPOO 500ML,10,300,300,0,1
31-03-2025,Snacks & Ready-to-Eat,RSC ORANGE 100GMS,14,20,20,0,1
31-03-2025,"Grains, Flours & Dals",PESARA PAPPU 1 KG,4,170,145,25,1
31-03-2025,Spices & Seasonings,SWEET SOUNF,15,60,60,0,3
31-03-2025,Snacks & Ready-to-Eat,VD PALLI CHIKKI,14,80,80,0,1
31-03-2025,Oils & Ghee,Castor oil 200 ml,9,200,160,40,2
31-03-2025,"Grains, Flours & Dals",RICE FLOUR 500 GM,4,35,28,7,1
31-03-2025,Spices & Seasonings,NUVVULU 500GM,15,200,170,30,1
31-03-2025,Snacks & Ready-to-Eat,VD NUVULU CHEGODI 175GM,14,60,60,0,1
31-03-2025,Snacks & Ready-to-Eat,VD MULTI CHAKKA,14,110,110,0,1
31-03-2025,"Grains, Flours & Dals",SAMALU (Little millet) 500 gms,4,85,65,20,1
31-03-2025,Snacks & Ready-to-Eat,VD PALLI CHIKKI,14,80,80,0,1
31-03-2025,Snacks & Ready-to-Eat,GB SALT COOKIES,14,60,55,5,1
31-03-2025,Sweeteners,ACHU BELLAM 1KG,16,100,80,20,1
31-03-2025,Oils & Ghee,Groundnut oil 1 L,9,360,330,30,1
31-03-2025,Snacks & Ready-to-Eat,BB VERMICELLY 500GM,14,53,53,0,1
31-03-2025,Oils & Ghee,Sesame oil 500ml,9,295,280,15,1
31-03-2025,"Grains, Flours & Dals",SRILATHA RICE RAVVA 500GM,4,35,35,0,1
31-03-2025,"Health, Wellness & Ayurvedic Products",MD Satavari Choornam 50GM,5,90,90,0,1
31-03-2025,Oils & Ghee,Safflower oil 1 L,9,440,400,40,1
31-03-2025,"Grains, Flours & Dals",PESARA PAPPU 500GMS,4,85,75,10,1
31-03-2025,"Grains, Flours & Dals",Multigrain 1 kg,4,100,85,15,1
31-03-2025,Snacks & Ready-to-Eat,Corn Chips 250GM,14,40,35,5,1
31-03-2025,"Grains, Flours & Dals",SAMALU (Little millet) 500 gms,4,85,65,20,1
31-03-2025,Beverages,REFRESH SHARBATH SUGAR FREE,1,299,285,14,1
31-03-2025,"Grains, Flours & Dals",VGR RICE bag 1,4,1899,"1,650.00",249,1
31-03-2025,"Grains, Flours & Dals",UDALU (Barnyard millet) 1 kg,4,140,115,25,1
31-03-2025,Oils & Ghee,Groundnut oil 500ml,9,180,165,15,1
31-03-2025,Snacks & Ready-to-Eat,RINGS 200GM,14,30,30,0,1
31-03-2025,"Dry Fruits, Nuts & Seeds",Groundnuts 500 gms,2,95,85,10,1
31-03-2025,"Grains, Flours & Dals",KORRALU (FOXTAIL M) 500GM,4,65,55,10,1
31-03-2025,Snacks & Ready-to-Eat,VD MINAPA VADIYAM,14,65,65,0,1
31-03-2025,"Grains, Flours & Dals",Urad dall 1 Kg,4,185,170,15,1
31-03-2025,"Dry Fruits, Nuts & Seeds",sabja seeds,2,80,70,10,1
31-03-2025,"Grains, Flours & Dals",White jowar.F 1 kg,4,100,80,20,1
31-03-2025,Snacks & Ready-to-Eat,RAJGIRA PEANUT CHIKKI 450GM,14,125,125,0,1
31-03-2025,"Dry Fruits, Nuts & Seeds",SD Mango cubes 100gm,2,45,45,0,1
31-03-2025,"Grains, Flours & Dals",SA WHITE JOWAR RAVA 500GM,4,69,69,0,1
31-03-2025,"Grains, Flours & Dals",Chittimuthaylu rice 1 kg,4,320,280,40,2
31-03-2025,"Grains, Flours & Dals",Chana Flour 500 gms,4,70,65,5,1
31-03-2025,"Grains, Flours & Dals",HS JOWAR IDLY RAWA,4,65,65,0,1
31-03-2025,"Grains, Flours & Dals",Wheat Flour 1 kg,4,280,240,40,4
31-03-2025,"Grains, Flours & Dals",SRILATHA RICE RAVVA 500GM,4,35,35,0,1
31-03-2025,"Grains, Flours & Dals",VYS.SP.RICE BAG 1,4,1800,"1,650.00",150,1
31-03-2025,Oils & Ghee,Safflower oil 500 ml,9,220,200,20,1
31-03-2025,Oils & Ghee,Sesame oil 500ml,9,295,280,15,1
31-03-2025,"Grains, Flours & Dals",Urad dall 1 Kg,4,185,170,15,1
31-03-2025,"Grains, Flours & Dals",Quinova 500 gms,4,220,200,20,2
31-03-2025,"Dry Fruits, Nuts & Seeds",BLACK KISMIS 250GM,2,175,140,35,1
31-03-2025,"Grains, Flours & Dals",Urad dall 1 Kg,4,370,340,30,2
31-03-2025,"Grains, Flours & Dals",VGR rice 1 kg,4,140,130,10,2
31-03-2025,"Grains, Flours & Dals",idly/Dosa rice 1 kg,4,140,120,20,2
31-03-2025,"Grains, Flours & Dals",Quinova 500 gms,4,220,200,20,2
31-03-2025,Pooja & Spiritual Items,SWASTIK CAMPHORE,12,180,180,0,2
31-03-2025,"Health, Wellness & Ayurvedic Products",RB Max Protein PERI PERI 60gm,5,45,45,0,1
31-03-2025,"Dry Fruits, Nuts & Seeds",YELLOW KISHMISH 250GM,2,130,110,20,1
31-03-2025,Pooja & Spiritual Items,divya deeparadhana oil,12,190,190,0,1
31-03-2025,Sweeteners,SUGAR 1KG,16,120,100,20,2
31-03-2025,Pooja & Spiritual Items,GD JASMINE 75GM,12,60,60,0,1
31-03-2025,Spices & Seasonings,DRY MIECHI 200GM,15,80,60,20,1
31-03-2025,Pooja & Spiritual Items,GB Bharatha Woods 75GM,12,60,60,0,1
31-03-2025,Spices & Seasonings,Menthulu 250 gms,15,50,45,5,1
31-03-2025,Spices & Seasonings,PN ORGANIC PINK SALT 1KG,15,124,124,0,1
31-03-2025,"Dry Fruits, Nuts & Seeds",WALLNUTS 250GM,2,380,360,20,1
31-03-2025,"Grains, Flours & Dals",PESARA PAPPU 1 KG,4,170,145,25,1
31-03-2025,Pooja & Spiritual Items,GD TULASI 75GM,12,60,60,0,1
31-03-2025,Spices & Seasonings,Coriander seeds 200 gms,15,48,40,8,1
31-03-2025,Personal Care & Cosmetics,MYSORE SANDAL SOAP 75G,10,126,126,0,3
31-03-2025,Pooja & Spiritual Items,bilwa patra,12,60,60,0,1
31-03-2025,Snacks & Ready-to-Eat,BB VERMICELLY 500GM,14,53,53,0,1
31-03-2025,Spices & Seasonings,PRO HIMALAYAN PINK SALT 500GM,15,68,68,0,1
31-03-2025,Spices & Seasonings,Tamarind 250GMS,15,160,130,30,2
31-03-2025,"Dry Fruits, Nuts & Seeds",PLAIN PISTA 250GM,2,660,550,110,1
31-03-2025,"Grains, Flours & Dals",SRILATHA RICE RAVVA 500GM,4,70,70,0,2
31-03-2025,"Dry Fruits, Nuts & Seeds",SUNFLOWER SEEDS 250GRM,2,150,130,20,1
31-03-2025,"Grains, Flours & Dals",THICK POHA 1KG,4,80,70,10,1
31-03-2025,"Grains, Flours & Dals",VYS.SP.RICE BAG 1,4,1800,"1,650.00",150,1
31-03-2025,"Grains, Flours & Dals",RAGI FLOUR 500GRMS,4,80,70,10,2
31-03-2025,"Dry Fruits, Nuts & Seeds",SALTED PISTA 250GM,2,400,350,50,1
31-03-2025,"Dry Fruits, Nuts & Seeds",ANJEER 250GM,2,400,360,40,1
31-03-2025,"Dry Fruits, Nuts & Seeds",SATHVI CHIA SEEDS 100GM,2,100,80,20,1
31-03-2025,"Health, Wellness & Ayurvedic Products",RB Max Protein Cheese&amp;,5,45,45,0,1
31-03-2025,"Grains, Flours & Dals",Wheat Flour 1 kg,4,140,120,20,2
31-03-2025,"Grains, Flours & Dals",turdal 1kg,4,220,170,50,1
31-03-2025,"Dry Fruits, Nuts & Seeds",ALMONDS 250GM,2,280,260,20,1
31-03-2025,Pooja & Spiritual Items,GD Bhagavatha Mallika 75GM,12,60,60,0,1
31-03-2025,Pooja & Spiritual Items,GD Kailash 60 GM,12,60,60,0,1
31-03-2025,Personal Care & Cosmetics,GOW DURBAR 75G,10,60,60,0,1
31-03-2025,"Dry Fruits, Nuts & Seeds",D kimia,2,620,360,260,2
31-03-2025,"Grains, Flours & Dals",SAMALU,4,170,130,40,1
31-03-2025,"Dry Fruits, Nuts & Seeds",FLAX SEEDS 250GM,2,60,50,10,1
31-03-2025,"Grains, Flours & Dals",CHANA DAL 1KG,4,140,120,20,1
31-03-2025,Snacks & Ready-to-Eat,MAAGAANI M JOWAR PASTA 200GM,14,199,199,0,1
31-03-2025,Sweeteners,MISHRI D,16,40,30,10,1
31-03-2025,"Dry Fruits, Nuts & Seeds",cashew,2,680,620,60,2
31-03-2025,"Dry Fruits, Nuts & Seeds",ALMONDS 250GM,2,560,520,40,2
31-03-2025,"Grains, Flours & Dals",RAGI FLOUR 1KG,4,80,70,10,1
31-03-2025,Sweeteners,ACHU BELLAM 1KG,16,200,160,40,2
31-03-2025,"Grains, Flours & Dals",SL Idly Rava 1KG,4,195,165,30,3
31-03-2025,"Grains, Flours & Dals",Wheat Rava M 500GM,4,33,30,3,1
31-03-2025,Spices & Seasonings,AV Iodized Salt 1KG,15,112,100,12,4
31-03-2025,"Grains, Flours & Dals",Urad dall 1 Kg,4,555,510,45,3
31-03-2025,"Dry Fruits, Nuts & Seeds",PULMAKHANA 100 GM,2,360,340,20,2
31-03-2025,"Grains, Flours & Dals",SABDANA,4,80,70,10,2
31-03-2025,"Dry Fruits, Nuts & Seeds",WALLNUTS 250GM,2,380,360,20,1
31-03-2025,Snacks & Ready-to-Eat,BB VERMICELLY 500GM,14,53,53,0,1
31-03-2025,Spices & Seasonings,JEERA 250 gms,15,125,105,20,1
31-03-2025,"Grains, Flours & Dals",SRILALITHA MAIDA FLOUR 500G,4,32,32,0,1
31-03-2025,"Dry Fruits, Nuts & Seeds",YELLOW KISHMISH 250GM,2,130,110,20,1
31-03-2025,"Grains, Flours & Dals",CHANADALL 250 GMS,4,35,30,5,1
31-03-2025,Spices & Seasonings,Turmeric powder 250 gms,15,100,75,25,1
31-03-2025,"Grains, Flours & Dals",SL Suji Rava 500GM,4,64,64,0,2
31-03-2025,"Dry Fruits, Nuts & Seeds",Groundnuts 500 gms,2,190,170,20,2
31-03-2025,"Grains, Flours & Dals",turdal 1kg,4,220,170,50,1
31-03-2025,Spices & Seasonings,NUVVULU 250GM,15,80,65,15,1
31-03-2025,Spices & Seasonings,PRO ORG MUSTARD SMALL -RAI 200G,15,84,84,0,1
31-03-2025,Oils & Ghee,Sesame oil 1 L,9,1770,"1,680.00",90,3
31-03-2025,Spices & Seasonings,Tamarind 250GMS,15,80,65,15,1
31-03-2025,"Dry Fruits, Nuts & Seeds",PUMPKIN SEEDS 250GM,2,200,160,40,1
31-03-2025,Personal Care & Cosmetics,GOW DURBAR 75G,10,60,60,0,1
31-03-2025,Spices & Seasonings,idli karam powdwer,15,65,65,0,1
31-03-2025,Spices & Seasonings,PUTNALA KARAM POWDER 100GM,15,65,65,0,1
31-03-2025,Pooja & Spiritual Items,GD Ramayana Sandal 75GM,12,60,60,0,1
31-03-2025,Pooja & Spiritual Items,BALAJI KASTURI DHOOP STICKS,12,70,70,0,1
31-03-2025,Pooja & Spiritual Items,GD Camphor 50GM,12,115,115,0,1
31-03-2025,"Grains, Flours & Dals",Brown RICE 1KG,4,350,325,25,5
31-03-2025,Pooja & Spiritual Items,SWASTIK CAMPHORE,12,90,90,0,1
31-03-2025,Pooja & Spiritual Items,GD Dhoop Sticks 26GM,12,20,20,0,1
31-03-2025,Pooja & Spiritual Items,SWASTIK CAMPHOR 10GM,12,20,20,0,1
31-03-2025,General Household & Kitchenware,GOOD HOME,3,15,15,0,1
31-03-2025,Pooja & Spiritual Items,GD Kumkum 50GM,12,30,30,0,1
31-03-2025,Spices & Seasonings,GD Turmeric 50GM,15,25,25,0,1
31-03-2025,Snacks & Ready-to-Eat,SD Moringa with plam jaggery 250gm,14,135,135,0,1
31-03-2025,Personal Care & Cosmetics,MYSORE SANDAL BABY SOAP,10,90,90,0,2
31-03-2025,Pooja & Spiritual Items,GD Aiswarya Deepam 700ML,12,195,195,0,1
31-03-2025,Snacks & Ready-to-Eat,SD FINGER Millet with palm Jaggery 250gm,14,135,135,0,1
31-03-2025,"Grains, Flours & Dals",Bombay Rava 500GM,4,35,30,5,1
31-03-2025,Snacks & Ready-to-Eat,FOXTAIL NOODLES,14,75,75,0,1
31-03-2025,Snacks & Ready-to-Eat,SAGOPAPAD RED CHILLI VD,14,55,55,0,1
31-03-2025,"Dry Fruits, Nuts & Seeds",FLAX SEEDS 250GM,2,60,50,10,1
31-03-2025,"Grains, Flours & Dals",MELMEKER 250GMS,4,60,45,15,1
31-03-2025,Spices & Seasonings,DRY MIECHI 200GM,15,80,60,20,1
31-03-2025,"Grains, Flours & Dals",Urad dall 1 Kg,4,185,170,15,1
31-03-2025,"Grains, Flours & Dals",Wheat Flour 1 kg,4,140,120,20,2
31-03-2025,Snacks & Ready-to-Eat,SATHVI REGIVADA 200GM,14,80,60,20,1
31-03-2025,Oils & Ghee,Coconut oil 500 ml,9,220,200,20,1
31-03-2025,"Grains, Flours & Dals",RAGI FLOUR 500GRMS,4,40,35,5,1
31-03-2025,Oils & Ghee,Sesame oil 1 L,9,590,560,30,1
31-03-2025,Spices & Seasonings,BIRYANI LEAF 10GM,15,30,20,10,1
31-03-2025,Spices & Seasonings,SWEET SOUNF,15,20,20,0,1
31-03-2025,"Dry Fruits, Nuts & Seeds",sabja seeds,2,80,70,10,1
31-03-2025,Snacks & Ready-to-Eat,SD VAMU APPADALU 200GM,14,80,80,0,1
31-03-2025,Spices & Seasonings,Dalchin Chekka 50GM,15,50,40,10,1
31-03-2025,Oils & Ghee,Castor oil 200 ml,9,100,80,20,1
31-03-2025,"Grains, Flours & Dals",Chana Flour 1 kg,4,280,260,20,2
31-03-2025,"Grains, Flours & Dals",RICE FLOUR 1KG,4,350,275,75,5
31-03-2025,"Grains, Flours & Dals",RICE FLOUR 1KG,4,70,55,15,1
31-03-2025,"Grains, Flours & Dals",Multigrain 1 kg,4,100,85,15,1
31-03-2025,Oils & Ghee,rice bran oil f,9,194,169,25,1
31-03-2025,"Grains, Flours & Dals",Wheat Flour 1 kg,4,350,300,50,5
31-03-2025,Milk & Dairy,BROWN EGGS 1P,7,168,144,24,12
31-03-2025,"Grains, Flours & Dals",RAGI FLOUR 1KG,4,80,70,10,1
31-03-2025,"Grains, Flours & Dals",VGR RICE bag 1,4,1899,"1,650.00",249,1
31-03-2025,"Grains, Flours & Dals",White jowar.F 1 kg,4,100,80,20,1
31-03-2025,"Grains, Flours & Dals",Brown RICE 1KG,4,350,325,25,5
31-03-2025,"Grains, Flours & Dals",aishwarya rice,4,450,450,0,1
31-03-2025,Snacks & Ready-to-Eat,SD Moringa with plam jaggery 250gm,14,135,135,0,1
31-03-2025,Snacks & Ready-to-Eat,SD FINGER Millet with palm Jaggery 250gm,14,135,135,0,1
31-03-2025,Oils & Ghee,Groundnut oil 1 L,9,360,330,30,1
31-03-2025,"Grains, Flours & Dals",SL Idly Rava 1KG,4,65,55,10,1
31-03-2025,Oils & Ghee,Safflower oil 500 ml,9,220,200,20,1
31-03-2025,"Grains, Flours & Dals",UNPOLISHED TURDALL 1KG,4,240,210,30,1
31-03-2025,"Grains, Flours & Dals",Wheat Flour 1 kg,4,70,60,10,1
31-03-2025,"Grains, Flours & Dals",RAGI FLOUR 500GRMS,4,40,35,5,1
31-03-2025,Milk & Dairy,BROWN EGGS 1P,7,168,144,24,12
31-03-2025,"Grains, Flours & Dals",VYS.SP.RICE BAG 1,4,1800,"1,650.00",150,1
31-03-2025,Sweeteners,NATURAL HONEY 1KG,16,560,480,80,1
31-03-2025,"Grains, Flours & Dals",UDALU (Barnyard millet) 1 kg,4,140,115,25,1
31-03-2025,"Grains, Flours & Dals",Arikalu (kodo),4,70,65,5,1
30-03-2025,Snacks & Ready-to-Eat,black pepper ricepapad,14,50,50,0,1
30-03-2025,Milk & Dairy,SANGAM TONED MILK 500ML,7,30,30,0,1
30-03-2025,Snacks & Ready-to-Eat,RINGS 200GM,14,30,30,0,1
30-03-2025,Spices & Seasonings,ROYAL SAFFRON 400GRMS,15,65,65,0,1
30-03-2025,Oils & Ghee,Sesame oil 500ml,9,295,280,15,1
30-03-2025,Spices & Seasonings,Turmeric powder 250 gms,15,100,75,25,1
30-03-2025,Oils & Ghee,Groundnut oil 1 L,9,360,330,30,1
30-03-2025,Spices & Seasonings,Masala Karam 250 gms,15,130,120,10,1
30-03-2025,Spices & Seasonings,AV Iodized Salt 1KG,15,28,25,3,1
30-03-2025,"Grains, Flours & Dals",POORI ATTA 1KG,4,70,60,10,1
30-03-2025,Oils & Ghee,rice bran oil f,9,194,169,25,1
30-03-2025,Spices & Seasonings,DURGA SALT CRYSTAL 1KG,15,25,25,0,1
30-03-2025,Spices & Seasonings,Turmeric powder 250 gms,15,100,75,25,1
30-03-2025,Spices & Seasonings,PN ORGANIC PINK SALT 1KG,15,248,248,0,2
30-03-2025,Spices & Seasonings,RED COPRA 250GMS,15,85,74,11,1
30-03-2025,Spices & Seasonings,SWEET SOUNF,15,20,20,0,1
30-03-2025,Spices & Seasonings,DRY MIECHI 200GM,15,80,60,20,1
30-03-2025,Spices & Seasonings,ROYAL SAFFRON 400GRMS,15,260,260,0,4
30-03-2025,Snacks & Ready-to-Eat,TILLI CHIKKI,14,30,30,0,6
30-03-2025,Snacks & Ready-to-Eat,GREEN FRIED BATANA,14,40,40,0,2
30-03-2025,Snacks & Ready-to-Eat,NGT CHATPATTA CHANA 90GM,14,75,75,0,3
30-03-2025,"Grains, Flours & Dals",Wheat Flour 1 kg,4,70,60,10,1
30-03-2025,Spices & Seasonings,Tamarind 250GMS,15,80,65,15,1
30-03-2025,"Grains, Flours & Dals",RICE FLOUR 1KG,4,70,55,15,1
30-03-2025,"Grains, Flours & Dals",PRO SOYA CHUNKS 200G,4,79,79,0,1
29-03-2025,Spices & Seasonings,ROYAL SAFFRON 400GRMS,15,65,65,0,1
29-03-2025,Spices & Seasonings,SWEET SOUNF,15,20,20,0,1
29-03-2025,Snacks & Ready-to-Eat,VD Minapa papad 200gm,14,120,120,0,2
29-03-2025,"Dry Fruits, Nuts & Seeds",Groundnuts 1 kg,2,190,165,25,1
29-03-2025,"Dry Fruits, Nuts & Seeds",PUTNALU 500GMS,2,90,76,14,1
29-03-2025,"Grains, Flours & Dals",AISHWARYA SP 1KG,4,80,70,10,1
29-03-2025,Milk & Dairy,BROWN EGGS 1P,7,168,144,24,12
29-03-2025,"Grains, Flours & Dals",Multigrain 1 kg,4,100,85,15,1
29-03-2025,"Grains, Flours & Dals",Wheat Flour 1 kg,4,140,120,20,2
29-03-2025,Baking & Cooking Aids,GONDKATIRA Ag,0,85,75,10,1
29-03-2025,Spices & Seasonings,Chilli powder 500 gms,15,290,210,80,1
29-03-2025,Sweeteners,YB JAGGERY POWDER 500GMS,16,75,75,0,1
29-03-2025,Snacks & Ready-to-Eat,COPRA LADDU 200GM,14,100,80,20,1
29-03-2025,"Grains, Flours & Dals",Wheat Flour 1 kg,4,70,60,10,1
29-03-2025,Oils & Ghee,Sesame oil 1 L,9,1180,"1,120.00",60,2
29-03-2025,Spices & Seasonings,3M.MIRCHI POWDER,15,1632,"1,100.00",532,4
29-03-2025,Oils & Ghee,Sesame oil 5 L,9,2950,"2,750.00",200,1
29-03-2025,Spices & Seasonings,DURGA SALT CRYSTAL 1KG,15,50,50,0,2
29-03-2025,Spices & Seasonings,mustrad powder 1kg,15,420,360,60,2
29-03-2025,Personal Care & Cosmetics,HERBAL BATH POWDER,10,160,160,0,1
29-03-2025,Spices & Seasonings,DURGA SALT CRYSTAL 1KG,15,25,25,0,1
29-03-2025,Oils & Ghee,Sesame oil 500ml,9,295,280,15,1
29-03-2025,Oils & Ghee,Groundnut oil 500ml,9,180,165,15,1
29-03-2025,"Grains, Flours & Dals",Multigrain 1 kg,4,100,85,15,1
29-03-2025,"Grains, Flours & Dals",Multigrain 1 kg,4,100,85,15,1
29-03-2025,"Grains, Flours & Dals",SRILATHA RICE RAVVA 500GM,4,35,35,0,1
29-03-2025,Snacks & Ready-to-Eat,NGT CHATPATTA CHANA 90GM,14,25,25,0,1
29-03-2025,Snacks & Ready-to-Eat,GREEN FRIED BATANA,14,20,20,0,1
29-03-2025,"Grains, Flours & Dals",SAMALU (Little millet) 500 gms,4,85,65,20,1
29-03-2025,"Grains, Flours & Dals",SATHVI BARELY SEEDS 500GMS,4,90,70,20,1
29-03-2025,Spices & Seasonings,SWEET SOUNF,15,20,20,0,1
29-03-2025,"Dry Fruits, Nuts & Seeds",BLACK KISMIS 250GM,2,175,140,35,1
29-03-2025,"Grains, Flours & Dals",Bombay Rava 500GM,4,35,30,5,1
29-03-2025,"Health, Wellness & Ayurvedic Products",MD Ashwagandha Choornam 100GM,5,170,170,0,1
29-03-2025,Sweeteners,GS Palm Jaggery Powder 400GM,16,360,360,0,2
29-03-2025,"Grains, Flours & Dals",VYS.SP RICE 1 KG,4,350,325,25,5
29-03-2025,"Grains, Flours & Dals",Wheat Flour 1 kg,4,70,60,10,1
29-03-2025,Personal Care & Cosmetics,COW DURBAR 7 HERBS SHAMPOO,10,125,125,0,1
29-03-2025,Spices & Seasonings,ROYAL SAFFRON 400GRMS,15,65,65,0,1
29-03-2025,Sweeteners,YB FOREST HONEY 250GM,16,180,180,0,1
29-03-2025,Pooja & Spiritual Items,bilwa patra,12,60,60,0,1
29-03-2025,Snacks & Ready-to-Eat,KURNOOL MARMURA,14,70,55,15,1
29-03-2025,Pooja & Spiritual Items,GD TULASI 75GM,12,60,60,0,1
29-03-2025,"Grains, Flours & Dals",Chittimuthaylu rice 1 kg,4,160,140,20,1
29-03-2025,Oils & Ghee,Coconut oil 1 L,9,440,400,40,1
29-03-2025,"Grains, Flours & Dals",Bombay Rava 500GM,4,35,30,5,1
29-03-2025,Spices & Seasonings,Lavangam 50GM,15,60,50,10,1
29-03-2025,Spices & Seasonings,BIRYANI LEAF 10GM,15,30,20,10,1
29-03-2025,Spices & Seasonings,SAJEERA,15,60,40,20,1
29-03-2025,Pooja & Spiritual Items,JAGI KAYA 25GM,12,80,60,20,1
29-03-2025,Spices & Seasonings,SATHVI ANASAPUVUU 25GM,15,90,65,25,1
29-03-2025,"Grains, Flours & Dals",POORI ATTA 1KG,4,70,60,10,1
29-03-2025,Spices & Seasonings,Japatri 25GM,15,100,80,20,1
29-03-2025,Spices & Seasonings,MIRYALU 50 GRMS,15,100,80,20,1
29-03-2025,Spices & Seasonings,Marati Magga 50GM,15,130,110,20,1
29-03-2025,Milk & Dairy,HRITAGE TOTAL CURD 130GM,7,10,10,0,1
29-03-2025,Oils & Ghee,Groundnut oil 1 L,9,360,330,30,1
29-03-2025,"Grains, Flours & Dals",Chana Flour 500 gms,4,140,130,10,2
29-03-2025,Pooja & Spiritual Items,GOPURAM SAMBRANI CUPS,12,8,8,0,1
29-03-2025,Spices & Seasonings,ROYAL SAFFRON 400GRMS,15,65,65,0,1
29-03-2025,Pooja & Spiritual Items,SWASTIK SAMBRANI 25 GRMS,12,20,20,0,1
29-03-2025,"Dry Fruits, Nuts & Seeds",PUTNALU 500GMS,2,90,76,14,1
29-03-2025,"Dry Fruits, Nuts & Seeds",Groundnuts 500 gms,2,95,85,10,1
29-03-2025,Sweeteners,YB FOREST HONEY 250GM,16,180,180,0,1
29-03-2025,Snacks & Ready-to-Eat,VD PALLI LADDU,14,80,80,0,1
29-03-2025,Snacks & Ready-to-Eat,GANTASALA GINGER CANDY 200GM,14,115,115,0,1
29-03-2025,"Grains, Flours & Dals",SRILATHA RICE RAVVA 500GM,4,35,35,0,1
29-03-2025,Pooja & Spiritual Items,SWAATHI GATTI DEEPAM VATTULU,12,60,60,0,2
29-03-2025,Pooja & Spiritual Items,s karpuram,12,180,180,0,1
29-03-2025,Snacks & Ready-to-Eat,VD MIXTURE 175 GM,14,60,60,0,1
29-03-2025,"Dry Fruits, Nuts & Seeds",mango cubes s,2,50,50,0,1
29-03-2025,"Grains, Flours & Dals",Bombay Rava 500GM,4,35,30,5,1
29-03-2025,"Dry Fruits, Nuts & Seeds",YB GRANMA NUTS,2,90,90,0,1
29-03-2025,Snacks & Ready-to-Eat,COPRA LADDU 200GM,14,200,160,40,2
29-03-2025,Snacks & Ready-to-Eat,VD PALLI LADDU,14,240,240,0,3
29-03-2025,Snacks & Ready-to-Eat,VD PALLI CHIKKI,14,80,80,0,1
29-03-2025,"Grains, Flours & Dals",SRI LALITHA SONAMASOORI 5KG,4,440,370,70,1
29-03-2025,Snacks & Ready-to-Eat,VD RIBBON PAKODI 175GM,14,60,60,0,1
29-03-2025,Snacks & Ready-to-Eat,NGT CHATPATTA CHANA 90GM,14,200,200,0,8
29-03-2025,Snacks & Ready-to-Eat,SATHVI REGIVADA 200GM,14,80,60,20,1
29-03-2025,"Grains, Flours & Dals",SAMALU (Little millet) 500 gms,4,85,65,20,1
29-03-2025,"Dry Fruits, Nuts & Seeds",pn makhana 100 gms,2,288,288,0,1
29-03-2025,"Grains, Flours & Dals",Arikalu (kodo),4,70,65,5,1
29-03-2025,"Grains, Flours & Dals",KORRALU (FOXTAIL M) 500GM,4,65,55,10,1
29-03-2025,"Health, Wellness & Ayurvedic Products",AMLA PACHAK,5,100,100,0,1
29-03-2025,Snacks & Ready-to-Eat,SD VAMU APPADALU 200GM,14,80,80,0,1
29-03-2025,Oils & Ghee,Sesame oil 500ml,9,295,280,15,1
29-03-2025,Personal Care & Cosmetics,ROUND LOOFAH,10,65,65,0,1
29-03-2025,Oils & Ghee,Coconut oil 500 ml,9,220,200,20,1
29-03-2025,Oils & Ghee,cow ghee 500 ml,9,430,390,40,1
29-03-2025,"Grains, Flours & Dals",Wheat Flour 1 kg,4,70,60,10,1
29-03-2025,Snacks & Ready-to-Eat,GS INSTANT KORRA DOSA MIX 400GM,14,120,120,0,1
29-03-2025,Pooja & Spiritual Items,SRI HARI KRISHNA DOOM 12PIC,12,80,80,0,1
29-03-2025,Snacks & Ready-to-Eat,VD MINAPA VADIYAM,14,65,65,0,1
29-03-2025,Snacks & Ready-to-Eat,VD SAGOPAPAD 150GM,14,55,55,0,1
29-03-2025,Pooja & Spiritual Items,GD WOODS 150GM,12,110,110,0,1
29-03-2025,Pooja & Spiritual Items,BALAJI KASTURI DHOOP STICKS,12,70,70,0,1
29-03-2025,"Grains, Flours & Dals",POORI ATTA 1KG,4,70,60,10,1
29-03-2025,Pooja & Spiritual Items,GD KUMKUM 50GM,12,30,30,0,1
29-03-2025,"Grains, Flours & Dals",SRILALITHA MAIDA FLOUR 500G,4,64,64,0,2
29-03-2025,"Grains, Flours & Dals",KORRALU (FOXTAIL M) 500GM,4,65,55,10,1
29-03-2025,Spices & Seasonings,ROYAL SAFFRON 400GRMS,15,65,65,0,1
29-03-2025,Oils & Ghee,rice bran oil f,9,194,169,25,1
29-03-2025,"Grains, Flours & Dals",Chana Flour 500 gms,4,70,65,5,1
29-03-2025,Oils & Ghee,Safflower oil 1 L,9,440,400,40,1
29-03-2025,"Grains, Flours & Dals",THICK POHA 500GM,4,40,35,5,1
29-03-2025,Snacks & Ready-to-Eat,SD Vamu with palm jaggery 250gm,14,135,135,0,1
29-03-2025,"Grains, Flours & Dals",Multigrain 1 kg,4,100,85,15,1
29-03-2025,Spices & Seasonings,ROYAL SAFFRON,15,125,125,0,1
29-03-2025,"Grains, Flours & Dals",Bombay Rava 500GM,4,35,30,5,1
29-03-2025,"Grains, Flours & Dals",Wheat Flour 1 kg,4,70,60,10,1
29-03-2025,Oils & Ghee,Safflower oil 1 L,9,440,400,40,1
29-03-2025,Milk & Dairy,BROWN EGGS 1P,7,84,72,12,6
29-03-2025,Oils & Ghee,cow ghee 500 ml,9,430,390,40,1
29-03-2025,Spices & Seasonings,coconut powder,15,90,70,20,1
29-03-2025,Oils & Ghee,Groundnut oil 1 L,9,360,330,30,1
29-03-2025,Spices & Seasonings,Tamarind 250GMS,15,80,65,15,1
29-03-2025,"Grains, Flours & Dals",Wheat Flour 1 kg,4,140,120,20,2
29-03-2025,"Grains, Flours & Dals",KORRALU (FOXTAIL M) 500GM,4,65,55,10,1
29-03-2025,"Grains, Flours & Dals",Arikalu (kodo),4,70,65,5,1
29-03-2025,"Grains, Flours & Dals",WHITE BATANI 500GM,4,80,60,20,1
29-03-2025,Snacks & Ready-to-Eat,KURNOOL MARMURA,14,70,55,15,1
29-03-2025,Spices & Seasonings,SATHVI ANASAPUVUU 25GM,15,90,65,25,1
29-03-2025,"Dry Fruits, Nuts & Seeds",sabja seeds,2,80,70,10,1
29-03-2025,Snacks & Ready-to-Eat,Pani Poori Chips 250GM,14,50,40,10,1
29-03-2025,Spices & Seasonings,SAJEERA,15,60,40,20,1
29-03-2025,Oils & Ghee,Safflower oil 1 L,9,440,400,40,1
29-03-2025,Spices & Seasonings,Marati Magga 50GM,15,130,110,20,1
29-03-2025,Oils & Ghee,Groundnut oil 1 L,9,360,330,30,1
29-03-2025,Snacks & Ready-to-Eat,HS JOWAR BISCUITS,14,50,50,0,1
29-03-2025,Snacks & Ready-to-Eat,HS Ragi biscuits,14,50,50,0,1
29-03-2025,Snacks & Ready-to-Eat,BATANA NGT 70GMS,14,20,20,0,1
29-03-2025,Spices & Seasonings,GS Moringa Leaves Spicy Powder 100GM,15,90,90,0,1
29-03-2025,Spices & Seasonings,SWASTIKS GINGER&amp;GARLIC,15,49,49,0,1
29-03-2025,"Dry Fruits, Nuts & Seeds",cashew,2,340,310,30,1
29-03-2025,"Dry Fruits, Nuts & Seeds",ALMONDS 250GM,2,280,260,20,1
29-03-2025,Personal Care & Cosmetics,GOW DURBAR NAVA 100GM SOAP,10,40,40,0,1
29-03-2025,Personal Care & Cosmetics,DWIBHASHI GULABA ARKA ROSA WATER,10,60,60,0,1
29-03-2025,General Household & Kitchenware,ODONIL ROSE GARDEN 220ML,3,169,169,0,1
29-03-2025,Personal Care & Cosmetics,UVIS RED SANDAL SOAP 100GM,10,85,85,0,1
29-03-2025,Snacks & Ready-to-Eat,GROUNDNUT LADDU WITH DATES,14,135,135,0,1
29-03-2025,Personal Care & Cosmetics,ORGANIC SPONGE LOOFAH,10,70,70,0,1
29-03-2025,Pickles & Cooking Pastes,SD TAMARIND PICKLE,11,110,110,0,1
29-03-2025,Snacks & Ready-to-Eat,RI SPORTS BAR 40G,14,45,45,0,1
29-03-2025,"Grains, Flours & Dals",Red Bobarlu 500 gms,4,95,85,10,1
29-03-2025,Pickles & Cooking Pastes,SD BITTER GOURD PICKLE,11,110,110,0,1
29-03-2025,Snacks & Ready-to-Eat,NGT CHATPATTA CHANA 90GM,14,50,50,0,2
29-03-2025,Oils & Ghee,Coconut oil 500 ml,9,220,200,20,1
29-03-2025,Spices & Seasonings,GREEN SOUNF,15,60,40,20,1
29-03-2025,Spices & Seasonings,dalchin chekka,15,50,40,10,1
29-03-2025,Spices & Seasonings,Turmeric powder 250 gms,15,100,75,25,1
29-03-2025,"Grains, Flours & Dals",Chana Flour 500 gms,4,70,65,5,1
29-03-2025,"Grains, Flours & Dals",Red Wheat Flour 1 kg,4,280,260,20,2
29-03-2025,"Grains, Flours & Dals",Multigrain 1 kg,4,200,170,30,2
29-03-2025,"Health, Wellness & Ayurvedic Products",MD Triphala Chorrnam 100GM,5,80,80,0,1
29-03-2025,Pooja & Spiritual Items,javadhu,12,60,60,0,1
29-03-2025,"Grains, Flours & Dals",VGR rice 1 kg,4,350,325,25,5
29-03-2025,"Dry Fruits, Nuts & Seeds",Groundnuts 1 kg,2,190,165,25,1
29-03-2025,"Grains, Flours & Dals",Red Wheat Flour 1 kg,4,140,130,10,1
29-03-2025,Sweeteners,YB JAGGERY POWDER 500GMS,16,75,75,0,1
29-03-2025,Spices & Seasonings,Jeera 100GM,15,50,45,5,1
29-03-2025,"Grains, Flours & Dals",URAD DALL,4,95,85,10,1
29-03-2025,"Grains, Flours & Dals",turdal 1kg,4,220,170,50,1
29-03-2025,Spices & Seasonings,Tamarind 250GMS,15,80,65,15,1
29-03-2025,Sweeteners,ACHUBELLAM 500GM,16,50,40,10,1
29-03-2025,Pooja & Spiritual Items,bilwa patra,12,60,60,0,1
29-03-2025,"Dry Fruits, Nuts & Seeds",Groundnuts 500 gms,2,95,85,10,1
29-03-2025,"Grains, Flours & Dals",CHANA DAL 500GM,4,70,60,10,1
29-03-2025,"Grains, Flours & Dals",SRILALITHA MAIDA FLOUR 500G,4,32,32,0,1
29-03-2025,"Grains, Flours & Dals",VGR rice 1 kg,4,280,260,20,4
29-03-2025,"Grains, Flours & Dals",Wheat Flour 1 kg,4,350,300,50,5
29-03-2025,Oils & Ghee,Coconut oil 500 ml,9,220,200,20,1
29-03-2025,"Grains, Flours & Dals",RAGI FLOUR 500GRMS,4,40,35,5,1
29-03-2025,Pooja & Spiritual Items,GD KUMKUM 50GM,12,30,30,0,1
29-03-2025,Oils & Ghee,Sesame oil 500ml,9,295,280,15,1
29-03-2025,Spices & Seasonings,ROYAL SAFFRON 400GRMS,15,65,65,0,1
29-03-2025,Pooja & Spiritual Items,GD Dhoop Cones 40GM,12,30,30,0,1
29-03-2025,Pooja & Spiritual Items,999 SINGAPORE DHOOP POW 50GM,12,35,35,0,1
29-03-2025,"Grains, Flours & Dals",KORRALU (FOXTAIL M) 1KG,4,150,110,40,1
29-03-2025,"Grains, Flours & Dals",UDALU (Barnyard millet) 1 kg,4,140,115,25,1
29-03-2025,"Grains, Flours & Dals",SAMALU,4,170,130,40,1
29-03-2025,"Grains, Flours & Dals",Arikadu ( kodo),4,140,130,10,1
29-03-2025,Spices & Seasonings,Chilli powder 500 gms,15,290,210,80,1
29-03-2025,"Dry Fruits, Nuts & Seeds",SUNFLOWER SEEDS 250GRM,2,150,130,20,1
29-03-2025,Pooja & Spiritual Items,GOMATHA AGARBATHI,12,75,75,0,1
29-03-2025,"Health, Wellness & Ayurvedic Products",RB FRUITS &amp;seeds Cranberries,5,45,45,0,1
29-03-2025,Spices & Seasonings,PRO ORG CORIANDER WHOLE 100G,15,70,70,0,1
29-03-2025,Spices & Seasonings,PRO ORG AJWAIN 100G,15,105,105,0,1
29-03-2025,Spices & Seasonings,PRO ORG CUMIN 100G,15,176,176,0,1
29-03-2025,Personal Care & Cosmetics,HEART SHAPE LOOFAH,10,79,79,0,1
29-03-2025,"Grains, Flours & Dals",SABDANA 500GM,4,90,70,20,1
29-03-2025,"Dry Fruits, Nuts & Seeds",SUNFLOWER SEEDS 250GRM,2,150,130,20,1
29-03-2025,Household & Cleaning,SRFR EXCEL,6,20,20,0,2
29-03-2025,"Dry Fruits, Nuts & Seeds",SD Mango cubes 200gm,2,90,90,0,1
29-03-2025,Personal Care & Cosmetics,COW DURBAR 7 HERBS SHAMPOO,10,125,125,0,1
29-03-2025,"Health, Wellness & Ayurvedic Products",MD Hibiscus Flower Choornam 30GM,5,100,100,0,1
29-03-2025,"Dry Fruits, Nuts & Seeds",PUMPKIN SEEDS 250GM,2,200,160,40,1
29-03-2025,Spices & Seasonings,FLAXSEED KARAM,15,75,75,0,1
29-03-2025,"Grains, Flours & Dals",HS JOWAR FLAKES 250GM 1+1,4,119,119,0,1
29-03-2025,"Health, Wellness & Ayurvedic Products",VAMU WATER,5,99,99,0,1
29-03-2025,Personal Care & Cosmetics,Soapnut 250GM,10,60,45,15,1
29-03-2025,"Grains, Flours & Dals",SA WHITE JOWAR RAVA 500GM,4,69,69,0,1
29-03-2025,Pooja & Spiritual Items,GD JASMINE 75GM,12,60,60,0,1
29-03-2025,Spices & Seasonings,3M.MIRCHI POWDER,15,408,275,133,1
29-03-2025,Milk & Dairy,SANGAM TONED MILK 500ML,7,60,60,0,2
29-03-2025,Snacks & Ready-to-Eat,VD Pappu Chekkalu 190gm,14,60,60,0,1
29-03-2025,"Health, Wellness & Ayurvedic Products",MH Millets Malt 500GM,5,200,190,10,1
29-03-2025,Sweeteners,YB JAGGERY POWDER 500GMS,16,75,75,0,1
29-03-2025,"Grains, Flours & Dals",Wheat Flour 1 kg,4,140,120,20,2
29-03-2025,Snacks & Ready-to-Eat,VD DASA DINUSULU,14,199,199,0,1
29-03-2025,"Grains, Flours & Dals",multi mllit umpa ravva,4,129,129,0,1
29-03-2025,"Grains, Flours & Dals",Multigrain 1 kg,4,200,170,30,2
29-03-2025,Snacks & Ready-to-Eat,Sprouted Ragi Biscuits 450GM,14,150,150,0,1
29-03-2025,Beverages,ASSAM ELAICHI TEA,1,199,199,0,1
29-03-2025,Beverages,BRU GREEN LABEL 1.2G,1,48,48,0,24
29-03-2025,"Grains, Flours & Dals",MULTIMILLET IDLY RAVVA,4,65,65,0,1
29-03-2025,"Grains, Flours & Dals",RAGI FLOUR 1KG,4,80,70,10,1
29-03-2025,Sweeteners,SD Palm Jaggery 500GM,16,200,200,0,1
29-03-2025,Sweeteners,YB Brown Sugar 1KG,16,140,140,0,1
29-03-2025,"Grains, Flours & Dals",DISANO ROLED OATS,4,395,395,0,1
29-03-2025,"Grains, Flours & Dals",Wheat Rava M 1KG,4,65,55,10,1
29-03-2025,Beverages,BISLERI 100ml,1,10,10,0,1
29-03-2025,Snacks & Ready-to-Eat,OK MACARONI,14,120,120,0,1
29-03-2025,Spices & Seasonings,AV Iodized Salt 1KG,15,28,25,3,1
29-03-2025,"Grains, Flours & Dals",Bajra Flour 1 kg,4,70,60,10,1
29-03-2025,Oils & Ghee,Groundnut oil 1 L,9,360,330,30,1
29-03-2025,"Grains, Flours & Dals",Wheat Rava S 1KG,4,65,55,10,1
29-03-2025,"Grains, Flours & Dals",turdal 1kg,4,220,170,50,1
29-03-2025,Spices & Seasonings,Jeera 100GM,15,50,45,5,1
29-03-2025,Snacks & Ready-to-Eat,murmura venk,14,50,45,5,1
29-03-2025,Spices & Seasonings,ROYAL SAFFRON 400GRMS,15,65,65,0,1
29-03-2025,Spices & Seasonings,Turmeric powder 250 gms,15,100,75,25,1
29-03-2025,"Dry Fruits, Nuts & Seeds",Groundnuts 500 gms,2,95,85,10,1
29-03-2025,Personal Care & Cosmetics,MYSORE SANDAL SOAP 75G,10,84,84,0,2
29-03-2025,"Grains, Flours & Dals",SRILALITHA MAIDA FLOUR 500G,4,32,32,0,1
29-03-2025,"Grains, Flours & Dals",Black uluvalu 250 gms,4,45,35,10,1
29-03-2025,"Grains, Flours & Dals",Kandulu 250GM,4,40,35,5,1
29-03-2025,"Dry Fruits, Nuts & Seeds",WATERMELON SEEDS 250GRM,2,320,280,40,1
29-03-2025,Snacks & Ready-to-Eat,BB ROASTED VERMICELLY 850GM,14,117,117,0,1
29-03-2025,"Dry Fruits, Nuts & Seeds",PUMPKIN SEEDS 250GM,2,200,160,40,1
29-03-2025,"Grains, Flours & Dals",Red Bobarlu 1 kg,4,190,170,20,1
29-03-2025,Oils & Ghee,Coconut oil 1 L,9,440,400,40,1
29-03-2025,Oils & Ghee,Safflower oil 1 L,9,440,400,40,1
29-03-2025,Oils & Ghee,Sesame oil 1 L,9,590,560,30,1
29-03-2025,"Dry Fruits, Nuts & Seeds",SALTED PISTA 250GM,2,400,350,50,1
29-03-2025,Spices & Seasonings,Tamarind 250GMS,15,80,65,15,1
29-03-2025,"Grains, Flours & Dals",Wheat Flour 1 kg,4,70,60,10,1
29-03-2025,Beverages,REFRESH SHARBATH SUGAR FREE,1,299,285,14,1
29-03-2025,"Grains, Flours & Dals",Multigrain 1 kg,4,100,85,15,1
29-03-2025,Sweeteners,ACHU BELLAM 1KG,16,100,80,20,1
29-03-2025,"Grains, Flours & Dals",Chana Flour 1 kg,4,140,130,10,1
29-03-2025,Spices & Seasonings,MASALA KAR 500GMS,15,260,240,20,1
29-03-2025,"Dry Fruits, Nuts & Seeds",PUTNALU 500GMS,2,90,76,14,1
29-03-2025,"Health, Wellness & Ayurvedic Products",RB FRUITS &amp;seeds Cranberries,5,45,45,0,1
29-03-2025,"Grains, Flours & Dals",Wheat Flour 1 kg,4,70,60,10,1
29-03-2025,"Dry Fruits, Nuts & Seeds",SH GROUNDNUT 500GM,2,163,130,33,1
29-03-2025,"Dry Fruits, Nuts & Seeds",SUNFLOWER SEEDS 250GRM,2,150,130,20,1
29-03-2025,"Health, Wellness & Ayurvedic Products",NEELI LEAF CHOORNAM,5,110,110,0,1
29-03-2025,"Grains, Flours & Dals",Bombay Rava 500GM,4,35,30,5,1
29-03-2025,"Dry Fruits, Nuts & Seeds",PUMPKIN SEEDS 250GM,2,200,160,40,1
29-03-2025,Snacks & Ready-to-Eat,VD PALLI LADDU,14,80,80,0,1
29-03-2025,Personal Care & Cosmetics,MD Henna Choornam 100GM,10,80,80,0,1
29-03-2025,Spices & Seasonings,ROYAL SAFFRON 400GRMS,15,65,65,0,1
29-03-2025,Sweeteners,YB JAGGERY POWDER 500GMS,16,75,75,0,1
29-03-2025,Spices & Seasonings,Tamarind 250GMS,15,80,65,15,1
29-03-2025,Pooja & Spiritual Items,GD WOODS 150GM,12,110,110,0,1
29-03-2025,Pooja & Spiritual Items,GD Aiswarya Deepam 700ML,12,195,195,0,1
29-03-2025,"Grains, Flours & Dals",KORRALU (FOXTAIL M) 1KG,4,150,110,40,1
29-03-2025,Sweeteners,SUGAR 1KG,16,60,50,10,1
29-03-2025,"Grains, Flours & Dals",CHANA DAL 500GM,4,70,60,10,1
29-03-2025,"Grains, Flours & Dals",MELMEKER 250GMS,4,60,45,15,1
29-03-2025,Sweeteners,YB JAGGERY POWDER 500GMS,16,75,75,0,1
29-03-2025,"Grains, Flours & Dals",THICK POHA 500GM,4,40,35,5,1
29-03-2025,Oils & Ghee,Sesame oil 1 L,9,590,560,30,1
29-03-2025,"Grains, Flours & Dals",PESARA PAPPU 500GMS,4,85,75,10,1
29-03-2025,"Grains, Flours & Dals",SABDANA 500GM,4,90,70,20,1
29-03-2025,Oils & Ghee,Groundnut oil 1 L,9,360,330,30,1
29-03-2025,Spices & Seasonings,DRY MIECHI 200GM,15,80,60,20,1
29-03-2025,Pooja & Spiritual Items,SWASTIK CAMPHORE,12,90,90,0,1
29-03-2025,Sweeteners,YB JAGGERY POWDER 500GMS,16,75,75,0,1
29-03-2025,Sweeteners,ACHUBELLAM 500GM,16,50,40,10,1
29-03-2025,Sweeteners,MISHRI D,16,40,30,10,1
29-03-2025,Snacks & Ready-to-Eat,SS IDLY BATTER 1KG,14,60,60,0,1
29-03-2025,"Grains, Flours & Dals",WHEAT 1 KG,4,180,150,30,3
29-03-2025,Spices & Seasonings,AV Iodized Salt 1KG,15,28,25,3,1
29-03-2025,"Grains, Flours & Dals",SL Idly Rava 1KG,4,65,55,10,1
29-03-2025,Pooja & Spiritual Items,KASHI ASHTAGANDHA CHANDHANA,12,20,20,0,1
29-03-2025,Spices & Seasonings,DRY MIECHI 200GM,15,80,60,20,1
29-03-2025,"Grains, Flours & Dals",SL Suji Rava 500GM,4,32,32,0,1
29-03-2025,"Grains, Flours & Dals",white Bobarlu 1 KG,4,170,150,20,1
29-03-2025,Pooja & Spiritual Items,SWAATHI GATTI DEEPAM VATTULU,12,60,60,0,2
29-03-2025,Personal Care & Cosmetics,HIMALAYA LIP BALM 10GM,10,80,80,0,2
29-03-2025,Spices & Seasonings,ROYAL SAFFRON,15,125,125,0,1
29-03-2025,Milk & Dairy,SANGAM TONED MILK 500ML,7,60,60,0,2
29-03-2025,"Dry Fruits, Nuts & Seeds",Groundnuts 1 kg,2,190,165,25,1
29-03-2025,"Grains, Flours & Dals",Red Wheat Flour 1 kg,4,140,130,10,1
29-03-2025,Spices & Seasonings,Jeera 100GM,15,50,45,5,1
29-03-2025,"Grains, Flours & Dals",PESARA PAPPU 500GMS,4,85,75,10,1
29-03-2025,Spices & Seasonings,Tamarind 250GMS,15,160,130,30,2
29-03-2025,"Dry Fruits, Nuts & Seeds",Putnalu 250GM,2,45,38,7,1
29-03-2025,"Grains, Flours & Dals",SRILATHA RICE RAVVA 500GM,4,35,35,0,1
29-03-2025,"Grains, Flours & Dals",SB Javva Wheat Ravva 500GM,4,90,90,0,1
29-03-2025,Sweeteners,MADHUR SUGAR 1KG,16,65,55,10,1
29-03-2025,Pooja & Spiritual Items,GD Sree Chandan 50GM,12,50,50,0,1
29-03-2025,"Grains, Flours & Dals",CHANA DAL 1KG,4,140,120,20,1
29-03-2025,Pooja & Spiritual Items,GD Camphor 50GM,12,115,115,0,1
29-03-2025,"Grains, Flours & Dals",HS RAGI Idly rava 500 gms,4,70,70,0,1
29-03-2025,Personal Care & Cosmetics,GOW DURBAR 75G,10,60,60,0,1
29-03-2025,Oils & Ghee,Groundnut oil 1 L,9,360,330,30,1
29-03-2025,Spices & Seasonings,ROYAL SAFFRON,15,125,125,0,1
29-03-2025,"Grains, Flours & Dals",Bombay Rava 500GM,4,35,30,5,1
29-03-2025,Spices & Seasonings,dalchin chekka,15,50,40,10,1
29-03-2025,Spices & Seasonings,NUVVULU 500GM,15,200,170,30,1
29-03-2025,"Grains, Flours & Dals",Green gram 1 kg,4,150,130,20,1
29-03-2025,"Dry Fruits, Nuts & Seeds",Groundnuts 1 kg,2,190,165,25,1
29-03-2025,"Grains, Flours & Dals",CHANA DAL 500GM,4,70,60,10,1
29-03-2025,"Grains, Flours & Dals",split black gram 1 kg,4,180,170,10,1
29-03-2025,Snacks & Ready-to-Eat,RSC ORANGE 100GMS,14,20,20,0,1
29-03-2025,Spices & Seasonings,AVALU 100GM,15,25,20,5,1
29-03-2025,Snacks & Ready-to-Eat,Corn Chips 250GM,14,80,70,10,2
29-03-2025,Spices & Seasonings,Jeera 100GM,15,50,45,5,1
29-03-2025,"Grains, Flours & Dals",BOMBAY RAVA,4,70,55,15,1
29-03-2025,Snacks & Ready-to-Eat,Corn Chips 250GM,14,80,70,10,2
29-03-2025,Sweeteners,YB JAGGERY POWDER 500GMS,16,75,75,0,1
29-03-2025,Milk & Dairy,BROWN EGGS 1P,7,168,144,24,12
29-03-2025,Snacks & Ready-to-Eat,VD DRY FRUIT PUTHAREKULU,14,120,120,0,1
29-03-2025,Snacks & Ready-to-Eat,SD Aswagandha with palm Jaggery250Gm,14,135,135,0,1
29-03-2025,"Grains, Flours & Dals",Red Wheat Flour 1 kg,4,140,130,10,1
29-03-2025,"Grains, Flours & Dals",Yellow jowar .F1 kg,4,110,100,10,1
29-03-2025,Oils & Ghee,cow ghee 500 ml,9,430,390,40,1
29-03-2025,"Grains, Flours & Dals",ANDU KORRALU (Brown top .mlt) 500,4,130,110,20,1
29-03-2025,"Grains, Flours & Dals",Bajra Flour 1 kg,4,70,60,10,1
29-03-2025,Oils & Ghee,A2 BUFFALO GHEE 250ML,9,299,299,0,1
29-03-2025,"Dry Fruits, Nuts & Seeds",DRYDATES YELLOW 250GM,2,135,120,15,1
29-03-2025,Spices & Seasonings,Dalchin Chekka 50GM,15,50,40,10,1
29-03-2025,"Grains, Flours & Dals",RICE FLOUR 500 GM,4,35,28,7,1
29-03-2025,"Grains, Flours & Dals",SABDANA,4,40,35,5,1
29-03-2025,Spices & Seasonings,RED COPRA 250GMS,15,85,74,11,1
29-03-2025,Spices & Seasonings,ROYAL SAFFRON 400GRMS,15,65,65,0,1
29-03-2025,Spices & Seasonings,Menthulu 250 gms,15,50,45,5,1
29-03-2025,"Grains, Flours & Dals",split black gram 1 kg,4,180,170,10,1
29-03-2025,Spices & Seasonings,JEERA 250 gms,15,125,105,20,1
29-03-2025,"Grains, Flours & Dals",CHANA DAL 500GM,4,70,60,10,1
29-03-2025,"Dry Fruits, Nuts & Seeds",PULMAKHANA 100 GM,2,360,340,20,2
29-03-2025,"Grains, Flours & Dals",JOWAR WHITE 1 KG,4,80,70,10,1
29-03-2025,"Grains, Flours & Dals",Quinova 500 gms,4,220,200,20,2
29-03-2025,"Dry Fruits, Nuts & Seeds",SATHVI CHIA SEEDS 100GM,2,200,160,40,2
29-03-2025,Oils & Ghee,Safflower oil 1 L,9,440,400,40,1
29-03-2025,"Dry Fruits, Nuts & Seeds",Putnalu 250GM,2,45,38,7,1
29-03-2025,"Grains, Flours & Dals",Em jowar idly R 500G,4,75,75,0,1
29-03-2025,Spices & Seasonings,GREEN SOUNF,15,60,40,20,1
29-03-2025,"Dry Fruits, Nuts & Seeds",SUNFLOWER SEEDS 250GRM,2,150,130,20,1
29-03-2025,Pooja & Spiritual Items,KASHI ASHTAGANDHA CHANDHANA,12,20,20,0,1
29-03-2025,"Grains, Flours & Dals",RICE FLOUR 1KG,4,70,55,15,1
29-03-2025,Spices & Seasonings,ROYAL SAFFRON 400GRMS,15,65,65,0,1
29-03-2025,"Grains, Flours & Dals",Chana Flour 500 gms,4,70,65,5,1
29-03-2025,"Grains, Flours & Dals",Yellow jowar .F1 kg,4,110,100,10,1
29-03-2025,Snacks & Ready-to-Eat,Popcorn Seeds 250GM,14,45,40,5,1
29-03-2025,"Dry Fruits, Nuts & Seeds",SATHVI CHIA SEEDS 100GM,2,100,80,20,1
29-03-2025,"Grains, Flours & Dals",Multigrain 1 kg,4,100,85,15,1
29-03-2025,Pooja & Spiritual Items,SWAATHI GATTI DEEPAM VATTULU,12,30,30,0,1
29-03-2025,Spices & Seasonings,LG 50GM,15,92,92,0,1
29-03-2025,"Grains, Flours & Dals",RAJMA 250GM,4,55,45,10,1
29-03-2025,Oils & Ghee,Safflower oil 500 ml,9,220,200,20,1
29-03-2025,Oils & Ghee,Sesame oil 500ml,9,295,280,15,1
29-03-2025,Oils & Ghee,Flaxseed oil 500 ml,9,300,270,30,1
29-03-2025,"Grains, Flours & Dals",RAGI FLOUR 1KG,4,80,70,10,1
29-03-2025,Snacks & Ready-to-Eat,VD MULTI CHAKKA,14,110,110,0,1
29-03-2025,"Grains, Flours & Dals",CHANA DAL 500GM,4,70,60,10,1
29-03-2025,"Grains, Flours & Dals",SRILALITHA MAIDA FLOUR 500G,4,32,32,0,1
29-03-2025,General Household & Kitchenware,SIRIDHANYALU BOOK,3,200,180,20,1
29-03-2025,"Grains, Flours & Dals",SPLIT BLACK GRAM 500 GM,4,90,85,5,1
29-03-2025,Household & Cleaning,VIM SOAP,6,35,35,0,7
29-03-2025,"Grains, Flours & Dals",split black gram 1 kg,4,180,170,10,1
29-03-2025,Spices & Seasonings,Jeera 100GM,15,50,45,5,1
29-03-2025,"Grains, Flours & Dals",Wheat Flour 1 kg,4,70,60,10,1
29-03-2025,Misc,VD00014,8,100,90,10,1
29-03-2025,Spices & Seasonings,GS Moringa Leaves Spicy Powder 100GM,15,90,90,0,1
29-03-2025,"Grains, Flours & Dals",SL Idly Rava 1KG,4,65,55,10,1
29-03-2025,"Grains, Flours & Dals",SAMALU,4,170,130,40,1
29-03-2025,"Grains, Flours & Dals",BOBBARA PAPPU 500GM,4,85,80,5,1
29-03-2025,"Grains, Flours & Dals",split green gram 1 kg,4,150,140,10,1
29-03-2025,"Grains, Flours & Dals",CHANA DAL 500GM,4,70,60,10,1
29-03-2025,"Dry Fruits, Nuts & Seeds",Groundnuts 1 kg,2,380,330,50,2
29-03-2025,Spices & Seasonings,ROYAL SAFFRON 400GRMS,15,195,195,0,3
29-03-2025,"Grains, Flours & Dals",PESARA PAPPU 500GMS,4,85,75,10,1
29-03-2025,"Grains, Flours & Dals",Wheat Flour 1 kg,4,70,60,10,1
29-03-2025,"Grains, Flours & Dals",Bajra Flour 500 gms,4,35,30,5,1
29-03-2025,"Grains, Flours & Dals",turdal 1kg,4,440,340,100,2
29-03-2025,"Grains, Flours & Dals",Green gram 500 gms,4,75,70,5,1
29-03-2025,"Grains, Flours & Dals",RICE FLOUR 500 GM,4,35,28,7,1
29-03-2025,Oils & Ghee,Groundnut oil 1 L,9,360,330,30,1
29-03-2025,"Dry Fruits, Nuts & Seeds",PUTNALU 500GMS,2,90,76,14,1
29-03-2025,"Grains, Flours & Dals",White jowar.F 500 Gms,4,50,40,10,1
29-03-2025,Spices & Seasonings,Tamarind 500GM,15,160,130,30,1
29-03-2025,Spices & Seasonings,PN ORGANIC PINK SALT 1KG,15,124,124,0,1
29-03-2025,Spices & Seasonings,JEERA 250 gms,15,125,105,20,1
29-03-2025,"Dry Fruits, Nuts & Seeds",Groundnuts 1 kg,2,190,165,25,1
29-03-2025,"Grains, Flours & Dals",Idly Rava L 1KG,4,60,50,10,1
29-03-2025,"Grains, Flours & Dals",Urad dall 1 Kg,4,185,170,15,1
29-03-2025,"Grains, Flours & Dals",PESARA PAPPU 1 KG,4,170,145,25,1
29-03-2025,Spices & Seasonings,Coriander seeds 200 gms,15,96,80,16,2
29-03-2025,Sweeteners,SUGAR 500 GM,16,30,25,5,1
29-03-2025,Spices & Seasonings,ROYAL SAFFRON 400GRMS,15,65,65,0,1
29-03-2025,Oils & Ghee,rice bran oil f,9,194,169,25,1
29-03-2025,Spices & Seasonings,DRY MIECHI 200GM,15,80,60,20,1
29-03-2025,"Grains, Flours & Dals",CHANA DAL 500GM,4,70,60,10,1
29-03-2025,"Grains, Flours & Dals",turdal 500 gms,4,110,85,25,1
29-03-2025,Spices & Seasonings,ROYAL SAFFRON 400GRMS,15,130,130,0,2
29-03-2025,Personal Care & Cosmetics,HERBAL ROSE SPRAY 250ML,10,225,225,0,1
29-03-2025,Sweeteners,SUGAR 1KG,16,60,50,10,1
29-03-2025,Spices & Seasonings,Jeera 100GM,15,50,45,5,1
29-03-2025,Spices & Seasonings,Tamarind 250GMS,15,80,65,15,1
29-03-2025,Pooja & Spiritual Items,SWAATHI GATTI DEEPAM VATTULU,12,30,30,0,1
29-03-2025,Spices & Seasonings,Elaichi 25GM,15,145,120,25,1
29-03-2025,"Grains, Flours & Dals",Wheat Flour 1 kg,4,140,120,20,2
29-03-2025,Household & Cleaning,VIM EXTRA 110GM,6,50,50,0,5
29-03-2025,Sweeteners,MISHRI D,16,40,30,10,1
29-03-2025,Personal Care & Cosmetics,kadhi neem tulsi,10,90,90,0,1
29-03-2025,Spices & Seasonings,NUVVULU 250GM,15,80,65,15,1
29-03-2025,"Grains, Flours & Dals",VYS.SP RICE 1 KG,4,70,65,5,1
29-03-2025,Snacks & Ready-to-Eat,JUNNU POWDER 100GM,14,70,70,0,1
29-03-2025,"Grains, Flours & Dals",Wheat Flour 1 kg,4,140,120,20,2
29-03-2025,"Grains, Flours & Dals",CHANA DAL 500GM,4,70,60,10,1
29-03-2025,Snacks & Ready-to-Eat,VD PALLI LADDU,14,80,80,0,1
29-03-2025,Misc,VD00014,8,100,90,10,1
29-03-2025,Spices & Seasonings,Telaga Pindi 250 GM,15,40,35,5,1
29-03-2025,Sweeteners,NATURAL HONEY 250GM,16,150,130,20,1
29-03-2025,"Grains, Flours & Dals",RICE FLOUR 1KG,4,70,55,15,1
29-03-2025,"Grains, Flours & Dals",RICE FLOUR 500 GM,4,35,28,7,1
29-03-2025,Snacks & Ready-to-Eat,VD MURMURA LADDU,14,50,50,0,1
29-03-2025,Snacks & Ready-to-Eat,VD PALLI CHIKKI,14,80,80,0,1
29-03-2025,"Grains, Flours & Dals",POORI ATTA 1KG,4,70,60,10,1
29-03-2025,Oils & Ghee,Sesame oil 500ml,9,295,280,15,1
29-03-2025,"Grains, Flours & Dals",Wheat Flour 1 kg,4,140,120,20,2
29-03-2025,Milk & Dairy,HRITAGE TOTAL CURD 130GM,7,10,10,0,1
29-03-2025,Spices & Seasonings,Tamarind 250GMS,15,80,65,15,1
29-03-2025,"Grains, Flours & Dals",Wheat Flour 1 kg,4,70,60,10,1
29-03-2025,Milk & Dairy,HERITAGE TONED MILK 500ML,7,31,31,0,1
29-03-2025,Spices & Seasonings,ROYAL SAFFRON 400GRMS,15,65,65,0,1
29-03-2025,Sweeteners,SUGAR 1KG,16,60,50,10,1
29-03-2025,Pooja & Spiritual Items,GD KUMKUM 50GM,12,30,30,0,1
29-03-2025,Spices & Seasonings,Turmeric powder 250 gms,15,100,75,25,1
29-03-2025,Pooja & Spiritual Items,GD Sree Chandan 50GM,12,50,50,0,1
29-03-2025,Spices & Seasonings,ROYAL SAFFRON 400GRMS,15,65,65,0,1
29-03-2025,Sweeteners,YB JAGGERY POWDER 1KG,16,140,140,0,1
29-03-2025,Spices & Seasonings,DRY MIECHI 200GM,15,80,60,20,1
29-03-2025,"Grains, Flours & Dals",Urad dall 1 Kg,4,185,170,15,1
29-03-2025,Spices & Seasonings,Tamarind 500GM,15,160,130,30,1
29-03-2025,"Grains, Flours & Dals",idly ravva,4,65,65,0,1
29-03-2025,"Grains, Flours & Dals",COW B rice 1 kg,4,144,138,6,2
29-03-2025,"Dry Fruits, Nuts & Seeds",SD Mango cubes 100gm,2,45,45,0,1
29-03-2025,"Grains, Flours & Dals",VYS.SP RICE 1 KG,4,140,130,10,2
29-03-2025,Spices & Seasonings,Tamarind 250GMS,15,80,65,15,1
29-03-2025,"Grains, Flours & Dals",Wheat Flour 1 kg,4,210,180,30,3
29-03-2025,Sweeteners,YB JAGGERY POWDER 500GMS,16,150,150,0,2
29-03-2025,"Grains, Flours & Dals",BOMBAY RAVA,4,70,55,15,1
29-03-2025,"Grains, Flours & Dals",Multigrain 1 kg,4,100,85,15,1
29-03-2025,"Grains, Flours & Dals",POORI ATTA 1KG,4,70,60,10,1
29-03-2025,"Grains, Flours & Dals",SRILALITHA MAIDA FLOUR 500G,4,64,64,0,2
29-03-2025,"Grains, Flours & Dals",White jowar.F 1 kg,4,200,160,40,2
29-03-2025,Sweeteners,SUGAR 1KG,16,60,50,10,1
29-03-2025,"Grains, Flours & Dals",Chana Flour 500 gms,4,70,65,5,1
29-03-2025,"Grains, Flours & Dals",RICE FLOUR 1KG,4,70,55,15,1
29-03-2025,Sweeteners,ACHUBELLAM 500GM,16,50,40,10,1
29-03-2025,"Grains, Flours & Dals",Green gram 500 gms,4,75,70,5,1
29-03-2025,Oils & Ghee,Coconut oil 1 L,9,440,400,40,1
29-03-2025,"Grains, Flours & Dals",RAGI FLOUR 500GRMS,4,40,35,5,1
29-03-2025,"Grains, Flours & Dals",Wheat Flour 1 kg,4,140,120,20,2
29-03-2025,"Dry Fruits, Nuts & Seeds",sabja seeds,2,80,70,10,1
29-03-2025,"Grains, Flours & Dals",JOWAR WHITE 1 KG,4,80,70,10,1
29-03-2025,Oils & Ghee,Groundnut oil 1 L,9,720,660,60,2
29-03-2025,"Grains, Flours & Dals",KORRALU (FOXTAIL M) 1KG,4,150,110,40,1
29-03-2025,"Dry Fruits, Nuts & Seeds",PUMPKIN SEEDS 250GM,2,200,160,40,1
29-03-2025,Snacks & Ready-to-Eat,RAJGIRA PEANUT CHIKKI,14,5,5,0,1
29-03-2025,"Dry Fruits, Nuts & Seeds",SUNFLOWER SEEDS 250GRM,2,150,130,20,1
29-03-2025,"Health, Wellness & Ayurvedic Products",MXP CREAM ONION,5,45,45,0,1
29-03-2025,General Household & Kitchenware,B3 BOWL,3,265,265,0,1
29-03-2025,"Grains, Flours & Dals",Brown RICE 1KG,4,140,130,10,2
29-03-2025,"Health, Wellness & Ayurvedic Products",RB Nuts& Seeds cashews 35g,5,45,45,0,1
29-03-2025,"Grains, Flours & Dals",BARLEY SEEDS 250GMS,4,40,35,5,1
29-03-2025,"Grains, Flours & Dals",Red Chana 250GM,4,35,30,5,1
29-03-2025,"Grains, Flours & Dals",CHANA DAL 500GM,4,70,60,10,1
29-03-2025,"Grains, Flours & Dals",turdal 500 gms,4,110,85,25,1
29-03-2025,"Grains, Flours & Dals",Chana Flour 500 gms,4,70,65,5,1
29-03-2025,"Dry Fruits, Nuts & Seeds",Groundnuts 500 gms,2,95,85,10,1
29-03-2025,"Grains, Flours & Dals",SL Suji Rava 500GM,4,32,32,0,1
29-03-2025,"Grains, Flours & Dals",RICE FLOUR 1KG,4,140,110,30,2
29-03-2025,Spices & Seasonings,NUVVULU 250GM,15,100,85,15,1
29-03-2025,"Dry Fruits, Nuts & Seeds",ALMONDS 250GM,2,560,520,40,2
29-03-2025,"Grains, Flours & Dals",Wheat Rava M 500GM,4,33,30,3,1
29-03-2025,"Grains, Flours & Dals",PESARA PAPPU 500GMS,4,85,75,10,1
29-03-2025,"Grains, Flours & Dals",RAGI FLOUR 500GRMS,4,40,35,5,1
29-03-2025,Snacks & Ready-to-Eat,murmura venk,14,50,45,5,1
29-03-2025,"Grains, Flours & Dals",THICK POHA 1KG,4,80,70,10,1
29-03-2025,Baking & Cooking Aids,GONDKATIRA Ag,0,85,75,10,1
29-03-2025,"Grains, Flours & Dals",URAD DALL,4,95,85,10,1
29-03-2025,"Grains, Flours & Dals",Wheat Flour 1 kg,4,70,60,10,1
29-03-2025,"Dry Fruits, Nuts & Seeds",Putnalu 250GM,2,45,38,7,1
29-03-2025,"Grains, Flours & Dals",Wheat Rava S 1KG,4,65,55,10,1
29-03-2025,"Grains, Flours & Dals",SRILATHA RICE RAVVA 500GM,4,70,70,0,2
29-03-2025,"Dry Fruits, Nuts & Seeds",Putnalu 250GM,2,45,38,7,1
29-03-2025,"Grains, Flours & Dals",BOMBAY RAVA,4,70,55,15,1
29-03-2025,Spices & Seasonings,AVALU 100GM,15,50,40,10,2
29-03-2025,"Grains, Flours & Dals",CHANA DAL 500GM,4,70,60,10,1
29-03-2025,"Grains, Flours & Dals",Urad dall 1 Kg,4,370,340,30,2
29-03-2025,"Dry Fruits, Nuts & Seeds",Groundnuts 1 kg,2,190,165,25,1
29-03-2025,"Grains, Flours & Dals",KORRALU (FOXTAIL M) 500GM,4,65,55,10,1
29-03-2025,Sweeteners,SUGAR 1KG,16,60,50,10,1
29-03-2025,"Dry Fruits, Nuts & Seeds",PUTNALU 500GMS,2,90,76,14,1
29-03-2025,"Grains, Flours & Dals",POORI ATTA 500GM,4,35,30,5,1
29-03-2025,"Grains, Flours & Dals",RED TURDAL 500GM,4,75,70,5,1
29-03-2025,"Grains, Flours & Dals",split urad dall 250 gms,4,45,40,5,1
29-03-2025,Pooja & Spiritual Items,GB Bharatha Woods 75GM,12,60,60,0,1
29-03-2025,Spices & Seasonings,ROYAL SAFFRON 400GRMS,15,65,65,0,1
29-03-2025,"Grains, Flours & Dals",PESARA PAPPU 1 KG,4,170,145,25,1
29-03-2025,Pooja & Spiritual Items,GD TULASI 75GM,12,60,60,0,1
29-03-2025,Spices & Seasonings,SAJEERA,15,60,40,20,1
29-03-2025,Beverages,REFRESH SHARBATH NORMAL,1,199,190,9,1
29-03-2025,"Grains, Flours & Dals",VYS.SP.RICE BAG 1,4,1800,"1,650.00",150,1
29-03-2025,"Grains, Flours & Dals",turdal 1kg,4,220,170,50,1
29-03-2025,Snacks & Ready-to-Eat,JUNNU POWDER 100GM,14,70,70,0,1
29-03-2025,"Dry Fruits, Nuts & Seeds",cashew,2,340,310,30,1
29-03-2025,"Grains, Flours & Dals",MAIDA 1KG,4,70,60,10,1
29-03-2025,Snacks & Ready-to-Eat,urban murmura,14,60,55,5,1
29-03-2025,"Grains, Flours & Dals",Wheat Rava M 500GM,4,33,30,3,1
29-03-2025,"Grains, Flours & Dals",PESARA PAPPU 1 KG,4,170,145,25,1
29-03-2025,"Grains, Flours & Dals",BASMATHI RICE 1KG,4,150,135,15,1
29-03-2025,Spices & Seasonings,ROYAL SAFFRON 400GRMS,15,130,130,0,2
29-03-2025,"Grains, Flours & Dals",Chana Flour 500 gms,4,70,65,5,1
29-03-2025,"Dry Fruits, Nuts & Seeds",PULMAKHANA 100 GM,2,720,680,40,4
29-03-2025,Snacks & Ready-to-Eat,SD Vamu with palm jaggery 250gm,14,135,135,0,1
29-03-2025,Snacks & Ready-to-Eat,VD DRY FRUIT PUTHAREKULU,14,120,120,0,1
29-03-2025,Misc,VD0001,8,100,100,0,1
29-03-2025,"Health, Wellness & Ayurvedic Products",RB Max Protein Salt & Caramel Bar 50g,5,75,75,0,1
29-03-2025,Sweeteners,SD PALM JAGGERY 500GM,16,200,200,0,1
29-03-2025,Personal Care & Cosmetics,GOW DURBAR 75G,10,60,60,0,1
29-03-2025,Oils & Ghee,Groundnut oil 1 L,9,360,330,30,1
29-03-2025,Snacks & Ready-to-Eat,SD KODO MILLET WITH PALM JAGGERY,14,135,135,0,1
29-03-2025,Snacks & Ready-to-Eat,SD MASALA GAVVALU 200GM,14,95,95,0,1
29-03-2025,Pooja & Spiritual Items,HERBAL VETIVER STICK 20INC,12,45,45,0,1
29-03-2025,Personal Care & Cosmetics,ROUND LOOFAH,10,65,65,0,1
29-03-2025,"Grains, Flours & Dals",CHANA DAL 500GM,4,70,60,10,1
29-03-2025,"Dry Fruits, Nuts & Seeds",SD Mango cubes 100gm,2,45,45,0,1
29-03-2025,Sweeteners,SUGAR 1KG,16,60,50,10,1
29-03-2025,"Grains, Flours & Dals",VGR rice 1 kg,4,140,130,10,2
29-03-2025,Snacks & Ready-to-Eat,DOSA BATTER 1KG,14,60,60,0,1
29-03-2025,"Health, Wellness & Ayurvedic Products",RB Max Protein Choco chips 55gm,5,50,50,0,1
29-03-2025,Baking & Cooking Aids,Baking Soda 50GM,0,60,45,15,3
29-03-2025,Personal Care & Cosmetics,HEART SHAPE LOOFAH,10,79,79,0,1
29-03-2025,Snacks & Ready-to-Eat,NGT CHATPATTA CHANA 90GM,14,75,75,0,3
29-03-2025,Beverages,BISLERI WATER 1L,1,20,20,0,1
29-03-2025,"Grains, Flours & Dals",Wheat Flour 1 kg,4,70,60,10,1
29-03-2025,"Grains, Flours & Dals",RAGULU 1 KG,4,70,60,10,1
29-03-2025,"Grains, Flours & Dals",SAMALU (Little millet) 500 gms,4,85,65,20,1
29-03-2025,Spices & Seasonings,LG 50GM,15,92,92,0,1
29-03-2025,"Dry Fruits, Nuts & Seeds",WATERMELON SEEDS 250GRM,2,320,280,40,1
29-03-2025,"Grains, Flours & Dals",RICE FLOUR 1KG,4,70,55,15,1
29-03-2025,Oils & Ghee,Groundnut oil 500ml,9,180,165,15,1
29-03-2025,"Dry Fruits, Nuts & Seeds",PUMPKIN SEEDS 250GM,2,200,160,40,1
29-03-2025,Spices & Seasonings,Turmeric powder 250 gms,15,100,75,25,1
29-03-2025,Oils & Ghee,Sesame oil 500ml,9,295,280,15,1
29-03-2025,"Grains, Flours & Dals",turdal 500 gms,4,110,85,25,1
29-03-2025,"Grains, Flours & Dals",JOWAR WHITE 1 KG,4,80,70,10,1
29-03-2025,"Grains, Flours & Dals",KORRALU (FOXTAIL M) 500GM,4,65,55,10,1
29-03-2025,"Grains, Flours & Dals",AISHWARAYA IDLY RAVA 1KG,4,99,66,33,1
29-03-2025,"Grains, Flours & Dals",Chana Flour 500 gms,4,70,65,5,1
29-03-2025,"Grains, Flours & Dals",BASMATHI RICE 1KG,4,150,135,15,1
29-03-2025,"Grains, Flours & Dals",Wheat Flour 1 kg,4,70,60,10,1
29-03-2025,"Grains, Flours & Dals",RAGI FLOUR 500GRMS,4,40,35,5,1
29-03-2025,"Dry Fruits, Nuts & Seeds",ANJEER 250GM,2,400,360,40,1
29-03-2025,General Household & Kitchenware,SIRIDHANYALU BOOK,3,200,180,20,1
29-03-2025,"Grains, Flours & Dals",SABDANA,4,40,35,5,1
29-03-2025,Snacks & Ready-to-Eat,VD SAGOPAPAD 150GM,14,55,55,0,1
29-03-2025,"Dry Fruits, Nuts & Seeds",SD Mango cubes 100gm,2,45,45,0,1
29-03-2025,"Grains, Flours & Dals",RED TURDAL 500GM,4,75,70,5,1
29-03-2025,Household & Cleaning,VIM SOAP,6,60,60,0,12
29-03-2025,"Grains, Flours & Dals",SL Idly Rava 1KG,4,65,55,10,1
29-03-2025,General Household & Kitchenware,MATCH BOX,3,20,20,0,1
29-03-2025,Beverages,BISLERI 100ml,1,10,10,0,1
29-03-2025,Spices & Seasonings,ROYAL SAFFRON,15,125,125,0,1
29-03-2025,Sweeteners,NATURAL HONEY 250GM,16,150,130,20,1
29-03-2025,Snacks & Ready-to-Eat,sagopapad red chilli,14,55,55,0,1
29-03-2025,"Health, Wellness & Ayurvedic Products",MD Aamlaki Choornam 100GM,5,160,160,0,2
29-03-2025,"Health, Wellness & Ayurvedic Products",MD Tulasi Leaf Powder 50GM,5,80,80,0,1
29-03-2025,Snacks & Ready-to-Eat,VD RICE PAPAD 150GM,14,50,50,0,1
29-03-2025,"Grains, Flours & Dals",unpolished turdall500grms,4,120,110,10,1
29-03-2025,"Dry Fruits, Nuts & Seeds",sabja seeds,2,80,70,10,1
29-03-2025,Personal Care & Cosmetics,MYSORE SANDAL SOAP 75G,10,42,42,0,1
29-03-2025,"Grains, Flours & Dals",Urad dall 1 Kg,4,185,170,15,1
29-03-2025,Personal Care & Cosmetics,Soapnut 250GM,10,60,45,15,1
29-03-2025,"Dry Fruits, Nuts & Seeds",Groundnuts 1 kg,2,190,165,25,1
29-03-2025,"Grains, Flours & Dals",SABDANA,4,40,35,5,1
29-03-2025,"Dry Fruits, Nuts & Seeds",PUTNALU 500GMS,2,90,76,14,1
29-03-2025,Spices & Seasonings,ROYAL SAFFRON 400GRMS,15,65,65,0,1
29-03-2025,Pooja & Spiritual Items,SWASTIK CAMPHORE,12,90,90,0,1
29-03-2025,"Grains, Flours & Dals",AISHWARAYA IDLY RAVA 1KG,4,198,132,66,2
29-03-2025,Household & Cleaning,VIM SOAP,6,20,20,0,4
29-03-2025,Sweeteners,SUGAR 500 GM,16,30,25,5,1
29-03-2025,Snacks & Ready-to-Eat,VD MULTI CHAKKA,14,110,110,0,1
29-03-2025,"Grains, Flours & Dals",RAGI FLOUR 1KG,4,80,70,10,1
29-03-2025,Pooja & Spiritual Items,SOSR GATTI DEEPAM VATTULU 125PICS,12,30,30,0,1
29-03-2025,Oils & Ghee,Coconut oil 500 ml,9,220,200,20,1
29-03-2025,"Grains, Flours & Dals",URAD DALL,4,95,85,10,1
29-03-2025,"Grains, Flours & Dals",turdal 1kg,4,220,170,50,1
28-03-2025,Milk & Dairy,BROWN EGGS 1P,7,84,72,12,6
28-03-2025,Snacks & Ready-to-Eat,NGT CHATPATTA CHANA 90GM,14,25,25,0,1
28-03-2025,"Grains, Flours & Dals",Wheat Flour 1 kg,4,70,60,10,1
28-03-2025,"Dry Fruits, Nuts & Seeds",Groundnuts 1 kg,2,190,165,25,1
28-03-2025,Spices & Seasonings,SATHVI ANASAPUVUU 25GM,15,90,65,25,1
28-03-2025,"Dry Fruits, Nuts & Seeds",Groundnuts 500 gms,2,95,85,10,1
28-03-2025,Personal Care & Cosmetics,MYSORE SANDAL SOAP 75G,10,126,126,0,3
28-03-2025,"Grains, Flours & Dals",turdal 500 gms,4,110,85,25,1
28-03-2025,Sweeteners,YB JAGGERY POWDER 500GMS,16,75,75,0,1
28-03-2025,"Grains, Flours & Dals",SL Idly Rava 1KG,4,65,55,10,1
28-03-2025,Household & Cleaning,PITAMBARI,6,28,28,0,1
28-03-2025,"Grains, Flours & Dals",Bombay Rava 500GM,4,35,30,5,1
28-03-2025,"Grains, Flours & Dals",RICE FLOUR 500 GM,4,35,28,7,1
28-03-2025,Spices & Seasonings,DRY MIECHI 200GM,15,80,60,20,1
28-03-2025,Snacks & Ready-to-Eat,VD GUMMADI VADIYAM,14,75,75,0,1
28-03-2025,Spices & Seasonings,Tamarind 500GM,15,160,130,30,1
28-03-2025,Oils & Ghee,Sesame oil 500ml,9,295,280,15,1
28-03-2025,"Dry Fruits, Nuts & Seeds",Putnalu 250GM,2,45,38,7,1
28-03-2025,Oils & Ghee,Coconut oil 500 ml,9,220,200,20,1
28-03-2025,"Grains, Flours & Dals",Wheat Flour 1 kg,4,70,60,10,1
28-03-2025,"Grains, Flours & Dals",UNPOLISHED TURDALL 1KG,4,240,210,30,1
28-03-2025,Oils & Ghee,Safflower oil 1 L,9,440,400,40,1
28-03-2025,Spices & Seasonings,Tamarind 250GMS,15,80,65,15,1
28-03-2025,"Grains, Flours & Dals",Arikadu ( kodo),4,140,130,10,1
28-03-2025,Pooja & Spiritual Items,SOSR GATTI DEEPAM VATTULU 125PICS,12,30,30,0,1
28-03-2025,Spices & Seasonings,AVALU 250grms,15,60,60,0,1
28-03-2025,Spices & Seasonings,menthulu,15,90,90,0,1
28-03-2025,"Grains, Flours & Dals",Chana Flour 1 kg,4,140,130,10,1
28-03-2025,"Grains, Flours & Dals",KORRALU (FOXTAIL M) 1KG,4,150,110,40,1
28-03-2025,Oils & Ghee,Groundnut oil 1 L,9,360,330,30,1
28-03-2025,"Grains, Flours & Dals",White jowar.F 1 kg,4,100,80,20,1
28-03-2025,"Grains, Flours & Dals",POORI ATTA 500GM,4,35,30,5,1
28-03-2025,"Dry Fruits, Nuts & Seeds",Groundnuts 1 kg,2,190,165,25,1
28-03-2025,Spices & Seasonings,JEERA 250 gms,15,125,105,20,1
28-03-2025,"Grains, Flours & Dals",Urad dall 1 Kg,4,185,170,15,1
28-03-2025,"Grains, Flours & Dals",Wheat Flour 2 kgs,4,140,120,20,1
28-03-2025,Oils & Ghee,Coconut oil 1 L,9,440,400,40,1
28-03-2025,"Grains, Flours & Dals",POORI ATTA 500GM,4,35,30,5,1
28-03-2025,Oils & Ghee,Groundnut oil 1 L,9,360,330,30,1
28-03-2025,"Grains, Flours & Dals",Wheat Rava M 500GM,4,33,30,3,1
28-03-2025,Snacks & Ready-to-Eat,SATHVI REGIVADA 200GM,14,80,60,20,1
28-03-2025,Spices & Seasonings,LG 50GM,15,92,92,0,1
28-03-2025,"Grains, Flours & Dals",Green gram 500 gms,4,75,70,5,1
28-03-2025,Sweeteners,SUGAR 1KG,16,60,50,10,1
28-03-2025,Oils & Ghee,Sesame oil 500ml,9,295,280,15,1
28-03-2025,"Grains, Flours & Dals",ANDU KORRALU (Browntop.m) 1 kg,4,260,220,40,1
28-03-2025,"Dry Fruits, Nuts & Seeds",SD Mango cubes 100gm,2,45,45,0,1
28-03-2025,Pooja & Spiritual Items,javadhu,12,60,60,0,1
28-03-2025,"Grains, Flours & Dals",white Bobarlu 500 gms,4,80,75,5,1
28-03-2025,"Grains, Flours & Dals",Chana Flour 500 gms,4,70,65,5,1
28-03-2025,"Grains, Flours & Dals",SABDANA,4,40,35,5,1
28-03-2025,Snacks & Ready-to-Eat,RB Choco Delite Almonds Raisins 40g,14,45,45,0,1
28-03-2025,"Grains, Flours & Dals",PRO ORG KABULI CHANNA 500GM,4,392,392,0,2
28-03-2025,"Grains, Flours & Dals",SAMALU,4,170,130,40,1
28-03-2025,Oils & Ghee,groundnet oil,9,1600,"1,600.00",0,1
28-03-2025,Beverages,BISLERI 100ml,1,10,10,0,1
28-03-2025,Sweeteners,MISHRI D,16,40,30,10,1
28-03-2025,Pooja & Spiritual Items,astamulika gugilam,12,50,50,0,1
28-03-2025,"Grains, Flours & Dals",PRO ORG MEDIUM POHA 500G,4,78,78,0,1
28-03-2025,"Grains, Flours & Dals",KORRALU (FOXTAIL M) 1KG,4,150,110,40,1
28-03-2025,"Grains, Flours & Dals",UDALU (Barnyard millet) 1 kg,4,140,115,25,1
28-03-2025,"Grains, Flours & Dals",RAGI FLOUR 500GRMS,4,40,35,5,1
28-03-2025,"Grains, Flours & Dals",Arikadu ( kodo),4,140,130,10,1
28-03-2025,"Grains, Flours & Dals",Wheat Flour 1 kg,4,70,60,10,1
28-03-2025,"Dry Fruits, Nuts & Seeds",Putnalu 250GM,2,45,38,7,1
28-03-2025,Spices & Seasonings,Tamarind 250GMS,15,80,65,15,1
28-03-2025,"Grains, Flours & Dals",CHANA DAL 500GM,4,140,120,20,2
28-03-2025,Spices & Seasonings,ROYAL SAFFRON,15,125,125,0,1
28-03-2025,Oils & Ghee,Black Sesame oil 500 ml,9,220,190,30,1
28-03-2025,Oils & Ghee,Groundnut oil 1 L,9,360,330,30,1
28-03-2025,Pooja & Spiritual Items,BALAJI ROSE DHOOP STIKS 10STK,12,125,125,0,1
28-03-2025,Pooja & Spiritual Items,GD Aiswarya Deepam 700ML,12,195,195,0,1
28-03-2025,"Grains, Flours & Dals",RAGI FLOUR 1KG,4,80,70,10,1
28-03-2025,Oils & Ghee,Coconut oil 500 ml,9,220,200,20,1
28-03-2025,"Grains, Flours & Dals",Yellow jowar.F 500 gms,4,55,50,5,1
28-03-2025,Pooja & Spiritual Items,GB Bharatha Woods 75GM,12,120,120,0,2
28-03-2025,"Grains, Flours & Dals",Urad dall 1 Kg,4,185,170,15,1
28-03-2025,"Dry Fruits, Nuts & Seeds",PUTNALU 500GMS,2,90,76,14,1
28-03-2025,"Grains, Flours & Dals",unpolished turdall500grms,4,120,110,10,1
28-03-2025,Oils & Ghee,Sesame oil 1 L,9,590,560,30,1
28-03-2025,"Grains, Flours & Dals",Wheat Flour 1 kg,4,70,60,10,1
28-03-2025,"Grains, Flours & Dals",SRILATHA RICE RAVVA 500GM,4,35,35,0,1
28-03-2025,Pooja & Spiritual Items,GOMATHA AGARBATHI,12,75,75,0,1
28-03-2025,Pooja & Spiritual Items,SWAATHI GATTI DEEPAM VATTULU,12,60,60,0,2
28-03-2025,"Grains, Flours & Dals",BOBBARA PAPPU 500GM,4,85,80,5,1
28-03-2025,Sweeteners,ACHU BELLAM 1KG,16,100,80,20,1
28-03-2025,Oils & Ghee,Groundnut oil 1 L,9,360,330,30,1
28-03-2025,Pooja & Spiritual Items,PACHAKARPURAM,12,60,50,10,1
28-03-2025,Spices & Seasonings,DRY MIECHI 200GM,15,80,60,20,1
28-03-2025,"Dry Fruits, Nuts & Seeds",KAJU HALF 250GM,2,310,290,20,1
28-03-2025,"Dry Fruits, Nuts & Seeds",SD Mango cubes 100gm,2,45,45,0,1
28-03-2025,Spices & Seasonings,Turmeric powder 250 gms,15,100,75,25,1
28-03-2025,Spices & Seasonings,JEERA 250 gms,15,125,105,20,1
28-03-2025,Spices & Seasonings,DURGA SALT CRYSTAL 1KG,15,25,25,0,1
28-03-2025,"Grains, Flours & Dals",CHANA DAL 500GM,4,70,60,10,1
28-03-2025,Oils & Ghee,rice bran oil f,9,194,169,25,1
28-03-2025,Personal Care & Cosmetics,MYSORE SANDAL SOAP 75G,10,42,42,0,1
28-03-2025,Snacks & Ready-to-Eat,RAJGIRA PEANUT CHIKKI 450GM,14,125,125,0,1
28-03-2025,Spices & Seasonings,GS Pink Rock Salt 1KG,15,120,120,0,1
28-03-2025,Oils & Ghee,Safflower oil 1 L,9,440,400,40,1
28-03-2025,Milk & Dairy,HERITAGE BUTTERMILK,7,40,40,0,4
28-03-2025,"Grains, Flours & Dals",Em Multimillet idli r 500g,4,129,129,0,1
28-03-2025,Oils & Ghee,Coconut oil 500 ml,9,220,200,20,1
28-03-2025,"Grains, Flours & Dals",Multigrain 1 kg,4,100,85,15,1
28-03-2025,"Health, Wellness & Ayurvedic Products",RB Max Protein Cheese&amp;,5,45,45,0,1
28-03-2025,"Dry Fruits, Nuts & Seeds",SUNFLOWER SEEDS 250GRM,2,150,130,20,1
28-03-2025,Milk & Dairy,SANGAM CURD 450GM,7,38,38,0,1
28-03-2025,"Dry Fruits, Nuts & Seeds",PUMPKIN SEEDS 250GM,2,200,160,40,1
28-03-2025,Pooja & Spiritual Items,GD Bhagavatha Mallika 75GM,12,60,60,0,1
28-03-2025,Pooja & Spiritual Items,GD JASMINE 75GM,12,60,60,0,1
28-03-2025,Pooja & Spiritual Items,bilwa patra,12,60,60,0,1
28-03-2025,"Grains, Flours & Dals",Wheat Flour 1 kg,4,140,120,20,2
28-03-2025,Oils & Ghee,Groundnut oil 1 L,9,720,660,60,2
28-03-2025,Sweeteners,GS JAGGERY NUGGETS 500GM,16,120,120,0,1
28-03-2025,Snacks & Ready-to-Eat,RAJGIRA PEANUT CHIKKI 450GM,14,125,125,0,1
28-03-2025,"Grains, Flours & Dals",Multigrain 1 kg,4,200,170,30,2
28-03-2025,"Grains, Flours & Dals",Wheat Rava S 1KG,4,65,55,10,1
28-03-2025,Snacks & Ready-to-Eat,SD Atreyapuram DRY Fruit ghee,14,150,150,0,1
28-03-2025,Snacks & Ready-to-Eat,SESAME CHIKKI,14,120,100,20,1
28-03-2025,Sweeteners,SD PALM JAGGERY 500GM,16,200,200,0,1
28-03-2025,Snacks & Ready-to-Eat,SD Groundnut with palm jaggery 250gm,14,135,135,0,1
28-03-2025,"Dry Fruits, Nuts & Seeds",YELLOW KISHMISH 250GM,2,130,110,20,1
28-03-2025,"Dry Fruits, Nuts & Seeds",Groundnuts 500 gms,2,95,85,10,1
28-03-2025,Oils & Ghee,Sesame oil 1 L,9,590,560,30,1
28-03-2025,Oils & Ghee,Groundnut oil 1 L,9,360,330,30,1
28-03-2025,Sweeteners,MADHUR SUGAR 1KG,16,65,55,10,1
28-03-2025,Spices & Seasonings,AVALU 250grms,15,60,60,0,1
28-03-2025,"Grains, Flours & Dals",RAGI FLOUR 1KG,4,80,70,10,1
28-03-2025,Spices & Seasonings,ROYAL SAFFRON,15,125,125,0,1
28-03-2025,"Grains, Flours & Dals",RICE FLOUR 1KG,4,70,55,15,1
28-03-2025,"Grains, Flours & Dals",unpolished turdall500grms,4,120,110,10,1
28-03-2025,"Grains, Flours & Dals",Chana Flour 500 gms,4,70,65,5,1
28-03-2025,"Grains, Flours & Dals",CHANA DAL 500GM,4,70,60,10,1
28-03-2025,Snacks & Ready-to-Eat,PEANUT CHILLI,14,5,5,0,1
28-03-2025,"Dry Fruits, Nuts & Seeds",Groundnuts 500 gms,2,95,85,10,1
28-03-2025,Spices & Seasonings,Menthulu 250 gms,15,50,45,5,1
28-03-2025,"Grains, Flours & Dals",MELMEKER 250GMS,4,60,45,15,1
28-03-2025,Spices & Seasonings,ROYAL SAFFRON 400GRMS,15,65,65,0,1
28-03-2025,"Grains, Flours & Dals",SRILALITHA MAIDA FLOUR 500G,4,64,64,0,2
28-03-2025,Snacks & Ready-to-Eat,RAJGIRA PEANUT CHIKKI,14,5,5,0,1
28-03-2025,Sweeteners,GS Palm Jaggery Powder 400GM,16,180,180,0,1
28-03-2025,"Grains, Flours & Dals",Green gram 500 gms,4,75,70,5,1
28-03-2025,"Grains, Flours & Dals",PESARA PAPPU 500GMS,4,85,75,10,1
28-03-2025,Spices & Seasonings,NUVVULU 250GM,15,160,130,30,2
28-03-2025,Spices & Seasonings,GREEN SOUNF,15,60,40,20,1
28-03-2025,"Grains, Flours & Dals",Wheat Flour 1 kg,4,70,60,10,1
28-03-2025,"Grains, Flours & Dals",Red Bobarlu 500 gms,4,95,85,10,1
28-03-2025,Snacks & Ready-to-Eat,VD RICE MURUKU 150GM,14,50,50,0,1
28-03-2025,"Grains, Flours & Dals",PN ORGANIC KALA CHANA 500GM,4,119,119,0,1
28-03-2025,"Grains, Flours & Dals",URAD DALL,4,190,170,20,2
28-03-2025,Pooja & Spiritual Items,GD Kumkum 50GM,12,30,30,0,1
28-03-2025,"Grains, Flours & Dals",HS JOWAR IDLY RAWA,4,65,65,0,1
28-03-2025,Spices & Seasonings,Jeera 100GM,15,50,45,5,1
28-03-2025,"Grains, Flours & Dals",EM Ragi idli R 500G,4,75,75,0,1
28-03-2025,"Grains, Flours & Dals",MAAGAANI SP RICE 20 KGS,4,2300,"1,960.00",340,1
28-03-2025,"Dry Fruits, Nuts & Seeds",PN ORGANIC MAKHANA 50GM,2,125,125,0,1
28-03-2025,"Grains, Flours & Dals",RAGI FLOUR 1KG,4,80,70,10,1
28-03-2025,"Grains, Flours & Dals",Quinova 1 kg,4,220,195,25,1
28-03-2025,"Grains, Flours & Dals",Wheat Flour 1 kg,4,140,120,20,2
28-03-2025,Snacks & Ready-to-Eat,PEANUT CHILLI,14,30,30,0,6
28-03-2025,"Dry Fruits, Nuts & Seeds",Putnalu 250GM,2,45,38,7,1
28-03-2025,"Grains, Flours & Dals",RICE FLOUR 500 GM,4,35,28,7,1
28-03-2025,Oils & Ghee,Groundnut oil 1 L,9,720,660,60,2
28-03-2025,"Dry Fruits, Nuts & Seeds",FLAX SEEDS 250GM,2,60,50,10,1
28-03-2025,"Grains, Flours & Dals",Chana Flour 500 gms,4,70,65,5,1
28-03-2025,Oils & Ghee,Sesame oil 1 L,9,590,560,30,1
28-03-2025,"Grains, Flours & Dals",Multigrain 1 kg,4,100,85,15,1
28-03-2025,Oils & Ghee,Safflower oil 1 L,9,440,400,40,1
28-03-2025,Spices & Seasonings,PRO ORG MUSTARD SMALL -RAI 200G,15,84,84,0,1
28-03-2025,Spices & Seasonings,LG 50GM,15,92,92,0,1
28-03-2025,Oils & Ghee,Coconut oil 500 ml,9,220,200,20,1
28-03-2025,"Grains, Flours & Dals",PESARA PAPPU 500GMS,4,85,75,10,1
28-03-2025,Beverages,REFRESH SHARBATH SUGAR FREE,1,299,285,14,1
28-03-2025,Spices & Seasonings,ROYAL SAFFRON 400GRMS,15,65,65,0,1
28-03-2025,Sweeteners,SUGAR 500 GM,16,30,25,5,1
28-03-2025,Oils & Ghee,rice bran oil f,9,194,169,25,1
28-03-2025,Personal Care & Cosmetics,MYSORE SANDAL SOAP 75G,10,84,84,0,2
28-03-2025,"Grains, Flours & Dals",Chana Flour 500 gms,4,70,65,5,1
28-03-2025,"Grains, Flours & Dals",RICE FLOUR 500 GM,4,35,28,7,1
28-03-2025,Snacks & Ready-to-Eat,VD MURMURA LADDU,14,50,50,0,1
28-03-2025,"Grains, Flours & Dals",MAIDA 1KG,4,70,60,10,1
28-03-2025,Spices & Seasonings,Coriander seeds 200 gms,15,48,40,8,1
28-03-2025,"Grains, Flours & Dals",POORI ATTA 1KG,4,70,60,10,1
28-03-2025,Snacks & Ready-to-Eat,SATHVI REGIVADA 200GM,14,80,60,20,1
28-03-2025,Snacks & Ready-to-Eat,VD MURMURA LADDU,14,50,50,0,1
28-03-2025,Misc,VD0009,8,100,100,0,1
28-03-2025,"Dry Fruits, Nuts & Seeds",FLAX SEEDS 250GM,2,60,50,10,1
28-03-2025,Oils & Ghee,Groundnut oil 500ml,9,180,165,15,1
28-03-2025,Snacks & Ready-to-Eat,VD MURMURA LADDU,14,50,50,0,1
28-03-2025,Spices & Seasonings,Tamarind 250GMS,15,80,65,15,1
28-03-2025,"Grains, Flours & Dals",Multigrain 1 kg,4,100,85,15,1
28-03-2025,Oils & Ghee,Sesame oil 500ml,9,295,280,15,1
28-03-2025,"Grains, Flours & Dals",Red Wheat Flour 1 kg,4,140,130,10,1
28-03-2025,"Dry Fruits, Nuts & Seeds",PULMAKHANA 100 GM,2,180,170,10,1
28-03-2025,Oils & Ghee,Safflower oil 500 ml,9,220,200,20,1
28-03-2025,"Dry Fruits, Nuts & Seeds",Groundnuts 1 kg,2,190,165,25,1
28-03-2025,"Grains, Flours & Dals",SA WHITE JOWAR RAVA 500GM,4,69,69,0,1
28-03-2025,"Grains, Flours & Dals",RAGI FLOUR 1KG,4,80,70,10,1
28-03-2025,Spices & Seasonings,GS Pink Rock Salt 1KG,15,120,120,0,1
28-03-2025,"Grains, Flours & Dals",Wheat Flour 1 kg,4,140,120,20,2
28-03-2025,Spices & Seasonings,Vamu 100GM,15,60,50,10,1
28-03-2025,"Grains, Flours & Dals",THIN POHA 500GM,4,80,70,10,2
28-03-2025,Snacks & Ready-to-Eat,VD MURMURA LADDU,14,50,50,0,1
28-03-2025,"Grains, Flours & Dals",RICE FLOUR 1KG,4,70,55,15,1
28-03-2025,"Dry Fruits, Nuts & Seeds",ANJEER 250GM,2,400,360,40,1
28-03-2025,Personal Care & Cosmetics,UVIS MULTANI MITTI PW 100GM,10,49,49,0,1
28-03-2025,Personal Care & Cosmetics,UVIS HENNA 100GM,10,75,75,0,1
28-03-2025,"Dry Fruits, Nuts & Seeds",SALTED PISTA 250GM,2,400,350,50,1
28-03-2025,"Grains, Flours & Dals",Urad dall 500 gms,4,95,85,10,1
28-03-2025,"Dry Fruits, Nuts & Seeds",chironji 50grms,2,200,160,40,1
28-03-2025,Oils & Ghee,Sesame oil 500ml,9,295,280,15,1
28-03-2025,Spices & Seasonings,Telaga Pindi 250 GM,15,40,35,5,1
28-03-2025,"Dry Fruits, Nuts & Seeds",ANJEER 250GM,2,400,360,40,1
28-03-2025,Oils & Ghee,Black Sesame oil 500 ml,9,220,190,30,1
28-03-2025,"Dry Fruits, Nuts & Seeds",ALMONDS 250GM,2,280,260,20,1
28-03-2025,"Dry Fruits, Nuts & Seeds",cashew,2,340,310,30,1
28-03-2025,"Health, Wellness & Ayurvedic Products",MH Millets Malt 500GM,5,400,380,20,2
28-03-2025,Spices & Seasonings,Black Till 250GM,15,90,75,15,1
28-03-2025,"Dry Fruits, Nuts & Seeds",WALLNUTS 250GM,2,380,360,20,1
28-03-2025,"Dry Fruits, Nuts & Seeds",BLACK KISMIS 250GM,2,175,140,35,1
28-03-2025,"Grains, Flours & Dals",POORI ATTA 500GM,4,35,30,5,1
28-03-2025,"Grains, Flours & Dals",CHANA DAL 500GM,4,140,120,20,2
28-03-2025,Pooja & Spiritual Items,HUNUMAN SINDOOR,12,60,60,0,1
28-03-2025,"Grains, Flours & Dals",Yellow jowar .F1 kg,4,110,100,10,1
28-03-2025,Pooja & Spiritual Items,BANDA PUVVU 25GM 25GM,12,80,60,20,1
28-03-2025,Snacks & Ready-to-Eat,Corn Chips 250GM,14,40,35,5,1
28-03-2025,"Grains, Flours & Dals",Red Bobarlu 1 kg,4,190,170,20,1
28-03-2025,Pooja & Spiritual Items,GD Ramayana Sandal 75GM,12,60,60,0,1
28-03-2025,"Health, Wellness & Ayurvedic Products",MD Hibiscus Flower Choornam 30GM,5,100,100,0,1
28-03-2025,"Grains, Flours & Dals",RAGI FLOUR 1KG,4,80,70,10,1
28-03-2025,Milk & Dairy,HERITAGE TONED MILK 500ML,7,31,31,0,1
28-03-2025,"Health, Wellness & Ayurvedic Products",MD Fenugreek Choornam 100GM,5,80,80,0,1
28-03-2025,"Health, Wellness & Ayurvedic Products",MD Mandara Leaf Powder 50GM,5,100,100,0,1
28-03-2025,Spices & Seasonings,Chilli powder 500 gms,15,290,210,80,1
28-03-2025,Snacks & Ready-to-Eat,Corn Chips 250GM,14,40,35,5,1
28-03-2025,Pooja & Spiritual Items,BANDA PUVVU 25GM 25GM,12,80,60,20,1
28-03-2025,"Grains, Flours & Dals",Red Bobarlu 1 kg,4,190,170,20,1
28-03-2025,"Grains, Flours & Dals",WHEAT 1 KG,4,600,500,100,10
28-03-2025,Pooja & Spiritual Items,GD Ramayana Sandal 75GM,12,60,60,0,1
28-03-2025,"Grains, Flours & Dals",CHANA DAL 500GM,4,140,120,20,2
28-03-2025,Snacks & Ready-to-Eat,DOSA BATTER 1KG,14,60,60,0,1
28-03-2025,Snacks & Ready-to-Eat,PEANUT CHIKKI 450GM,14,125,125,0,1
28-03-2025,"Grains, Flours & Dals",Multigrain 1 kg,4,100,85,15,1
28-03-2025,"Grains, Flours & Dals",Wheat Flour 1 kg,4,140,120,20,2
28-03-2025,"Grains, Flours & Dals",Multigrain 1 kg,4,200,170,30,2
28-03-2025,"Grains, Flours & Dals",RICE FLOUR 1KG,4,140,110,30,2
28-03-2025,Oils & Ghee,Groundnut oil 1 L,9,360,330,30,1
28-03-2025,"Grains, Flours & Dals",BOBBARA PAPPU 500GM,4,85,80,5,1
28-03-2025,"Grains, Flours & Dals",White Chana 500GM,4,120,100,20,1
28-03-2025,"Grains, Flours & Dals",unpolished turdall500grms,4,120,110,10,1
28-03-2025,"Health, Wellness & Ayurvedic Products",ORGANIC MORINGA POWER 100GM,5,249,249,0,1
28-03-2025,"Grains, Flours & Dals",Chana Flour 500 gms,4,70,65,5,1
28-03-2025,"Grains, Flours & Dals",turdal 1kg,4,220,170,50,1
28-03-2025,"Grains, Flours & Dals",Green gram 500 gms,4,75,70,5,1
28-03-2025,Snacks & Ready-to-Eat,SD Moringa with plam jaggery 250gm,14,135,135,0,1
28-03-2025,"Grains, Flours & Dals",KORRALU (FOXTAIL M) 1KG,4,450,330,120,3
28-03-2025,"Grains, Flours & Dals",BOBBARA PAPPU 500GM,4,85,80,5,1
28-03-2025,"Grains, Flours & Dals",ANDU KORRALU (Browntop.m) 1 kg,4,260,220,40,1
28-03-2025,"Grains, Flours & Dals",Red Chana 500 GM,4,75,60,15,1
28-03-2025,"Grains, Flours & Dals",white Bobarlu 500 gms,4,80,75,5,1
28-03-2025,"Grains, Flours & Dals",split green gram 500 gms,4,75,70,5,1
28-03-2025,"Grains, Flours & Dals",WHEAT 1 KG,4,240,200,40,4
28-03-2025,"Health, Wellness & Ayurvedic Products",RB Max Protein Cheese&amp;,5,45,45,0,1
28-03-2025,Oils & Ghee,Castor oil 500 ml,9,250,200,50,1
28-03-2025,Snacks & Ready-to-Eat,NGT CHATPATTA CHANA 90GM,14,25,25,0,1
28-03-2025,"Health, Wellness & Ayurvedic Products",RB Max Protein DESI MASALA 60gm,5,45,45,0,1
28-03-2025,"Health, Wellness & Ayurvedic Products",RB Max Protein PERI PERI 60gm,5,45,45,0,1
28-03-2025,"Health, Wellness & Ayurvedic Products",MXP CREAM ONION,5,45,45,0,1
28-03-2025,Snacks & Ready-to-Eat,KURNOOL MARMURA,14,140,110,30,2
28-03-2025,"Grains, Flours & Dals",Chana Flour 500 gms,4,70,65,5,1
28-03-2025,General Household & Kitchenware,SPOON 4,3,64,64,0,4
28-03-2025,Oils & Ghee,Groundnut oil 5 L,9,1800,"1,600.00",200,1
28-03-2025,"Grains, Flours & Dals",RAGI FLOUR 1KG,4,80,70,10,1
28-03-2025,"Health, Wellness & Ayurvedic Products",MD Bringaraj Choornam 100GM,5,80,80,0,1
28-03-2025,"Grains, Flours & Dals",Wheat Flour 1 kg,4,140,120,20,2
28-03-2025,"Grains, Flours & Dals",VYS.SP RICE 1 KG,4,140,130,10,2
28-03-2025,Oils & Ghee,rice bran oil f,9,194,169,25,1
28-03-2025,"Dry Fruits, Nuts & Seeds",Groundnuts 1 kg,2,380,330,50,2
28-03-2025,Oils & Ghee,Sesame oil 1 L,9,590,560,30,1
28-03-2025,Spices & Seasonings,NUVVULU 250GM,15,100,85,15,1
28-03-2025,Spices & Seasonings,Telaga Pindi 500GM,15,80,70,10,1
28-03-2025,Snacks & Ready-to-Eat,SD Moringa with plam jaggery 250gm,14,135,135,0,1
28-03-2025,Oils & Ghee,Sesame oil 1 L,9,1180,"1,120.00",60,2
28-03-2025,"Grains, Flours & Dals",CHANA DAL 500GM,4,70,60,10,1
28-03-2025,"Grains, Flours & Dals",HS JOWAR FLAKES 250GM 1+1,4,357,357,0,3
28-03-2025,Snacks & Ready-to-Eat,VD MURMURA LADDU,14,50,50,0,1
28-03-2025,Sweeteners,YB JAGGERY POWDER 500GMS,16,150,150,0,2
28-03-2025,Spices & Seasonings,Elaichi 25GM,15,145,120,25,1
28-03-2025,Snacks & Ready-to-Eat,VD PALLI LADDU,14,80,80,0,1
28-03-2025,Snacks & Ready-to-Eat,GB SALT COOKIES,14,60,55,5,1
28-03-2025,Oils & Ghee,Sesame oil 1 L,9,590,560,30,1
28-03-2025,"Grains, Flours & Dals",turdal 1kg,4,440,340,100,2
28-03-2025,"Grains, Flours & Dals",THICK POHA 1KG,4,80,70,10,1
28-03-2025,"Grains, Flours & Dals",SRILATHA RICE RAVVA 500GM,4,70,70,0,2
28-03-2025,Spices & Seasonings,LG 50GM,15,92,92,0,1
28-03-2025,"Grains, Flours & Dals",Green gram 500 gms,4,75,70,5,1
28-03-2025,"Grains, Flours & Dals",AISHWARYA MOONGDAL RICE,4,140,84,56,1
28-03-2025,"Grains, Flours & Dals",SL Idly Rava 1KG,4,130,110,20,2
28-03-2025,"Grains, Flours & Dals",Wheat Rava M 500GM,4,33,30,3,1
28-03-2025,"Grains, Flours & Dals",Black gram 500 gms,4,75,70,5,1
28-03-2025,Sweeteners,YB JAGGERY POWDER 1KG,16,140,140,0,1
28-03-2025,"Dry Fruits, Nuts & Seeds",PUTNALU 500GMS,2,180,152,28,2
28-03-2025,"Grains, Flours & Dals",PESARA PAPPU 1 KG,4,170,145,25,1
28-03-2025,"Grains, Flours & Dals",Red Wheat Flour 1 kg,4,140,130,10,1
28-03-2025,"Grains, Flours & Dals",CHANA DAL 500GM,4,70,60,10,1
28-03-2025,"Grains, Flours & Dals",split black gram 1 kg,4,360,340,20,2
28-03-2025,Snacks & Ready-to-Eat,KURNOOL MARMURA,14,70,55,15,1
28-03-2025,"Grains, Flours & Dals",split green gram 500 gms,4,75,70,5,1
28-03-2025,Spices & Seasonings,DRY MIECHI 200GM,15,80,60,20,1
28-03-2025,"Dry Fruits, Nuts & Seeds",Groundnuts 1 kg,2,380,330,50,2
28-03-2025,Spices & Seasonings,BLACK JEERA 50 GM,15,45,30,15,1
28-03-2025,Oils & Ghee,Sesame oil 1 L,9,590,560,30,1
28-03-2025,"Grains, Flours & Dals",Hs yellow jowar r 500g,4,99,99,0,1
28-03-2025,Snacks & Ready-to-Eat,VD MIXTURE 175 GM,14,60,60,0,1
28-03-2025,Oils & Ghee,Groundnut oil 1 L,9,360,330,30,1
28-03-2025,Snacks & Ready-to-Eat,VD MURMURA LADDU,14,50,50,0,1
28-03-2025,Snacks & Ready-to-Eat,VD Pappu Chekkalu 190gm,14,60,60,0,1
28-03-2025,Snacks & Ready-to-Eat,NGT CHATPATTA CHANA 90GM,14,50,50,0,2
28-03-2025,Spices & Seasonings,Chilli powder 500 gms,15,290,210,80,1
28-03-2025,"Grains, Flours & Dals",Multigrain 1 kg,4,100,85,15,1
28-03-2025,"Grains, Flours & Dals",Wheat Flour 1 kg,4,70,60,10,1
28-03-2025,Oils & Ghee,Safflower oil 1 L,9,440,400,40,1
28-03-2025,Spices & Seasonings,ROYAL SAFFRON,15,125,125,0,1
28-03-2025,"Dry Fruits, Nuts & Seeds",Groundnuts 1 kg,2,190,165,25,1
28-03-2025,Snacks & Ready-to-Eat,PASTALICIOUS,14,175,175,0,1
28-03-2025,Snacks & Ready-to-Eat,RAJGIRA PEANUT CHIKKI,14,15,15,0,3
28-03-2025,Snacks & Ready-to-Eat,VD MULTI CHAKKA,14,110,110,0,1
28-03-2025,Misc,VD0009,8,100,100,0,1
28-03-2025,"Grains, Flours & Dals",HS BARLEY FLAKES 250GM 1+1,4,119,119,0,1
28-03-2025,"Dry Fruits, Nuts & Seeds",FLAX SEEDS 250GM,2,60,50,10,1
28-03-2025,"Dry Fruits, Nuts & Seeds",SUNFLOWER SEEDS 250GRM,2,150,130,20,1
28-03-2025,Personal Care & Cosmetics,UVIS MULTANI MITTI 200GM,10,90,90,0,1
28-03-2025,"Health, Wellness & Ayurvedic Products",DWI EUCALYPTUS 8ML,5,80,80,0,1
28-03-2025,Oils & Ghee,Safflower oil 1 L,9,440,400,40,1
28-03-2025,Household & Cleaning,HERBAL DISINFECTANT,6,160,160,0,1
28-03-2025,Snacks & Ready-to-Eat,BD RAGI NOODLES,14,150,150,0,2
28-03-2025,Beverages,REFRESH SHARBATH NORMAL,1,199,190,9,1
28-03-2025,Beverages,REFRESH SHARBATH NORMAL,1,199,190,9,1
28-03-2025,Snacks & Ready-to-Eat,BD RAGI NOODLES,14,150,150,0,2
28-03-2025,Household & Cleaning,HERBAL DISINFECTANT,6,160,160,0,1
28-03-2025,Personal Care & Cosmetics,UVIS MULTANI MITTI 200GM,10,90,90,0,1
28-03-2025,"Health, Wellness & Ayurvedic Products",DWI EUCALYPTUS 8ML,5,80,80,0,1
28-03-2025,Oils & Ghee,Safflower oil 1 L,9,440,400,40,1
28-03-2025,Oils & Ghee,cow ghee 500 ml,9,430,390,40,1
28-03-2025,"Dry Fruits, Nuts & Seeds",SATHVI CHIA SEEDS 100GM,2,100,80,20,1
28-03-2025,"Grains, Flours & Dals",split green gram 500 gms,4,75,70,5,1
28-03-2025,"Grains, Flours & Dals",Green Batani 250GM,4,55,45,10,1
28-03-2025,"Grains, Flours & Dals",CHANA DAL 500GM,4,70,60,10,1
28-03-2025,"Grains, Flours & Dals",WHITE BATANI,4,40,30,10,1
28-03-2025,"Dry Fruits, Nuts & Seeds",Groundnuts 1 kg,2,190,165,25,1
28-03-2025,"Grains, Flours & Dals",Idly Rava L 1KG,4,240,200,40,4
28-03-2025,Spices & Seasonings,JEERA 250 gms,15,125,105,20,1
28-03-2025,"Dry Fruits, Nuts & Seeds",SD Mango cubes 100gm,2,90,90,0,2
28-03-2025,Spices & Seasonings,Turmeric powder 250 gms,15,100,75,25,1
28-03-2025,Sweeteners,SUGAR 1KG,16,60,50,10,1
28-03-2025,"Grains, Flours & Dals",Green Batani 500GM,4,110,90,20,1
28-03-2025,"Grains, Flours & Dals",Black uluvalu 250 gms,4,90,70,20,2
28-03-2025,Spices & Seasonings,Menthulu 250 gms,15,50,45,5,1
28-03-2025,Household & Cleaning,VIM SOAP,6,30,30,0,6
28-03-2025,Spices & Seasonings,Coriander seeds 200 gms,15,48,40,8,1
28-03-2025,"Dry Fruits, Nuts & Seeds",PUTNALU 500GMS,2,90,76,14,1
28-03-2025,"Grains, Flours & Dals",Chana Flour 500 gms,4,70,65,5,1
28-03-2025,"Grains, Flours & Dals",THICK POHA 1KG,4,160,140,20,2
28-03-2025,Snacks & Ready-to-Eat,SATHVI REGIVADA 200GM,14,160,120,40,2
28-03-2025,"Grains, Flours & Dals",BOMBAY RAVA,4,70,55,15,1
28-03-2025,Spices & Seasonings,PRO ORG MUSTARD SMALL -RAI 200G,15,84,84,0,1
28-03-2025,"Dry Fruits, Nuts & Seeds",SD Mango cubes 200gm,2,180,180,0,2
28-03-2025,"Grains, Flours & Dals",ULAVALU RED,4,90,75,15,1
28-03-2025,Spices & Seasonings,Telaga Pindi 500GM,15,160,140,20,2
28-03-2025,Sweeteners,ACHU BELLAM 1KG,16,100,80,20,1
28-03-2025,Pooja & Spiritual Items,BALAJI KASTURI DHOOP STICKS,12,210,210,0,3
28-03-2025,"Grains, Flours & Dals",AISHWARYA SP 25KG,4,1999,"1,690.00",309,1
28-03-2025,"Grains, Flours & Dals",JOWAR YELLOW 1 K,4,100,90,10,1
28-03-2025,"Grains, Flours & Dals",White jowar.F 1 kg,4,200,160,40,2
28-03-2025,"Grains, Flours & Dals",MAIDA 1KG,4,70,60,10,1
28-03-2025,Sweeteners,YB JAGGERY POWDER 500GMS,16,150,150,0,2
28-03-2025,"Grains, Flours & Dals",Wheat Flour 1 kg,4,700,600,100,10
28-03-2025,Spices & Seasonings,Telaga Pindi 250 GM,15,40,35,5,1
28-03-2025,"Dry Fruits, Nuts & Seeds",SUNFLOWER SEEDS 250GRM,2,150,130,20,1
28-03-2025,"Dry Fruits, Nuts & Seeds",SATHVI CHIA SEEDS 100GM,2,100,80,20,1
28-03-2025,Spices & Seasonings,Tamarind 250GMS,15,80,65,15,1
28-03-2025,"Health, Wellness & Ayurvedic Products",DWI EUCALYPTUS 30ML,5,130,130,0,1
28-03-2025,"Grains, Flours & Dals",split urad dall 250 gms,4,45,40,5,1
28-03-2025,"Grains, Flours & Dals",Urad dall 1 Kg,4,185,170,15,1
28-03-2025,Spices & Seasonings,DURGA SALT CRYSTAL 1KG,15,25,25,0,1
28-03-2025,"Dry Fruits, Nuts & Seeds",PULMAKHANA 100 GM,2,180,170,10,1
28-03-2025,"Dry Fruits, Nuts & Seeds",PUMPKIN SEEDS 250GM,2,200,160,40,1
28-03-2025,"Grains, Flours & Dals",Wheat Rava M 500GM,4,33,30,3,1
28-03-2025,"Grains, Flours & Dals",SL Idly Rava 1KG,4,65,55,10,1
28-03-2025,"Grains, Flours & Dals",VGR RICE 10 KGS,4,700,650,50,1
28-03-2025,"Grains, Flours & Dals",Wheat Flour 5 kgs,4,700,600,100,2
28-03-2025,"Grains, Flours & Dals",JOWAR WHITE 1 KG,4,80,70,10,1
28-03-2025,"Grains, Flours & Dals",SAMALU,4,170,130,40,1
28-03-2025,"Grains, Flours & Dals",KORRALU (FOXTAIL M) 1KG,4,150,110,40,1
28-03-2025,Oils & Ghee,Groundnut oil 1 L,9,360,330,30,1
28-03-2025,Oils & Ghee,Safflower oil 1 L,9,440,400,40,1
27-03-2025,Snacks & Ready-to-Eat,VD PALLI CHIKKI,14,80,80,0,1
27-03-2025,"Grains, Flours & Dals",Chana Flour 500 gms,4,70,65,5,1
27-03-2025,"Health, Wellness & Ayurvedic Products",ORGANIC MORINGA POWER 100GM,5,249,249,0,1
27-03-2025,"Health, Wellness & Ayurvedic Products",RB Max Protein Salt & Caramel Bar 50g,5,75,75,0,1
27-03-2025,Oils & Ghee,Groundnut oil 1 L,9,360,330,30,1
27-03-2025,Sweeteners,SUGAR 1KG,16,300,250,50,5
27-03-2025,"Grains, Flours & Dals",VGR rice 1 kg,4,350,325,25,5
27-03-2025,"Grains, Flours & Dals",Idly Rava L 1KG,4,60,50,10,1
27-03-2025,Snacks & Ready-to-Eat,BD LITTLE MILLET NOODLES 200G,14,75,75,0,1
27-03-2025,"Health, Wellness & Ayurvedic Products",RB Max Protein Chinese Manchurian,5,45,45,0,1
27-03-2025,"Grains, Flours & Dals",Wheat Flour 1 kg,4,210,180,30,3
27-03-2025,Snacks & Ready-to-Eat,BD RAGI NOODLES,14,75,75,0,1
27-03-2025,Snacks & Ready-to-Eat,COPRA LADDU 200GM,14,100,80,20,1
27-03-2025,"Grains, Flours & Dals",RICE FLOUR 500 GM,4,35,28,7,1
27-03-2025,Snacks & Ready-to-Eat,VD PALLI LADDU,14,80,80,0,1
27-03-2025,Oils & Ghee,Coconut oil 500 ml,9,220,200,20,1
27-03-2025,Misc,VD00014,8,100,90,10,1
27-03-2025,"Grains, Flours & Dals",Wheat Flour 1 kg,4,140,120,20,2
27-03-2025,Misc,VD00014,8,100,90,10,1
27-03-2025,Snacks & Ready-to-Eat,VD MURMURA LADDU,14,100,100,0,2
27-03-2025,Snacks & Ready-to-Eat,VD PALLI LADDU,14,160,160,0,2
27-03-2025,Snacks & Ready-to-Eat,VD Pappu Chekkalu 190gm,14,120,120,0,2
27-03-2025,Spices & Seasonings,AVALU 100GM,15,25,20,5,1
27-03-2025,"Grains, Flours & Dals",Wheat Rava S 500GM,4,33,30,3,1
27-03-2025,"Grains, Flours & Dals",RAGI FLOUR 1KG,4,80,70,10,1
27-03-2025,Pooja & Spiritual Items,PACHAKARPURAM,12,60,50,10,1
27-03-2025,"Dry Fruits, Nuts & Seeds",YB GRANMA NUTS,2,90,90,0,1
27-03-2025,Oils & Ghee,Groundnut oil 500ml,9,180,165,15,1
27-03-2025,"Grains, Flours & Dals",UDALU (Barnyard millet) 500 gms,4,70,60,10,1
27-03-2025,Misc,VD00014,8,100,90,10,1
27-03-2025,"Grains, Flours & Dals",SAMALU (Little millet) 500 gms,4,85,65,20,1
27-03-2025,Oils & Ghee,Sesame oil 500ml,9,295,280,15,1
27-03-2025,Oils & Ghee,Groundnut oil 500ml,9,180,165,15,1
27-03-2025,Snacks & Ready-to-Eat,CHOCO BROWINE,14,80,80,0,4
27-03-2025,"Grains, Flours & Dals",SRILATHA RICE RAVVA 500GM,4,35,35,0,1
27-03-2025,"Dry Fruits, Nuts & Seeds",PULMAKHANA 100 GM,2,180,170,10,1
27-03-2025,"Grains, Flours & Dals",MAATEJA rice 5 kg,4,360,345,15,1
27-03-2025,"Dry Fruits, Nuts & Seeds",DRYDATES 250GM,2,150,120,30,1
27-03-2025,Spices & Seasonings,MASALA KAR 500GMS,15,260,240,20,1
27-03-2025,"Grains, Flours & Dals",Wheat Rava M 1KG,4,65,55,10,1
27-03-2025,"Dry Fruits, Nuts & Seeds",PUMPKIN SEEDS 250GM,2,200,160,40,1
27-03-2025,Spices & Seasonings,RED COPRA 500GM,15,170,148,22,1
27-03-2025,"Dry Fruits, Nuts & Seeds",FLAX SEEDS 250GM,2,60,50,10,1
27-03-2025,"Grains, Flours & Dals",BOMBAY RAVA,4,70,55,15,1
27-03-2025,Misc,ROLL D C,8,70,45,25,1
27-03-2025,"Grains, Flours & Dals",white Bobarlu 1 KG,4,170,150,20,1
27-03-2025,Spices & Seasonings,GS Pink Rock Salt 1KG,15,120,120,0,1
27-03-2025,"Grains, Flours & Dals",RAJMA 500GM,4,100,90,10,1
27-03-2025,Snacks & Ready-to-Eat,DISANO VERMICELLI 425 GM,14,50,50,0,1
27-03-2025,"Grains, Flours & Dals",THICK POHA 1KG,4,80,70,10,1
27-03-2025,"Dry Fruits, Nuts & Seeds",SUNFLOWER SEEDS 250GRM,2,150,130,20,1
27-03-2025,Beverages,redlabel nc teap,1,175,175,0,1
27-03-2025,"Grains, Flours & Dals",CHANA DAL 500GM,4,70,60,10,1
27-03-2025,Spices & Seasonings,JEERA 250 gms,15,125,105,20,1
27-03-2025,"Grains, Flours & Dals",Urad dall 1 Kg,4,185,170,15,1
27-03-2025,"Dry Fruits, Nuts & Seeds",Groundnuts 1 kg,2,190,165,25,1
27-03-2025,"Grains, Flours & Dals",Green gram 1 kg,4,150,130,20,1
27-03-2025,"Grains, Flours & Dals",split black gram 1 kg,4,180,170,10,1
27-03-2025,"Dry Fruits, Nuts & Seeds",PUTNALU 500GMS,2,90,76,14,1
27-03-2025,"Dry Fruits, Nuts & Seeds",Groundnuts 500 gms,2,95,85,10,1
27-03-2025,Spices & Seasonings,Tamarind 500GM,15,160,130,30,1
27-03-2025,"Grains, Flours & Dals",turdal 500 gms,4,330,255,75,3
27-03-2025,"Grains, Flours & Dals",turdal 500 gms,4,110,85,25,1
27-03-2025,Oils & Ghee,rice bran oil f,9,194,169,25,1
27-03-2025,"Grains, Flours & Dals",PESARA PAPPU 1 KG,4,170,145,25,1
27-03-2025,"Grains, Flours & Dals",RED TUDAL 1KG,4,150,140,10,1
27-03-2025,General Household & Kitchenware,WOODEN SPATULA 11,3,22,22,0,1
27-03-2025,Snacks & Ready-to-Eat,SD VAMU APPADALU 200GM,14,80,80,0,1
27-03-2025,Spices & Seasonings,AVALU 100GM,15,50,40,10,2
27-03-2025,"Grains, Flours & Dals",JOWAR YELLOW 1 K,4,200,180,20,2
27-03-2025,Spices & Seasonings,DRY MIECHI 200GM,15,80,60,20,1
27-03-2025,"Grains, Flours & Dals",ULAVALU RED,4,90,75,15,1
27-03-2025,"Grains, Flours & Dals",MAAGAANI LOW GI SP L 1KG,4,240,210,30,2
27-03-2025,Sweeteners,ACHU BELLAM 1KG,16,100,80,20,1
27-03-2025,Snacks & Ready-to-Eat,RICE PALTA,14,78,78,0,3
27-03-2025,General Household & Kitchenware,FANCY JHALI,3,42,42,0,1
27-03-2025,"Grains, Flours & Dals",Green gram 500 gms,4,75,70,5,1
27-03-2025,"Grains, Flours & Dals",RAGULU 1 KG,4,105,90,15,1
27-03-2025,"Grains, Flours & Dals",VYS.SP.RICE 5 KGS,4,350,325,25,1
27-03-2025,Spices & Seasonings,Jeera 100GM,15,50,45,5,1
27-03-2025,"Grains, Flours & Dals",Green gram 500 gms,4,75,70,5,1
27-03-2025,Spices & Seasonings,Tamarind 250GMS,15,80,65,15,1
27-03-2025,"Dry Fruits, Nuts & Seeds",SALTED PISTA 250GM,2,400,350,50,1
27-03-2025,"Grains, Flours & Dals",Red uluvalu 250 gms,4,45,40,5,1
27-03-2025,Snacks & Ready-to-Eat,SATHVI REGIVADA 200GM,14,80,60,20,1
27-03-2025,"Grains, Flours & Dals",RAGI FLOUR 500GRMS,4,40,35,5,1
27-03-2025,Snacks & Ready-to-Eat,NGT CHATPATTA CHANA 90GM,14,50,50,0,2
27-03-2025,Personal Care & Cosmetics,MADDI HIBISCUS HAIR SHAMPOO 500ML,10,300,300,0,1
27-03-2025,Personal Care & Cosmetics,Soapnut 250GM,10,60,45,15,1
27-03-2025,"Dry Fruits, Nuts & Seeds",YELLOW KISHMISH 250GM,2,130,110,20,1
27-03-2025,Household & Cleaning,VIM SOAP,6,10,10,0,2
27-03-2025,Snacks & Ready-to-Eat,SESAME CHIKKI,14,120,100,20,1
27-03-2025,Sweeteners,MISHRI D,16,40,30,10,1
27-03-2025,"Dry Fruits, Nuts & Seeds",cashew,2,680,620,60,2
27-03-2025,Snacks & Ready-to-Eat,VD MIXTURE 175 GM,14,60,60,0,1
27-03-2025,Household & Cleaning,VIM MAHA BAR,6,20,20,0,2
27-03-2025,Snacks & Ready-to-Eat,VD MURMURA LADDU,14,50,50,0,1
27-03-2025,Oils & Ghee,A2 BUFFALO GHEE 250ML,9,299,299,0,1
27-03-2025,Personal Care & Cosmetics,HERBAL BATH POWDER 200GM,10,80,80,0,1
27-03-2025,Spices & Seasonings,AVALU 250grms,15,60,60,0,1
27-03-2025,"Grains, Flours & Dals",split green gram 1 kg,4,150,140,10,1
27-03-2025,Oils & Ghee,Groundnut oil 1 L,9,720,660,60,2
27-03-2025,"Grains, Flours & Dals",RICE FLOUR 1KG,4,70,55,15,1
27-03-2025,"Grains, Flours & Dals",SB Javva Wheat Ravva 500GM,4,285,285,0,3
27-03-2025,"Grains, Flours & Dals",UNPOLISHED TURDALL 1KG,4,240,210,30,1
27-03-2025,"Grains, Flours & Dals",SABDANA 500GM,4,90,70,20,1
27-03-2025,"Dry Fruits, Nuts & Seeds",PUTNALU 500GMS,2,90,76,14,1
27-03-2025,Spices & Seasonings,PRO HIMALAYAN PINK SALT 500GM,15,136,136,0,2
27-03-2025,Spices & Seasonings,SHAHI BIRYANI MASALA,15,42,42,0,1
27-03-2025,"Grains, Flours & Dals",SA WHITE JOWAR RAVA 500GM,4,69,69,0,1
27-03-2025,Sweeteners,MISHRI 250 GM,16,35,30,5,1
27-03-2025,"Grains, Flours & Dals",split black gram 1 kg,4,180,170,10,1
27-03-2025,"Grains, Flours & Dals",turdal 500 gms,4,110,85,25,1
27-03-2025,Spices & Seasonings,THOKA MIRYALU 50GM,15,210,180,30,1
27-03-2025,"Grains, Flours & Dals",SABDANA,4,40,35,5,1
27-03-2025,Spices & Seasonings,JEERA 250 gms,15,125,105,20,1
27-03-2025,"Grains, Flours & Dals",JOWAR WHITE 1 KG,4,160,140,20,2
27-03-2025,Spices & Seasonings,DRY MANGO POWDER,15,45,45,0,1
27-03-2025,"Grains, Flours & Dals",Chana Flour 1 kg,4,140,130,10,1
27-03-2025,"Grains, Flours & Dals",Wheat Rava M 1KG,4,65,55,10,1
27-03-2025,"Grains, Flours & Dals",Wheat Rava S 1KG,4,65,55,10,1
27-03-2025,"Health, Wellness & Ayurvedic Products",AMLA PACHAK,5,100,100,0,1
27-03-2025,Personal Care & Cosmetics,MD Henna Choornam 100GM,10,80,80,0,1
27-03-2025,"Grains, Flours & Dals",RAGI FLOUR 1KG,4,80,70,10,1
27-03-2025,Household & Cleaning,VIM MAHA BAR,6,20,20,0,2
27-03-2025,"Grains, Flours & Dals",MAATEJA rice 1 kg,4,360,345,15,5
27-03-2025,Oils & Ghee,Groundnut oil 1 L,9,360,330,30,1
27-03-2025,"Grains, Flours & Dals",VYS.SP RICE 1 KG,4,350,325,25,5
27-03-2025,Snacks & Ready-to-Eat,VD MURUKU 175GM,14,60,60,0,1
27-03-2025,"Grains, Flours & Dals",Multigrain 1 kg,4,200,170,30,2
27-03-2025,"Grains, Flours & Dals",sf moong whole,4,122,122,0,1
27-03-2025,Spices & Seasonings,RED COPRA 250GMS,15,85,74,11,1
27-03-2025,"Grains, Flours & Dals",JOWAR WHITE 1 KG,4,80,70,10,1
27-03-2025,"Dry Fruits, Nuts & Seeds",sabja seeds,2,80,70,10,1
27-03-2025,Misc,VD00014,8,100,90,10,1
27-03-2025,Baking & Cooking Aids,GONDKATIRA Ag,0,170,150,20,2
27-03-2025,Oils & Ghee,Groundnut oil 500ml,9,180,165,15,1
27-03-2025,Snacks & Ready-to-Eat,SD MASALA GAVVALU 200GM,14,95,95,0,1
27-03-2025,Personal Care & Cosmetics,Soapnut 250GM,10,60,45,15,1
27-03-2025,"Dry Fruits, Nuts & Seeds",PN ORGANIC MAKHANA 50GM,2,125,125,0,1
27-03-2025,Snacks & Ready-to-Eat,PEANUT CHILLI,14,10,10,0,2
27-03-2025,Spices & Seasonings,RED COPRA 250GMS,15,85,74,11,1
27-03-2025,Spices & Seasonings,Coriander seeds 200 gms,15,48,40,8,1
27-03-2025,"Dry Fruits, Nuts & Seeds",YELLOW KISHMISH 250GM,2,130,110,20,1
27-03-2025,Spices & Seasonings,AVALU 100GM,15,25,20,5,1
27-03-2025,Spices & Seasonings,Turmeric powder 250 gms,15,100,75,25,1
27-03-2025,"Dry Fruits, Nuts & Seeds",sabja seeds,2,80,70,10,1
27-03-2025,Spices & Seasonings,Menthulu 250 gms,15,50,45,5,1
27-03-2025,Spices & Seasonings,SD Garlic Karam Powder 100GM,15,65,65,0,1
27-03-2025,"Grains, Flours & Dals",PRO ORG RED POHA 500GM,4,89,89,0,1
27-03-2025,Spices & Seasonings,Jeera 100GM,15,50,45,5,1
27-03-2025,"Grains, Flours & Dals",Green gram 500 gms,4,75,70,5,1
27-03-2025,"Grains, Flours & Dals",Red Bobarlu 500 gms,4,95,85,10,1
27-03-2025,"Dry Fruits, Nuts & Seeds",FLAX SEEDS 250GM,2,60,50,10,1
27-03-2025,Spices & Seasonings,dalchin chekka,15,50,40,10,1
27-03-2025,"Grains, Flours & Dals",AISHWARYA SP 25KG,4,1999,"1,690.00",309,1
27-03-2025,Misc,VD0009,8,100,100,0,1
27-03-2025,"Grains, Flours & Dals",Wheat Flour 1 kg,4,70,60,10,1
27-03-2025,Spices & Seasonings,Telaga Pindi 250 GM,15,40,35,5,1
27-03-2025,Sweeteners,GS Palm Jaggery Powder 400GM,16,360,360,0,2
27-03-2025,Personal Care & Cosmetics,BIOTIQUE SHINE &GLOSS 120ML,10,99,99,0,1
27-03-2025,"Grains, Flours & Dals",Urad dall 1 Kg,4,185,170,15,1
27-03-2025,"Grains, Flours & Dals",JOWAR YELLOW 1 K,4,100,90,10,1
27-03-2025,"Dry Fruits, Nuts & Seeds",Groundnuts 1 kg,2,190,165,25,1
27-03-2025,"Grains, Flours & Dals",RAGULU 1 KG,4,70,60,10,1
27-03-2025,"Grains, Flours & Dals",UDALU (Barnyard millet) 1 kg,4,140,115,25,1
27-03-2025,Sweeteners,ACHUBELLAM 500GM,16,50,40,10,1
27-03-2025,Pooja & Spiritual Items,GD Dhoop Cones 40GM,12,30,30,0,1
27-03-2025,Snacks & Ready-to-Eat,VD MURMURA LADDU,14,50,50,0,1
27-03-2025,"Grains, Flours & Dals",SA YELLOW JOWAR RAVA 500GM,4,190,190,0,2
27-03-2025,Pooja & Spiritual Items,GB Bharatha Woods 75GM,12,60,60,0,1
27-03-2025,"Grains, Flours & Dals",Yellow jowar .F1 kg,4,110,100,10,1
27-03-2025,Sweeteners,SUGAR 500 GM,16,30,25,5,1
27-03-2025,"Grains, Flours & Dals",HS JOWAR IDLY RAWA,4,130,130,0,2
27-03-2025,Oils & Ghee,Coconut oil 1 L,9,440,400,40,1
27-03-2025,Snacks & Ready-to-Eat,murmura venk,14,50,45,5,1
27-03-2025,Snacks & Ready-to-Eat,NGT CHATPATTA CHANA 90GM,14,50,50,0,2
27-03-2025,Oils & Ghee,Groundnut oil 1 L,9,720,660,60,2
27-03-2025,Pooja & Spiritual Items,SHANKARS SWARNA YUG 60GM,12,60,60,0,1
27-03-2025,"Dry Fruits, Nuts & Seeds",FLAX SEEDS 250GM,2,60,50,10,1
27-03-2025,Oils & Ghee,Mustard oil 1 L,9,440,400,40,1
27-03-2025,"Grains, Flours & Dals",White jowar.F 1 kg,4,100,80,20,1
27-03-2025,"Dry Fruits, Nuts & Seeds",sabja seeds,2,80,70,10,1
27-03-2025,"Grains, Flours & Dals",Brown RICE 1KG,4,70,65,5,1
27-03-2025,Sweeteners,SUGAR 500 GM,16,30,25,5,1
27-03-2025,"Grains, Flours & Dals",RAGI FLOUR 500GRMS,4,40,35,5,1
27-03-2025,Oils & Ghee,Groundnut oil 500ml,9,180,165,15,1
27-03-2025,Misc,VD00014,8,100,90,10,1
27-03-2025,Oils & Ghee,Coconut oil 1 L,9,440,400,40,1
27-03-2025,"Grains, Flours & Dals",SAMALU (Little millet) 500 gms,4,85,65,20,1
27-03-2025,Spices & Seasonings,KALONJI SEEDS,15,90,80,10,1
27-03-2025,Milk & Dairy,SANGAM CURD 450GM,7,38,38,0,1
27-03-2025,Sweeteners,GS Palm Jaggery Powder 400GM,16,180,180,0,1
27-03-2025,"Grains, Flours & Dals",UDALU (Barnyard millet) 500 gms,4,70,60,10,1
27-03-2025,Snacks & Ready-to-Eat,DOSA BATTER 1KG,14,60,60,0,1
27-03-2025,Spices & Seasonings,Black Till 250GM,15,90,75,15,1
27-03-2025,"Grains, Flours & Dals",White jowar.F 1 kg,4,100,80,20,1
27-03-2025,Snacks & Ready-to-Eat,VD Pappu Chekkalu 190gm,14,60,60,0,1
27-03-2025,"Grains, Flours & Dals",URAD DALL,4,95,85,10,1
27-03-2025,Snacks & Ready-to-Eat,VD NUVULU CHEGODI 175GM,14,60,60,0,1
27-03-2025,Pooja & Spiritual Items,KASHI ASHTAGANDHA CHANDHANA,12,20,20,0,1
27-03-2025,"Health, Wellness & Ayurvedic Products",MD Bringaraj Choornam 100GM,5,80,80,0,1
27-03-2025,Misc,C123,8,80,80,0,1
27-03-2025,Snacks & Ready-to-Eat,VD DAHI MIRCHI(SALTED) 100GM,14,45,45,0,1
27-03-2025,Snacks & Ready-to-Eat,VD RICE PAPAD 150GM,14,50,50,0,1
27-03-2025,"Grains, Flours & Dals",Chana Flour 500 gms,4,70,65,5,1
27-03-2025,Snacks & Ready-to-Eat,VD DAHI MIRCHI(SALTED) 100GM,14,45,45,0,1
27-03-2025,General Household & Kitchenware,SPOON 4,3,32,32,0,2
27-03-2025,"Grains, Flours & Dals",idly/Dosa rice 1 kg,4,70,60,10,1
27-03-2025,Misc,DOUBC123,8,80,80,0,1
27-03-2025,Oils & Ghee,Groundnut oil 500ml,9,180,165,15,1
27-03-2025,Spices & Seasonings,NUVVULU 500GM,15,160,130,30,1
27-03-2025,"Grains, Flours & Dals",SAMALU (Little millet) 500 gms,4,85,65,20,1
27-03-2025,"Grains, Flours & Dals",RAGI FLOUR 500GRMS,4,40,35,5,1
27-03-2025,Spices & Seasonings,Tamarind 250GMS,15,80,65,15,1
27-03-2025,Spices & Seasonings,GS Pink Rock Salt 1KG,15,120,120,0,1
27-03-2025,Oils & Ghee,GANTASALA A2 COW GHEE 250ML,9,299,299,0,1
27-03-2025,"Grains, Flours & Dals",THICK POHA 500GM,4,40,35,5,1
27-03-2025,Baking & Cooking Aids,Baking Soda 50GM,0,20,15,5,1
27-03-2025,"Health, Wellness & Ayurvedic Products",RB Max Protein Cheese&amp;,5,45,45,0,1
27-03-2025,Oils & Ghee,Coconut oil 500 ml,9,220,200,20,1
27-03-2025,Baking & Cooking Aids,GONDKATIRA Ag,0,85,75,10,1
27-03-2025,"Dry Fruits, Nuts & Seeds",Groundnuts 500 gms,2,95,85,10,1
27-03-2025,Oils & Ghee,Groundnut oil 500ml,9,180,165,15,1
27-03-2025,Milk & Dairy,HERITAGE TOTAL CURD 500GM,7,50,50,0,1
27-03-2025,"Dry Fruits, Nuts & Seeds",FLAX SEEDS 250GM,2,60,50,10,1
27-03-2025,Spices & Seasonings,SONTI 50GM,15,30,20,10,1
27-03-2025,"Grains, Flours & Dals",Chana Flour 500 gms,4,70,65,5,1
27-03-2025,"Grains, Flours & Dals",Wheat Flour 1 kg,4,700,600,100,10
27-03-2025,Snacks & Ready-to-Eat,SATHVI REGIVADA 200GM,14,80,60,20,1
27-03-2025,Spices & Seasonings,Telaga Pindi 250 GM,15,40,35,5,1
27-03-2025,"Grains, Flours & Dals",Red Wheat Flour 1 kg,4,280,260,20,2
27-03-2025,"Grains, Flours & Dals",split black gram 1 kg,4,180,170,10,1
27-03-2025,Oils & Ghee,Groundnut oil 1 L,9,360,330,30,1
27-03-2025,"Dry Fruits, Nuts & Seeds",ALMONDS 250GM,2,280,260,20,1
27-03-2025,"Grains, Flours & Dals",KORRALU (FOXTAIL M) 1KG,4,300,220,80,2
27-03-2025,"Dry Fruits, Nuts & Seeds",PUMPKIN SEEDS 250GM,2,200,160,40,1
27-03-2025,Spices & Seasonings,dalchin chekka,15,50,40,10,1
27-03-2025,Pooja & Spiritual Items,GD Sree Chandan 50GM,12,50,50,0,1
27-03-2025,Spices & Seasonings,ROYAL SAFFRON,15,125,125,0,1
27-03-2025,Spices & Seasonings,AV Iodized Salt 1KG,15,56,50,6,2
27-03-2025,"Grains, Flours & Dals",PRO NATURE CHANNA DAL500GM,4,124,124,0,1
27-03-2025,Spices & Seasonings,GREEN SOUNF,15,60,40,20,1
27-03-2025,"Grains, Flours & Dals",PESARA PAPPU 500GMS,4,85,75,10,1
27-03-2025,"Grains, Flours & Dals",YB CHITTIMUTYALU RICE 1KG,4,200,200,0,1
27-03-2025,"Grains, Flours & Dals",BARLEY SEEDS 250GMS,4,40,35,5,1
27-03-2025,"Health, Wellness & Ayurvedic Products",MAX PROTEIN ALMOND BAR,5,80,80,0,1
27-03-2025,"Grains, Flours & Dals",VGR rice 1 kg,4,350,325,25,5
27-03-2025,"Grains, Flours & Dals",white Bobarlu 500 gms,4,80,75,5,1
27-03-2025,"Grains, Flours & Dals",Red Wheat Flour 1 kg,4,140,130,10,1
27-03-2025,Pooja & Spiritual Items,javadhu,12,60,60,0,1
27-03-2025,"Grains, Flours & Dals",KORRALU (FOXTAIL M) 500GM,4,65,55,10,1
27-03-2025,Oils & Ghee,Sesame oil 5 L,9,2950,"2,750.00",200,1
27-03-2025,Personal Care & Cosmetics,Soapnut 250GM,10,60,45,15,1
27-03-2025,"Dry Fruits, Nuts & Seeds",PRO ORG RAW PEANUTS 500GM,2,174,174,0,1
27-03-2025,"Grains, Flours & Dals",SL Idly Rava 1KG,4,65,55,10,1
27-03-2025,Snacks & Ready-to-Eat,VD MURMURA LADDU,14,50,50,0,1
27-03-2025,"Grains, Flours & Dals",turdal 1kg,4,220,170,50,1
27-03-2025,Spices & Seasonings,Jeera 100GM,15,50,45,5,1
27-03-2025,Spices & Seasonings,GS Pink Rock Salt 1KG,15,120,120,0,1
27-03-2025,"Grains, Flours & Dals",PESARA PAPPU 500GMS,4,85,75,10,1
27-03-2025,Personal Care & Cosmetics,HIMALAYA LIP BALM 10GM,10,40,40,0,1
27-03-2025,General Household & Kitchenware,nippo gold,3,72,72,0,4
27-03-2025,"Dry Fruits, Nuts & Seeds",SALTED PISTA 250GM,2,400,350,50,1
27-03-2025,"Grains, Flours & Dals",Green gram 1 kg,4,150,130,20,1
27-03-2025,"Health, Wellness & Ayurvedic Products",RAMA BALM 10ML,5,50,50,0,1
27-03-2025,Oils & Ghee,Sesame oil 5 L,9,2950,"2,750.00",200,1
27-03-2025,Spices & Seasonings,ROYAL SAFFRON 400GRMS,15,130,130,0,2
27-03-2025,"Health, Wellness & Ayurvedic Products",RB Max Protein Spanish Tomato,5,45,45,0,1
27-03-2025,"Grains, Flours & Dals",Wheat Flour 1 kg,4,140,120,20,2
27-03-2025,"Dry Fruits, Nuts & Seeds",Putnalu 250GM,2,45,38,7,1
27-03-2025,Snacks & Ready-to-Eat,VD MANGO JELLY 250GRMS,14,80,80,0,1
27-03-2025,"Grains, Flours & Dals",turdal 1kg,4,440,340,100,2
27-03-2025,"Grains, Flours & Dals",BOMBAY RAVA,4,70,55,15,1
27-03-2025,Oils & Ghee,Groundnut oil 1 L,9,360,330,30,1
27-03-2025,"Dry Fruits, Nuts & Seeds",SD Mango cubes 200gm,2,90,90,0,1
27-03-2025,Spices & Seasonings,Gasagasalu 50GM,15,130,110,20,1
27-03-2025,"Dry Fruits, Nuts & Seeds",KAJU HALF 250GM,2,310,290,20,1
27-03-2025,"Grains, Flours & Dals",Urad dall 1 Kg,4,370,340,30,2
27-03-2025,"Grains, Flours & Dals",CHANA DAL 500GM,4,70,60,10,1
27-03-2025,"Grains, Flours & Dals",Idly Rava L 1KG,4,120,100,20,2
27-03-2025,Spices & Seasonings,JEERA 250 gms,15,125,105,20,1
27-03-2025,Sweeteners,SUGAR 1KG,16,120,100,20,2
27-03-2025,"Grains, Flours & Dals",Green gram 1 kg,4,300,260,40,2
27-03-2025,Snacks & Ready-to-Eat,VD RICE SAGO PAPAD 150GM,14,660,660,0,12
27-03-2025,Oils & Ghee,Groundnut oil 1 L,9,360,330,30,1
27-03-2025,Oils & Ghee,Sesame oil 1 L,9,590,560,30,1
27-03-2025,"Grains, Flours & Dals",split urad dall 250 gms,4,45,40,5,1
27-03-2025,"Dry Fruits, Nuts & Seeds",FLAX SEEDS 250GM,2,60,50,10,1
27-03-2025,"Grains, Flours & Dals",RAGI FLOUR 500GRMS,4,40,35,5,1
27-03-2025,Milk & Dairy,BROWN EGGS 1P,7,168,144,24,12
27-03-2025,"Grains, Flours & Dals",Multigrain 1 kg,4,200,170,30,2
27-03-2025,Oils & Ghee,Sesame oil 1 L,9,590,560,30,1
27-03-2025,"Grains, Flours & Dals",turdal 1kg,4,220,170,50,1
27-03-2025,"Grains, Flours & Dals",THICK POHA 500GM,4,40,35,5,1
27-03-2025,"Grains, Flours & Dals",PESARA PAPPU 500GMS,4,85,75,10,1
27-03-2025,"Grains, Flours & Dals",RED TUDAL 1KG,4,150,140,10,1
27-03-2025,Spices & Seasonings,RED COPRA 250GMS,15,85,74,11,1
27-03-2025,"Dry Fruits, Nuts & Seeds",PUTNALU 500GMS,2,90,76,14,1
27-03-2025,Sweeteners,SUGAR 1KG,16,120,100,20,2
27-03-2025,"Grains, Flours & Dals",turdal 500 gms,4,110,85,25,1
27-03-2025,"Grains, Flours & Dals",SL Idly Rava 1KG,4,130,110,20,2
27-03-2025,"Health, Wellness & Ayurvedic Products",MD Neem Leaf Choornam 100GM,5,160,160,0,2
27-03-2025,Beverages,BRU GREEN LABEL 1.2G,1,144,144,0,72
27-03-2025,"Dry Fruits, Nuts & Seeds",MAHA BEERA SEEDS 100GM,2,60,60,0,1
27-03-2025,"Grains, Flours & Dals",Urad dall 1 Kg,4,370,340,30,2
27-03-2025,"Grains, Flours & Dals",Green gram 1 kg,4,150,130,20,1
27-03-2025,"Dry Fruits, Nuts & Seeds",Groundnuts 1 kg,2,570,495,75,3
27-03-2025,Household & Cleaning,surfexcel 500,6,0,0,0,1
27-03-2025,Sweeteners,ACHU BELLAM 1KG,16,100,80,20,1
27-03-2025,Household & Cleaning,TIDE DOUBLE POWER LEMON &amp;MINT,6,132,132,0,1
27-03-2025,"Grains, Flours & Dals",SL Idly Rava 1KG,4,195,165,30,3
27-03-2025,"Grains, Flours & Dals",SL Idly Rava 1KG,4,65,55,10,1
27-03-2025,Oils & Ghee,Groundnut oil 1 L,9,720,660,60,2
27-03-2025,"Grains, Flours & Dals",VGR rice 1 kg,4,70,65,5,1
27-03-2025,"Grains, Flours & Dals",Green gram 1 kg,4,150,130,20,1
27-03-2025,"Grains, Flours & Dals",DH URAD GOTA 1KG,4,430,380,50,2
27-03-2025,"Grains, Flours & Dals",SABDANA 500GM,4,90,70,20,1
27-03-2025,Sweeteners,YB JAGGERY POWDER 500GMS,16,75,75,0,1
27-03-2025,"Grains, Flours & Dals",SRILATHA RICE RAVVA 500GM,4,35,35,0,1
27-03-2025,Oils & Ghee,Coconut oil 500 ml,9,220,200,20,1
27-03-2025,Spices & Seasonings,Jeera 100GM,15,50,45,5,1
27-03-2025,Spices & Seasonings,AVALU 100GM,15,25,20,5,1
27-03-2025,"Grains, Flours & Dals",Chana Flour 500 gms,4,70,65,5,1
27-03-2025,"Grains, Flours & Dals",White jowar.F 1 kg,4,100,80,20,1
27-03-2025,"Grains, Flours & Dals",EM Foxtail idli r 500 g,4,109,109,0,1
27-03-2025,"Grains, Flours & Dals",SH RED POHA 500GM,4,85,85,0,1
27-03-2025,"Grains, Flours & Dals",RAGULU 1 KG,4,70,60,10,1
27-03-2025,Spices & Seasonings,Tamarind 500GM,15,160,130,30,1
27-03-2025,"Grains, Flours & Dals",AISHWARYA SP 1KG,4,1200,"1,050.00",150,15
27-03-2025,Spices & Seasonings,DRY MIECHI 200GM,15,80,60,20,1
27-03-2025,"Grains, Flours & Dals",RICE FLOUR 1KG,4,70,55,15,1
27-03-2025,Oils & Ghee,Groundnut oil 1 L,9,360,330,30,1
27-03-2025,Pooja & Spiritual Items,GD Yagnadhara 31PC,12,70,70,0,1
27-03-2025,Oils & Ghee,Sesame oil 1 L,9,590,560,30,1
27-03-2025,"Grains, Flours & Dals",Multigrain 1 kg,4,100,85,15,1
27-03-2025,"Grains, Flours & Dals",Wheat Flour 1 kg,4,420,360,60,6
27-03-2025,Snacks & Ready-to-Eat,SD FINGER Millet with palm Jaggery 250gm,14,135,135,0,1
26-03-2025,Sweeteners,ACHU BELLAM 1KG,16,100,80,20,1
26-03-2025,"Grains, Flours & Dals",THICK POHA 1KG,4,80,70,10,1
26-03-2025,Baking & Cooking Aids,GONDKATIRA Ag,0,85,75,10,1
26-03-2025,"Grains, Flours & Dals",Red Wheat Flour 1 kg,4,140,130,10,1
26-03-2025,Oils & Ghee,Sesame oil 500ml,9,295,280,15,1
26-03-2025,Oils & Ghee,Groundnut oil 1 L,9,360,330,30,1
26-03-2025,Spices & Seasonings,Chilli powder 500 gms,15,290,210,80,1
26-03-2025,Oils & Ghee,Coconut oil 1 L,9,440,400,40,1
26-03-2025,Spices & Seasonings,Turmeric powder 250 gms,15,100,75,25,1
26-03-2025,Snacks & Ready-to-Eat,GB SALT COOKIES,14,60,55,5,1
26-03-2025,Oils & Ghee,Groundnut oil 1 L,9,360,330,30,1
26-03-2025,Sweeteners,NATURAL HONEY 1KG,16,1120,960,160,2
26-03-2025,Pooja & Spiritual Items,PACHAKARPURAM,12,60,50,10,1
26-03-2025,"Grains, Flours & Dals",Wheat Flour 1 kg,4,210,180,30,3
26-03-2025,"Grains, Flours & Dals",RAGI FLOUR 500GRMS,4,40,35,5,1
26-03-2025,Snacks & Ready-to-Eat,SD Vamu with palm jaggery 250gm,14,135,135,0,1
26-03-2025,Snacks & Ready-to-Eat,DINNER PAPAD,14,80,80,0,1
26-03-2025,"Grains, Flours & Dals",Yellow jowar .F1 kg,4,110,100,10,1
26-03-2025,Snacks & Ready-to-Eat,SD RAGI GAVVALU,14,95,95,0,1
26-03-2025,"Grains, Flours & Dals",HS MULTI UPMA RAVA,4,65,65,0,1
26-03-2025,"Grains, Flours & Dals",Hs yellow jowar r 500g,4,99,99,0,1
26-03-2025,"Grains, Flours & Dals",Red Bobarlu 500 gms,4,95,85,10,1
26-03-2025,"Grains, Flours & Dals",VYS.SP RICE 1 KG,4,140,130,10,2
26-03-2025,Oils & Ghee,cow ghee 500 ml,9,860,780,80,2
26-03-2025,Snacks & Ready-to-Eat,VD BELLAM GAVVALU 200GM,14,60,60,0,1
26-03-2025,Snacks & Ready-to-Eat,VD Pappu Chekkalu 190gm,14,120,120,0,2
26-03-2025,Snacks & Ready-to-Eat,VD BOONDI 175GM,14,120,120,0,2
26-03-2025,Misc,VD0009,8,200,200,0,2
26-03-2025,Snacks & Ready-to-Eat,VD NUVULU CHEGODI 175GM,14,60,60,0,1
26-03-2025,Snacks & Ready-to-Eat,VD MIXTURE 175 GM,14,120,120,0,2
26-03-2025,Snacks & Ready-to-Eat,RITEBITE BLUEBERRY BLAST,14,50,50,0,1
26-03-2025,"Health, Wellness & Ayurvedic Products",MXP CHOCO CLASSIC BAR,5,70,70,0,1
26-03-2025,Snacks & Ready-to-Eat,SD FINGER Millet with palm Jaggery 250gm,14,135,135,0,1
26-03-2025,Snacks & Ready-to-Eat,VD NUVULU CHEGODI 175GM,14,60,60,0,1
26-03-2025,"Health, Wellness & Ayurvedic Products",RB Max Protein Salt & Caramel Bar 50g,5,75,75,0,1
26-03-2025,"Health, Wellness & Ayurvedic Products",RB Max Protein Cheese&amp;,5,45,45,0,1
26-03-2025,Snacks & Ready-to-Eat,NGT CHATPATTA CHANA 90GM,14,75,75,0,3
26-03-2025,"Health, Wellness & Ayurvedic Products",RB Max Protein Choco chips 55gm,5,50,50,0,1
26-03-2025,"Grains, Flours & Dals",HS Ragi upma rava 500 gms,4,70,70,0,1
26-03-2025,Snacks & Ready-to-Eat,VD CORNFLAKES MIXTURE 175GM,14,60,60,0,1
26-03-2025,Snacks & Ready-to-Eat,SD black sesme laddu with dates 175gm,14,135,135,0,1
26-03-2025,"Health, Wellness & Ayurvedic Products",RB Max Protein DESI MASALA 60gm,5,45,45,0,1
26-03-2025,Oils & Ghee,Sesame oil 500ml,9,295,280,15,1
26-03-2025,"Health, Wellness & Ayurvedic Products",MAX PROTEIN ALMOND BAR,5,80,80,0,1
26-03-2025,Snacks & Ready-to-Eat,RB Choco Delite Almonds Raisins 40g,14,45,45,0,1
26-03-2025,Snacks & Ready-to-Eat,SD FLAX SEED APPADALU,14,90,90,0,1
26-03-2025,Snacks & Ready-to-Eat,VD DAHI MIRCHI(SALTED) 100GM,14,45,45,0,1
26-03-2025,"Health, Wellness & Ayurvedic Products",RB Nuts& Seeds cashews 35g,5,45,45,0,1
26-03-2025,Oils & Ghee,Groundnut oil 1 L,9,360,330,30,1
26-03-2025,"Dry Fruits, Nuts & Seeds",cashew,2,340,310,30,1
26-03-2025,Sweeteners,YB JAGGERY POWDER 500GMS,16,150,150,0,2
26-03-2025,Oils & Ghee,Safflower oil 1 L,9,440,400,40,1
26-03-2025,Snacks & Ready-to-Eat,VD KOBARI LADDU,14,80,80,0,1
26-03-2025,"Grains, Flours & Dals",DH URAD GOTA 1KG,4,215,190,25,1
26-03-2025,"Grains, Flours & Dals",Multigrain 1 kg,4,400,340,60,4
26-03-2025,"Grains, Flours & Dals",VL Sabdana 500GM,4,77,77,0,1
26-03-2025,Snacks & Ready-to-Eat,NGT CHATPATTA CHANA 90GM,14,50,50,0,2
26-03-2025,Pickles & Cooking Pastes,SD MESTA PICKLE,11,110,110,0,1
26-03-2025,Pickles & Cooking Pastes,SD BITTER GOURD PICKLE,11,110,110,0,1
26-03-2025,Spices & Seasonings,Chilli powder 500 gms,15,290,210,80,1
26-03-2025,"Dry Fruits, Nuts & Seeds",sabja seeds,2,80,70,10,1
26-03-2025,Sweeteners,GS A2 Buffalo Ghee 500ML,16,550,550,0,1
26-03-2025,"Grains, Flours & Dals",RAGI FLOUR 1KG,4,80,70,10,1
26-03-2025,Household & Cleaning,vim small,6,15,15,0,1
26-03-2025,Oils & Ghee,Groundnut oil 1 L,9,360,330,30,1
26-03-2025,Spices & Seasonings,Jeera 100GM,15,50,45,5,1
26-03-2025,"Grains, Flours & Dals",VYS.SP RICE 1 KG,4,140,130,10,2
26-03-2025,Household & Cleaning,comfort morning fresh,6,58,58,0,1
26-03-2025,Snacks & Ready-to-Eat,NGT CHATPATTA CHANA 90GM,14,50,50,0,2
26-03-2025,Personal Care & Cosmetics,DETTOL ORIGINAL,10,99,99,0,1
26-03-2025,Oils & Ghee,rice bran oil f,9,194,169,25,1
26-03-2025,Sweeteners,MISHRI 250 GM,16,35,30,5,1
26-03-2025,Spices & Seasonings,DRY MIECHI 200GM,15,80,60,20,1
26-03-2025,"Dry Fruits, Nuts & Seeds",PUTNALU 500GMS,2,90,76,14,1
26-03-2025,General Household & Kitchenware,GOOD HOME,3,15,15,0,1
26-03-2025,"Grains, Flours & Dals",turdal 500 gms,4,110,85,25,1
26-03-2025,Beverages,BRU GREEN LABEL 1.2G,1,48,48,0,24
26-03-2025,"Dry Fruits, Nuts & Seeds",Groundnuts 500 gms,2,95,85,10,1
26-03-2025,"Grains, Flours & Dals",Idly Rava L 1KG,4,60,50,10,1
26-03-2025,Snacks & Ready-to-Eat,KURNOOL MARMURA,14,70,55,15,1
26-03-2025,"Grains, Flours & Dals",RED TURDAL 500GM,4,75,70,5,1
26-03-2025,"Grains, Flours & Dals",split black gram 1 kg,4,180,170,10,1
26-03-2025,"Grains, Flours & Dals",Chana Flour 500 gms,4,70,65,5,1
26-03-2025,"Grains, Flours & Dals",Brown RICE 1KG,4,350,325,25,5
26-03-2025,"Grains, Flours & Dals",Multigrain 1 kg,4,300,255,45,3
26-03-2025,Oils & Ghee,Coconut oil 500 ml,9,220,200,20,1
26-03-2025,"Grains, Flours & Dals",Wheat Flour 1 kg,4,140,120,20,2
26-03-2025,"Grains, Flours & Dals",SRILATHA RICE RAVVA 500GM,4,70,70,0,2
26-03-2025,"Grains, Flours & Dals",turdal 1kg,4,220,170,50,1
26-03-2025,"Grains, Flours & Dals",PESARA PAPPU 500GMS,4,85,75,10,1
26-03-2025,"Grains, Flours & Dals",CHANA DAL 500GM,4,70,60,10,1
26-03-2025,Spices & Seasonings,SWEET SOUNF,15,20,20,0,1
26-03-2025,"Grains, Flours & Dals",Wheat Flour 1 kg,4,70,60,10,1
26-03-2025,Milk & Dairy,BROWN EGGS 1P,7,168,144,24,12
26-03-2025,"Grains, Flours & Dals",chana dall,4,35,30,5,1
26-03-2025,"Grains, Flours & Dals",ANDU KORRALU (Brown top .mlt) 500,4,130,110,20,1
26-03-2025,"Grains, Flours & Dals",SAMALU (Little millet) 500 gms,4,85,65,20,1
26-03-2025,"Grains, Flours & Dals",KORRALU (FOXTAIL M) 500GM,4,130,110,20,2
26-03-2025,"Grains, Flours & Dals",POORI ATTA 500GM,4,35,30,5,1
26-03-2025,Snacks & Ready-to-Eat,VD DAHI MIRCHI(SALTED) 100GM,14,45,45,0,1
26-03-2025,Spices & Seasonings,SWEET SOUNF,15,20,20,0,1
26-03-2025,Snacks & Ready-to-Eat,PEANUT CHILLI,14,15,15,0,3
26-03-2025,Spices & Seasonings,dalchin chekka,15,50,40,10,1
26-03-2025,"Grains, Flours & Dals",Multigrain 1 kg,4,100,85,15,1
26-03-2025,"Grains, Flours & Dals",Wheat Flour 1 kg,4,70,60,10,1
26-03-2025,Sweeteners,NATURAL HONEY 250GM,16,150,130,20,1
26-03-2025,"Grains, Flours & Dals",Wheat Flour 1 kg,4,70,60,10,1
26-03-2025,"Grains, Flours & Dals",HS JOWAR IDLY RAWA,4,65,65,0,1
26-03-2025,"Grains, Flours & Dals",White jowar.F 1 kg,4,100,80,20,1
26-03-2025,"Grains, Flours & Dals",MULTIMILLET IDLY RAVVA,4,65,65,0,1
26-03-2025,"Grains, Flours & Dals",KORRALU (FOXTAIL M) 1KG,4,300,220,80,2
26-03-2025,Spices & Seasonings,kasturi methi,15,60,60,0,1
26-03-2025,"Grains, Flours & Dals",Wheat Rava M 1KG,4,65,55,10,1
26-03-2025,Oils & Ghee,Groundnut oil 1 L,9,360,330,30,1
26-03-2025,Oils & Ghee,Sesame oil 1 L,9,590,560,30,1
26-03-2025,"Grains, Flours & Dals",THICK POHA 1KG,4,80,70,10,1
26-03-2025,"Grains, Flours & Dals",DH URAD GOTA 1KG,4,430,380,50,2
26-03-2025,"Dry Fruits, Nuts & Seeds",Groundnuts 1 kg,2,190,165,25,1
26-03-2025,"Dry Fruits, Nuts & Seeds",SD Mango cubes 100gm,2,45,45,0,1
26-03-2025,Personal Care & Cosmetics,Soapnut 250GM,10,60,45,15,1
26-03-2025,"Grains, Flours & Dals",VGR rice 1 kg,4,350,325,25,5
26-03-2025,"Grains, Flours & Dals",Idly Rava L 1KG,4,120,100,20,2
26-03-2025,"Grains, Flours & Dals",turdal 500 gms,4,110,85,25,1
26-03-2025,General Household & Kitchenware,GOOD HOME,3,15,15,0,1
26-03-2025,"Dry Fruits, Nuts & Seeds",Groundnuts 1 kg,2,190,165,25,1
26-03-2025,Household & Cleaning,VIM EXTRA 110GM,6,20,20,0,2
26-03-2025,Oils & Ghee,Groundnut oil 1 L,9,360,330,30,1
26-03-2025,Oils & Ghee,Safflower oil 1 L,9,880,800,80,2
26-03-2025,Milk & Dairy,BROWN EGGS 1P,7,196,168,28,14
26-03-2025,Oils & Ghee,Safflower oil 1 L,9,440,400,40,1
26-03-2025,Snacks & Ready-to-Eat,SD Moringa with plam jaggery 250gm,14,135,135,0,1
26-03-2025,"Grains, Flours & Dals",unpolished turdall500grms,4,120,110,10,1
26-03-2025,Snacks & Ready-to-Eat,DINNER PAPAD,14,80,80,0,1
26-03-2025,Misc,R8904117900258,8,55,55,0,1
26-03-2025,"Dry Fruits, Nuts & Seeds",PUMPKIN SEEDS 250GM,2,200,160,40,1
26-03-2025,Household & Cleaning,VIM MAHA BAR,6,30,30,0,3
26-03-2025,Milk & Dairy,BROWN EGGS TRAY 30P,7,360,330,30,1
26-03-2025,Snacks & Ready-to-Eat,VD PALLI CHIKKI,14,80,80,0,1
26-03-2025,Snacks & Ready-to-Eat,PEANUT CHILLI,14,30,30,0,6
26-03-2025,Pooja & Spiritual Items,SWASTIK CAMPHORE,12,90,90,0,1
26-03-2025,Personal Care & Cosmetics,DWI SMARA SOAP 100GM,10,150,150,0,2
26-03-2025,Oils & Ghee,GANTASALA A2 COW GHEE 500ML,9,550,550,0,1
26-03-2025,"Dry Fruits, Nuts & Seeds",ANJEER 250GM,2,400,360,40,1
26-03-2025,"Dry Fruits, Nuts & Seeds",PLAIN PISTA 250GM,2,660,550,110,1
26-03-2025,"Grains, Flours & Dals",SAMALU (Little millet) 500 gms,4,85,65,20,1
26-03-2025,"Grains, Flours & Dals",Green gram 500 gms,4,75,70,5,1
26-03-2025,"Grains, Flours & Dals",KORRALU (FOXTAIL M) 500GM,4,65,55,10,1
26-03-2025,"Dry Fruits, Nuts & Seeds",WATERMELON SEEDS 250GRM,2,320,280,40,1
26-03-2025,Personal Care & Cosmetics,DWI FOOT CARE 30G,10,90,90,0,1
26-03-2025,Pooja & Spiritual Items,PACHAKARPURAM,12,60,50,10,1
26-03-2025,Oils & Ghee,Coconut oil 500 ml,9,220,200,20,1
26-03-2025,"Grains, Flours & Dals",PESARA PAPPU 500GMS,4,85,75,10,1
26-03-2025,Snacks & Ready-to-Eat,VD MINAPA MIRCHI PAPAD 195GM,14,60,60,0,1
26-03-2025,"Grains, Flours & Dals",Urad dall 1 Kg,4,370,340,30,2
26-03-2025,"Grains, Flours & Dals",white Bobarlu 500 gms,4,80,75,5,1
26-03-2025,"Grains, Flours & Dals",KORRALU (FOXTAIL M) 1KG,4,150,110,40,1
26-03-2025,Oils & Ghee,Sesame oil 1 L,9,590,560,30,1
26-03-2025,"Grains, Flours & Dals",VYS.SP RICE 1 KG,4,280,260,20,4
26-03-2025,Snacks & Ready-to-Eat,NGT CHATPATTA CHANA 90GM,14,25,25,0,1
26-03-2025,Snacks & Ready-to-Eat,murmura venk,14,50,45,5,1
26-03-2025,"Grains, Flours & Dals",Idly Rava L 1KG,4,60,50,10,1
26-03-2025,Spices & Seasonings,AVALU 100GM,15,25,20,5,1
26-03-2025,Personal Care & Cosmetics,ORAL B KIDS,10,25,25,0,1
26-03-2025,Oils & Ghee,A2 BUFFALO GHEE 250ML,9,299,299,0,1
26-03-2025,"Grains, Flours & Dals",Wheat Rava M 500GM,4,33,30,3,1
26-03-2025,Spices & Seasonings,sf jeera,15,120,120,0,1
26-03-2025,General Household & Kitchenware,MATCH BOX,3,40,40,0,2
26-03-2025,Sweeteners,ACHU BELLAM 1KG,16,100,80,20,1
26-03-2025,Pooja & Spiritual Items,GD Aiswarya Deepam 700ML,12,195,195,0,1
26-03-2025,Spices & Seasonings,SAFE HARVEST FENNEL SANUF,15,110,110,0,1
26-03-2025,Misc,ROLL D C,8,70,45,25,1
26-03-2025,"Grains, Flours & Dals",Wheat Flour 1 kg,4,280,240,40,4
26-03-2025,Spices & Seasonings,Tamarind 250GMS,15,80,65,15,1
26-03-2025,Sweeteners,YB Brown Sugar 500GM,16,75,75,0,1
26-03-2025,Spices & Seasonings,SAJEERA,15,60,40,20,1
26-03-2025,Spices & Seasonings,Turmeric powder 250 gms,15,100,75,25,1
26-03-2025,"Dry Fruits, Nuts & Seeds",Groundnuts 1 kg,2,190,165,25,1
26-03-2025,"Grains, Flours & Dals",SRILALITHA MAIDA FLOUR 500G,4,32,32,0,1
26-03-2025,"Grains, Flours & Dals",Urad dall 1 Kg,4,185,170,15,1
26-03-2025,Spices & Seasonings,Tamarind 500GM,15,160,130,30,1
26-03-2025,"Grains, Flours & Dals",CHANA DAL 500GM,4,140,120,20,2
26-03-2025,Spices & Seasonings,JEERA 250 gms,15,125,105,20,1
26-03-2025,"Grains, Flours & Dals",MAA TEJA RICE BAG 26KG,4,2210,"1,750.00",460,1
26-03-2025,"Grains, Flours & Dals",turdal 1kg,4,440,340,100,2
26-03-2025,"Grains, Flours & Dals",chana dall,4,35,30,5,1
26-03-2025,"Grains, Flours & Dals",Wheat Flour 1 kg,4,70,60,10,1
26-03-2025,Snacks & Ready-to-Eat,murmura venk,14,50,45,5,1
26-03-2025,"Grains, Flours & Dals",turdal 1kg,4,220,170,50,1
26-03-2025,"Grains, Flours & Dals",SRILATHA RICE RAVVA 500GM,4,35,35,0,1
26-03-2025,Spices & Seasonings,ROYAL SAFFRON 400GRMS,15,65,65,0,1
26-03-2025,Snacks & Ready-to-Eat,KURNOOL MARMURA,14,70,55,15,1
26-03-2025,"Dry Fruits, Nuts & Seeds",sabja seeds,2,80,70,10,1
26-03-2025,Spices & Seasonings,Menthulu 250 gms,15,50,45,5,1
26-03-2025,Snacks & Ready-to-Eat,VD Minapa papad 200gm,14,60,60,0,1
26-03-2025,"Grains, Flours & Dals",Yellow jowar .F1 kg,4,110,100,10,1
26-03-2025,"Grains, Flours & Dals",White jowar.F 1 kg,4,100,80,20,1
26-03-2025,Spices & Seasonings,JEERA 250 gms,15,125,105,20,1
26-03-2025,Oils & Ghee,Groundnut oil 500ml,9,180,165,15,1
26-03-2025,"Grains, Flours & Dals",VGR RICE 5 KGS,4,350,325,25,1
26-03-2025,"Grains, Flours & Dals",Bombay Rava 500GM,4,35,30,5,1
26-03-2025,Oils & Ghee,Sesame oil 1 L,9,590,560,30,1
26-03-2025,"Grains, Flours & Dals",AISHWARYA MOONGDAL RICE,4,140,84,56,1
26-03-2025,Spices & Seasonings,GREEN SOUNF,15,120,80,40,2
26-03-2025,"Grains, Flours & Dals",HS JOWAR IDLY RAWA,4,195,195,0,3
26-03-2025,Spices & Seasonings,Jeera 100GM,15,50,45,5,1
26-03-2025,Spices & Seasonings,Vamu 100GM,15,60,50,10,1
26-03-2025,"Grains, Flours & Dals",Wheat Flour 1 kg,4,140,120,20,2
26-03-2025,Pooja & Spiritual Items,PACHAKARPURAM,12,120,100,20,2
26-03-2025,Household & Cleaning,VIM MAHA BAR,6,50,50,0,5
26-03-2025,"Dry Fruits, Nuts & Seeds",DIANUTS 500GM,2,240,240,0,2
26-03-2025,"Dry Fruits, Nuts & Seeds",DRYDATES YELLOW 250GM,2,135,120,15,1
26-03-2025,"Health, Wellness & Ayurvedic Products",MD Triphala Chorrnam 100GM,5,80,80,0,1
26-03-2025,Snacks & Ready-to-Eat,VD MINAPA VADIYAM,14,65,65,0,1
26-03-2025,"Grains, Flours & Dals",Chana Flour 500 gms,4,70,65,5,1
26-03-2025,"Dry Fruits, Nuts & Seeds",Groundnuts 500 gms,2,95,85,10,1
26-03-2025,"Grains, Flours & Dals",Red Chana 250GM,4,35,30,5,1
26-03-2025,Snacks & Ready-to-Eat,VD BELLAM GAVVALU 200GM,14,60,60,0,1
26-03-2025,Misc,VD0001,8,100,100,0,1
26-03-2025,Milk & Dairy,BROWN EGGS 1P,7,168,144,24,12
26-03-2025,Sweeteners,NATURAL HONEY 250GM,16,150,130,20,1
26-03-2025,Snacks & Ready-to-Eat,CHOCO BROWINE,14,40,40,0,2
26-03-2025,Snacks & Ready-to-Eat,SD Groundnut with palm jaggery 250gm,14,135,135,0,1
26-03-2025,Oils & Ghee,Sesame oil 500ml,9,295,280,15,1
26-03-2025,Snacks & Ready-to-Eat,SD Atreyapuram DRY Fruit ghee,14,150,150,0,1
26-03-2025,Milk & Dairy,HERITAGE BUTTERMILK,7,60,60,0,6
26-03-2025,Oils & Ghee,Groundnut oil 1 L,9,360,330,30,1
26-03-2025,Milk & Dairy,BROWN EGGS 1P,7,168,144,24,12
26-03-2025,Pickles & Cooking Pastes,SD RED CHILLI MESTA,11,110,110,0,1
26-03-2025,Snacks & Ready-to-Eat,JUNNU POWDER 100GM,14,70,70,0,1
26-03-2025,Snacks & Ready-to-Eat,RICE PALTA,14,26,26,0,1
26-03-2025,Snacks & Ready-to-Eat,SESAME CHIKKI,14,120,100,20,1
26-03-2025,Snacks & Ready-to-Eat,VD PALLI CHIKKI,14,80,80,0,1
26-03-2025,Sweeteners,SUGAR 500 GM,16,30,25,5,1
26-03-2025,"Grains, Flours & Dals",WHITE J F,4,50,40,10,1
26-03-2025,Oils & Ghee,Flaxseed oil 1 L,9,1180,"1,080.00",100,2
26-03-2025,"Health, Wellness & Ayurvedic Products",RB Max Protein DESI MASALA 60gm,5,45,45,0,1
26-03-2025,"Health, Wellness & Ayurvedic Products",RB Max Protein Cheese&amp;,5,45,45,0,1
26-03-2025,Milk & Dairy,HERITAGE BUTTERMILK,7,40,40,0,4
26-03-2025,"Grains, Flours & Dals",Green gram 500 gms,4,75,70,5,1
26-03-2025,"Grains, Flours & Dals",SABDANA 500GM,4,180,140,40,2
26-03-2025,Spices & Seasonings,Chilli powder 500 gms,15,290,210,80,1
26-03-2025,Snacks & Ready-to-Eat,VD RIBBON PAKODI 175GM,14,60,60,0,1
26-03-2025,"Grains, Flours & Dals",SABDANA 500GM,4,90,70,20,1
26-03-2025,Spices & Seasonings,Tamarind 250GMS,15,80,65,15,1
26-03-2025,Snacks & Ready-to-Eat,BB VERMICELLY 500GM,14,53,53,0,1
26-03-2025,"Grains, Flours & Dals",split black gram 1 kg,4,180,170,10,1
26-03-2025,Household & Cleaning,harpic 500ml,6,110,110,0,1
26-03-2025,Oils & Ghee,Groundnut oil 1 L,9,360,330,30,1
26-03-2025,"Grains, Flours & Dals",Wheat Rava M 1KG,4,65,55,10,1
26-03-2025,Oils & Ghee,Groundnut oil 1 L,9,720,660,60,2
26-03-2025,Oils & Ghee,rice bran oil f,9,194,169,25,1
26-03-2025,Spices & Seasonings,LG 50GM,15,92,92,0,1
25-03-2025,Beverages,REFRESH SHARBATH SUGAR FREE,1,299,285,14,1
25-03-2025,"Dry Fruits, Nuts & Seeds",PULMAKHANA 100 GM,2,360,340,20,2
25-03-2025,Spices & Seasonings,PRO ORG FENUGREEK 200GM,15,86,86,0,1
25-03-2025,Snacks & Ready-to-Eat,GS INSTANT KORRA DOSA MIX 400GM,14,120,120,0,1
25-03-2025,"Grains, Flours & Dals",MELMEKER 250GMS,4,60,45,15,1
25-03-2025,"Dry Fruits, Nuts & Seeds",PRO ORG RAW PEANUTS 500GM,2,174,174,0,1
25-03-2025,Snacks & Ready-to-Eat,BD RAGI NOODLES,14,75,75,0,1
25-03-2025,Snacks & Ready-to-Eat,SD Little Millet WITH PLAM JAGGERY,14,135,135,0,1
25-03-2025,"Grains, Flours & Dals",HS JOWAR FLAKES 250GM 1+1,4,119,119,0,1
25-03-2025,Spices & Seasonings,dalchin chekka,15,50,40,10,1
25-03-2025,"Grains, Flours & Dals",RICE FLOUR 1KG,4,70,55,15,1
25-03-2025,Snacks & Ready-to-Eat,CHOCO BROWINE,14,20,20,0,1
25-03-2025,"Dry Fruits, Nuts & Seeds",Putnalu 250GM,2,45,38,7,1
25-03-2025,Snacks & Ready-to-Eat,NGT CHATPATTA CHANA 90GM,14,25,25,0,1
25-03-2025,"Grains, Flours & Dals",White jowar.F 1 kg,4,100,80,20,1
25-03-2025,Spices & Seasonings,SATHVI ANASAPUVUU 25GM,15,90,65,25,1
25-03-2025,Snacks & Ready-to-Eat,VD GUMMADI VADIYAM,14,75,75,0,1
25-03-2025,Snacks & Ready-to-Eat,RINGS 200GM,14,30,30,0,1
25-03-2025,"Grains, Flours & Dals",MELMEKER 250GMS,4,60,45,15,1
25-03-2025,"Grains, Flours & Dals",MAATEJA rice 1 kg,4,144,138,6,2
25-03-2025,"Grains, Flours & Dals",VYS.SP RICE 1 KG,4,490,455,35,7
25-03-2025,Snacks & Ready-to-Eat,CHOCO BROWINE,14,60,60,0,3
25-03-2025,"Grains, Flours & Dals",RAGI FLOUR 500GRMS,4,40,35,5,1
25-03-2025,Spices & Seasonings,Jeera 100GM,15,50,45,5,1
25-03-2025,Spices & Seasonings,Masala Karam 500 gms,15,260,240,20,1
25-03-2025,"Grains, Flours & Dals",VGR rice 1 kg,4,350,325,25,5
25-03-2025,Spices & Seasonings,ROYAL SAFFRON 400GRMS,15,65,65,0,1
25-03-2025,Personal Care & Cosmetics,Soapnut 250GM,10,60,45,15,1
25-03-2025,"Dry Fruits, Nuts & Seeds",sabja seeds,2,80,70,10,1
25-03-2025,Spices & Seasonings,Turmeric powder 250 gms,15,100,75,25,1
25-03-2025,Personal Care & Cosmetics,HERBAL BATH POWDER 200GM,10,80,80,0,1
25-03-2025,Milk & Dairy,BROWN EGGS TRAY 30P,7,360,330,30,1
25-03-2025,"Dry Fruits, Nuts & Seeds",MAHA BEERA SEEDS 100GM,2,160,160,0,2
25-03-2025,Personal Care & Cosmetics,MADDI HIBISCUS HAIR SHAMPOO 500ML,10,300,300,0,1
25-03-2025,Pooja & Spiritual Items,GD KUMKUM 50GM,12,60,60,0,2
25-03-2025,"Grains, Flours & Dals",MAAGAANI W RICE 1KG,4,695,550,145,5
25-03-2025,"Grains, Flours & Dals",Chana Flour 500 gms,4,70,65,5,1
25-03-2025,"Grains, Flours & Dals",Urad dall 1 Kg,4,215,200,15,1
25-03-2025,"Grains, Flours & Dals",White jowar.F 1 kg,4,100,80,20,1
25-03-2025,"Grains, Flours & Dals",white Bobarlu 500 gms,4,80,75,5,1
25-03-2025,"Grains, Flours & Dals",split urad dall 250 gms,4,45,40,5,1
25-03-2025,Snacks & Ready-to-Eat,VD SAGOPAPAD 150GM,14,55,55,0,1
25-03-2025,"Grains, Flours & Dals",Chana Flour 500 gms,4,70,65,5,1
25-03-2025,"Grains, Flours & Dals",Sathya Javva Wheat Rava 500GM,4,95,95,0,1
25-03-2025,Spices & Seasonings,Jeera 100GM,15,50,45,5,1
25-03-2025,Personal Care & Cosmetics,Soapnut 250GM,10,60,45,15,1
25-03-2025,Personal Care & Cosmetics,OVAL BODY LOOFAH,10,55,55,0,1
25-03-2025,Spices & Seasonings,AVALU 250grms,15,60,60,0,1
25-03-2025,Personal Care & Cosmetics,VASELINE 5GM,10,54,54,0,1
25-03-2025,Household & Cleaning,ROOPERI PITAMBARI SILVER 50ML,6,110,110,0,1
25-03-2025,"Grains, Flours & Dals",Wheat Flour 1 kg,4,70,60,10,1
25-03-2025,"Dry Fruits, Nuts & Seeds",YELLOW KISHMISH 250GM,2,130,110,20,1
25-03-2025,Snacks & Ready-to-Eat,SD Pumpkin Seeds With Dates 175gm,14,170,170,0,1
25-03-2025,Spices & Seasonings,white miryalu,15,60,50,10,1
25-03-2025,Sweeteners,GS JAGGERY NUGGETS 500GM,16,120,120,0,1
25-03-2025,"Dry Fruits, Nuts & Seeds",ANJEER 250GM,2,400,360,40,1
25-03-2025,Snacks & Ready-to-Eat,VD DASA DINUSULU,14,199,199,0,1
25-03-2025,"Grains, Flours & Dals",PESARA PAPPU 500GMS,4,85,75,10,1
25-03-2025,"Grains, Flours & Dals",Red Bobarlu 500 gms,4,95,85,10,1
25-03-2025,"Grains, Flours & Dals",Green gram 1 kg,4,150,130,20,1
25-03-2025,Snacks & Ready-to-Eat,BD KODO MILLET NOODLES 200GM,14,75,75,0,1
25-03-2025,Beverages,BRU GREEN LABEL 1.2G,1,48,48,0,24
25-03-2025,Snacks & Ready-to-Eat,SD FLAX SEED APPADALU,14,90,90,0,1
25-03-2025,"Grains, Flours & Dals",Em Multimillet idli r 500g,4,129,129,0,1
25-03-2025,Snacks & Ready-to-Eat,DINNER PAPAD,14,80,80,0,1
25-03-2025,"Grains, Flours & Dals",Chana Flour 500 gms,4,70,65,5,1
25-03-2025,"Grains, Flours & Dals",Yellow jowar .F1 kg,4,110,100,10,1
25-03-2025,"Grains, Flours & Dals",EM kodo upma R 500g,4,129,129,0,1
25-03-2025,"Dry Fruits, Nuts & Seeds",DIANUTS 500GM,2,120,120,0,1
25-03-2025,"Dry Fruits, Nuts & Seeds",FLAX SEEDS 250GM,2,60,50,10,1
25-03-2025,Snacks & Ready-to-Eat,BD RAGI NOODLES,14,75,75,0,1
25-03-2025,"Grains, Flours & Dals",RICE FLOUR 500 GM,4,35,28,7,1
25-03-2025,"Health, Wellness & Ayurvedic Products",MD Kasturi Pasupu Choornam 50GM,5,80,80,0,1
25-03-2025,"Grains, Flours & Dals",Idly Rava L 1KG,4,120,100,20,2
25-03-2025,Snacks & Ready-to-Eat,MIX MILLET NOODLES,14,75,75,0,1
25-03-2025,Sweeteners,YB JAGGERY POWDER 500GMS,16,75,75,0,1
25-03-2025,Misc,VD00014,8,100,90,10,1
25-03-2025,"Grains, Flours & Dals",RAGI FLOUR 500GRMS,4,40,35,5,1
25-03-2025,Spices & Seasonings,MG Dasa dinasalu 250gm,15,220,220,0,1
25-03-2025,Oils & Ghee,Groundnut oil 500ml,9,180,165,15,1
25-03-2025,Household & Cleaning,VIM EXTRA 110GM,6,20,20,0,2
25-03-2025,Snacks & Ready-to-Eat,SD Ginger Candy 100g,14,60,60,0,1
25-03-2025,Pooja & Spiritual Items,PACHAKARPURAM,12,120,100,20,2
25-03-2025,"Grains, Flours & Dals",White jowar.F 500 Gms,4,50,40,10,1
25-03-2025,Pooja & Spiritual Items,SWASTIK CAMPHORE,12,90,90,0,1
25-03-2025,Beverages,BRU GREEN LABEL 1.2G,1,28,28,0,14
25-03-2025,Oils & Ghee,Sesame oil 500ml,9,295,280,15,1
25-03-2025,Household & Cleaning,VIM SOAP,6,10,10,0,2
25-03-2025,"Grains, Flours & Dals",unpolished turdall500grms,4,120,110,10,1
25-03-2025,"Grains, Flours & Dals",VL Sabdana 500GM,4,77,77,0,1
25-03-2025,Milk & Dairy,HRITAGE TOTAL CURD 130GM,7,20,20,0,2
25-03-2025,"Grains, Flours & Dals",HS JOWAR IDLY RAWA,4,130,130,0,2
25-03-2025,"Grains, Flours & Dals",Wheat Rava S 500GM,4,33,30,3,1
25-03-2025,"Dry Fruits, Nuts & Seeds",ALMONDS 250GM,2,280,260,20,1
25-03-2025,Snacks & Ready-to-Eat,GROUNDNUT LADDU WITH DATES,14,135,135,0,1
25-03-2025,"Grains, Flours & Dals",AISHWARYA SP 25KG,4,1999,"1,690.00",309,1
25-03-2025,Oils & Ghee,Mustard oil 500 ml,9,220,195,25,1
25-03-2025,"Grains, Flours & Dals",VGR RICE 5 KGS,4,350,325,25,1
25-03-2025,"Health, Wellness & Ayurvedic Products",RB Max Protein Spanish Tomato,5,45,45,0,1
25-03-2025,"Health, Wellness & Ayurvedic Products",RB Max Protein Choco Berry bar 50g,5,75,75,0,1
25-03-2025,Snacks & Ready-to-Eat,RSC ORANGE 100GMS,14,20,20,0,1
25-03-2025,"Dry Fruits, Nuts & Seeds",Groundnuts 1 kg,2,190,165,25,1
25-03-2025,"Grains, Flours & Dals",RED TUDAL 1KG,4,150,140,10,1
25-03-2025,"Grains, Flours & Dals",SL Idly Rava 1KG,4,65,55,10,1
25-03-2025,"Grains, Flours & Dals",turdal 1kg,4,220,170,50,1
25-03-2025,"Grains, Flours & Dals",unpolished turdall500grms,4,120,110,10,1
25-03-2025,"Grains, Flours & Dals",KORRALU (FOXTAIL M) 500GM,4,65,55,10,1
25-03-2025,"Grains, Flours & Dals",MAAGAANI LOW GI SP L 1KG,4,600,525,75,5
25-03-2025,"Grains, Flours & Dals",SINGLE POLISH 1KG,4,65,65,0,1
25-03-2025,"Grains, Flours & Dals",Wheat Rava S 1KG,4,65,55,10,1
25-03-2025,Sweeteners,YB Brown Sugar 500GM,16,75,75,0,1
25-03-2025,Household & Cleaning,VIM SOAP,6,5,5,0,1
25-03-2025,"Grains, Flours & Dals",ANDU KORRALU (Browntop.m) 1 kg,4,260,220,40,1
25-03-2025,Sweeteners,SUGAR 1KG,16,60,50,10,1
25-03-2025,"Grains, Flours & Dals",JOWAR YELLOW 1 K,4,200,180,20,2
25-03-2025,"Grains, Flours & Dals",BAJRA 1 KG,4,60,50,10,1
25-03-2025,Personal Care & Cosmetics,Soapnut 250GM,10,60,45,15,1
25-03-2025,"Grains, Flours & Dals",WHEAT 1 KG,4,120,100,20,2
25-03-2025,Household & Cleaning,ODOMOS,6,32,32,0,1
25-03-2025,Personal Care & Cosmetics,UVIS MULTANI MITTI PW 100GM,10,49,49,0,1
25-03-2025,"Grains, Flours & Dals",Wheat Flour 1 kg,4,70,60,10,1
25-03-2025,Personal Care & Cosmetics,DWI ROSE WATER 120ML,10,90,90,0,1
25-03-2025,Pooja & Spiritual Items,GD SANDAL 150GM,12,110,110,0,1
25-03-2025,Pooja & Spiritual Items,GD Kailash 60 GM,12,60,60,0,1
25-03-2025,Spices & Seasonings,SWEET SOUNF,15,20,20,0,1
25-03-2025,Pooja & Spiritual Items,GOMATHA AGARBATHI,12,75,75,0,1
25-03-2025,"Grains, Flours & Dals",RAGI FLOUR 500GRMS,4,40,35,5,1
25-03-2025,"Grains, Flours & Dals",HS Multimillet idly R 500 gms,4,65,65,0,1
25-03-2025,Milk & Dairy,BROWN EGGS TRAY 30P,7,360,330,30,1
25-03-2025,"Grains, Flours & Dals",THICK POHA 500GM,4,40,35,5,1
25-03-2025,"Grains, Flours & Dals",Wheat Flour 1 kg,4,70,60,10,1
25-03-2025,Spices & Seasonings,RED COPRA 250GMS,15,85,74,11,1
25-03-2025,Spices & Seasonings,Coriander seeds 200 gms,15,48,40,8,1
25-03-2025,Snacks & Ready-to-Eat,mixed chikki,14,220,220,0,2
25-03-2025,Snacks & Ready-to-Eat,SD RED CHILLY PAPADS,14,80,80,0,1
25-03-2025,Snacks & Ready-to-Eat,VD Minapa papad 200gm,14,280,280,0,4
25-03-2025,Personal Care & Cosmetics,ORGANIC SPONGE LOOFAH,10,70,70,0,1
25-03-2025,"Health, Wellness & Ayurvedic Products",AMLA PACHAK,5,100,100,0,1
25-03-2025,Personal Care & Cosmetics,SVE SHIKAKAI SOAP 100GM,10,100,100,0,1
25-03-2025,Snacks & Ready-to-Eat,jeera papad,14,80,80,0,1
25-03-2025,Spices & Seasonings,SD Foxtail Millet Mix Karam Powder 100GM,15,75,75,0,1
25-03-2025,Pickles & Cooking Pastes,SD GINGER PICKLE 250GM,11,220,220,0,2
25-03-2025,Misc,VD00014,8,200,180,20,2
25-03-2025,Personal Care & Cosmetics,SVE PREMIUM PAPAYA SOAP 100GM,10,110,110,0,1
25-03-2025,Pickles & Cooking Pastes,SD RED CHILLI MESTA,11,110,110,0,1
25-03-2025,"Health, Wellness & Ayurvedic Products",PULIPIRI WARTS REMOVER 9GM,5,125,125,0,1
25-03-2025,Spices & Seasonings,SD Redgram Karam Powder 100GM,15,65,65,0,1
25-03-2025,Spices & Seasonings,SD Coriander Seeds Karam Powder 100GM,15,65,65,0,1
25-03-2025,Pickles & Cooking Pastes,SD AMALA PICKLE,11,110,110,0,1
25-03-2025,Snacks & Ready-to-Eat,VD DASA DINUSULU,14,398,398,0,2
25-03-2025,"Grains, Flours & Dals",turdal 1kg,4,220,170,50,1
25-03-2025,"Grains, Flours & Dals",RAGI FLOUR 500GRMS,4,80,70,10,2
25-03-2025,"Grains, Flours & Dals",PRO SABUDHANA 500GM,4,89,89,0,1
25-03-2025,Sweeteners,YB JAGGERY POWDER 500GMS,16,75,75,0,1
25-03-2025,"Grains, Flours & Dals",SRILATHA RICE RAVVA 500GM,4,70,70,0,2
25-03-2025,Snacks & Ready-to-Eat,VD SAGOPAPAD 150GM,14,165,165,0,3
25-03-2025,"Grains, Flours & Dals",Idly Rava L 1KG,4,60,50,10,1
25-03-2025,"Dry Fruits, Nuts & Seeds",Groundnuts 1 kg,2,190,165,25,1
25-03-2025,"Grains, Flours & Dals",YB CHITTIMUTYALU RICE 1KG,4,200,200,0,1
25-03-2025,"Grains, Flours & Dals",PRO ORG MEDIUM POHA 500G,4,78,78,0,1
25-03-2025,Spices & Seasonings,Chilli powder 500 gms,15,290,210,80,1
25-03-2025,Sweeteners,SUGAR 1KG,16,60,50,10,1
25-03-2025,"Grains, Flours & Dals",SL Suji Rava 500GM,4,64,64,0,2
25-03-2025,Oils & Ghee,Groundnut oil 1 L,9,360,330,30,1
25-03-2025,Snacks & Ready-to-Eat,ELITE MILK RUSK 200GM,14,35,35,0,1
25-03-2025,"Grains, Flours & Dals",turdal 1kg,4,220,170,50,1
25-03-2025,Snacks & Ready-to-Eat,VD DASA DINUSULU,14,398,398,0,2
25-03-2025,Pickles & Cooking Pastes,SD RED CHILLI PICKLE,11,110,110,0,1
25-03-2025,Pickles & Cooking Pastes,SD AMALA PICKLE,11,110,110,0,1
25-03-2025,Personal Care & Cosmetics,SVE PREMIUM PAPAYA SOAP 100GM,10,110,110,0,1
25-03-2025,Sweeteners,YB JAGGERY POWDER 500GMS,16,75,75,0,1
25-03-2025,"Grains, Flours & Dals",Wheat Flour 1 kg,4,350,300,50,5
25-03-2025,"Grains, Flours & Dals",RAGI FLOUR 500GRMS,4,80,70,10,2
25-03-2025,"Grains, Flours & Dals",SRILATHA RICE RAVVA 500GM,4,70,70,0,2
25-03-2025,Misc,VD00014,8,200,180,20,2
25-03-2025,Spices & Seasonings,SD Coriander Seeds Karam Powder 100GM,15,65,65,0,1
25-03-2025,"Grains, Flours & Dals",PRO SABUDHANA 500GM,4,89,89,0,1
25-03-2025,Spices & Seasonings,SD Redgram Karam Powder 100GM,15,65,65,0,1
25-03-2025,"Grains, Flours & Dals",White jowar.F 1 kg,4,300,240,60,3
25-03-2025,"Health, Wellness & Ayurvedic Products",AMLA PACHAK,5,100,100,0,1
25-03-2025,Snacks & Ready-to-Eat,SD RED CHILLY PAPADS,14,80,80,0,1
25-03-2025,Snacks & Ready-to-Eat,VD MINAPA MIRCHI PAPAD 195GM,14,120,120,0,2
25-03-2025,Snacks & Ready-to-Eat,mixed chikki,14,220,220,0,2
25-03-2025,Personal Care & Cosmetics,ORGANIC SPONGE LOOFAH,10,70,70,0,1
25-03-2025,"Grains, Flours & Dals",Idly Rava L 1KG,4,60,50,10,1
25-03-2025,Snacks & Ready-to-Eat,VD SAGOPAPAD 150GM,14,165,165,0,3
25-03-2025,Snacks & Ready-to-Eat,VD Minapa papad 200gm,14,70,70,0,1
25-03-2025,"Grains, Flours & Dals",YB CHITTIMUTYALU RICE 1KG,4,200,200,0,1
25-03-2025,"Dry Fruits, Nuts & Seeds",Groundnuts 1 kg,2,190,165,25,1
25-03-2025,Pickles & Cooking Pastes,SD GINGER PICKLE 250GM,11,220,220,0,2
25-03-2025,Personal Care & Cosmetics,SVE SHIKAKAI SOAP 100GM,10,100,100,0,1
25-03-2025,"Health, Wellness & Ayurvedic Products",VEMANA PULIPIRI 10GM,5,120,120,0,1
25-03-2025,"Grains, Flours & Dals",PRO ORG MEDIUM POHA 500G,4,78,78,0,1
25-03-2025,Spices & Seasonings,FLAXSEED KARAM,15,75,75,0,1
25-03-2025,Snacks & Ready-to-Eat,jeera papad,14,80,80,0,1
25-03-2025,"Dry Fruits, Nuts & Seeds",cashew,2,340,310,30,1
25-03-2025,Snacks & Ready-to-Eat,VD MIXTURE 175 GM,14,60,60,0,1
25-03-2025,Sweeteners,SD PALM JAGGERY 500GM,16,200,200,0,1
25-03-2025,"Dry Fruits, Nuts & Seeds",SD Mango cubes 200gm,2,90,90,0,1
25-03-2025,"Dry Fruits, Nuts & Seeds",ALMONDS 250GM,2,280,260,20,1
25-03-2025,"Health, Wellness & Ayurvedic Products",RB Max Protein DESI MASALA 60gm,5,45,45,0,1
25-03-2025,Milk & Dairy,BROWN EGGS 1P,7,84,72,12,6
25-03-2025,Snacks & Ready-to-Eat,CHOCO BROWINE,14,20,20,0,1
25-03-2025,"Grains, Flours & Dals",RAGI FLOUR 500GRMS,4,40,35,5,1
25-03-2025,Snacks & Ready-to-Eat,SF NOODLES CLKASSIC MASALA,14,129,129,0,1
25-03-2025,"Dry Fruits, Nuts & Seeds",PULMAKHANA 100 GM,2,180,170,10,1
25-03-2025,Snacks & Ready-to-Eat,VD BOONDI 175GM,14,60,60,0,1
25-03-2025,Spices & Seasonings,ROYAL SAFFRON 400GRMS,15,65,65,0,1
25-03-2025,Snacks & Ready-to-Eat,Popcorn Seeds 250GM,14,45,40,5,1
25-03-2025,Snacks & Ready-to-Eat,VD SAGOPAPAD 150GM,14,55,55,0,1
25-03-2025,Snacks & Ready-to-Eat,Pani Poori Chips 250GM,14,50,40,10,1
25-03-2025,"Dry Fruits, Nuts & Seeds",sabja seeds,2,80,70,10,1
25-03-2025,"Grains, Flours & Dals",RAGI FLOUR 1KG,4,80,70,10,1
25-03-2025,Pooja & Spiritual Items,PACHAKARPURAM,12,60,50,10,1
25-03-2025,"Grains, Flours & Dals",Multigrain 1 kg,4,100,85,15,1
25-03-2025,"Grains, Flours & Dals",Wheat Flour 1 kg,4,70,60,10,1
25-03-2025,Milk & Dairy,BROWN EGGS TRAY 30P,7,360,330,30,1
25-03-2025,Sweeteners,ACHU BELLAM 1KG,16,100,80,20,1
25-03-2025,Spices & Seasonings,NUVVULU 500GM,15,400,340,60,2
25-03-2025,"Grains, Flours & Dals",Bombay Rava 500GM,4,35,30,5,1
25-03-2025,Spices & Seasonings,RED COPRA 250GMS,15,85,74,11,1
25-03-2025,"Grains, Flours & Dals",split black gram 1 kg,4,180,170,10,1
25-03-2025,"Grains, Flours & Dals",BARLEY FLOUR 250GM,4,45,40,5,1
25-03-2025,"Dry Fruits, Nuts & Seeds",Groundnuts 500 gms,2,95,85,10,1
25-03-2025,"Grains, Flours & Dals",RAGI FLOUR 500GRMS,4,40,35,5,1
25-03-2025,Spices & Seasonings,NUVVULU 500GM,15,160,130,30,1
25-03-2025,"Dry Fruits, Nuts & Seeds",SATHVI CHIA SEEDS 100GM,2,100,80,20,1
25-03-2025,Milk & Dairy,HERITAGE TOTAL CURD 500GM,7,50,50,0,1
25-03-2025,"Grains, Flours & Dals",White jowar.F 1 kg,4,100,80,20,1
25-03-2025,"Grains, Flours & Dals",PESARA PAPPU 1 KG,4,170,145,25,1
25-03-2025,"Grains, Flours & Dals",Yellow jowar .F1 kg,4,110,100,10,1
25-03-2025,"Grains, Flours & Dals",BARLEY FLOUR 250GM,4,45,40,5,1
25-03-2025,"Grains, Flours & Dals",BLACK GRAM 1KG,4,150,140,10,1
25-03-2025,Personal Care & Cosmetics,SVE SUNNI PINDI SCRUBSOAP 100GM,10,100,100,0,1
25-03-2025,"Grains, Flours & Dals",VYS.SP RICE 1 KG,4,700,650,50,10
25-03-2025,Snacks & Ready-to-Eat,murmura venk,14,50,45,5,1
25-03-2025,Oils & Ghee,Sesame oil 1 L,9,590,560,30,1
25-03-2025,"Grains, Flours & Dals",Wheat Flour 1 kg,4,70,60,10,1
25-03-2025,Oils & Ghee,Groundnut oil 1 L,9,360,330,30,1
25-03-2025,Pooja & Spiritual Items,GD Aiswarya Deepam 700ML,12,195,195,0,1
25-03-2025,Oils & Ghee,Groundnut oil 1 L,9,360,330,30,1
25-03-2025,"Grains, Flours & Dals",KORRALU (FOXTAIL M) 500GM,4,65,55,10,1
25-03-2025,Milk & Dairy,SANGAM TONED MILK 500ML,7,30,30,0,1
25-03-2025,Personal Care & Cosmetics,ORAL B KIDS,10,25,25,0,1
25-03-2025,Pooja & Spiritual Items,GD Kailash 60 GM,12,60,60,0,1
25-03-2025,General Household & Kitchenware,good home,3,110,110,0,1
25-03-2025,Sweeteners,SUGAR 500 GM,16,30,25,5,1
25-03-2025,Personal Care & Cosmetics,harbal shampoo,10,175,175,0,1
25-03-2025,Snacks & Ready-to-Eat,VD PALLI CHIKKI,14,80,80,0,1
25-03-2025,Snacks & Ready-to-Eat,VD SAGOPAPAD 150GM,14,55,55,0,1
25-03-2025,"Grains, Flours & Dals",Wheat Flour 1 kg,4,210,180,30,3
25-03-2025,"Grains, Flours & Dals",HS RAGI FLAKES 250GM 1+1,4,119,119,0,1
25-03-2025,"Grains, Flours & Dals",multi mllit umpa ravva,4,129,129,0,1
25-03-2025,"Grains, Flours & Dals",jowar flakes,4,299,299,0,1
25-03-2025,"Grains, Flours & Dals",HS BAJRA FLAKES 250GM 1+1,4,119,119,0,1
25-03-2025,"Grains, Flours & Dals",HS BARLEY FLAKES 250GM 1+1,4,119,119,0,1
25-03-2025,"Grains, Flours & Dals",HS MULTI UPMA RAVA,4,65,65,0,1
25-03-2025,Snacks & Ready-to-Eat,SD Little Millet WITH PLAM JAGGERY,14,135,135,0,1
25-03-2025,"Grains, Flours & Dals",RAGI FLOUR 1KG,4,80,70,10,1
25-03-2025,"Grains, Flours & Dals",EM Foxtail idli r 500 g,4,109,109,0,1
25-03-2025,"Grains, Flours & Dals",EM kodo upma R 500g,4,129,129,0,1
25-03-2025,Snacks & Ready-to-Eat,GS INSTANT KORRA DOSA MIX 400GM,14,120,120,0,1
25-03-2025,"Grains, Flours & Dals",Em Foxtail upma r 500 g,4,109,109,0,1
25-03-2025,Milk & Dairy,BROWN EGGS 1P,7,140,120,20,10
25-03-2025,Snacks & Ready-to-Eat,SD Thati thandra 200gm,14,150,150,0,1
25-03-2025,Spices & Seasonings,NUVVULU 250GM,15,100,85,15,1
25-03-2025,Oils & Ghee,Groundnut oil 1 L,9,360,330,30,1
25-03-2025,Spices & Seasonings,Tamarind 500GM,15,160,130,30,1
25-03-2025,Oils & Ghee,rice bran oil f,9,194,169,25,1
25-03-2025,Snacks & Ready-to-Eat,SD JOWAR WITH PALM JAGGERY 250GM,14,135,135,0,1
25-03-2025,"Grains, Flours & Dals",split green gram 500 gms,4,75,70,5,1
25-03-2025,Spices & Seasonings,RED COPRA 250GMS,15,85,74,11,1
25-03-2025,Household & Cleaning,HERBAL FLOOR CLEANER 500ML,6,116,116,0,1
25-03-2025,Spices & Seasonings,NUVVULU 250GM,15,100,85,15,1
25-03-2025,"Grains, Flours & Dals",MAAGAANI LOW GI SP L 1KG,4,240,210,30,2
25-03-2025,Spices & Seasonings,LG 50GM,15,92,92,0,1
25-03-2025,"Grains, Flours & Dals",Urad dall 1 Kg,4,370,340,30,2
25-03-2025,Milk & Dairy,HERITAGE TONED MILK 500ML,7,31,31,0,1
25-03-2025,Spices & Seasonings,DRY MIECHI 200GM,15,80,60,20,1
25-03-2025,"Grains, Flours & Dals",idly ravva,4,130,130,0,2
25-03-2025,Milk & Dairy,BROWN EGGS TRAY 30P,7,360,330,30,1
25-03-2025,"Grains, Flours & Dals",Chana Flour 1 kg,4,140,130,10,1
25-03-2025,"Grains, Flours & Dals",Wheat Flour 1 kg,4,140,120,20,2
25-03-2025,"Grains, Flours & Dals",AISHWARYA SP 1KG,4,1200,"1,050.00",150,15
25-03-2025,"Grains, Flours & Dals",AISHWARYA SP 1KG,4,1200,"1,050.00",150,15
25-03-2025,Milk & Dairy,BROWN EGGS TRAY 30P,7,360,330,30,1
25-03-2025,Milk & Dairy,BROWN EGGS TRAY 30P,7,360,330,30,1
25-03-2025,Oils & Ghee,Groundnut oil 1 L,9,360,330,30,1
25-03-2025,Oils & Ghee,Sesame oil 500ml,9,295,280,15,1
25-03-2025,Oils & Ghee,Safflower oil 1 L,9,440,400,40,1
25-03-2025,"Grains, Flours & Dals",Multigrain 1 kg,4,100,85,15,1
25-03-2025,Oils & Ghee,Sesame oil 1 L,9,590,560,30,1
25-03-2025,Snacks & Ready-to-Eat,VD RIBBON PAKODI 175GM,14,60,60,0,1
25-03-2025,Oils & Ghee,Safflower oil 1 L,9,440,400,40,1
25-03-2025,Oils & Ghee,Freedom Rice Bran Oil 1L,9,194,180,14,1
25-03-2025,Oils & Ghee,Groundnut oil 1 L,9,360,330,30,1
25-03-2025,"Grains, Flours & Dals",RAGI FLOUR 1KG,4,160,140,20,2
25-03-2025,Snacks & Ready-to-Eat,NGT CHATPATTA CHANA 90GM,14,75,75,0,3
25-03-2025,"Grains, Flours & Dals",Chana Flour 500 gms,4,70,65,5,1
25-03-2025,Oils & Ghee,Safflower oil 500 ml,9,220,200,20,1
25-03-2025,Spices & Seasonings,Turmeric powder 250 gms,15,100,75,25,1
25-03-2025,"Grains, Flours & Dals",chana dall,4,35,30,5,1
25-03-2025,"Grains, Flours & Dals",Quinova 1 kg,4,220,195,25,1
25-03-2025,Spices & Seasonings,idli karam powdwer,15,65,65,0,1
25-03-2025,General Household & Kitchenware,scissor o,3,20,20,0,1
24-03-2025,"Dry Fruits, Nuts & Seeds",SD Mango cubes 100gm,2,45,45,0,1
24-03-2025,"Grains, Flours & Dals",BARLEY FLOUR 500GM,4,180,160,20,2
24-03-2025,"Dry Fruits, Nuts & Seeds",SATHVI CHIA SEEDS 100GM,2,100,80,20,1
24-03-2025,"Grains, Flours & Dals",Quinova 1 kg,4,220,195,25,1
24-03-2025,"Dry Fruits, Nuts & Seeds",FLAX SEEDS 250GM,2,60,50,10,1
24-03-2025,"Dry Fruits, Nuts & Seeds",cashew,2,340,310,30,1
24-03-2025,"Dry Fruits, Nuts & Seeds",FLAX SEEDS 250GM,2,60,50,10,1
24-03-2025,"Dry Fruits, Nuts & Seeds",DRYDATES YELLOW 250GM,2,135,120,15,1
24-03-2025,"Dry Fruits, Nuts & Seeds",PUMPKIN SEEDS 250GM,2,200,160,40,1
24-03-2025,"Dry Fruits, Nuts & Seeds",YELLOW KISHMISH 250GM,2,130,110,20,1
24-03-2025,"Dry Fruits, Nuts & Seeds",WALLNUTS 250GM,2,380,360,20,1
24-03-2025,"Dry Fruits, Nuts & Seeds",ANJEER 250GM,2,400,360,40,1
24-03-2025,Spices & Seasonings,Elaichi 25GM,15,145,120,25,1
24-03-2025,"Dry Fruits, Nuts & Seeds",SATHVI CHIA SEEDS 100GM,2,100,80,20,1
24-03-2025,Oils & Ghee,Groundnut oil 5 L,9,1800,"1,600.00",200,1
24-03-2025,"Grains, Flours & Dals",SAMALU,4,340,260,80,2
24-03-2025,Oils & Ghee,Groundnut oil 1 L,9,360,330,30,1
24-03-2025,"Grains, Flours & Dals",RAGI FLOUR 500GRMS,4,40,35,5,1
24-03-2025,Milk & Dairy,BROWN EGGS 1P,7,168,144,24,12
24-03-2025,Spices & Seasonings,Tamarind 250GMS,15,80,65,15,1
24-03-2025,Misc,VD00014,8,100,90,10,1
24-03-2025,Snacks & Ready-to-Eat,VD PALLI LADDU,14,80,80,0,1
24-03-2025,"Grains, Flours & Dals",Idly Rava L 1KG,4,60,50,10,1
24-03-2025,Sweeteners,YB Brown Sugar 500GM,16,75,75,0,1
24-03-2025,"Dry Fruits, Nuts & Seeds",Groundnuts 1 kg,2,190,165,25,1
24-03-2025,Snacks & Ready-to-Eat,MB SORGHUM NOODLES 180GM,14,190,190,0,2
24-03-2025,"Health, Wellness & Ayurvedic Products",MXP CHOCO CLASSIC BAR,5,70,70,0,1
24-03-2025,Oils & Ghee,Groundnut oil 1 L,9,360,330,30,1
24-03-2025,"Health, Wellness & Ayurvedic Products",RB Max Protein Chinese Manchurian,5,45,45,0,1
24-03-2025,"Grains, Flours & Dals",Wheat Flour 1 kg,4,140,120,20,2
24-03-2025,"Health, Wellness & Ayurvedic Products",RB Max Protein Chinese Manchurian,5,45,45,0,1
24-03-2025,"Grains, Flours & Dals",DM LOW GI SONA RICE 1KG,4,119,119,0,1
24-03-2025,Oils & Ghee,Sesame oil 500ml,9,295,280,15,1
24-03-2025,"Grains, Flours & Dals",Chana Flour 500 gms,4,70,65,5,1
24-03-2025,Spices & Seasonings,Masala Karam 250 gms,15,130,120,10,1
24-03-2025,Sweeteners,NATURAL HONEY 1KG,16,560,480,80,1
24-03-2025,Milk & Dairy,BROWN EGGS 1P,7,84,72,12,6
24-03-2025,"Dry Fruits, Nuts & Seeds",SD Mango cubes 100gm,2,45,45,0,1
24-03-2025,"Health, Wellness & Ayurvedic Products",MORINGA LEAF POWDER M,5,80,75,5,1
24-03-2025,Personal Care & Cosmetics,ORGANIC SPONGE LOOFAH,10,70,70,0,1
24-03-2025,"Grains, Flours & Dals",RAGI FLOUR 1KG,4,80,70,10,1
24-03-2025,Baking & Cooking Aids,Baking Soda 50GM,0,20,15,5,1
24-03-2025,Oils & Ghee,Sesame oil 1 L,9,590,560,30,1
24-03-2025,Spices & Seasonings,SONTI 50GM,15,100,100,0,1
24-03-2025,"Health, Wellness & Ayurvedic Products",MD Manjistha Choornam 50GM,5,150,150,0,1
24-03-2025,"Dry Fruits, Nuts & Seeds",Groundnuts 1 kg,2,190,165,25,1
24-03-2025,Snacks & Ready-to-Eat,RAJGIRA PEANUT CHIKKI 450GM,14,125,125,0,1
24-03-2025,Baking & Cooking Aids,Baking Soda 50GM,0,20,15,5,1
24-03-2025,Oils & Ghee,Sesame oil 1 L,9,590,560,30,1
24-03-2025,"Grains, Flours & Dals",Red Chana 250GM,4,35,30,5,1
24-03-2025,"Dry Fruits, Nuts & Seeds",Groundnuts 1 kg,2,190,165,25,1
24-03-2025,"Health, Wellness & Ayurvedic Products",RB Max Protein Choco Berry bar 50g,5,50,50,0,1
24-03-2025,"Dry Fruits, Nuts & Seeds",SD Mango cubes 100gm,2,45,45,0,1
24-03-2025,Oils & Ghee,Coconut oil 500 ml,9,220,200,20,1
24-03-2025,Snacks & Ready-to-Eat,RI SPORTS BAR 40G,14,90,90,0,2
24-03-2025,"Grains, Flours & Dals",Wheat Flour 1 kg,4,70,60,10,1
24-03-2025,"Grains, Flours & Dals",PESARA PAPPU 500GMS,4,85,75,10,1
24-03-2025,Oils & Ghee,Groundnut oil 500ml,9,180,165,15,1
24-03-2025,"Grains, Flours & Dals",BARLEY SEEDS 1KG,4,16,14,2,0.1
24-03-2025,Spices & Seasonings,NUVVULU 250GM,15,100,85,15,1
24-03-2025,Spices & Seasonings,NUVVULU 500GM,15,200,170,30,1
24-03-2025,"Grains, Flours & Dals",SL Idly Rava 1KG,4,65,55,10,1
24-03-2025,Sweeteners,YB JAGGERY POWDER 500GMS,16,75,75,0,1
24-03-2025,"Grains, Flours & Dals",Wheat Flour 1 kg,4,210,180,30,3
24-03-2025,Spices & Seasonings,LG 50GM,15,92,92,0,1
24-03-2025,"Grains, Flours & Dals",Multigrain 1 kg,4,100,85,15,1
24-03-2025,Snacks & Ready-to-Eat,BD BARELY NOODLES 200G,14,70,70,0,1
24-03-2025,Oils & Ghee,Coconut oil 500 ml,9,220,200,20,1
24-03-2025,Snacks & Ready-to-Eat,BD RED RICE NOODLES 200G,14,70,70,0,1
24-03-2025,Spices & Seasonings,DRY MIECHI 200GM,15,80,60,20,1
24-03-2025,Snacks & Ready-to-Eat,MIX MILLET NOODLES,14,75,75,0,1
24-03-2025,Spices & Seasonings,Turmeric powder 250 gms,15,100,75,25,1
24-03-2025,Snacks & Ready-to-Eat,VD MINAPA VADIYAM,14,65,65,0,1
24-03-2025,"Grains, Flours & Dals",split urad dall 500 gms,4,90,80,10,1
24-03-2025,Spices & Seasonings,DURGA SALT CRYSTAL 1KG,15,25,25,0,1
24-03-2025,Personal Care & Cosmetics,MD Soapnut Choornam 100GM,10,80,80,0,1
24-03-2025,Oils & Ghee,Coconut oil 500 ml,9,220,200,20,1
24-03-2025,Oils & Ghee,Safflower oil 1 L,9,440,400,40,1
24-03-2025,Oils & Ghee,Groundnut oil 1 L,9,720,660,60,2
24-03-2025,Snacks & Ready-to-Eat,SD Thati thandra 200gm,14,150,150,0,1
24-03-2025,Misc,VD0009,8,100,100,0,1
24-03-2025,Snacks & Ready-to-Eat,mixed chikki,14,110,110,0,1
24-03-2025,Snacks & Ready-to-Eat,VD DAHI MIRCHI(SALTED) 100GM,14,45,45,0,1
24-03-2025,Snacks & Ready-to-Eat,CHOCO BROWINE,14,40,40,0,2
24-03-2025,Pickles & Cooking Pastes,SD LEMON PICKLE,11,110,110,0,1
24-03-2025,Personal Care & Cosmetics,aleova soap,10,90,90,0,1
24-03-2025,Pickles & Cooking Pastes,SD MANGO TOKKU,11,110,110,0,1
24-03-2025,"Grains, Flours & Dals",Wheat Flour 1 kg,4,140,120,20,2
24-03-2025,Milk & Dairy,SANGAM TONED MILK 500ML,7,30,30,0,1
24-03-2025,"Dry Fruits, Nuts & Seeds",PUTNALU 500GMS,2,90,76,14,1
24-03-2025,Spices & Seasonings,DURGA SALT CRYSTAL 1KG,15,28,28,0,1
24-03-2025,Pickles & Cooking Pastes,SD TOMATO PICKLE,11,110,110,0,1
24-03-2025,Spices & Seasonings,AV Iodized Salt 1KG,15,56,50,6,2
24-03-2025,Oils & Ghee,cow ghee 500 ml,9,430,390,40,1
24-03-2025,Oils & Ghee,Safflower oil 1 L,9,440,400,40,1
24-03-2025,Household & Cleaning,surfexcel Tl,6,170,170,0,1
24-03-2025,Oils & Ghee,Coconut oil 500 ml,9,220,200,20,1
24-03-2025,Spices & Seasonings,Masala Karam 250 gms,15,130,120,10,1
24-03-2025,Snacks & Ready-to-Eat,VD Minapa papad 200gm,14,60,60,0,1
24-03-2025,"Grains, Flours & Dals",Multigrain 1 kg,4,100,85,15,1
24-03-2025,"Grains, Flours & Dals",Wheat Flour 1 kg,4,70,60,10,1
24-03-2025,Snacks & Ready-to-Eat,SD Vamu with palm jaggery 250gm,14,135,135,0,1
24-03-2025,"Grains, Flours & Dals",RICE FLOUR 500 GM,4,35,28,7,1
24-03-2025,Oils & Ghee,Groundnut oil 5 L,9,1800,"1,600.00",200,1
24-03-2025,Snacks & Ready-to-Eat,COPRA LADDU 200GM,14,100,80,20,1
24-03-2025,General Household & Kitchenware,MATCH BOX,3,20,20,0,1
24-03-2025,Snacks & Ready-to-Eat,BATANA NGT 70GMS,14,20,20,0,1
24-03-2025,"Grains, Flours & Dals",POORI ATTA 500GM,4,35,30,5,1
24-03-2025,Snacks & Ready-to-Eat,VD Pappu Chekkalu 190gm,14,60,60,0,1
24-03-2025,"Grains, Flours & Dals",PESARA PAPPU 500GMS,4,85,75,10,1
24-03-2025,"Grains, Flours & Dals",Wheat Flour 1 kg,4,140,120,20,2
24-03-2025,Oils & Ghee,cow ghee 500 ml,9,430,390,40,1
24-03-2025,"Grains, Flours & Dals",AISHWARYA SP 1KG,4,320,280,40,4
24-03-2025,Baking & Cooking Aids,MTR GULAB JAMUN MIX 190GM,0,80,80,0,1
24-03-2025,"Grains, Flours & Dals",BASMATHI RICE 1KG,4,150,135,15,1
24-03-2025,Oils & Ghee,Freedom Rice Bran Oil 1L,9,194,180,14,1
24-03-2025,Oils & Ghee,Groundnut oil 1 L,9,360,330,30,1
24-03-2025,"Grains, Flours & Dals",UNPOLISHED TURDALL 1KG,4,240,210,30,1
24-03-2025,Oils & Ghee,Safflower oil 1 L,9,440,400,40,1
24-03-2025,Snacks & Ready-to-Eat,Sprouted Ragi Biscuits 450GM,14,150,150,0,1
24-03-2025,"Grains, Flours & Dals",Wheat Flour 1 kg,4,140,120,20,2
24-03-2025,Spices & Seasonings,KALONJI SEEDS,15,90,80,10,1
24-03-2025,"Dry Fruits, Nuts & Seeds",SATHVI CHIA SEEDS 100GM,2,100,80,20,1
24-03-2025,"Grains, Flours & Dals",Green gram 1 kg,4,150,130,20,1
24-03-2025,"Grains, Flours & Dals",Red Chana 250GM,4,35,30,5,1
24-03-2025,"Dry Fruits, Nuts & Seeds",FLAX SEEDS 250GM,2,60,50,10,1
24-03-2025,"Grains, Flours & Dals",Bajra Flour 1 kg,4,70,60,10,1
24-03-2025,Spices & Seasonings,ROYAL SAFFRON,15,125,125,0,1
24-03-2025,Oils & Ghee,Groundnut oil 1 L,9,700,700,0,1
24-03-2025,"Grains, Flours & Dals",RAGI FLOUR 500GRMS,4,40,35,5,1
24-03-2025,Snacks & Ready-to-Eat,VD PALLI CHIKKI,14,80,80,0,1
24-03-2025,Spices & Seasonings,Tamarind 500GM,15,160,130,30,1
24-03-2025,Sweeteners,SUGAR 500 GM,16,30,25,5,1
24-03-2025,"Grains, Flours & Dals",Idly Rava L 1KG,4,120,100,20,2
24-03-2025,"Grains, Flours & Dals",JOWAR WHITE 1 KG,4,40,35,5,0.5
24-03-2025,"Grains, Flours & Dals",RAGULU 1 KG,4,70,60,10,1
24-03-2025,Spices & Seasonings,Vamu 100GM,15,60,50,10,1
24-03-2025,Snacks & Ready-to-Eat,NGT CHATPATTA CHANA 90GM,14,50,50,0,2
24-03-2025,"Grains, Flours & Dals",VYS.SP RICE 1 KG,4,350,325,25,5
24-03-2025,Snacks & Ready-to-Eat,VD MIXTURE 175 GM,14,60,60,0,1
24-03-2025,Spices & Seasonings,dalchin chekka,15,50,40,10,1
24-03-2025,"Grains, Flours & Dals",Urad dall 1 Kg,4,185,170,15,1
24-03-2025,Snacks & Ready-to-Eat,VD PALLI LADDU,14,80,80,0,1
24-03-2025,"Grains, Flours & Dals",AISHWARYA MOONGDAL RICE,4,140,84,56,1
24-03-2025,Personal Care & Cosmetics,UVIS MULTANI MITTI PW 100GM,10,98,98,0,2
24-03-2025,Spices & Seasonings,Tamalapaku Karam Powder 100GM,15,160,160,0,2
24-03-2025,"Grains, Flours & Dals",SL Idly Rava 1KG,4,130,110,20,2
24-03-2025,Spices & Seasonings,FLAXSEED KARAM,15,150,150,0,2
24-03-2025,Oils & Ghee,Sesame oil 1 L,9,590,560,30,1
24-03-2025,"Grains, Flours & Dals",SH CHANA DAL 500GM,4,72,72,0,1
24-03-2025,"Grains, Flours & Dals",BOMBAY RAVA,4,70,55,15,1
24-03-2025,Spices & Seasonings,Tamarind 250GMS,15,80,65,15,1
24-03-2025,Household & Cleaning,HERBAL MOSQUITO REP RS 100ML,6,240,240,0,1
24-03-2025,Beverages,REFRESH SHARBATH SUGAR FREE,1,299,285,14,1
24-03-2025,Snacks & Ready-to-Eat,VD Pappu Chekkalu 190gm,14,60,60,0,1
24-03-2025,"Dry Fruits, Nuts & Seeds",sabja seeds,2,80,70,10,1
24-03-2025,Spices & Seasonings,THOKA MIRYALU 50GM,15,210,180,30,1
24-03-2025,"Grains, Flours & Dals",KORRALU IDLI D B.T,4,84,84,0,1
24-03-2025,"Grains, Flours & Dals",RICE FLOUR 1KG,4,140,110,30,2
24-03-2025,"Grains, Flours & Dals",PESARA PAPPU 500GMS,4,85,75,10,1
24-03-2025,Snacks & Ready-to-Eat,VD MANGO JELLY 250GRMS,14,80,80,0,1
24-03-2025,Oils & Ghee,Safflower oil 1 L,9,440,400,40,1
24-03-2025,Snacks & Ready-to-Eat,VD RICE MURUKU 150GM,14,50,50,0,1
24-03-2025,"Grains, Flours & Dals",Red Bobarlu 500 gms,4,95,85,10,1
24-03-2025,Oils & Ghee,Groundnut oil 1 L,9,360,330,30,1
24-03-2025,"Dry Fruits, Nuts & Seeds",sabja seeds,2,80,70,10,1
24-03-2025,"Grains, Flours & Dals",idly/Dosa rice 1 kg,4,70,60,10,1
24-03-2025,Snacks & Ready-to-Eat,MILLET PANCAKE CHOCOLATE,14,199,199,0,1
24-03-2025,"Grains, Flours & Dals",White jowar.F 1 kg,4,100,80,20,1
24-03-2025,"Grains, Flours & Dals",AISHWARYA SP IDLY RAVA 1KG,4,120,66,54,1
24-03-2025,"Grains, Flours & Dals",Green gram 1 kg,4,150,130,20,1
24-03-2025,Spices & Seasonings,Turmeric powder 250 gms,15,100,75,25,1
24-03-2025,"Grains, Flours & Dals",AISHWARYA SP 1KG,4,800,700,100,10
24-03-2025,Snacks & Ready-to-Eat,MASALA PAPAD,14,80,80,0,1
24-03-2025,"Grains, Flours & Dals",Sathya Javva Wheat Rava 500GM,4,95,95,0,1
24-03-2025,"Grains, Flours & Dals",EM Ragi idli R 500G,4,75,75,0,1
24-03-2025,Oils & Ghee,Safflower oil 1 L,9,440,400,40,1
24-03-2025,Oils & Ghee,Sesame oil 1 L,9,590,560,30,1
24-03-2025,Oils & Ghee,Groundnut oil 1 L,9,720,660,60,2
24-03-2025,"Grains, Flours & Dals",RAGI FLOUR 1KG,4,80,70,10,1
24-03-2025,"Grains, Flours & Dals",Wheat Rava M 500GM,4,33,30,3,1
24-03-2025,Spices & Seasonings,Telaga Pindi 500GM,15,80,70,10,1
24-03-2025,Snacks & Ready-to-Eat,VD BOONDI 175GM,14,60,60,0,1
24-03-2025,Sweeteners,SUGAR 1KG,16,60,50,10,1
24-03-2025,"Health, Wellness & Ayurvedic Products",MH Millets Malt 500GM,5,200,190,10,1
24-03-2025,Snacks & Ready-to-Eat,SD JOWAR WITH PALM JAGGERY 250GM,14,135,135,0,1
24-03-2025,Snacks & Ready-to-Eat,VD DAHI MIRCHI(SALTED) 100GM,14,90,90,0,2
24-03-2025,Pooja & Spiritual Items,javadhu,12,60,60,0,1
24-03-2025,Snacks & Ready-to-Eat,VD GUMMADI VADIYAM,14,300,300,0,4
24-03-2025,Personal Care & Cosmetics,OVAL BODY LOOFAH,10,55,55,0,1
24-03-2025,"Health, Wellness & Ayurvedic Products",MD Tulasi Leaf Powder 50GM,5,80,80,0,1
24-03-2025,Snacks & Ready-to-Eat,SD KODO MILLET WITH PALM JAGGERY,14,135,135,0,1
24-03-2025,"Grains, Flours & Dals",SAMALU (Little millet) 1 kg,4,170,130,40,1
24-03-2025,"Grains, Flours & Dals",SA Multi Grain Mix 500GM,4,159,159,0,1
24-03-2025,Pooja & Spiritual Items,GD Dhoop Cones 40GM,12,60,60,0,2
24-03-2025,"Grains, Flours & Dals",JOWAR UPMA RAVA,4,75,75,0,1
24-03-2025,Snacks & Ready-to-Eat,PUMPKIN CHIKKI 200GM,14,700,600,100,5
24-03-2025,Snacks & Ready-to-Eat,VD PAPPU CHEGODI 200GM,14,60,60,0,1
24-03-2025,Snacks & Ready-to-Eat,Sprouted Ragi Biscuits 450GM,14,150,150,0,1
24-03-2025,"Grains, Flours & Dals",Em Multimillet upma 500g,4,129,129,0,1
24-03-2025,"Grains, Flours & Dals",unpolished turdall500grms,4,120,110,10,1
24-03-2025,"Dry Fruits, Nuts & Seeds",PUTNALU 500GMS,2,90,76,14,1
24-03-2025,"Grains, Flours & Dals",SPLIT BLACK GRAM 500 GM,4,90,85,5,1
24-03-2025,"Grains, Flours & Dals",Wheat Rava M 500GM,4,33,30,3,1
24-03-2025,"Grains, Flours & Dals",HS MULTI UPMA RAVA,4,65,65,0,1
24-03-2025,Oils & Ghee,Groundnut oil 1 L,9,720,660,60,2
24-03-2025,"Grains, Flours & Dals",Wheat Rava M 500GM,4,33,30,3,1
24-03-2025,"Grains, Flours & Dals",RAGI FLOUR 1KG,4,80,70,10,1
24-03-2025,Snacks & Ready-to-Eat,urban murmura,14,60,55,5,1
24-03-2025,"Grains, Flours & Dals",COW B rice 1 kg,4,720,690,30,10
24-03-2025,"Grains, Flours & Dals",VYS.SP RICE 1 KG,4,700,650,50,10
24-03-2025,"Grains, Flours & Dals",URAD DALL,4,95,85,10,1
24-03-2025,"Grains, Flours & Dals",Wheat Rava S 1KG,4,65,55,10,1
24-03-2025,Personal Care & Cosmetics,HIMALAYA LIP BALM 10GM,10,40,40,0,1
24-03-2025,"Grains, Flours & Dals",CORN FOUR 250GM,4,40,35,5,1
24-03-2025,General Household & Kitchenware,PREMIER SOFT FACE TISSUES 100PULLS,3,110,110,0,1
24-03-2025,"Grains, Flours & Dals",Chana Flour 500 gms,4,70,65,5,1
24-03-2025,"Dry Fruits, Nuts & Seeds",Groundnuts 1 kg,2,190,165,25,1
24-03-2025,Sweeteners,SUGAR 500 GM,16,30,25,5,1
24-03-2025,Snacks & Ready-to-Eat,VD SAGOPAPAD 150GM,14,55,55,0,1
24-03-2025,"Grains, Flours & Dals",POORI ATTA 1KG,4,70,60,10,1
24-03-2025,Spices & Seasonings,DRY MIECHI 200GM,15,80,60,20,1
24-03-2025,Oils & Ghee,Sesame oil 1 L,9,590,560,30,1
24-03-2025,"Grains, Flours & Dals",SRILATHA RICE RAVVA 500GM,4,70,70,0,2
24-03-2025,Misc,VD00014,8,100,90,10,1
24-03-2025,"Grains, Flours & Dals",RAGI FLOUR 500GRMS,4,40,35,5,1
24-03-2025,"Grains, Flours & Dals",SRILATHA RICE RAVVA 500GM,4,70,70,0,2
24-03-2025,"Grains, Flours & Dals",JOWAR UPMA RAVA,4,75,75,0,1
24-03-2025,Spices & Seasonings,NUVVULU 250GM,15,100,85,15,1
24-03-2025,"Grains, Flours & Dals",BARLEY SEEDS 250GMS,4,40,35,5,1
24-03-2025,"Grains, Flours & Dals",JOWAR WHITE 1 KG,4,80,70,10,1
24-03-2025,Spices & Seasonings,Telaga Pindi 250 GM,15,80,70,10,2
24-03-2025,Oils & Ghee,Sesame oil 1 L,9,590,560,30,1
24-03-2025,Snacks & Ready-to-Eat,VD RIBBON PAKODI 175GM,14,60,60,0,1
24-03-2025,"Dry Fruits, Nuts & Seeds",Groundnuts 1 kg,2,190,165,25,1
24-03-2025,Snacks & Ready-to-Eat,mixed chikki,14,110,110,0,1
24-03-2025,Snacks & Ready-to-Eat,SD FINGER Millet with palm Jaggery 250gm,14,135,135,0,1
24-03-2025,Snacks & Ready-to-Eat,VD NUVULU CHEGODI 175GM,14,60,60,0,1
24-03-2025,Snacks & Ready-to-Eat,SD Little Millet WITH PLAM JAGGERY,14,135,135,0,1
24-03-2025,"Grains, Flours & Dals",RAGI FLOUR 1KG,4,160,140,20,2
24-03-2025,Milk & Dairy,BROWN EGGS TRAY 30P,7,360,330,30,1
24-03-2025,"Grains, Flours & Dals",VGR rice 1 kg,4,350,325,25,5
24-03-2025,"Dry Fruits, Nuts & Seeds",SD Mango cubes 200gm,2,90,90,0,1
24-03-2025,Oils & Ghee,Groundnut oil 5 L,9,1800,"1,600.00",200,1
24-03-2025,Baking & Cooking Aids,GONDH 50GRMS,0,50,40,10,1
24-03-2025,Baking & Cooking Aids,GONDH 50GRMS,0,50,40,10,1
24-03-2025,"Dry Fruits, Nuts & Seeds",SD Mango cubes 200gm,2,90,90,0,1
24-03-2025,Oils & Ghee,Groundnut oil 5 L,9,1800,"1,600.00",200,1
24-03-2025,"Grains, Flours & Dals",KORRALU (FOXTAIL M) 1KG,4,150,110,40,1
24-03-2025,Oils & Ghee,GANTASALA A2 COW GHEE 250ML,9,299,299,0,1
24-03-2025,"Grains, Flours & Dals",White jowar.F 1 kg,4,100,80,20,1
24-03-2025,"Grains, Flours & Dals",Brown RICE 1KG,4,70,65,5,1
24-03-2025,"Dry Fruits, Nuts & Seeds",Groundnuts 500 gms,2,95,85,10,1
24-03-2025,Sweeteners,SUGAR 500 GM,16,30,25,5,1
24-03-2025,"Grains, Flours & Dals",turdal 500 gms,4,110,85,25,1
24-03-2025,Oils & Ghee,Sesame oil 500ml,9,295,280,15,1
24-03-2025,Snacks & Ready-to-Eat,BB VERMICELLY 500GM,14,53,53,0,1
24-03-2025,"Grains, Flours & Dals",SABDANA,4,40,35,5,1
24-03-2025,Spices & Seasonings,Menthulu 250 gms,15,50,45,5,1
24-03-2025,"Dry Fruits, Nuts & Seeds",Groundnuts 1 kg,2,190,165,25,1
24-03-2025,"Grains, Flours & Dals",BOBBARA PAPPU 500GM,4,85,80,5,1
24-03-2025,Oils & Ghee,Groundnut oil 1 L,9,720,660,60,2
24-03-2025,Household & Cleaning,surfexcel Tl,6,170,170,0,1
24-03-2025,Sweeteners,YB Palm Jaggery 250GM,16,200,200,0,1
24-03-2025,Beverages,redlabel nc teap,1,175,175,0,1
24-03-2025,"Grains, Flours & Dals",Multigrain 1 kg,4,200,170,30,2
24-03-2025,Household & Cleaning,vim dish liquid,6,55,55,0,1
24-03-2025,"Grains, Flours & Dals",Wheat Flour 1 kg,4,70,60,10,1
24-03-2025,Snacks & Ready-to-Eat,NGT CHATPATTA CHANA 90GM,14,25,25,0,1
24-03-2025,"Grains, Flours & Dals",RAGI FLOUR 500GRMS,4,40,35,5,1
24-03-2025,"Grains, Flours & Dals",VL Sabdana 500GM,4,77,77,0,1
24-03-2025,"Dry Fruits, Nuts & Seeds",PULMAKHANA 100 GM,2,180,170,10,1
24-03-2025,Snacks & Ready-to-Eat,COPRA LADDU 200GM,14,100,80,20,1
24-03-2025,Spices & Seasonings,NUVVULU 500GM,15,200,170,30,1
24-03-2025,Snacks & Ready-to-Eat,millet cake,14,119,119,0,1
24-03-2025,Oils & Ghee,Groundnut oil 1 L,9,2160,"1,920.00",240,6
24-03-2025,Sweeteners,YB Brown Sugar 1KG,16,280,280,0,2
24-03-2025,"Grains, Flours & Dals",Wheat Flour 2 kgs,4,140,120,20,1
24-03-2025,Milk & Dairy,BROWN EGGS 1P,7,210,180,30,15
24-03-2025,"Grains, Flours & Dals",Yellow jowar .F1 kg,4,220,200,20,2
24-03-2025,Sweeteners,YB FOREST HONEY 250GM,16,180,180,0,1
24-03-2025,Snacks & Ready-to-Eat,TILLI CHIKKI,14,20,20,0,4
24-03-2025,Snacks & Ready-to-Eat,BLACK SESAME CHIKKI,14,40,40,0,4
24-03-2025,Spices & Seasonings,Elaichi 25GM,15,145,120,25,1
24-03-2025,Snacks & Ready-to-Eat,PEANUT CHIKKI 450GM,14,250,250,0,2
24-03-2025,Snacks & Ready-to-Eat,BB VERMICELLY 500GM,14,53,53,0,1
24-03-2025,Oils & Ghee,Groundnut oil 1 L,9,360,330,30,1
24-03-2025,"Health, Wellness & Ayurvedic Products",RB Max Protein Spanish Tomato,5,45,45,0,1
24-03-2025,Misc,VD00014,8,100,90,10,1
24-03-2025,"Grains, Flours & Dals",SH TUR DAL 500GM,4,165,165,0,1
24-03-2025,Snacks & Ready-to-Eat,VD CORNFLAKES MIXTURE 175GM,14,60,60,0,1
24-03-2025,Snacks & Ready-to-Eat,VD Pappu Chekkalu 190gm,14,60,60,0,1
24-03-2025,Snacks & Ready-to-Eat,VD BOONDI 175GM,14,60,60,0,1
24-03-2025,Snacks & Ready-to-Eat,GROUNDNUT LADDU WITH DATES,14,135,135,0,1
24-03-2025,Personal Care & Cosmetics,UVIS ALOEVERA GEL,10,298,298,0,2
24-03-2025,Oils & Ghee,Sesame oil 1 L,9,590,560,30,1
24-03-2025,Oils & Ghee,Coconut oil 500 ml,9,220,200,20,1
24-03-2025,Oils & Ghee,Sesame oil 500ml,9,295,280,15,1
24-03-2025,Milk & Dairy,BROWN EGGS TRAY 30P,7,360,330,30,1
24-03-2025,Milk & Dairy,BROWN EGGS TRAY 30P,7,360,330,30,1
24-03-2025,Pooja & Spiritual Items,GD Aiswarya Deepam 700ML,12,195,195,0,1
24-03-2025,Beverages,REFRESH SHARBATH NORMAL,1,199,190,9,1
24-03-2025,"Health, Wellness & Ayurvedic Products",RB Nuts& Seeds cashews 35g,5,90,90,0,2
24-03-2025,"Health, Wellness & Ayurvedic Products",GD 27 HERBS OIL 120ML,5,150,150,0,1
24-03-2025,"Grains, Flours & Dals",White jowar.F 1 kg,4,100,80,20,1
24-03-2025,Household & Cleaning,EXO DISHWASH POWER OF CYCLOZAN,6,15,15,0,1
24-03-2025,Spices & Seasonings,Menthulu 250 gms,15,50,45,5,1
24-03-2025,Spices & Seasonings,GS Pink Rock Salt 1KG,15,120,120,0,1
24-03-2025,Pooja & Spiritual Items,GD Kumkum 50GM,12,30,30,0,1
24-03-2025,Pooja & Spiritual Items,GD Aiswarya Deepam 700ML,12,195,195,0,1
24-03-2025,"Health, Wellness & Ayurvedic Products",MH Millets Malt 1KG,5,400,380,20,1
24-03-2025,Baking & Cooking Aids,GONDH 50GRMS,0,50,40,10,1
24-03-2025,"Dry Fruits, Nuts & Seeds",cashew,2,340,310,30,1
24-03-2025,Beverages,REFRESH SHARBATH NORMAL,1,199,190,9,1
24-03-2025,"Grains, Flours & Dals",split green gram 500 gms,4,75,70,5,1
24-03-2025,Snacks & Ready-to-Eat,RAJGIRA PEANUT CHIKKI,14,25,25,0,5
24-03-2025,"Grains, Flours & Dals",turdal 1kg,4,220,170,50,1
24-03-2025,Spices & Seasonings,GS Pink Rock Salt 1KG,15,120,120,0,1
24-03-2025,Snacks & Ready-to-Eat,NGT CHATPATTA CHANA 90GM,14,25,25,0,1
24-03-2025,Snacks & Ready-to-Eat,COPRA LADDU 200GM,14,100,80,20,1
24-03-2025,"Grains, Flours & Dals",SL Idly Rava 1KG,4,65,55,10,1
24-03-2025,Snacks & Ready-to-Eat,GANTASALA GINGER CANDY 200GM,14,105,105,0,1
24-03-2025,"Grains, Flours & Dals",turdal 500 gms,4,110,85,25,1
24-03-2025,Spices & Seasonings,ROYAL SAFFRON 400GRMS,15,65,65,0,1
24-03-2025,"Grains, Flours & Dals",chana dall,4,35,30,5,1
24-03-2025,"Grains, Flours & Dals",URAD DALL,4,95,85,10,1
24-03-2025,Spices & Seasonings,Chilli powder 1 kg,15,580,420,160,1
24-03-2025,Spices & Seasonings,SD Garlic Karam Powder 100GM,15,65,65,0,1
24-03-2025,Spices & Seasonings,FLAXSEED KARAM,15,75,75,0,1
24-03-2025,"Grains, Flours & Dals",RAGI FLOUR 1KG,4,160,140,20,2
24-03-2025,Oils & Ghee,Groundnut oil 1 L,9,360,330,30,1
24-03-2025,"Dry Fruits, Nuts & Seeds",SH GROUNDNUT 250GM,2,85,85,0,1
24-03-2025,"Grains, Flours & Dals",split green gram 1 kg,4,150,140,10,1
24-03-2025,"Grains, Flours & Dals",Chana Flour 500 gms,4,70,65,5,1
24-03-2025,Oils & Ghee,Sesame oil 500ml,9,295,280,15,1
24-03-2025,Spices & Seasonings,SATHVI ANASAPUVUU 25GM,15,90,65,25,1
24-03-2025,"Grains, Flours & Dals",Chittimuthaylu rice 1 kg,4,160,140,20,1
24-03-2025,Spices & Seasonings,Tamarind 250GMS,15,80,65,15,1
24-03-2025,Spices & Seasonings,LG 50GM,15,92,92,0,1
24-03-2025,Misc,ROLL D C,8,70,45,25,1
24-03-2025,Snacks & Ready-to-Eat,VD RICE MURUKU 150GM,14,50,50,0,1
24-03-2025,"Grains, Flours & Dals",Green gram 500 gms,4,75,70,5,1
24-03-2025,"Grains, Flours & Dals",URAD DALL,4,95,85,10,1
24-03-2025,"Grains, Flours & Dals",chana dall,4,35,30,5,1
24-03-2025,Snacks & Ready-to-Eat,VD RICE SAGO PAPAD 150GM,14,55,55,0,1
24-03-2025,Oils & Ghee,Groundnut oil 1 L,9,360,330,30,1
24-03-2025,"Grains, Flours & Dals",SABDANA,4,40,35,5,1
24-03-2025,Milk & Dairy,HERITAGE TONED MILK 500ML,7,31,31,0,1
24-03-2025,Sweeteners,SUGAR 500 GM,16,30,25,5,1
24-03-2025,"Grains, Flours & Dals",SPLIT BLACK GRAM 500 GM,4,90,85,5,1
24-03-2025,Milk & Dairy,HERITAGE TONED MILK 500ML,7,31,31,0,1
24-03-2025,Spices & Seasonings,RED COPRA 250GMS,15,85,74,11,1
24-03-2025,"Grains, Flours & Dals",SINGHAM 26KG BAG,4,1650,"1,650.00",0,1
24-03-2025,"Dry Fruits, Nuts & Seeds",SUNFLOWER SEEDS 250GRM,2,150,130,20,1
24-03-2025,"Grains, Flours & Dals",Quinova 1 kg,4,220,195,25,1
24-03-2025,"Grains, Flours & Dals",THICK POHA 500GM,4,40,35,5,1
24-03-2025,Milk & Dairy,HERITAGE BUTTERMILK,7,10,10,0,1
24-03-2025,"Dry Fruits, Nuts & Seeds",ALMONDS 250GM,2,280,260,20,1
24-03-2025,Sweeteners,ACHU BELLAM 1KG,16,100,80,20,1
24-03-2025,"Grains, Flours & Dals",Wheat Rava M 1KG,4,65,55,10,1
24-03-2025,General Household & Kitchenware,BLADE,3,12,12,0,1
24-03-2025,Beverages,BRU GREEN LABEL 1.2G,1,48,48,0,24
24-03-2025,"Health, Wellness & Ayurvedic Products",DWI EUCALYPTUS 8ML,5,80,80,0,1
24-03-2025,Oils & Ghee,Sesame oil 1 L,9,590,560,30,1
24-03-2025,"Grains, Flours & Dals",Arikadu ( kodo),4,140,130,10,1
24-03-2025,"Grains, Flours & Dals",SAMALU,4,170,130,40,1
24-03-2025,"Grains, Flours & Dals",KORRALU (FOXTAIL M) 1KG,4,150,110,40,1
24-03-2025,"Grains, Flours & Dals",UDALU (Barnyard millet) 1 kg,4,140,115,25,1
24-03-2025,"Grains, Flours & Dals",ANDU KORRALU (Browntop.m) 1 kg,4,260,220,40,1
24-03-2025,Milk & Dairy,BROWN EGGS 1P,7,84,72,12,6
24-03-2025,Milk & Dairy,BROWN EGGS TRAY 30P,7,360,330,30,1
24-03-2025,Household & Cleaning,vim small,6,15,15,0,1
24-03-2025,Milk & Dairy,HERITAGE TONED MILK 500ML,7,124,124,0,4
23-03-2025,"Grains, Flours & Dals",KORRALU (FOXTAIL M) 500GM,4,130,110,20,2
23-03-2025,"Grains, Flours & Dals",Green gram 1 kg,4,150,130,20,1
23-03-2025,"Grains, Flours & Dals",JOWAR YELLOW 1 K,4,100,90,10,1
23-03-2025,Personal Care & Cosmetics,GOW DURBAR NAVA 100GM SOAP,10,40,40,0,1
23-03-2025,Oils & Ghee,Groundnut oil 1 L,9,360,330,30,1
23-03-2025,Spices & Seasonings,AVALU 100GM,15,25,20,5,1
23-03-2025,"Grains, Flours & Dals",Urad dall 1 Kg,4,185,170,15,1
23-03-2025,"Grains, Flours & Dals",Chana Flour 1 kg,4,140,130,10,1
23-03-2025,"Grains, Flours & Dals",Wheat Flour 1 kg,4,210,180,30,3
23-03-2025,Oils & Ghee,Coconut oil 1 L,9,440,400,40,1
23-03-2025,"Grains, Flours & Dals",Wheat Flour 1 kg,4,70,60,10,1
23-03-2025,"Grains, Flours & Dals",Multigrain 1 kg,4,100,85,15,1
23-03-2025,Snacks & Ready-to-Eat,SD Moringa with plam jaggery 250gm,14,135,135,0,1
23-03-2025,Spices & Seasonings,Coriander seeds 200 gms,15,48,40,8,1
23-03-2025,"Grains, Flours & Dals",RAGI FLOUR 1KG,4,80,70,10,1
23-03-2025,Oils & Ghee,Groundnut oil 1 L,9,360,330,30,1
23-03-2025,Snacks & Ready-to-Eat,BATANA NGT 70GMS,14,40,40,0,2
23-03-2025,Spices & Seasonings,NUVVULU 250GM,15,80,65,15,1
23-03-2025,Snacks & Ready-to-Eat,PALLI LADDU 200GMS,14,90,70,20,1
23-03-2025,Milk & Dairy,BROWN EGGS 1P,7,168,144,24,12
23-03-2025,"Grains, Flours & Dals",Black gram 500 gms,4,75,70,5,1
23-03-2025,Spices & Seasonings,ROYAL SAFFRON 400GRMS,15,65,65,0,1
23-03-2025,Oils & Ghee,Groundnut oil 5 L,9,1800,"1,600.00",200,1
23-03-2025,Spices & Seasonings,ER GARAM MASALA,15,52,52,0,1
23-03-2025,"Grains, Flours & Dals",RAGI FLOUR 500GRMS,4,40,35,5,1
23-03-2025,"Grains, Flours & Dals",VYS.SP.RICE BAG 1,4,1800,"1,650.00",150,1
23-03-2025,Oils & Ghee,Sesame oil 1 L,9,590,560,30,1
23-03-2025,Snacks & Ready-to-Eat,SD RAGI GAVVALU,14,95,95,0,1
23-03-2025,Snacks & Ready-to-Eat,VD DAHI MIRCHI(SALTED) 100GM,14,45,45,0,1
23-03-2025,Milk & Dairy,BROWN EGGS TRAY 30P,7,360,330,30,1
23-03-2025,Snacks & Ready-to-Eat,ZEEDI,14,70,70,0,1
23-03-2025,Sweeteners,YB Palm Crystals 100GM,16,75,75,0,1
23-03-2025,"Grains, Flours & Dals",VGR RICE 5 KGS,4,350,325,25,1
23-03-2025,Milk & Dairy,BROWN EGGS TRAY 30P,7,360,330,30,1
23-03-2025,Spices & Seasonings,Lavangam 50GM,15,60,50,10,1
23-03-2025,Spices & Seasonings,MIRYALU 50 GRMS,15,200,160,40,2
23-03-2025,Oils & Ghee,Safflower oil 1 L,9,440,400,40,1
23-03-2025,Spices & Seasonings,GREEN SOUNF,15,60,40,20,1
23-03-2025,"Grains, Flours & Dals",Quinova 1 kg,4,220,195,25,1
23-03-2025,Spices & Seasonings,Coriander seeds 200 gms,15,48,40,8,1
23-03-2025,"Grains, Flours & Dals",CHANA DAL 500GM,4,70,60,10,1
23-03-2025,"Dry Fruits, Nuts & Seeds",Groundnuts 1 kg,2,190,165,25,1
23-03-2025,Spices & Seasonings,PRO ORG FENUGREEK 200GM,15,86,86,0,1
23-03-2025,Spices & Seasonings,DRY MIECHI 200GM,15,80,60,20,1
23-03-2025,Snacks & Ready-to-Eat,MILK BREAD,14,55,55,0,1
23-03-2025,"Grains, Flours & Dals",Urad dall 1 Kg,4,185,170,15,1
23-03-2025,"Grains, Flours & Dals",BARLEY SEEDS 250GMS,4,40,35,5,1
23-03-2025,Household & Cleaning,VANISH 10X OXI POWER 400ML,6,122,122,0,1
23-03-2025,"Grains, Flours & Dals",KORRALU (FOXTAIL M) 1KG,4,150,110,40,1
23-03-2025,"Grains, Flours & Dals",UDALU (Barnyard millet) 1 kg,4,140,115,25,1
23-03-2025,Sweeteners,MADHUR SUGAR 1KG,16,65,55,10,1
23-03-2025,Snacks & Ready-to-Eat,URBAN MARMURA 450GM,14,60,55,5,1
23-03-2025,"Grains, Flours & Dals",SL Idly Rava 1KG,4,65,55,10,1
23-03-2025,Household & Cleaning,TIDE LEMON &CHANDAN 1KG,6,146,146,0,1
23-03-2025,"Grains, Flours & Dals",Green gram 500 gms,4,75,70,5,1
23-03-2025,Spices & Seasonings,Jeera 100GM,15,50,45,5,1
23-03-2025,Oils & Ghee,cow ghee 500 ml,9,430,390,40,1
23-03-2025,"Grains, Flours & Dals",Wheat Flour 1 kg,4,210,180,30,3
23-03-2025,"Grains, Flours & Dals",SL Suji Rava 500GM,4,32,32,0,1
23-03-2025,Household & Cleaning,VIM SOAP,6,30,30,0,6
23-03-2025,"Grains, Flours & Dals",KORRALU (FOXTAIL M) 500GM,4,65,55,10,1
23-03-2025,"Health, Wellness & Ayurvedic Products",MH Millets Malt 500GM,5,200,190,10,1
23-03-2025,Snacks & Ready-to-Eat,PEANUT CHILLI,14,5,5,0,1
23-03-2025,Snacks & Ready-to-Eat,SF MILLET NOODLES MILD MASALA 192GM,14,129,129,0,1
23-03-2025,Pickles & Cooking Pastes,SD TOMATO PICKLE,11,110,110,0,1
23-03-2025,"Grains, Flours & Dals",Chana Flour 500 gms,4,70,65,5,1
23-03-2025,"Grains, Flours & Dals",UDALU (Barnyard millet) 1 kg,4,140,115,25,1
23-03-2025,Personal Care & Cosmetics,GOW DURBAR NAVA 100GM SOAP,10,80,80,0,2
23-03-2025,Snacks & Ready-to-Eat,SD barnyard Millet with palm jaggery,14,135,135,0,1
23-03-2025,Snacks & Ready-to-Eat,SALTED PHALLI,14,50,50,0,2
23-03-2025,Snacks & Ready-to-Eat,SD FINGER Millet with palm Jaggery 250gm,14,135,135,0,1
23-03-2025,Snacks & Ready-to-Eat,SD KODO MILLET WITH PALM JAGGERY,14,135,135,0,1
23-03-2025,Oils & Ghee,Sesame oil 1 L,9,590,560,30,1
23-03-2025,Oils & Ghee,Safflower oil 1 L,9,440,400,40,1
23-03-2025,Snacks & Ready-to-Eat,SD JOWAR WITH PALM JAGGERY 250GM,14,135,135,0,1
23-03-2025,"Grains, Flours & Dals",Chana Flour 500 gms,4,70,65,5,1
23-03-2025,"Grains, Flours & Dals",Quinova 1 kg,4,440,390,50,2
23-03-2025,"Grains, Flours & Dals",Wheat Flour 2 kgs,4,140,120,20,1
23-03-2025,Snacks & Ready-to-Eat,RI SPORTS BAR 40G,14,45,45,0,1
23-03-2025,"Grains, Flours & Dals",RAGI FLOUR 500GRMS,4,40,35,5,1
23-03-2025,Spices & Seasonings,Jeera 100GM,15,50,45,5,1
23-03-2025,Spices & Seasonings,ROYAL SAFFRON,15,125,125,0,1
23-03-2025,"Grains, Flours & Dals",KORRALU (FOXTAIL M) 500GM,4,65,55,10,1
23-03-2025,Snacks & Ready-to-Eat,PEANUT CHILLI,14,5,5,0,1
23-03-2025,"Grains, Flours & Dals",MELMEKER 250GMS,4,60,45,15,1
23-03-2025,Oils & Ghee,Sesame oil 1 L,9,590,560,30,1
23-03-2025,"Grains, Flours & Dals",Green gram 500 gms,4,150,140,10,2
23-03-2025,Oils & Ghee,Sesame oil 1 L,9,590,560,30,1
23-03-2025,Oils & Ghee,Coconut oil 1 L,9,440,400,40,1
23-03-2025,Oils & Ghee,Safflower oil 500 ml,9,220,200,20,1
23-03-2025,"Dry Fruits, Nuts & Seeds",SD Mango cubes 100gm,2,90,90,0,2
23-03-2025,"Grains, Flours & Dals",turdal 500 gms,4,110,85,25,1
23-03-2025,Personal Care & Cosmetics,SVE SUNNI PINDI SCRUBSOAP 100GM,10,100,100,0,1
23-03-2025,General Household & Kitchenware,WOODEN SPOON SMALL,3,75,75,0,5
23-03-2025,Spices & Seasonings,Coriander seeds 200 gms,15,48,40,8,1
23-03-2025,"Grains, Flours & Dals",SPLIT BLACK GRAM 500 GM,4,90,85,5,1
23-03-2025,"Grains, Flours & Dals",unpolished turdall500grms,4,120,110,10,1
23-03-2025,Snacks & Ready-to-Eat,PEANUT CHIKKI 450GM,14,125,125,0,1
23-03-2025,Personal Care & Cosmetics,MYSORE SANDAL SOAP 75G,10,42,42,0,1
23-03-2025,"Grains, Flours & Dals",PESARA PAPPU 500GMS,4,85,75,10,1
23-03-2025,"Grains, Flours & Dals",Green gram 500 gms,4,75,70,5,1
23-03-2025,"Dry Fruits, Nuts & Seeds",Putnalu 250GM,2,90,76,14,2
23-03-2025,Oils & Ghee,Groundnut oil 500ml,9,180,165,15,1
23-03-2025,Spices & Seasonings,GARAM MASALA 200GM,15,120,95,25,1
23-03-2025,General Household & Kitchenware,WOODEN SPOON BIG,3,50,50,0,2
23-03-2025,Personal Care & Cosmetics,EYETEX,10,5,5,0,1
23-03-2025,Personal Care & Cosmetics,SVE PREMIUM WILD TURMEIC 100GM,10,110,110,0,1
23-03-2025,"Grains, Flours & Dals",KORRALU (FOXTAIL M) 1KG,4,150,110,40,1
23-03-2025,Spices & Seasonings,NUVVULU 250GM,15,100,85,15,1
23-03-2025,"Grains, Flours & Dals",Yellow jowar .F1 kg,4,220,200,20,2
23-03-2025,"Grains, Flours & Dals",JOWAR YELLOW 1 K,4,200,180,20,2
23-03-2025,"Grains, Flours & Dals",HS JOWAR IDLY RAWA,4,65,65,0,1
23-03-2025,"Grains, Flours & Dals",Em jowar idly R 500G,4,75,75,0,1
23-03-2025,"Grains, Flours & Dals",Multigrain 1 kg,4,100,85,15,1
23-03-2025,"Grains, Flours & Dals",Wheat Flour 2 kgs,4,140,120,20,1
23-03-2025,"Grains, Flours & Dals",JOWAR UPMA RAVA,4,75,75,0,1
23-03-2025,Household & Cleaning,GOOD KNIGHT,6,105,105,0,1
23-03-2025,Snacks & Ready-to-Eat,VD BELLAM GAVVALU 200GM,14,120,120,0,2
23-03-2025,Pooja & Spiritual Items,GD Ramayana Sandal 75GM,12,60,60,0,1
23-03-2025,Snacks & Ready-to-Eat,COPRA LADDU 200GM,14,100,80,20,1
23-03-2025,"Grains, Flours & Dals",Wheat Rava M 500GM,4,33,30,3,1
23-03-2025,"Grains, Flours & Dals",Arikalu (kodo),4,140,130,10,2
23-03-2025,"Health, Wellness & Ayurvedic Products",DWI MADIPHALA 100ML,5,75,75,0,1
23-03-2025,Pooja & Spiritual Items,GD TULASI 75GM,12,60,60,0,1
23-03-2025,Snacks & Ready-to-Eat,Pani Poori Chips 250GM,14,50,40,10,1
23-03-2025,Pooja & Spiritual Items,GD JASMINE 75GM,12,60,60,0,1
23-03-2025,Spices & Seasonings,Tamarind 500GM,15,160,130,30,1
23-03-2025,"Health, Wellness & Ayurvedic Products",RB Max Protein Fruit &amp;Nut 50g,5,75,75,0,1
23-03-2025,"Grains, Flours & Dals",SINGLE POLISH 1KG,4,65,65,0,1
23-03-2025,Pooja & Spiritual Items,GD Dhoop Cones 40GM,12,30,30,0,1
23-03-2025,"Health, Wellness & Ayurvedic Products",MH Millets Milk Powder 250GM,5,250,250,0,1
23-03-2025,Pooja & Spiritual Items,GD Kailash 60 GM,12,60,60,0,1
23-03-2025,"Grains, Flours & Dals",JOWAR WHITE 1 KG,4,80,70,10,1
23-03-2025,Pooja & Spiritual Items,GD TULASI 75GM,12,60,60,0,1
23-03-2025,Snacks & Ready-to-Eat,GROUNDNUT LADDU WITH DATES,14,135,135,0,1
23-03-2025,Snacks & Ready-to-Eat,SD Aswagandha with palm Jaggery250Gm,14,135,135,0,1
23-03-2025,Snacks & Ready-to-Eat,VD SAGOPAPAD 150GM,14,55,55,0,1
23-03-2025,"Grains, Flours & Dals",KORRALU (FOXTAIL M) 500GM,4,65,55,10,1
23-03-2025,Oils & Ghee,BUFFALLO GHEE 500ML,9,1640,"1,480.00",160,4
23-03-2025,"Grains, Flours & Dals",RAGULU 1 KG,4,70,60,10,1
23-03-2025,"Grains, Flours & Dals",SAMALU (Little millet) 500 gms,4,85,65,20,1
23-03-2025,Snacks & Ready-to-Eat,SD Vamu with palm jaggery 250gm,14,135,135,0,1
23-03-2025,"Grains, Flours & Dals",Arikadu ( kodo),4,140,130,10,1
23-03-2025,"Grains, Flours & Dals",turdal 1kg,4,220,170,50,1
23-03-2025,Oils & Ghee,Coconut oil 500 ml,9,220,200,20,1
23-03-2025,"Grains, Flours & Dals",Multigrain 1 kg,4,100,85,15,1
23-03-2025,Snacks & Ready-to-Eat,VD NUVULU PAPAD 200GM,14,100,100,0,1
23-03-2025,Milk & Dairy,HERITAGE TONED MILK 500ML,7,31,31,0,1
23-03-2025,"Grains, Flours & Dals",SL Suji Rava 500GM,4,32,32,0,1
23-03-2025,Oils & Ghee,Groundnut oil 1 L,9,360,330,30,1
23-03-2025,"Grains, Flours & Dals",SL Idly Rava 1KG,4,65,55,10,1
23-03-2025,"Dry Fruits, Nuts & Seeds",Putnalu 250GM,2,45,38,7,1
23-03-2025,Snacks & Ready-to-Eat,VD CORNFLAKES MIXTURE 175GM,14,60,60,0,1
23-03-2025,Snacks & Ready-to-Eat,VD PALLI CHIKKI,14,80,80,0,1
23-03-2025,Beverages,GEMINI TEA 500GRMS,1,275,275,0,1
23-03-2025,Sweeteners,MADHUR SUGAR 1KG,16,65,55,10,1
23-03-2025,"Grains, Flours & Dals",SINGLE POLISH 1KG,4,325,325,0,5
23-03-2025,Spices & Seasonings,GS Pink Rock Salt 1KG,15,120,120,0,1
23-03-2025,"Health, Wellness & Ayurvedic Products",MXP CREAM ONION,5,45,45,0,1
23-03-2025,Spices & Seasonings,DURGA SALT CRYSTAL 1KG,15,25,25,0,1
23-03-2025,"Grains, Flours & Dals",BASMATHI RICE 1KG,4,150,135,15,1
23-03-2025,"Dry Fruits, Nuts & Seeds",PULMAKHANA 100 GM,2,180,170,10,1
23-03-2025,Snacks & Ready-to-Eat,VD Minapa papad 200gm,14,60,60,0,1
23-03-2025,Snacks & Ready-to-Eat,SD barnyard Millet with palm jaggery,14,135,135,0,1
23-03-2025,Milk & Dairy,BROWN EGGS TRAY 30P,7,360,330,30,1
23-03-2025,"Grains, Flours & Dals",Bajra Flour 1 kg,4,70,60,10,1
23-03-2025,"Grains, Flours & Dals",White jowar.F 1 kg,4,100,80,20,1
23-03-2025,"Grains, Flours & Dals",RAGI FLOUR 500GRMS,4,40,35,5,1
23-03-2025,"Grains, Flours & Dals",Wheat Flour 1 kg,4,70,60,10,1
23-03-2025,"Grains, Flours & Dals",Multigrain 1 kg,4,100,85,15,1
23-03-2025,"Grains, Flours & Dals",Wheat Flour 1 kg,4,70,60,10,1
23-03-2025,Oils & Ghee,Sesame oil 500ml,9,295,280,15,1
23-03-2025,Snacks & Ready-to-Eat,TILLI CHIKKI,14,125,125,0,1
23-03-2025,"Grains, Flours & Dals",VGR rice 1 kg,4,70,65,5,1
23-03-2025,Snacks & Ready-to-Eat,RAGI IDLI DOSA B.T,14,63,63,0,1
23-03-2025,Oils & Ghee,Safflower oil 500 ml,9,220,200,20,1
23-03-2025,"Grains, Flours & Dals",White jowar.F 1 kg,4,100,80,20,1
23-03-2025,"Dry Fruits, Nuts & Seeds",WATERMELON SEEDS 250GRM,2,320,280,40,1
23-03-2025,Milk & Dairy,HERITAGE TOTAL CURD 500GM,7,50,50,0,1
23-03-2025,"Grains, Flours & Dals",DISANO OATS 1KG,4,285,142.5,142.5,1
23-03-2025,Snacks & Ready-to-Eat,VD DRY FRUIT PUTHAREKULU,14,120,120,0,1
23-03-2025,"Dry Fruits, Nuts & Seeds",SUNFLOWER SEEDS 250GRM,2,150,130,20,1
23-03-2025,"Dry Fruits, Nuts & Seeds",SATHVI CHIA SEEDS 100GM,2,100,80,20,1
23-03-2025,Spices & Seasonings,Marati Magga 50GM,15,130,110,20,1
23-03-2025,Snacks & Ready-to-Eat,ELITE MILK RUSK 200GM,14,35,35,0,1
23-03-2025,Spices & Seasonings,DURGA SALT CRYSTAL 1KG,15,56,56,0,2
23-03-2025,General Household & Kitchenware,GOOD HOME,3,30,30,0,2
23-03-2025,Snacks & Ready-to-Eat,GB SALT COOKIES,14,60,55,5,1
23-03-2025,Spices & Seasonings,Gasagasalu 50GM,15,130,110,20,1
23-03-2025,Beverages,ASSAM ELAICHI TEA,1,199,199,0,1
23-03-2025,"Dry Fruits, Nuts & Seeds",Groundnuts 500 gms,2,95,85,10,1
23-03-2025,General Household & Kitchenware,LASER STAINLESS 50N,3,120,120,0,1
23-03-2025,Spices & Seasonings,dalchin chekka,15,50,40,10,1
23-03-2025,Spices & Seasonings,NUVVULU 250GM,15,100,85,15,1
23-03-2025,Oils & Ghee,Groundnut oil 1 L,9,360,330,30,1
23-03-2025,Oils & Ghee,cow ghee 500 ml,9,430,390,40,1
23-03-2025,"Grains, Flours & Dals",Wheat Flour 2 kgs,4,140,120,20,1
23-03-2025,"Grains, Flours & Dals",Multigrain 1 kg,4,100,85,15,1
23-03-2025,Oils & Ghee,Groundnut oil 1 L,9,360,330,30,1
23-03-2025,Sweeteners,YB FOREST HONEY 250GM,16,180,180,0,1
23-03-2025,Oils & Ghee,Sesame oil 500ml,9,295,280,15,1
23-03-2025,"Grains, Flours & Dals",DESI CHANA,4,50,50,0,2
23-03-2025,Snacks & Ready-to-Eat,BD PEARL MILLET NOODLES 200G,14,70,70,0,1
23-03-2025,Snacks & Ready-to-Eat,RAJGIRA PEANUT CHIKKI 450GM,14,125,125,0,1
23-03-2025,Spices & Seasonings,Jeera 100GM,15,50,45,5,1
23-03-2025,"Grains, Flours & Dals",THICK POHA 500GM,4,40,35,5,1
23-03-2025,"Grains, Flours & Dals",Multigrain 1 kg,4,100,85,15,1
23-03-2025,Personal Care & Cosmetics,HERBAL BATH POWDER 200GM,10,80,80,0,1
23-03-2025,"Grains, Flours & Dals",DISANO OATS 1KG,4,285,142.5,142.5,1
23-03-2025,"Grains, Flours & Dals",Chana Flour 500 gms,4,70,65,5,1
23-03-2025,Spices & Seasonings,JEERA 250 gms,15,125,105,20,1
23-03-2025,"Grains, Flours & Dals",Wheat Flour 1 kg,4,140,120,20,2
23-03-2025,"Grains, Flours & Dals",DH URAD GOTA 1KG,4,430,380,50,2
23-03-2025,"Grains, Flours & Dals",Sathya Javva Wheat Rava 500GM,4,190,190,0,2
23-03-2025,Oils & Ghee,Coconut oil 1 L,9,440,400,40,1
23-03-2025,Oils & Ghee,Groundnut oil 1 L,9,360,330,30,1
23-03-2025,"Grains, Flours & Dals",Brown RICE 1KG,4,350,325,25,5
23-03-2025,Snacks & Ready-to-Eat,SD JOWAR WITH PALM JAGGERY 250GM,14,135,135,0,1
23-03-2025,"Grains, Flours & Dals",DESI CHANA,4,25,25,0,1
23-03-2025,Snacks & Ready-to-Eat,VD ARISELU 5 PIC,14,100,100,0,1
23-03-2025,"Grains, Flours & Dals",Yellow jowar.F 500 gms,4,55,50,5,1
23-03-2025,"Grains, Flours & Dals",Chana Flour 500 gms,4,70,65,5,1
23-03-2025,Snacks & Ready-to-Eat,VD Pappu Chekkalu 190gm,14,60,60,0,1
23-03-2025,Snacks & Ready-to-Eat,SATHVI PALLI CHIKKI 200GM,14,100,80,20,1
23-03-2025,Snacks & Ready-to-Eat,RSC ORANGE 100GMS,14,20,20,0,1
23-03-2025,"Grains, Flours & Dals",UDALU (Barnyard millet) 500 gms,4,70,60,10,1
23-03-2025,"Grains, Flours & Dals",JOWAR UPMA RAVA,4,75,75,0,1
23-03-2025,Personal Care & Cosmetics,MULTANI MITTI CHOORNAM,10,40,40,0,1
23-03-2025,"Grains, Flours & Dals",SAMALU (Little millet) 500 gms,4,85,65,20,1
23-03-2025,Spices & Seasonings,Telaga Pindi 250 GM,15,40,35,5,1
23-03-2025,Household & Cleaning,ROOPERI PITAMBARI SILVER 50ML,6,110,110,0,1
23-03-2025,Oils & Ghee,Groundnut oil 1 L,9,360,330,30,1
23-03-2025,"Grains, Flours & Dals",KORRALU (FOXTAIL M) 1KG,4,150,110,40,1
23-03-2025,"Grains, Flours & Dals",SAMALU,4,170,130,40,1
23-03-2025,Snacks & Ready-to-Eat,SD Atreyapuram DRY Fruit ghee,14,150,150,0,1
23-03-2025,Pooja & Spiritual Items,GD Camphor 50GM,12,180,180,0,1
23-03-2025,"Grains, Flours & Dals",ANDU KORRALU (Browntop.m) 1 kg,4,260,220,40,1
23-03-2025,Personal Care & Cosmetics,gow durbar sandal,10,40,40,0,1
23-03-2025,Snacks & Ready-to-Eat,DINNER PAPAD,14,80,80,0,1
23-03-2025,"Grains, Flours & Dals",Arikadu ( kodo),4,140,130,10,1
23-03-2025,Snacks & Ready-to-Eat,CHOCO BROWINE,14,40,40,0,2
23-03-2025,Oils & Ghee,Mustard oil 500 ml,9,220,195,25,1
23-03-2025,Milk & Dairy,BROWN EGGS TRAY 30P,7,360,330,30,1
23-03-2025,"Grains, Flours & Dals",VGR RICE 5 KGS,4,350,325,25,1
23-03-2025,Oils & Ghee,Groundnut oil 500ml,9,180,165,15,1
23-03-2025,Beverages,BISLERI WATER 1L,1,20,20,0,1
23-03-2025,Spices & Seasonings,SH CASSIA STICKS 50GM,15,75,75,0,1
23-03-2025,"Grains, Flours & Dals",Wheat Flour 1 kg,4,70,60,10,1
23-03-2025,Oils & Ghee,Sesame oil 1 L,9,1180,"1,120.00",60,2
23-03-2025,Snacks & Ready-to-Eat,NGT CHATPATTA CHANA 90GM,14,50,50,0,2
23-03-2025,"Grains, Flours & Dals",Wheat Flour 1 kg,4,140,120,20,2
23-03-2025,"Grains, Flours & Dals",Red uluvalu 500 gms,4,90,75,15,1
23-03-2025,"Grains, Flours & Dals",DISANO ROLED OATS,4,395,345,50,1
23-03-2025,Oils & Ghee,Groundnut oil 1 L,9,360,330,30,1
23-03-2025,"Grains, Flours & Dals",SINGLE POLISH 1KG,4,650,650,0,10
23-03-2025,Spices & Seasonings,Jeera 100GM,15,50,45,5,1
23-03-2025,"Grains, Flours & Dals",Wheat Flour 1 kg,4,140,120,20,2
23-03-2025,"Dry Fruits, Nuts & Seeds",Groundnuts 500 gms,2,95,85,10,1
23-03-2025,"Grains, Flours & Dals",Chana Flour 500 gms,4,70,65,5,1
23-03-2025,"Grains, Flours & Dals",Idly Rava L 1KG,4,60,50,10,1
23-03-2025,"Dry Fruits, Nuts & Seeds",Groundnuts 1 kg,2,190,165,25,1
23-03-2025,Milk & Dairy,HERITAGE TONED MILK 500ML,7,31,31,0,1
23-03-2025,Spices & Seasonings,ROYAL SAFFRON,15,125,125,0,1
23-03-2025,Oils & Ghee,Groundnut oil 1 L,9,360,330,30,1
23-03-2025,"Grains, Flours & Dals",Chana Flour 500 gms,4,140,130,10,2
23-03-2025,"Grains, Flours & Dals",JOWAR YELLOW 1 K,4,100,90,10,1
23-03-2025,"Grains, Flours & Dals",FLOUR CHARGE,4,82,82,0,1
23-03-2025,"Grains, Flours & Dals",JOWAR WHITE 1 KG,4,80,70,10,1
23-03-2025,"Grains, Flours & Dals",Wheat Flour 1 kg,4,140,120,20,2
23-03-2025,"Grains, Flours & Dals",RAGI FLOUR 500GRMS,4,40,35,5,1
23-03-2025,Pooja & Spiritual Items,LOOSE VATHULU,12,60,50,10,2
23-03-2025,Oils & Ghee,Mustard oil 500 ml,9,220,195,25,1
23-03-2025,"Grains, Flours & Dals",RICE FLOUR 1KG,4,210,165,45,3
23-03-2025,"Grains, Flours & Dals",Chana Flour 1 kg,4,140,130,10,1
23-03-2025,"Grains, Flours & Dals",RICE FLOUR 500 GM,4,35,28,7,1
23-03-2025,Spices & Seasonings,RED COPRA 500GM,15,170,148,22,1
23-03-2025,Oils & Ghee,Safflower oil 1 L,9,1320,"1,200.00",120,3
23-03-2025,Snacks & Ready-to-Eat,KURNOOL MARMURA,14,140,110,30,2
23-03-2025,"Grains, Flours & Dals",CHANA DAL 500GM,4,140,120,20,2
23-03-2025,Sweeteners,YB Brown Sugar 500GM,16,75,75,0,1
23-03-2025,Personal Care & Cosmetics,NEEM SOAP 100GM,10,400,400,0,4
23-03-2025,Snacks & Ready-to-Eat,BD PEARL MILLET NOODLES 200G,14,70,70,0,1
23-03-2025,Oils & Ghee,A2 BUFFALO GHEE 250ML,9,299,299,0,1
23-03-2025,Oils & Ghee,Groundnut oil 1 L,9,720,660,60,2
23-03-2025,Sweeteners,PN ORGANIC JAGGERY POWDER 400GM,16,86,86,0,1
23-03-2025,"Grains, Flours & Dals",Wheat Flour 2 kgs,4,140,120,20,1
23-03-2025,Snacks & Ready-to-Eat,SATHVI PALLI CHIKKI 200GM,14,100,80,20,1
23-03-2025,Oils & Ghee,Sesame oil 500ml,9,295,280,15,1
23-03-2025,Snacks & Ready-to-Eat,FOXTAIL BIS,14,135,135,0,1
23-03-2025,"Grains, Flours & Dals",Multigrain 1 kg,4,100,85,15,1
23-03-2025,Snacks & Ready-to-Eat,SD Little Millet WITH PLAM JAGGERY,14,135,135,0,1
23-03-2025,Spices & Seasonings,JEERA 250 gms,15,125,105,20,1
23-03-2025,Spices & Seasonings,Turmeric powder 250 gms,15,100,75,25,1
23-03-2025,"Grains, Flours & Dals",SABDANA 500GM,4,90,70,20,1
23-03-2025,"Grains, Flours & Dals",BOMBAY RAVA,4,140,110,30,2
23-03-2025,"Grains, Flours & Dals",Wheat Flour 1 kg,4,280,240,40,4
23-03-2025,"Dry Fruits, Nuts & Seeds",SUNFLOWER SEEDS 250GRM,2,150,130,20,1
23-03-2025,"Dry Fruits, Nuts & Seeds",ALMONDS 250GM,2,280,260,20,1
23-03-2025,"Dry Fruits, Nuts & Seeds",PUMPKIN SEEDS 250GM,2,200,160,40,1
23-03-2025,"Dry Fruits, Nuts & Seeds",WATERMELON SEEDS 250GRM,2,320,280,40,1
23-03-2025,"Dry Fruits, Nuts & Seeds",FLAX SEEDS 250GM,2,60,50,10,1
23-03-2025,"Dry Fruits, Nuts & Seeds",WALLNUTS 250GM,2,380,360,20,1
23-03-2025,"Grains, Flours & Dals",Chana Flour 500 gms,4,70,65,5,1
23-03-2025,"Grains, Flours & Dals",split black gram 1 kg,4,180,170,10,1
23-03-2025,Sweeteners,YB FOREST HONEY 250GM,16,180,180,0,1
23-03-2025,Spices & Seasonings,Gasagasalu 50GM,15,130,110,20,1
23-03-2025,General Household & Kitchenware,SPOON 4,3,48,48,0,3
23-03-2025,Snacks & Ready-to-Eat,NGT CHATPATTA CHANA 90GM,14,50,50,0,2
23-03-2025,Pickles & Cooking Pastes,SD MESTA PICKLE,11,110,110,0,1
23-03-2025,Milk & Dairy,BROWN EGGS 1P,7,140,120,20,10
23-03-2025,"Health, Wellness & Ayurvedic Products",DWI OMU WATER 100ML,5,40,40,0,1
23-03-2025,"Grains, Flours & Dals",chana dall,4,35,30,5,1
23-03-2025,Oils & Ghee,Safflower oil 1 L,9,440,400,40,1
23-03-2025,Oils & Ghee,Groundnut oil 1 L,9,360,330,30,1
23-03-2025,Spices & Seasonings,DRY MIECHI 200GM,15,160,120,40,2
23-03-2025,Spices & Seasonings,Tamarind 500GM,15,160,130,30,1
23-03-2025,"Grains, Flours & Dals",AISHWARYA SP 25KG,4,1999,"1,690.00",309,1
23-03-2025,Snacks & Ready-to-Eat,mixed chikki,14,110,110,0,1
23-03-2025,Snacks & Ready-to-Eat,VD NUVVULU LADDU,14,80,80,0,1
23-03-2025,Snacks & Ready-to-Eat,NGT CHATPATTA CHANA 90GM,14,25,25,0,1
23-03-2025,"Grains, Flours & Dals",RAGI FLOUR 500GRMS,4,40,35,5,1
23-03-2025,"Health, Wellness & Ayurvedic Products",RB Max Protein Chinese Manchurian,5,45,45,0,1
23-03-2025,"Grains, Flours & Dals",Quinova 1 kg,4,220,195,25,1
23-03-2025,Personal Care & Cosmetics,SVE MULTANI MITTI SOAP 100GM,10,90,90,0,1
23-03-2025,"Grains, Flours & Dals",Arikadu ( kodo),4,140,130,10,1
23-03-2025,"Health, Wellness & Ayurvedic Products",RB Max Protein PERI PERI 60gm,5,45,45,0,1
23-03-2025,Personal Care & Cosmetics,SVE RED SANDAL SOAP 100GM,10,90,90,0,1
23-03-2025,"Grains, Flours & Dals",SAMALU,4,170,130,40,1
23-03-2025,"Grains, Flours & Dals",KORRALU (FOXTAIL M) 1KG,4,150,110,40,1
23-03-2025,Oils & Ghee,Groundnut oil 1 L,9,720,660,60,2
23-03-2025,Sweeteners,PN ORGANIC JAGGERY POWDER 400GM,16,172,172,0,2
23-03-2025,"Grains, Flours & Dals",RED RICE 1KG,4,150,120,30,1
23-03-2025,Snacks & Ready-to-Eat,GROUNDNUT LADDU WITH DATES,14,135,135,0,1
23-03-2025,"Grains, Flours & Dals",Red Wheat Flour 1 kg,4,140,130,10,1
23-03-2025,"Grains, Flours & Dals",Yellow jowar.F 500 gms,4,55,50,5,1
23-03-2025,"Grains, Flours & Dals",ANDU KORRALU (Browntop.m) 1 kg,4,520,440,80,2
23-03-2025,"Dry Fruits, Nuts & Seeds",MAHA BEERA SEEDS 100GM,2,80,80,0,1
23-03-2025,"Dry Fruits, Nuts & Seeds",sabja seeds,2,80,70,10,1
23-03-2025,"Grains, Flours & Dals",KORRALU (FOXTAIL M) 1KG,4,300,220,80,2
23-03-2025,"Grains, Flours & Dals",UDALU (Barnyard millet) 1 kg,4,280,230,50,2
23-03-2025,"Grains, Flours & Dals",SAMALU,4,340,260,80,2
23-03-2025,"Dry Fruits, Nuts & Seeds",SATHVI CHIA SEEDS 100GM,2,100,80,20,1
23-03-2025,"Grains, Flours & Dals",Arikadu ( kodo),4,280,260,20,2
23-03-2025,Oils & Ghee,Sesame oil 1 L,9,1180,"1,120.00",60,2
23-03-2025,"Grains, Flours & Dals",RAGI FLOUR 500GRMS,4,40,35,5,1
23-03-2025,Snacks & Ready-to-Eat,PALLI LADDU 200GMS,14,90,70,20,1
23-03-2025,"Grains, Flours & Dals",Arikadu ( kodo),4,140,130,10,1
23-03-2025,Snacks & Ready-to-Eat,NGT CHATPATTA CHANA 90GM,14,25,25,0,1
23-03-2025,"Grains, Flours & Dals",RAGI FLOUR 500GRMS,4,40,35,5,1
23-03-2025,"Grains, Flours & Dals",ANDU KORRALU (Browntop.m) 1 kg,4,260,220,40,1
23-03-2025,Spices & Seasonings,Black Till 250GM,15,90,75,15,1
23-03-2025,"Grains, Flours & Dals",SAMALU,4,170,130,40,1
23-03-2025,"Grains, Flours & Dals",UDALU (Barnyard millet) 1 kg,4,140,115,25,1
23-03-2025,"Grains, Flours & Dals",KORRALU (FOXTAIL M) 1KG,4,150,110,40,1
23-03-2025,Pickles & Cooking Pastes,SD MANGO PICKLE,11,110,110,0,1
23-03-2025,Snacks & Ready-to-Eat,VD RED CHILLI RICEPAPAD 150GM,14,100,100,0,2
23-03-2025,Snacks & Ready-to-Eat,VD RICE SAGO PAPAD 150GM,14,110,110,0,2
23-03-2025,Personal Care & Cosmetics,SVE TURMERIC SOAP 100GM,10,90,90,0,1
23-03-2025,Misc,VD0009,8,100,100,0,1
23-03-2025,Snacks & Ready-to-Eat,ragi apadalu,14,90,90,0,1
23-03-2025,Personal Care & Cosmetics,SVE SUNNI PINDI SCRUBSOAP 100GM,10,100,100,0,1
23-03-2025,Snacks & Ready-to-Eat,SD FLAX SEED APPADALU,14,90,90,0,1
23-03-2025,Personal Care & Cosmetics,SVE RED SANDAL SOAP 100GM,10,90,90,0,1
23-03-2025,Oils & Ghee,Sesame oil 500ml,9,295,280,15,1
23-03-2025,"Dry Fruits, Nuts & Seeds",SD Mango cubes 200gm,2,90,90,0,1
23-03-2025,Oils & Ghee,Groundnut oil 1 L,9,360,330,30,1
23-03-2025,Spices & Seasonings,AVALU 250grms,15,60,60,0,1
23-03-2025,Sweeteners,NATURAL HONEY 1KG,16,560,480,80,1
23-03-2025,"Grains, Flours & Dals",Bombay Rava 500GM,4,35,30,5,1
23-03-2025,Spices & Seasonings,BIRYANI LEAF 10GM,15,30,20,10,1
23-03-2025,Spices & Seasonings,dalchin chekka,15,50,40,10,1
23-03-2025,Household & Cleaning,HERBAL FLOOR CLEANER 500ML,6,116,116,0,1
23-03-2025,Spices & Seasonings,ever c masala,15,48,48,0,1
23-03-2025,Snacks & Ready-to-Eat,VD GUMMADI VADIYAM,14,75,75,0,1
23-03-2025,Spices & Seasonings,DHANIYA POWDER 200GM,15,100,85,15,1
23-03-2025,Pooja & Spiritual Items,SWASTIK SAMBRANI 25 GRMS,12,20,20,0,1
23-03-2025,Oils & Ghee,Sesame oil 500ml,9,295,280,15,1
23-03-2025,"Dry Fruits, Nuts & Seeds",Groundnuts 1 kg,2,190,165,25,1
23-03-2025,Sweeteners,YB JAGGERY POWDER 500GMS,16,75,75,0,1
23-03-2025,Milk & Dairy,BROWN EGGS 1P,7,140,120,20,10
23-03-2025,"Health, Wellness & Ayurvedic Products",DWI EUCALYPTUS 8ML,5,80,80,0,1
23-03-2025,Pooja & Spiritual Items,BANDA PUVVU 25GM 25GM,12,80,60,20,1
23-03-2025,"Grains, Flours & Dals",THICK POHA 1KG,4,80,70,10,1
23-03-2025,Spices & Seasonings,Elaichi 25GM,15,145,120,25,1
23-03-2025,"Grains, Flours & Dals",Wheat Rava S 1KG,4,65,55,10,1
23-03-2025,"Grains, Flours & Dals",SRILATHA RICE RAVVA 500GM,4,70,70,0,2
23-03-2025,"Grains, Flours & Dals",DISANO ROLED OATS,4,395,200,195,1
23-03-2025,"Grains, Flours & Dals",split urad dall 250 gms,4,45,40,5,1
23-03-2025,Snacks & Ready-to-Eat,KURNOOL MARMURA,14,140,110,30,2
23-03-2025,Sweeteners,SUGAR 1KG,16,240,200,40,4
23-03-2025,"Grains, Flours & Dals",Idly Rava L 1KG,4,300,250,50,5
23-03-2025,Spices & Seasonings,JEERA 250 gms,15,125,105,20,1
23-03-2025,Spices & Seasonings,DRY MIECHI 200GM,15,80,60,20,1
23-03-2025,Spices & Seasonings,Menthulu 250 gms,15,50,45,5,1
23-03-2025,"Grains, Flours & Dals",Urad dall 1 Kg,4,370,340,30,2
23-03-2025,"Dry Fruits, Nuts & Seeds",PUTNALU 500GMS,2,90,76,14,1
23-03-2025,Spices & Seasonings,Coriander seeds 200 gms,15,48,40,8,1
23-03-2025,Snacks & Ready-to-Eat,BB VERMICELLY 500GM,14,53,53,0,1
23-03-2025,Oils & Ghee,Sesame oil 1 L,9,590,560,30,1
23-03-2025,Spices & Seasonings,Chilli powder 500 gms,15,290,210,80,1
23-03-2025,Spices & Seasonings,3M.MIRCHI POWDER,15,145,115,30,1
23-03-2025,Spices & Seasonings,THREE MANGO RAI 200G,15,84,84,0,2
23-03-2025,"Dry Fruits, Nuts & Seeds",SD Mango cubes 200gm,2,90,90,0,1
23-03-2025,Oils & Ghee,Groundnut oil 1 L,9,720,660,60,2
23-03-2025,Oils & Ghee,Sesame oil 1 L,9,590,560,30,1
23-03-2025,Oils & Ghee,Safflower oil 1 L,9,1320,"1,200.00",120,3
23-03-2025,"Grains, Flours & Dals",Wheat Flour 1 kg,4,70,60,10,1
23-03-2025,Snacks & Ready-to-Eat,ZEEDI,14,70,70,0,1
23-03-2025,Snacks & Ready-to-Eat,COPRA LADDU 200GM,14,100,80,20,1
23-03-2025,"Health, Wellness & Ayurvedic Products",MORINGA LEAF POWDER M,5,80,75,5,1
23-03-2025,"Grains, Flours & Dals",Em kodo idli R 500G,4,129,129,0,1
23-03-2025,"Grains, Flours & Dals",RAGI FLOUR 500GRMS,4,40,35,5,1
23-03-2025,"Grains, Flours & Dals",Multigrain 1 kg,4,200,170,30,2
23-03-2025,"Grains, Flours & Dals",Wheat Flour 1 kg,4,70,60,10,1
23-03-2025,Snacks & Ready-to-Eat,SD Moringa with plam jaggery 250gm,14,135,135,0,1
23-03-2025,Spices & Seasonings,Chilli powder 500 gms,15,290,210,80,1
23-03-2025,Oils & Ghee,Groundnut oil 1 L,9,360,330,30,1
23-03-2025,Personal Care & Cosmetics,MADDI HIBISCUS HAIR SHAMPOO 500ML,10,300,300,0,1
23-03-2025,Personal Care & Cosmetics,UVIS ONION HAIR OIL100ML,10,199,199,0,1
23-03-2025,"Grains, Flours & Dals",split black gram 1 kg,4,360,340,20,2
23-03-2025,"Dry Fruits, Nuts & Seeds",PULMAKHANA 100 GM,2,180,170,10,1
23-03-2025,"Grains, Flours & Dals",Multigrain 1 kg,4,100,85,15,1
23-03-2025,Oils & Ghee,Safflower oil 1 L,9,880,800,80,2
23-03-2025,Oils & Ghee,Groundnut oil 1 L,9,360,330,30,1
23-03-2025,"Dry Fruits, Nuts & Seeds",DIANUTS 500GM,2,120,120,0,1
23-03-2025,Sweeteners,MADHUR SUGAR 1KG,16,130,110,20,2
23-03-2025,"Grains, Flours & Dals",VGR RICE 5 KGS,4,350,325,25,1
23-03-2025,"Grains, Flours & Dals",CHANA DAL 500GM,4,70,60,10,1
23-03-2025,Snacks & Ready-to-Eat,mixed chikki,14,110,110,0,1
23-03-2025,"Health, Wellness & Ayurvedic Products",MH Millets Malt 500GM,5,200,190,10,1
23-03-2025,Snacks & Ready-to-Eat,VD Pappu Chekkalu 190gm,14,120,120,0,2
23-03-2025,Snacks & Ready-to-Eat,VD BOONDI 175GM,14,60,60,0,1
23-03-2025,"Grains, Flours & Dals",PESARA PAPPU 1 KG,4,170,145,25,1
23-03-2025,"Grains, Flours & Dals",RAGI FLOUR 500GRMS,4,80,70,10,2
23-03-2025,Snacks & Ready-to-Eat,VD RIBBON PAKODI 175GM,14,60,60,0,1
23-03-2025,Snacks & Ready-to-Eat,PALLI LADDU 200GMS,14,180,140,40,2
23-03-2025,Oils & Ghee,Coconut oil 500 ml,9,220,200,20,1
23-03-2025,"Grains, Flours & Dals",POORI ATTA 1KG,4,70,60,10,1
23-03-2025,Snacks & Ready-to-Eat,VD DAHI MIRCHI(SALTED) 100GM,14,45,45,0,1
23-03-2025,Personal Care & Cosmetics,dove s,10,144,108,36,2
23-03-2025,"Grains, Flours & Dals",SPLIT BLACK GRAM 500 GM,4,90,85,5,1
23-03-2025,Sweeteners,MADHUR SUGAR 1KG,16,65,55,10,1
23-03-2025,"Grains, Flours & Dals",Bombay Rava 500GM,4,35,30,5,1
23-03-2025,Spices & Seasonings,SH MUSTARD 100GM,15,30,30,0,1
23-03-2025,"Grains, Flours & Dals",Multigrain 1 kg,4,100,85,15,1
23-03-2025,"Grains, Flours & Dals",Wheat Flour 1 kg,4,70,60,10,1
23-03-2025,Oils & Ghee,Coconut oil 500 ml,9,220,200,20,1
23-03-2025,"Grains, Flours & Dals",Wheat Flour 1 kg,4,210,180,30,3
23-03-2025,"Grains, Flours & Dals",DH URAD GOTA 1KG,4,430,380,50,2
23-03-2025,"Grains, Flours & Dals",THICK POHA 1KG,4,80,70,10,1
23-03-2025,"Grains, Flours & Dals",turdal 1kg,4,220,170,50,1
23-03-2025,Milk & Dairy,BROWN EGGS 1P,7,168,144,24,12
23-03-2025,"Grains, Flours & Dals",RAGI FLOUR 500GRMS,4,40,35,5,1
23-03-2025,"Grains, Flours & Dals",White Chana 250 GM,4,60,50,10,1
23-03-2025,Oils & Ghee,Sesame oil 1 L,9,1180,"1,120.00",60,2
23-03-2025,"Grains, Flours & Dals",split black gram 1 kg,4,180,170,10,1
23-03-2025,"Grains, Flours & Dals",SABDANA,4,40,35,5,1
23-03-2025,Spices & Seasonings,AVALU 100GM,15,25,20,5,1
23-03-2025,"Dry Fruits, Nuts & Seeds",PUTNALU 500GMS,2,90,76,14,1
23-03-2025,Spices & Seasonings,JEERA 250 gms,15,125,105,20,1
23-03-2025,Snacks & Ready-to-Eat,Popcorn Seeds 250GM,14,45,40,5,1
23-03-2025,"Grains, Flours & Dals",SL Suji Rava 500GM,4,96,96,0,3
23-03-2025,"Grains, Flours & Dals",PESARA PAPPU 1 KG,4,170,145,25,1
23-03-2025,"Grains, Flours & Dals",CHANA DAL 500GM,4,70,60,10,1
23-03-2025,"Grains, Flours & Dals",idly/Dosa rice 1 kg,4,70,60,10,1
23-03-2025,"Dry Fruits, Nuts & Seeds",Groundnuts 1 kg,2,570,495,75,3
23-03-2025,"Grains, Flours & Dals",SA YELLOW JOWAR RAVA 500GM,4,95,95,0,1
23-03-2025,"Health, Wellness & Ayurvedic Products",RB Max Protein Oats &Raisins 55gm,5,50,50,0,1
23-03-2025,"Grains, Flours & Dals",Wheat Rava M 1KG,4,65,55,10,1
23-03-2025,"Grains, Flours & Dals",SL Idly Rava 1KG,4,130,110,20,2
23-03-2025,Pooja & Spiritual Items,GD Aiswarya Deepam 700ML,12,195,195,0,1
23-03-2025,"Grains, Flours & Dals",DISANO ROLED OATS,4,395,197.5,197.5,1
23-03-2025,Pooja & Spiritual Items,GD Dhoop Cones 40GM,12,30,30,0,1
23-03-2025,"Grains, Flours & Dals",split green gram 1 kg,4,150,140,10,1
23-03-2025,Milk & Dairy,BROWN EGGS TRAY 30P,7,360,330,30,1
23-03-2025,Snacks & Ready-to-Eat,GB SALT COOKIES,14,60,55,5,1
23-03-2025,Oils & Ghee,Sesame oil 500ml,9,295,280,15,1
23-03-2025,"Grains, Flours & Dals",VYS.SP.RICE 5 KGS,4,350,325,25,1
23-03-2025,Oils & Ghee,Groundnut oil 1 L,9,720,660,60,2
23-03-2025,"Grains, Flours & Dals",VGR RICE bag 1,4,1899,"1,650.00",249,1
23-03-2025,"Grains, Flours & Dals",KORRALU (FOXTAIL M) 500GM,4,65,55,10,1
23-03-2025,"Grains, Flours & Dals",White jowar.F 500 Gms,4,50,40,10,1
23-03-2025,"Grains, Flours & Dals",SA WHITE JOWAR RAVA 500GM,4,69,69,0,1
23-03-2025,"Grains, Flours & Dals",JOWAR WHITE 1 KG,4,40,35,5,0.5
23-03-2025,Snacks & Ready-to-Eat,MB PEARL MILLET NOODLES 180GM,14,95,95,0,1
23-03-2025,Snacks & Ready-to-Eat,MB SORGHUM NOODLES 180GM,14,95,95,0,1
23-03-2025,"Grains, Flours & Dals",Urad dall 1 Kg,4,370,340,30,2
23-03-2025,Spices & Seasonings,SREE MARUTHI IDLY KARAM 200GM,15,65,65,0,1
23-03-2025,"Grains, Flours & Dals",SAMALU (Little millet) 500 gms,4,85,65,20,1
23-03-2025,"Grains, Flours & Dals",DH URAD GOTA 1KG,4,215,190,25,1
23-03-2025,"Grains, Flours & Dals",SRILATHA RICE RAVVA 500GM,4,35,35,0,1
23-03-2025,Oils & Ghee,Sesame oil 1 L,9,590,560,30,1
23-03-2025,Oils & Ghee,Groundnut oil 1 L,9,360,330,30,1
23-03-2025,Milk & Dairy,HERITAGE TONED MILK 500ML,7,62,62,0,2
23-03-2025,"Grains, Flours & Dals",VGR rice 1 kg,4,140,130,10,2
23-03-2025,Snacks & Ready-to-Eat,SATHVI PALLI CHIKKI 200GM,14,100,80,20,1
23-03-2025,"Grains, Flours & Dals",Wheat Flour 1 kg,4,70,60,10,1
23-03-2025,Spices & Seasonings,Chilli powder 500 gms,15,290,210,80,1
23-03-2025,Oils & Ghee,Groundnut oil 1 L,9,1080,990,90,3
23-03-2025,Oils & Ghee,Sesame oil 1 L,9,1180,"1,120.00",60,2
23-03-2025,Oils & Ghee,Coconut oil 1 L,9,440,400,40,1
23-03-2025,Oils & Ghee,Groundnut oil 1 L,9,360,330,30,1
23-03-2025,Oils & Ghee,Groundnut oil 1 L,9,360,330,30,1
23-03-2025,Oils & Ghee,cow ghee 500 ml,9,430,390,40,1
23-03-2025,Spices & Seasonings,Chilli powder 500 gms,15,290,210,80,1
23-03-2025,"Grains, Flours & Dals",RAGI FLOUR 500GRMS,4,40,35,5,1
23-03-2025,"Grains, Flours & Dals",White Chana 500GM,4,120,100,20,1
23-03-2025,"Grains, Flours & Dals",BARLEY SEEDS 1KG,4,160,140,20,1
23-03-2025,"Grains, Flours & Dals",SINGLE POLISH 1KG,4,130,130,0,2
23-03-2025,Spices & Seasonings,Masala Karam 250 gms,15,130,120,10,1
23-03-2025,"Dry Fruits, Nuts & Seeds",WATERMELON SEEDS 250GRM,2,320,280,40,1
23-03-2025,Snacks & Ready-to-Eat,RINGS 200GM,14,30,30,0,1
23-03-2025,"Grains, Flours & Dals",split green gram 500 gms,4,75,70,5,1
23-03-2025,"Grains, Flours & Dals",UNPOLISHED TURDALL 1KG,4,240,210,30,1
23-03-2025,"Grains, Flours & Dals",MAAGAANI W RICE 5KGS,4,1798,"1,070.00",728,2
23-03-2025,Milk & Dairy,BROWN EGGS 1P,7,168,144,24,12
23-03-2025,Oils & Ghee,Freedom Rice Bran Oil 1L,9,194,180,14,1
23-03-2025,Spices & Seasonings,AVALU 100GM,15,25,20,5,1
23-03-2025,"Grains, Flours & Dals",Yellow jowar .F1 kg,4,110,100,10,1
23-03-2025,"Grains, Flours & Dals",Chana Flour 500 gms,4,70,65,5,1
23-03-2025,"Grains, Flours & Dals",Multigrain 1 kg,4,100,85,15,1
23-03-2025,"Health, Wellness & Ayurvedic Products",RB Max Protein Fruit &amp;Nut 50g,5,75,75,0,1
23-03-2025,"Grains, Flours & Dals",KORRALU (FOXTAIL M) 500GM,4,65,55,10,1
23-03-2025,"Grains, Flours & Dals",turdal 500 gms,4,110,85,25,1
23-03-2025,"Dry Fruits, Nuts & Seeds",Groundnuts 500 gms,2,95,85,10,1
23-03-2025,"Grains, Flours & Dals",SPLIT BLACK GRAM 500 GM,4,90,85,5,1
23-03-2025,Personal Care & Cosmetics,DETTOL ORIGINAL,10,99,99,0,1
23-03-2025,"Grains, Flours & Dals",SRILATHA RICE RAVVA 500GM,4,35,35,0,1
23-03-2025,Spices & Seasonings,Black Elaichi 25GM,15,75,65,10,1
23-03-2025,Pooja & Spiritual Items,BANDA PUVVU 25GM 25GM,12,80,60,20,1
23-03-2025,Spices & Seasonings,Coriander seeds 200 gms,15,48,40,8,1
23-03-2025,Snacks & Ready-to-Eat,Popcorn Seeds 250GM,14,45,40,5,1
23-03-2025,Oils & Ghee,Groundnut oil 1 L,9,360,330,30,1
23-03-2025,Oils & Ghee,Groundnut oil 500ml,9,180,165,15,1
23-03-2025,Oils & Ghee,Sesame oil 1 L,9,590,560,30,1
23-03-2025,Spices & Seasonings,NUVVULU 500GM,15,160,130,30,1
23-03-2025,Spices & Seasonings,NUVVULU 250GM,15,80,65,15,1
23-03-2025,Snacks & Ready-to-Eat,NGT CHATPATTA CHANA 90GM,14,50,50,0,2
23-03-2025,Misc,VD00014,8,200,180,20,2
23-03-2025,"Dry Fruits, Nuts & Seeds",PLAIN PISTA 250GM,2,660,550,110,1
23-03-2025,Snacks & Ready-to-Eat,PALLI LADDU 200GMS,14,180,140,40,2
23-03-2025,Snacks & Ready-to-Eat,VD RIBBON PAKODI 175GM,14,120,120,0,2
23-03-2025,"Grains, Flours & Dals",RAGULU 1 KG,4,105,90,15,1.5
23-03-2025,"Grains, Flours & Dals",THICK POHA 500GM,4,40,35,5,1
23-03-2025,"Grains, Flours & Dals",SOYA BEANS 1KG,4,50,45,5,0.25
23-03-2025,Snacks & Ready-to-Eat,VD RED CHILLI RICEPAPAD 150GM,14,50,50,0,1
23-03-2025,Snacks & Ready-to-Eat,VD NUVULU CHEGODI 175GM,14,120,120,0,2
23-03-2025,"Grains, Flours & Dals",FLOUR CHARGE,4,33,33,0,2.75
23-03-2025,"Grains, Flours & Dals",JOWAR WHITE 1 KG,4,20,17.5,2.5,0.25
23-03-2025,Snacks & Ready-to-Eat,SATHVI PALLI CHIKKI 200GM,14,100,80,20,1
23-03-2025,"Dry Fruits, Nuts & Seeds",ROASTED FLAXSEED,2,18.75,18.75,0,0.25
23-03-2025,"Dry Fruits, Nuts & Seeds",WALLNUTS 250GM,2,380,360,20,1
23-03-2025,"Grains, Flours & Dals",PLAIN OATS 1KG,4,52.5,52.5,0,0.25
23-03-2025,Snacks & Ready-to-Eat,VD MINAPA VADIYAM,14,65,65,0,1
23-03-2025,"Grains, Flours & Dals",MELMEKER 250GMS,4,60,45,15,1
23-03-2025,"Grains, Flours & Dals",BAJRA 1 KG,4,15,12.5,2.5,0.25
23-03-2025,"Grains, Flours & Dals",Idly Rava L 1KG,4,60,50,10,1
23-03-2025,Milk & Dairy,HERITAGE TONED MILK 500ML,7,82,82,0,2
23-03-2025,"Grains, Flours & Dals",Urad dall 1 Kg,4,370,340,30,2
23-03-2025,"Dry Fruits, Nuts & Seeds",PLAIN PISTA 250GM,2,660,550,110,1
23-03-2025,"Grains, Flours & Dals",BOMBAY RAVA,4,140,110,30,2
23-03-2025,Oils & Ghee,cow ghee 500 ml,9,430,390,40,1
23-03-2025,Milk & Dairy,HERITAGE TOTAL CURD 500GM,7,100,100,0,2
23-03-2025,Snacks & Ready-to-Eat,MB FOXTAIL MILLET NOODLES 180GM,14,95,95,0,1
23-03-2025,"Grains, Flours & Dals",SA Multi Grain Mix 500GM,4,159,159,0,1
23-03-2025,Milk & Dairy,BROWN EGGS TRAY 30P,7,360,330,30,1
23-03-2025,Personal Care & Cosmetics,MYSORE SANDAL SOAP 75G,10,84,84,0,2
23-03-2025,Snacks & Ready-to-Eat,SD Bajra with palm Jaggery 250gm,14,135,135,0,1
23-03-2025,Oils & Ghee,Sesame oil 1 L,9,590,560,30,1
23-03-2025,"Grains, Flours & Dals",Multigrain 1 kg,4,200,170,30,2
23-03-2025,Oils & Ghee,Groundnut oil 1 L,9,360,330,30,1
23-03-2025,Snacks & Ready-to-Eat,VD Pappu Chekkalu 190gm,14,60,60,0,1
23-03-2025,Oils & Ghee,Groundnut oil 1 L,9,1080,990,90,3
23-03-2025,Oils & Ghee,Groundnut oil 1 L,9,720,660,60,2
23-03-2025,Snacks & Ready-to-Eat,NGT CHATPATTA CHANA 90GM,14,25,25,0,1
23-03-2025,Sweeteners,YB Brown Sugar 500GM,16,150,150,0,2
23-03-2025,Milk & Dairy,BROWN EGGS 1P,7,84,72,12,6
23-03-2025,Oils & Ghee,Groundnut oil 1 L,9,360,330,30,1
23-03-2025,Snacks & Ready-to-Eat,ANNAPURNA APPALAM,14,35,35,0,1
23-03-2025,"Grains, Flours & Dals",BASMATHI RICE 1KG,4,150,135,15,1
23-03-2025,Oils & Ghee,MUSTARD OIL 100ML,9,100,100,0,1
23-03-2025,Personal Care & Cosmetics,garnier black naturals,10,45,45,0,1
23-03-2025,Milk & Dairy,SANGAM CURD 450GM,7,76,76,0,2
23-03-2025,Spices & Seasonings,Jeera 100GM,15,50,45,5,1
23-03-2025,"Grains, Flours & Dals",RAGI FLOUR 500GRMS,4,40,35,5,1
23-03-2025,Milk & Dairy,BROWN EGGS 1P,7,140,120,20,10
23-03-2025,"Grains, Flours & Dals",AISHWARYA SP 1KG,4,320,280,40,4
23-03-2025,Oils & Ghee,Safflower oil 1 L,9,440,400,40,1
23-03-2025,Oils & Ghee,Sesame oil 1 L,9,590,560,30,1
23-03-2025,Oils & Ghee,Groundnut oil 1 L,9,360,330,30,1
23-03-2025,Oils & Ghee,Castor oil 200 ml,9,95,80,15,1
23-03-2025,Oils & Ghee,Groundnut oil 1 L,9,720,660,60,2
23-03-2025,Snacks & Ready-to-Eat,sf berry crunch,14,299,299,0,1
23-03-2025,Oils & Ghee,Coconut oil 1 L,9,440,400,40,1
23-03-2025,Oils & Ghee,Safflower oil 1 L,9,440,400,40,1
23-03-2025,Snacks & Ready-to-Eat,SATHVI PALLI CHIKKI 200GM,14,80,80,0,1
23-03-2025,"Dry Fruits, Nuts & Seeds",ROASTED FLAXSEED,2,75,75,0,1
23-03-2025,Snacks & Ready-to-Eat,SATHVI MIXED CHIKKI 200GM,14,110,110,0,1
23-03-2025,Snacks & Ready-to-Eat,SD Aswagandha with palm Jaggery250Gm,14,135,135,0,1
23-03-2025,Sweeteners,ACHU BELLAM 1KG,16,100,80,20,1
23-03-2025,Oils & Ghee,Groundnut oil 1 L,9,360,330,30,1
22-03-2025,Snacks & Ready-to-Eat,IDLI &amp; DOSA BATTER .T,14,84,84,0,1
22-03-2025,"Grains, Flours & Dals",SL Idly Rava 1KG,4,65,55,10,1
22-03-2025,Pooja & Spiritual Items,PACHAKARPURAM,12,60,50,10,1
22-03-2025,"Dry Fruits, Nuts & Seeds",YB GRANMA NUTS,2,90,90,0,1
22-03-2025,Snacks & Ready-to-Eat,VD MIXTURE 175 GM,14,60,60,0,1
22-03-2025,"Grains, Flours & Dals",idly/Dosa rice 1 kg,4,70,60,10,1
22-03-2025,Spices & Seasonings,SWEET SOUNF,15,20,20,0,1
22-03-2025,"Grains, Flours & Dals",POORI ATTA 1KG,4,70,60,10,1
22-03-2025,"Grains, Flours & Dals",maida 500grms,4,35,30,5,1
22-03-2025,General Household & Kitchenware,SIRIDHANYALU BOOK,3,200,180,20,1
22-03-2025,Pooja & Spiritual Items,BLACK DRAGON AGABATHI,12,100,100,0,5
22-03-2025,Spices & Seasonings,AVALU 100GM,15,50,40,10,2
22-03-2025,Snacks & Ready-to-Eat,MILLET PANCAKE CHOCOLATE,14,199,199,0,1
22-03-2025,"Grains, Flours & Dals",Green Batani 250GM,4,55,45,10,1
22-03-2025,"Grains, Flours & Dals",turdal 500 gms,4,110,85,25,1
22-03-2025,"Grains, Flours & Dals",Green gram 1 kg,4,150,130,20,1
22-03-2025,Snacks & Ready-to-Eat,SF CEREAL WHEAT APPLE &amp;,14,349,349,0,1
22-03-2025,Sweeteners,YB Brown Sugar 500GM,16,75,75,0,1
22-03-2025,"Grains, Flours & Dals",Urad dall 1 Kg,4,185,170,15,1
22-03-2025,"Dry Fruits, Nuts & Seeds",KAJU HALF 250GM,2,310,290,20,1
22-03-2025,Spices & Seasonings,Elaichi 25GM,15,145,120,25,1
22-03-2025,"Grains, Flours & Dals",turdal 1kg,4,440,340,100,2
22-03-2025,"Health, Wellness & Ayurvedic Products",RB Peanut butter Peanuts Dark 40g,5,180,180,0,4
22-03-2025,Spices & Seasonings,LG 50GM,15,92,92,0,1
22-03-2025,"Health, Wellness & Ayurvedic Products",RB Max Protein Choco chips 55gm,5,100,100,0,2
22-03-2025,"Health, Wellness & Ayurvedic Products",RB Max Protein Salt & Caramel Bar 50g,5,75,75,0,1
22-03-2025,Personal Care & Cosmetics,GOW DURBAR 75G,10,60,60,0,1
22-03-2025,Personal Care & Cosmetics,DWI ROSE WATER 120ML,10,90,90,0,1
22-03-2025,Snacks & Ready-to-Eat,BATANA NGT 70GMS,14,20,20,0,1
22-03-2025,Snacks & Ready-to-Eat,MB PEARL MILLET NOODLES 180GM,14,95,95,0,1
22-03-2025,"Health, Wellness & Ayurvedic Products",RB Max Protein Choco Berry bar 50g,5,80,80,0,1
22-03-2025,Snacks & Ready-to-Eat,PUMPKIN CHIKKI 200GM,14,140,130,10,1
22-03-2025,"Grains, Flours & Dals",chana dall,4,35,30,5,1
22-03-2025,"Grains, Flours & Dals",turdal 1kg,4,220,170,50,1
22-03-2025,"Grains, Flours & Dals",SL Idly Rava 1KG,4,65,55,10,1
22-03-2025,Household & Cleaning,VIM SOAP,6,20,20,0,4
22-03-2025,Snacks & Ready-to-Eat,BB VERMICELLY 500GM,14,53,53,0,1
22-03-2025,"Grains, Flours & Dals",Urad dall 1 Kg,4,185,170,15,1
22-03-2025,Pooja & Spiritual Items,GB Bharatha Woods 75GM,12,60,60,0,1
22-03-2025,Personal Care & Cosmetics,MADDI NEEM AND TULASI HAIR,10,300,300,0,1
22-03-2025,"Grains, Flours & Dals",SRILATHA RICE RAVVA 500GM,4,35,35,0,1
22-03-2025,Pooja & Spiritual Items,SHANKARS SWARNA YUG 60GM,12,60,60,0,1
22-03-2025,Pooja & Spiritual Items,GD Ramayana Sandal 75GM,12,60,60,0,1
22-03-2025,Oils & Ghee,Groundnut oil 1 L,9,1440,"1,320.00",120,4
22-03-2025,Personal Care & Cosmetics,COCONUT BATH SCRUBBER,10,40,40,0,1
22-03-2025,Personal Care & Cosmetics,NEEM SOAP 100GM,10,200,200,0,2
22-03-2025,Pooja & Spiritual Items,SWASTIK CAMPHORE,12,90,90,0,1
22-03-2025,"Grains, Flours & Dals",Chana Flour 500 gms,4,70,65,5,1
22-03-2025,Oils & Ghee,Freedom Rice Bran Oil 1L,9,194,180,14,1
22-03-2025,"Dry Fruits, Nuts & Seeds",PUMPKIN SEEDS 250GM,2,200,160,40,1
22-03-2025,Spices & Seasonings,NUVVULU 250GM,15,100,85,15,1
22-03-2025,"Grains, Flours & Dals",RICE FLOUR 1KG,4,70,55,15,1
22-03-2025,Pooja & Spiritual Items,GD Aiswarya Deepam 700ML,12,195,195,0,1
22-03-2025,"Dry Fruits, Nuts & Seeds",FLAX SEEDS 250GM,2,60,50,10,1
22-03-2025,"Dry Fruits, Nuts & Seeds",SUNFLOWER SEEDS 250GRM,2,150,130,20,1
22-03-2025,"Dry Fruits, Nuts & Seeds",SATHVI CHIA SEEDS 100GM,2,100,80,20,1
22-03-2025,"Grains, Flours & Dals",URAD DALL,4,95,85,10,1
22-03-2025,"Dry Fruits, Nuts & Seeds",Putnalu 250GM,2,45,38,7,1
22-03-2025,"Grains, Flours & Dals",WHITE BATANI,4,40,30,10,1
22-03-2025,Spices & Seasonings,AVALU 100GM,15,25,20,5,1
22-03-2025,"Grains, Flours & Dals",CHANA DAL 500GM,4,70,60,10,1
22-03-2025,Spices & Seasonings,ROYAL SAFFRON 400GRMS,15,65,65,0,1
22-03-2025,"Grains, Flours & Dals",Chana Flour 500 gms,4,70,65,5,1
22-03-2025,Pooja & Spiritual Items,GD Ramayana Sandal 75GM,12,60,60,0,1
22-03-2025,Oils & Ghee,Castor oil 200 ml,9,100,80,20,1
22-03-2025,"Grains, Flours & Dals",WHEAT 1 KG,4,300,250,50,5
22-03-2025,"Grains, Flours & Dals",KORRALU (FOXTAIL M) 1KG,4,150,110,40,1
22-03-2025,"Grains, Flours & Dals",SAMALU,4,170,130,40,1
22-03-2025,Snacks & Ready-to-Eat,BATANA NGT 70GMS,14,60,60,0,3
22-03-2025,Misc,VD0009,8,100,100,0,1
22-03-2025,"Grains, Flours & Dals",UDALU (Barnyard millet) 1 kg,4,140,115,25,1
22-03-2025,"Dry Fruits, Nuts & Seeds",PLAIN PISTA 250GM,2,660,550,110,1
22-03-2025,"Grains, Flours & Dals",Arikadu ( kodo),4,140,130,10,1
22-03-2025,Spices & Seasonings,Elaichi 25GM,15,145,120,25,1
22-03-2025,"Grains, Flours & Dals",turdal 1kg,4,440,340,100,2
22-03-2025,Spices & Seasonings,GREEN SOUNF,15,60,40,20,1
22-03-2025,"Dry Fruits, Nuts & Seeds",YELLOW KISHMISH 250GM,2,130,110,20,1
22-03-2025,"Grains, Flours & Dals",DESI CHANA,4,50,50,0,2
22-03-2025,Spices & Seasonings,DRY MIECHI 200GM,15,80,60,20,1
22-03-2025,Spices & Seasonings,SAJEERA,15,60,40,20,1
22-03-2025,Baking & Cooking Aids,MTR GULAB JAMUN MIX 190GM,0,80,80,0,1
22-03-2025,"Grains, Flours & Dals",Red Chana 250GM,4,35,30,5,1
22-03-2025,"Dry Fruits, Nuts & Seeds",Groundnuts 1 kg,2,190,165,25,1
22-03-2025,"Grains, Flours & Dals",ANDU KORRALU (Browntop.m) 1 kg,4,260,220,40,1
22-03-2025,"Grains, Flours & Dals",Green Batani 500GM,4,110,90,20,1
22-03-2025,Snacks & Ready-to-Eat,Popcorn Seeds 250GM,14,45,40,5,1
22-03-2025,"Grains, Flours & Dals",Red Chana 500 GM,4,75,60,15,1
22-03-2025,"Grains, Flours & Dals",SABDANA,4,40,35,5,1
22-03-2025,Spices & Seasonings,MM CHAT MASALA,15,44,44,0,1
22-03-2025,"Dry Fruits, Nuts & Seeds",YB GRANMA NUTS,2,90,90,0,1
22-03-2025,Snacks & Ready-to-Eat,BLACK SESAME CHIKKI,14,10,10,0,1
22-03-2025,Snacks & Ready-to-Eat,CHOCO BROWINE,14,40,40,0,2
22-03-2025,"Grains, Flours & Dals",MELMEKER 250GMS,4,60,45,15,1
22-03-2025,"Grains, Flours & Dals",idly/Dosa rice 1 kg,4,70,60,10,1
22-03-2025,"Grains, Flours & Dals",SABDANA,4,40,35,5,1
22-03-2025,Oils & Ghee,Sesame oil 500ml,9,295,280,15,1
22-03-2025,Sweeteners,MISHRI D,16,40,30,10,1
22-03-2025,Snacks & Ready-to-Eat,URBAN MARMURA 450GM,14,60,45,15,1
22-03-2025,Snacks & Ready-to-Eat,jeera papad,14,80,80,0,1
22-03-2025,"Health, Wellness & Ayurvedic Products",MD Orange Peel Choornam 50GM,5,80,80,0,1
22-03-2025,Spices & Seasonings,ER GARAM MASALA,15,52,52,0,1
22-03-2025,Spices & Seasonings,EV Chicken Masala 50GM,15,48,48,0,1
22-03-2025,"Grains, Flours & Dals",White jowar.F 1 kg,4,300,240,60,3
22-03-2025,"Dry Fruits, Nuts & Seeds",Groundnuts 1 kg,2,380,330,50,2
22-03-2025,"Grains, Flours & Dals",Bajra Flour 1 kg,4,70,60,10,1
22-03-2025,Spices & Seasonings,ROYAL SAFFRON,15,125,125,0,1
22-03-2025,"Grains, Flours & Dals",Wheat Flour 1 kg,4,140,120,20,2
22-03-2025,"Grains, Flours & Dals",turdal 1kg,4,220,170,50,1
22-03-2025,Spices & Seasonings,Menthulu 250 gms,15,50,45,5,1
22-03-2025,Personal Care & Cosmetics,KHADI ACTIVATED CHARCOAL SOAP,10,80,80,0,1
22-03-2025,"Grains, Flours & Dals",JOWAR YELLOW 1 K,4,200,180,20,2
22-03-2025,Spices & Seasonings,DRY MIECHI 200GM,15,80,60,20,1
22-03-2025,"Grains, Flours & Dals",Chittimuthaylu rice 1 kg,4,160,140,20,1
22-03-2025,Snacks & Ready-to-Eat,PN ORGANIC PUFFED RICE 200GM,14,55,55,0,1
22-03-2025,Spices & Seasonings,AVALU 100GM,15,25,20,5,1
22-03-2025,Oils & Ghee,Safflower oil 1 L,9,440,400,40,1
22-03-2025,"Grains, Flours & Dals",PESARA PAPPU 500GMS,4,85,75,10,1
22-03-2025,Snacks & Ready-to-Eat,BATANA NGT 70GMS,14,20,20,0,1
22-03-2025,Spices & Seasonings,white miryalu,15,60,50,10,1
22-03-2025,Snacks & Ready-to-Eat,RITEBITE BLUEBERRY BLAST,14,50,50,0,1
22-03-2025,"Health, Wellness & Ayurvedic Products",RB Max Protein Choco Berry bar 50g,5,75,75,0,1
22-03-2025,Sweeteners,GS A2 Buffalo Ghee 500ML,16,550,550,0,1
22-03-2025,General Household & Kitchenware,TEA CUP 1P,3,315,315,0,7
22-03-2025,Milk & Dairy,BROWN EGGS 1P,7,84,72,12,6
22-03-2025,Household & Cleaning,SRFR EXCEL,6,20,20,0,2
22-03-2025,Oils & Ghee,Coconut oil 500 ml,9,220,200,20,1
22-03-2025,"Grains, Flours & Dals",Em jowar idly R 500G,4,75,75,0,1
22-03-2025,Household & Cleaning,vim small,6,45,45,0,3
22-03-2025,Snacks & Ready-to-Eat,VD NUVULU CHEGODI 175GM,14,60,60,0,1
22-03-2025,Snacks & Ready-to-Eat,FOXTAIL NOODLES,14,75,75,0,1
22-03-2025,Household & Cleaning,VIM SOAP,6,20,20,0,4
22-03-2025,Beverages,BRU GREEN LABEL 1.2G,1,48,48,0,24
22-03-2025,"Grains, Flours & Dals",THIN POHA 500GM,4,40,35,5,1
22-03-2025,"Dry Fruits, Nuts & Seeds",PULMAKHANA 100 GM,2,360,340,20,2
22-03-2025,Oils & Ghee,Coconut oil 500 ml,9,440,400,40,2
22-03-2025,"Dry Fruits, Nuts & Seeds",Putnalu 250GM,2,45,38,7,1
22-03-2025,Spices & Seasonings,ROYAL SAFFRON,15,125,125,0,1
22-03-2025,Oils & Ghee,Groundnut oil 1 L,9,360,330,30,1
22-03-2025,Snacks & Ready-to-Eat,SF MILLET PANCAKE CLASSIC 150GM,14,149,149,0,1
22-03-2025,"Grains, Flours & Dals",RICE FLOUR 1KG,4,70,55,15,1
22-03-2025,Spices & Seasonings,AV Iodized Salt 1KG,15,28,25,3,1
22-03-2025,"Grains, Flours & Dals",Wheat Rava M 1KG,4,65,55,10,1
22-03-2025,Snacks & Ready-to-Eat,BATANA NGT 70GMS,14,20,20,0,1
22-03-2025,"Grains, Flours & Dals",CHANA DAL 500GM,4,70,60,10,1
22-03-2025,Spices & Seasonings,DURGA SALT CRYSTAL 1KG,15,25,25,0,1
22-03-2025,Spices & Seasonings,Japatri 25GM,15,100,80,20,1
22-03-2025,Snacks & Ready-to-Eat,DISANO VERMICELLI 425 GM,14,50,50,0,1
22-03-2025,Snacks & Ready-to-Eat,VD MANGO JELLY 250GRMS,14,80,80,0,1
22-03-2025,Snacks & Ready-to-Eat,CHOCO BROWINE,14,20,20,0,1
22-03-2025,"Grains, Flours & Dals",Wheat Flour 2 kgs,4,140,120,20,1
22-03-2025,"Grains, Flours & Dals",SABDANA 500GM,4,180,140,40,2
22-03-2025,"Grains, Flours & Dals",UNPOLISHED TURDALL 1KG,4,240,210,30,1
22-03-2025,"Grains, Flours & Dals",SRILATHA RICE RAVVA 500GM,4,70,70,0,2
22-03-2025,"Grains, Flours & Dals",PESARA PAPPU 500GMS,4,85,75,10,1
22-03-2025,Spices & Seasonings,Tamarind 250GMS,15,80,65,15,1
22-03-2025,"Grains, Flours & Dals",JOWAR UPMA RAVA,4,75,75,0,1
22-03-2025,"Grains, Flours & Dals",Em Multimillet upma 500g,4,129,129,0,1
22-03-2025,"Grains, Flours & Dals",Multigrain 1 kg,4,100,85,15,1
22-03-2025,Oils & Ghee,Mustard oil 1 L,9,440,400,40,1
22-03-2025,"Grains, Flours & Dals",RAGI FLOUR 1KG,4,80,70,10,1
22-03-2025,"Grains, Flours & Dals",Bajra Flour 1 kg,4,70,60,10,1
22-03-2025,Snacks & Ready-to-Eat,VD Pappu Chekkalu 190gm,14,120,120,0,2
22-03-2025,"Grains, Flours & Dals",EM Foxtail idli r 500 g,4,218,218,0,2
22-03-2025,"Health, Wellness & Ayurvedic Products",RB Max Protein Choco Berry bar 50g,5,160,160,0,2
22-03-2025,"Grains, Flours & Dals",White jowar.F 1 kg,4,100,80,20,1
22-03-2025,"Grains, Flours & Dals",SRILALITHA MAIDA FLOUR 500G,4,64,64,0,2
22-03-2025,Personal Care & Cosmetics,MD Henna Choornam 100GM,10,80,80,0,1
22-03-2025,"Dry Fruits, Nuts & Seeds",Groundnuts 1 kg,2,190,165,25,1
22-03-2025,"Grains, Flours & Dals",POORI ATTA 500GM,4,35,30,5,1
22-03-2025,"Grains, Flours & Dals",unpolished turdall500grms,4,120,110,10,1
22-03-2025,"Grains, Flours & Dals",Idly Rava L 1KG,4,60,50,10,1
22-03-2025,Snacks & Ready-to-Eat,PALLI LADDU 200GMS,14,90,80,10,1
22-03-2025,"Grains, Flours & Dals",THICK POHA 500GM,4,40,35,5,1
22-03-2025,Oils & Ghee,Safflower oil 1 L,9,440,400,40,1
22-03-2025,Sweeteners,YB JAGGERY POWDER 500GMS,16,75,75,0,1
22-03-2025,Oils & Ghee,Sesame oil 1 L,9,590,560,30,1
22-03-2025,Spices & Seasonings,Chilli powder 500 gms,15,290,210,80,1
22-03-2025,"Dry Fruits, Nuts & Seeds",Groundnuts 1 kg,2,190,165,25,1
22-03-2025,Snacks & Ready-to-Eat,RINGS 200GM,14,30,30,0,1
22-03-2025,Spices & Seasonings,Masala Karam 250 gms,15,130,120,10,1
22-03-2025,Oils & Ghee,Groundnut oil 1 L,9,360,330,30,1
22-03-2025,Pooja & Spiritual Items,SIVA JOOTHI 365 DEEPAPU,12,25,25,0,1
22-03-2025,"Dry Fruits, Nuts & Seeds",ALMONDS 250GM,2,280,260,20,1
22-03-2025,"Dry Fruits, Nuts & Seeds",PUMPKIN SEEDS 250GM,2,200,160,40,1
22-03-2025,Snacks & Ready-to-Eat,SD Ginger Candy 100g,14,60,60,0,1
22-03-2025,"Dry Fruits, Nuts & Seeds",SUNFLOWER SEEDS 250GRM,2,150,130,20,1
22-03-2025,"Dry Fruits, Nuts & Seeds",ANJEER 250GM,2,400,360,40,1
22-03-2025,"Dry Fruits, Nuts & Seeds",PLAIN PISTA 250GM,2,660,550,110,1
22-03-2025,"Dry Fruits, Nuts & Seeds",PULMAKHANA 100 GM,2,180,170,10,1
22-03-2025,"Dry Fruits, Nuts & Seeds",YELLOW KISHMISH 250GM,2,130,110,20,1
22-03-2025,"Grains, Flours & Dals",DESI CHANA,4,25,25,0,1
22-03-2025,"Dry Fruits, Nuts & Seeds",BLACK KISMIS 250GM,2,175,140,35,1
22-03-2025,"Dry Fruits, Nuts & Seeds",CASHEW,2,680,590,90,1
22-03-2025,Sweeteners,MISHRI 250 GM,16,35,30,5,1
22-03-2025,Pooja & Spiritual Items,SWASTIK CAMPHORE,12,90,90,0,1
22-03-2025,"Dry Fruits, Nuts & Seeds",Groundnuts 500 gms,2,95,85,10,1
22-03-2025,Snacks & Ready-to-Eat,VD SAGOPAPAD 150GM,14,55,55,0,1
22-03-2025,Personal Care & Cosmetics,YB Bath Powder 200GM,10,100,100,0,1
22-03-2025,"Dry Fruits, Nuts & Seeds",Putnalu 250GM,2,45,38,7,1
22-03-2025,Snacks & Ready-to-Eat,JUNNU POWDER 100GM,14,70,70,0,1
22-03-2025,Snacks & Ready-to-Eat,VD MANGO JELLY 250GRMS,14,80,80,0,1
22-03-2025,Spices & Seasonings,DRY MIECHI 200GM,15,80,60,20,1
22-03-2025,"Grains, Flours & Dals",MELMEKER 250GMS,4,60,45,15,1
22-03-2025,"Dry Fruits, Nuts & Seeds",KAJU HALF 250GM,2,310,290,20,1
22-03-2025,"Grains, Flours & Dals",Green gram 1 kg,4,150,130,20,1
22-03-2025,Household & Cleaning,PITAMBARI SHINING POWDER 200G,6,60,60,0,1
22-03-2025,Baking & Cooking Aids,MTR GULAB JAMUN MIX 190GM,0,80,80,0,1
22-03-2025,Snacks & Ready-to-Eat,VD DAHI MIRCHI(SALTED) 100GM,14,45,45,0,1
22-03-2025,Snacks & Ready-to-Eat,VD BOONDI 175GM,14,60,60,0,1
22-03-2025,"Dry Fruits, Nuts & Seeds",ALMONDS 250GM,2,280,260,20,1
22-03-2025,Sweeteners,ACHU BELLAM 1KG,16,100,80,20,1
22-03-2025,Spices & Seasonings,AV Iodized Salt 1KG,15,28,25,3,1
22-03-2025,Snacks & Ready-to-Eat,BATANA NGT 70GMS,14,20,20,0,1
22-03-2025,Baking & Cooking Aids,Baking Soda 50GM,0,20,15,5,1
22-03-2025,Spices & Seasonings,Chilli powder 500 gms,15,290,210,80,1
22-03-2025,"Grains, Flours & Dals",maida 500grms,4,35,30,5,1
22-03-2025,"Grains, Flours & Dals",Chana Flour 500 gms,4,140,130,10,2
22-03-2025,"Grains, Flours & Dals",DESI CHANA,4,25,25,0,1
22-03-2025,Snacks & Ready-to-Eat,VD MINAPA VADIYAM,14,65,65,0,1
22-03-2025,"Grains, Flours & Dals",MELMEKER 250GMS,4,60,45,15,1
22-03-2025,"Grains, Flours & Dals",BAJRA 1 KG,4,9,7.5,1.5,0.15
22-03-2025,"Grains, Flours & Dals",JOWAR YELLOW 1 K,4,25,22.5,2.5,0.25
22-03-2025,"Grains, Flours & Dals",Red Chana 250GM,4,35,30,5,1
22-03-2025,"Health, Wellness & Ayurvedic Products",RB Max Protein Choco Berry bar 50g,5,80,80,0,1
22-03-2025,"Grains, Flours & Dals",FLOUR CHARGE,4,24,24,0,2
22-03-2025,Oils & Ghee,Castor oil 200 ml,9,100,80,20,1
22-03-2025,"Grains, Flours & Dals",WHEAT 1 KG,4,75,62.5,12.5,1.25
22-03-2025,"Grains, Flours & Dals",RAGULU 1 KG,4,42,36,6,0.6
22-03-2025,Spices & Seasonings,GS Pink Rock Salt 1KG,15,120,120,0,1
22-03-2025,"Grains, Flours & Dals",PN ORGANIC KALA CHANA 500GM,4,119,119,0,1
22-03-2025,Spices & Seasonings,Jeera 100GM,15,50,45,5,1
22-03-2025,Beverages,BRU GREEN LABEL 1.2G,1,48,48,0,24
22-03-2025,"Grains, Flours & Dals",SABDANA,4,40,35,5,1
22-03-2025,"Grains, Flours & Dals",DESI CHANA,4,50,50,0,2
22-03-2025,"Grains, Flours & Dals",unpolished turdall500grms,4,120,110,10,1
22-03-2025,"Grains, Flours & Dals",split green gram 500 gms,4,75,70,5,1
22-03-2025,Oils & Ghee,Safflower oil 500 ml,9,220,200,20,1
22-03-2025,Oils & Ghee,Groundnut oil 500ml,9,180,165,15,1
22-03-2025,"Grains, Flours & Dals",Wheat Rava M 500GM,4,33,30,3,1
22-03-2025,Spices & Seasonings,dalchin chekka,15,50,40,10,1
22-03-2025,"Grains, Flours & Dals",Wheat Flour 2 kgs,4,140,120,20,1
22-03-2025,Oils & Ghee,Coconut oil 500 ml,9,440,400,40,2
22-03-2025,"Grains, Flours & Dals",DESI CHANA,4,25,25,0,1
22-03-2025,Spices & Seasonings,BLACK JEERA 50 GM,15,45,30,15,1
22-03-2025,Sweeteners,YB FOREST HONEY 250GM,16,180,180,0,1
22-03-2025,"Grains, Flours & Dals",turdal 500 gms,4,110,85,25,1
22-03-2025,"Dry Fruits, Nuts & Seeds",YELLOW KISHMISH 250GM,2,130,110,20,1
22-03-2025,"Grains, Flours & Dals",unpolished turdall500grms,4,120,110,10,1
22-03-2025,"Grains, Flours & Dals",Urad dall 1 Kg,4,370,340,30,2
22-03-2025,"Dry Fruits, Nuts & Seeds",FLAX SEEDS 250GM,2,60,50,10,1
22-03-2025,Spices & Seasonings,Masala Karam 250 gms,15,260,240,20,2
22-03-2025,"Grains, Flours & Dals",Bombay Rava 500GM,4,35,30,5,1
22-03-2025,Household & Cleaning,vim small,6,15,15,0,1
22-03-2025,"Grains, Flours & Dals",Wheat Rava M 500GM,4,33,30,3,1
22-03-2025,Baking & Cooking Aids,GONDH 50GRMS,0,50,40,10,1
22-03-2025,Spices & Seasonings,AVALU 100GM,15,25,20,5,1
22-03-2025,"Dry Fruits, Nuts & Seeds",sabja seeds,2,80,70,10,1
22-03-2025,Spices & Seasonings,Coriander seeds 200 gms,15,48,40,8,1
22-03-2025,"Grains, Flours & Dals",Idly Rava L 1KG,4,60,50,10,1
22-03-2025,Personal Care & Cosmetics,MD Henna Choornam 100GM,10,80,80,0,1
22-03-2025,"Grains, Flours & Dals",Urad dall 1 Kg,4,185,170,15,1
22-03-2025,Household & Cleaning,VIM SOAP,6,10,10,0,2
22-03-2025,Spices & Seasonings,DRY MIECHI 200GM,15,80,60,20,1
22-03-2025,Personal Care & Cosmetics,MESWAK 100GM,10,70,70,0,1
22-03-2025,"Grains, Flours & Dals",PESARA PAPPU 500GMS,4,85,75,10,1
22-03-2025,Spices & Seasonings,Chilli powder 500 gms,15,290,210,80,1
22-03-2025,"Grains, Flours & Dals",turdal 1kg,4,220,170,50,1
22-03-2025,Spices & Seasonings,Tamarind 250GMS,15,80,65,15,1
22-03-2025,"Grains, Flours & Dals",Wheat Flour 1 kg,4,70,60,10,1
22-03-2025,Snacks & Ready-to-Eat,VD MANGO JELLY 250GRMS,14,80,80,0,1
22-03-2025,"Grains, Flours & Dals",Multigrain 1 kg,4,100,85,15,1
22-03-2025,Spices & Seasonings,Jeera 100GM,15,50,45,5,1
22-03-2025,"Grains, Flours & Dals",Green gram 500 gms,4,75,70,5,1
22-03-2025,Oils & Ghee,Groundnut oil 1 L,9,360,320,40,1
22-03-2025,Snacks & Ready-to-Eat,SD Thati thandra 200gm,14,150,150,0,1
22-03-2025,"Grains, Flours & Dals",KORRALU (FOXTAIL M) 500GM,4,65,55,10,1
22-03-2025,"Grains, Flours & Dals",Chana Flour 500 gms,4,70,65,5,1
22-03-2025,Snacks & Ready-to-Eat,GB SALT COOKIES,14,120,110,10,2
22-03-2025,"Grains, Flours & Dals",Yellow jowar.F 2 kgs,4,220,200,20,1
22-03-2025,Oils & Ghee,Coconut oil 500 ml,9,220,200,20,1
22-03-2025,"Grains, Flours & Dals",Em Multimillet upma 500g,4,129,129,0,1
22-03-2025,"Grains, Flours & Dals",turdal 1kg,4,220,170,50,1
22-03-2025,"Grains, Flours & Dals",PESARA PAPPU 500GMS,4,85,75,10,1
22-03-2025,Spices & Seasonings,NUVVULU 500GM,15,160,130,30,1
22-03-2025,"Grains, Flours & Dals",DH URAD GOTA 1KG,4,215,190,25,1
22-03-2025,"Dry Fruits, Nuts & Seeds",Groundnuts 1 kg,2,190,165,25,1
22-03-2025,"Grains, Flours & Dals",Idly Rava L 1KG,4,60,50,10,1
22-03-2025,Snacks & Ready-to-Eat,BB VERMICELLI 1KG,14,95,90,5,1
22-03-2025,Snacks & Ready-to-Eat,ONION RINGS,14,50,50,0,1
22-03-2025,"Dry Fruits, Nuts & Seeds",ROASTED FLAXSEED,2,75,75,0,1
22-03-2025,"Grains, Flours & Dals",White jowar.F 1 kg,4,100,80,20,1
22-03-2025,Sweeteners,SD PALM JAGGERY 500GM,16,200,200,0,1
22-03-2025,Milk & Dairy,BROWN EGGS TRAY 30P,7,360,330,30,1
22-03-2025,Household & Cleaning,LIZOL 1L,6,246,246,0,1
22-03-2025,Spices & Seasonings,RED COPRA 500GM,15,170,148,22,1
22-03-2025,"Grains, Flours & Dals",DISANO OATS 1KG,4,285,142.5,142.5,1
22-03-2025,Oils & Ghee,cow ghee 500 ml,9,430,390,40,1
22-03-2025,"Grains, Flours & Dals",Bombay Rava 500GM,4,35,30,5,1
22-03-2025,"Grains, Flours & Dals",SL Idly Rava 1KG,4,65,55,10,1
22-03-2025,"Grains, Flours & Dals",Wheat Rava M 500GM,4,33,30,3,1
22-03-2025,"Grains, Flours & Dals",Green gram 1 kg,4,150,130,20,1
22-03-2025,"Dry Fruits, Nuts & Seeds",sabja seeds,2,80,70,10,1
22-03-2025,"Grains, Flours & Dals",Urad dall 1 Kg,4,185,170,15,1
22-03-2025,"Grains, Flours & Dals",split black gram 1 kg,4,360,340,20,2
22-03-2025,Snacks & Ready-to-Eat,ONION RINGS,14,50,50,0,1
22-03-2025,"Dry Fruits, Nuts & Seeds",Groundnuts 1 kg,2,190,165,25,1
22-03-2025,Snacks & Ready-to-Eat,DINNER PAPAD,14,80,80,0,1
22-03-2025,Household & Cleaning,PITAMBARI SHINING POWDER 200G,6,60,60,0,1
22-03-2025,Spices & Seasonings,DRY MIECHI 200GM,15,80,60,20,1
22-03-2025,Pooja & Spiritual Items,SWASTIK CAMPHORE,12,90,90,0,1
22-03-2025,Snacks & Ready-to-Eat,RINGS 200GM,14,60,60,0,2
22-03-2025,Pooja & Spiritual Items,javadhu,12,60,60,0,1
22-03-2025,"Grains, Flours & Dals",Idly Rava L 1KG,4,120,100,20,2
22-03-2025,Snacks & Ready-to-Eat,Corn Chips 250GM,14,40,35,5,1
22-03-2025,Snacks & Ready-to-Eat,VD MANGO JELLY 250GRMS,14,80,80,0,1
22-03-2025,Spices & Seasonings,Elaichi 25GM,15,145,120,25,1
22-03-2025,Spices & Seasonings,KALONJI SEEDS,15,90,80,10,1
22-03-2025,"Grains, Flours & Dals",SRILATHA RICE RAVVA 500GM,4,70,70,0,2
22-03-2025,"Grains, Flours & Dals",RAGI FLOUR 500GRMS,4,40,35,5,1
22-03-2025,"Grains, Flours & Dals",Wheat Flour 2 kgs,4,140,120,20,1
22-03-2025,Pooja & Spiritual Items,Banda Puvvu 25GM,12,80,80,0,1
22-03-2025,"Grains, Flours & Dals",split green gram 1 kg,4,150,140,10,1
22-03-2025,Oils & Ghee,Castor oil 200 ml,9,100,80,20,1
22-03-2025,"Dry Fruits, Nuts & Seeds",SD Mango cubes 200gm,2,90,90,0,1
22-03-2025,Oils & Ghee,Safflower oil 5 L,9,2200,"1,950.00",250,1
22-03-2025,Milk & Dairy,BROWN EGGS TRAY 30P,7,360,330,30,1
22-03-2025,Snacks & Ready-to-Eat,KURNOOL MARMURA,14,70,55,15,1
22-03-2025,"Grains, Flours & Dals",Red Wheat Flour 1 kg,4,280,260,20,2
22-03-2025,Snacks & Ready-to-Eat,PEANUT CHILLI,14,20,20,0,4
22-03-2025,Pooja & Spiritual Items,GOMATHA AGARBATHI,12,75,75,0,1
22-03-2025,"Grains, Flours & Dals",RAGI FLOUR 500GRMS,4,40,35,5,1
22-03-2025,"Grains, Flours & Dals",Wheat Flour 1 kg,4,140,120,20,2
22-03-2025,Spices & Seasonings,Black Till 250GM,15,90,75,15,1
22-03-2025,"Grains, Flours & Dals",Chana Flour 500 gms,4,70,65,5,1
22-03-2025,"Grains, Flours & Dals",White jowar.F 1 kg,4,100,80,20,1
22-03-2025,Snacks & Ready-to-Eat,PEANUT CHILLI,14,10,10,0,2
22-03-2025,"Grains, Flours & Dals",Bajra Flour 1 kg,4,70,60,10,1
22-03-2025,Snacks & Ready-to-Eat,SALTED PHALLI,14,25,25,0,1
22-03-2025,Snacks & Ready-to-Eat,BATANA NGT 70GMS,14,20,20,0,1
22-03-2025,Snacks & Ready-to-Eat,RAJGIRA PEANUT CHIKKI,14,10,10,0,2
22-03-2025,"Grains, Flours & Dals",RED WHEAT 1 KG,4,650,600,50,5
22-03-2025,"Health, Wellness & Ayurvedic Products",MH Baby Food 400GM,5,200,200,0,1
22-03-2025,"Health, Wellness & Ayurvedic Products",VEMANA PULIPIRI 10GM,5,120,120,0,1
22-03-2025,Snacks & Ready-to-Eat,BATANA NGT 70GMS,14,20,20,0,1
22-03-2025,"Dry Fruits, Nuts & Seeds",ALMONDS 250GM,2,280,260,20,1
22-03-2025,Pooja & Spiritual Items,MS RANGOLI 100G,12,80,80,0,8
22-03-2025,"Grains, Flours & Dals",CHANA DAL 500GM,4,70,60,10,1
22-03-2025,Snacks & Ready-to-Eat,GB SALT COOKIES,14,60,55,5,1
22-03-2025,"Dry Fruits, Nuts & Seeds",Groundnuts 1 kg,2,190,165,25,1
22-03-2025,Snacks & Ready-to-Eat,PEANUT CHIKKI 450GM,14,125,125,0,1
22-03-2025,"Grains, Flours & Dals",Urad dall 1 Kg,4,185,170,15,1
22-03-2025,Snacks & Ready-to-Eat,PALLI LADDU 200GMS,14,90,70,20,1
22-03-2025,"Grains, Flours & Dals",RAGI FLOUR 500GRMS,4,40,35,5,1
22-03-2025,Spices & Seasonings,Jeera 100GM,15,50,45,5,1
22-03-2025,Beverages,BISLERI WATER 1L,1,20,20,0,1
22-03-2025,Snacks & Ready-to-Eat,GB SALT COOKIES,14,60,55,5,1
22-03-2025,Milk & Dairy,HERITAGE TONED MILK 500ML,7,31,31,0,1
22-03-2025,"Grains, Flours & Dals",turdal 500 gms,4,110,85,25,1
22-03-2025,Pooja & Spiritual Items,GD KUMKUM 50GM,12,30,30,0,1
22-03-2025,"Health, Wellness & Ayurvedic Products",MD Manjistha Choornam 50GM,5,150,150,0,1
22-03-2025,"Grains, Flours & Dals",Arikalu (kodo),4,70,65,5,1
22-03-2025,"Grains, Flours & Dals",KORRALU (FOXTAIL M) 500GM,4,65,55,10,1
22-03-2025,"Grains, Flours & Dals",sprouts 10 rps p,4,12,10,2,1
22-03-2025,Snacks & Ready-to-Eat,VD DRY FRUIT PUTHAREKULU,14,120,120,0,1
22-03-2025,"Grains, Flours & Dals",SAMALU (Little millet) 500 gms,4,85,65,20,1
22-03-2025,Household & Cleaning,comfort lily fresh,6,58,58,0,1
22-03-2025,"Health, Wellness & Ayurvedic Products",MXP CHOCO CLASSIC BAR,5,70,70,0,1
22-03-2025,Oils & Ghee,BUFFALLO GHEE 500ML,9,410,370,40,1
22-03-2025,Milk & Dairy,HERITAGE TONED MILK 500ML,7,62,62,0,2
22-03-2025,"Health, Wellness & Ayurvedic Products",RB Max Protein Choco chips 55gm,5,50,50,0,1
22-03-2025,"Grains, Flours & Dals",Multigrain 1 kg,4,200,170,30,2
22-03-2025,Pooja & Spiritual Items,GD Dhoop Cones 40GM,12,60,60,0,2
22-03-2025,"Dry Fruits, Nuts & Seeds",PULMAKHANA 100 GM,2,180,170,10,1
22-03-2025,Pooja & Spiritual Items,BALAJI SANDAL DHOOP STICKS 10STK,12,125,125,0,1
22-03-2025,"Grains, Flours & Dals",Yellow jowar .F1 kg,4,220,200,20,2
22-03-2025,"Grains, Flours & Dals",RAGI FLOUR 500GRMS,4,40,35,5,1
22-03-2025,Oils & Ghee,Groundnut oil 1 L,9,360,330,30,1
22-03-2025,Pooja & Spiritual Items,SIVA SHAKTHI PUJA PURPOSE 10G,12,20,20,0,1
22-03-2025,Spices & Seasonings,Masala Karam 250 gms,15,130,120,10,1
22-03-2025,Pooja & Spiritual Items,GD Ramayana Sandal 75GM,12,60,60,0,1
22-03-2025,Pooja & Spiritual Items,SWASTIK CAMPHORE,12,90,90,0,1
22-03-2025,Milk & Dairy,SANGAM TONED MILK 500ML,7,30,30,0,1
22-03-2025,Milk & Dairy,HERITAGE TONED MILK 500ML,7,31,31,0,1
22-03-2025,Beverages,BRU GREEN LABEL 1.2G,1,24,24,0,12
22-03-2025,"Dry Fruits, Nuts & Seeds",Groundnuts 1 kg,2,380,330,50,2
22-03-2025,Oils & Ghee,Coconut oil 500 ml,9,440,400,40,2
22-03-2025,Snacks & Ready-to-Eat,SD FINGER Millet with palm Jaggery 250gm,14,135,135,0,1
22-03-2025,"Grains, Flours & Dals",RICE FLOUR 500 GM,4,35,28,7,1
22-03-2025,Household & Cleaning,HERBAL LIQ DISH WASH 500ML,6,170,170,0,1
22-03-2025,"Grains, Flours & Dals",SPLIT BLACK GRAM 500 GM,4,90,85,5,1
22-03-2025,"Health, Wellness & Ayurvedic Products",MORINGA LEAF POWDER M,5,80,75,5,1
22-03-2025,Spices & Seasonings,DRY MIECHI 200GM,15,80,60,20,1
22-03-2025,Snacks & Ready-to-Eat,VD PALLI LADDU,14,80,80,0,1
22-03-2025,Spices & Seasonings,Turmeric powder 250 gms,15,100,75,25,1
22-03-2025,Snacks & Ready-to-Eat,SD Atreyapuram DRY Fruit ghee,14,150,150,0,1
22-03-2025,Spices & Seasonings,AV Iodized Salt 1KG,15,28,25,3,1
22-03-2025,"Grains, Flours & Dals",Multigrain 1 kg,4,200,170,30,2
22-03-2025,Misc,VD00014,8,100,90,10,1
22-03-2025,Spices & Seasonings,SD Coriander Seeds Karam Powder 100GM,15,65,65,0,1
22-03-2025,Snacks & Ready-to-Eat,JUNNU POWDER 100GM,14,70,70,0,1
22-03-2025,"Grains, Flours & Dals",SRILATHA RICE RAVVA 500GM,4,35,35,0,1
22-03-2025,Snacks & Ready-to-Eat,NGT CHATPATTA CHANA 90GM,14,25,25,0,1
22-03-2025,Snacks & Ready-to-Eat,VD CORNFLAKES MIXTURE 175GM,14,60,60,0,1
22-03-2025,Snacks & Ready-to-Eat,VD BOONDI 175GM,14,60,60,0,1
22-03-2025,"Grains, Flours & Dals",SRILALITHA MAIDA FLOUR 500G,4,32,32,0,1
22-03-2025,"Grains, Flours & Dals",Wheat Rava M 500GM,4,33,30,3,1
22-03-2025,Oils & Ghee,Groundnut oil 1 L,9,360,330,30,1
22-03-2025,"Grains, Flours & Dals",Multigrain 1 kg,4,100,85,15,1
22-03-2025,Milk & Dairy,BROWN EGGS TRAY 30P,7,360,330,30,1
21-03-2025,"Grains, Flours & Dals",SAMALU (Little millet) 500 gms,4,85,65,20,1
21-03-2025,"Grains, Flours & Dals",UDALU (Barnyard millet) 500 gms,4,70,60,10,1
21-03-2025,Snacks & Ready-to-Eat,Corn Chips 250GM,14,80,70,10,2
21-03-2025,"Grains, Flours & Dals",ANDU KORRALU (Brown top .mlt) 500,4,130,110,20,1
21-03-2025,"Grains, Flours & Dals",VGR rice 1 kg,4,350,325,25,5
21-03-2025,"Grains, Flours & Dals",Arikalu (kodo),4,70,65,5,1
21-03-2025,"Grains, Flours & Dals",KORRALU (FOXTAIL M) 500GM,4,65,55,10,1
21-03-2025,"Grains, Flours & Dals",SA WHITE JOWAR RAVA 500GM,4,69,69,0,1
21-03-2025,General Household & Kitchenware,clay water bottle 1,3,265,251.75,13.25,1
21-03-2025,"Grains, Flours & Dals",Black RICE 1 KG,4,340,310,30,1
21-03-2025,"Grains, Flours & Dals",Em kodo idli R 500G,4,129,129,0,1
21-03-2025,"Grains, Flours & Dals",Arikadu ( kodo),4,140,130,10,1
21-03-2025,"Grains, Flours & Dals",JOWAR WHITE 1 KG,4,80,70,10,1
21-03-2025,"Grains, Flours & Dals",WHEAT 1 KG,4,120,100,20,2
21-03-2025,General Household & Kitchenware,MATCH BOX,3,10,10,0,1
21-03-2025,Pooja & Spiritual Items,SHANKARS KUMBHA MARK 3 100GM,12,130,130,0,1
21-03-2025,Sweeteners,GS JAGGERY NUGGETS 500GM,16,120,120,0,1
21-03-2025,Oils & Ghee,Black Sesame oil 1 L,9,440,380,60,1
21-03-2025,"Grains, Flours & Dals",Wheat Flour 1 kg,4,70,60,10,1
21-03-2025,Spices & Seasonings,Elaichi 25GM,15,145,120,25,1
21-03-2025,Spices & Seasonings,DURGA SALT CRYSTAL 1KG,15,25,25,0,1
21-03-2025,Personal Care & Cosmetics,swastik gulab,10,145,145,0,1
21-03-2025,Sweeteners,SUGAR 500 GM,16,30,25,5,1
21-03-2025,Snacks & Ready-to-Eat,GB SALT COOKIES,14,60,55,5,1
21-03-2025,"Grains, Flours & Dals",Urad dall 1 Kg,4,185,170,15,1
21-03-2025,"Dry Fruits, Nuts & Seeds",sabja seeds,2,80,70,10,1
21-03-2025,Sweeteners,SUGAR 1KG,16,60,50,10,1
21-03-2025,Spices & Seasonings,ROYAL SAFFRON 400GRMS,15,65,65,0,1
21-03-2025,"Grains, Flours & Dals",Chana Flour 500 gms,4,70,65,5,1
21-03-2025,Spices & Seasonings,SWEET SOUNF,15,20,20,0,1
21-03-2025,"Grains, Flours & Dals",Idly Rava L 1KG,4,120,100,20,2
21-03-2025,Beverages,BRU GREEN LABEL 1.2G,1,48,48,0,24
21-03-2025,Snacks & Ready-to-Eat,GB SALT COOKIES,14,60,55,5,1
21-03-2025,"Grains, Flours & Dals",Bombay Rava 500GM,4,35,30,5,1
21-03-2025,Personal Care & Cosmetics,stay free 1,10,390,390,0,2
21-03-2025,"Grains, Flours & Dals",turdal 1kg,4,220,170,50,1
21-03-2025,"Grains, Flours & Dals",DH URAD GOTA 1KG,4,215,190,25,1
21-03-2025,"Grains, Flours & Dals",Wheat Flour 1 kg,4,70,60,10,1
21-03-2025,Snacks & Ready-to-Eat,SD VAMU APPADALU 200GM,14,80,80,0,1
21-03-2025,"Grains, Flours & Dals",AISHWARYA SP 1KG,4,400,350,50,5
21-03-2025,Snacks & Ready-to-Eat,GB SALT COOKIES,14,60,55,5,1
21-03-2025,"Grains, Flours & Dals",Urad dall 1 Kg,4,185,170,15,1
21-03-2025,"Health, Wellness & Ayurvedic Products",MXP CREAM ONION,5,45,45,0,1
21-03-2025,"Health, Wellness & Ayurvedic Products",RB Max Protein Choco Berry bar 50g,5,80,80,0,1
21-03-2025,Spices & Seasonings,GREEN SOUNF,15,60,40,20,1
21-03-2025,"Grains, Flours & Dals",AISHWARYA LOW GI RICE 5KG,4,700,525,175,1
21-03-2025,Snacks & Ready-to-Eat,PALLI LADDU 200GMS,14,180,160,20,2
21-03-2025,Snacks & Ready-to-Eat,PUMPKIN CHIKKI 200GM,14,140,130,10,1
21-03-2025,"Grains, Flours & Dals",DOCTOR RICE DIABETIC SFR 1KG,4,600,600,0,5
21-03-2025,"Health, Wellness & Ayurvedic Products",RB Max Protein Salt & Caramel Bar 50g,5,45,45,0,1
21-03-2025,Snacks & Ready-to-Eat,GREEN FRIED batana,14,20,20,0,1
21-03-2025,Snacks & Ready-to-Eat,VD Pappu Chekkalu 190gm,14,60,60,0,1
21-03-2025,"Grains, Flours & Dals",BOBBARA PAPPU 500GM,4,85,80,5,1
21-03-2025,Oils & Ghee,cow ghee 500 ml,9,430,390,40,1
21-03-2025,Oils & Ghee,cow ghee 500 ml,9,430,390,40,1
21-03-2025,Snacks & Ready-to-Eat,VD RICE SAGO PAPAD 150GM,14,55,55,0,1
21-03-2025,Snacks & Ready-to-Eat,VD RED CHILLI RICEPAPAD 150GM,14,50,50,0,1
21-03-2025,"Grains, Flours & Dals",BOBBARA PAPPU 500GM,4,85,80,5,1
21-03-2025,"Grains, Flours & Dals",KORRALU (FOXTAIL M) 1KG,4,150,110,40,1
21-03-2025,"Grains, Flours & Dals",SAMALU,4,170,130,40,1
21-03-2025,Milk & Dairy,ID PANEER,7,135,135,0,1
21-03-2025,Oils & Ghee,Groundnut oil 5 L,9,3600,"3,200.00",400,2
21-03-2025,"Grains, Flours & Dals",unpolished turdall500grms,4,120,110,10,1
21-03-2025,"Grains, Flours & Dals",Green gram 1 kg,4,150,130,20,1
21-03-2025,"Grains, Flours & Dals",SPLIT BLACK GRAM 500 GM,4,180,170,10,2
21-03-2025,"Grains, Flours & Dals",Urad dall 1 Kg,4,185,170,15,1
21-03-2025,"Grains, Flours & Dals",PESARA PAPPU 1 KG,4,170,145,25,1
21-03-2025,Spices & Seasonings,Coriander seeds 200 gms,15,48,40,8,1
21-03-2025,"Grains, Flours & Dals",RED TURDAL 500GM,4,75,70,5,1
21-03-2025,Spices & Seasonings,DURGA SALT CRYSTAL 1KG,15,25,25,0,1
21-03-2025,"Grains, Flours & Dals",JOWAR YELLOW 1 K,4,100,90,10,1
21-03-2025,"Grains, Flours & Dals",UDALU (Barnyard millet) 500 gms,4,70,60,10,1
21-03-2025,Oils & Ghee,cow ghee 500 ml,9,430,390,40,1
21-03-2025,"Grains, Flours & Dals",Arikadu ( kodo),4,140,130,10,1
21-03-2025,"Health, Wellness & Ayurvedic Products",SAI DURGA MORINGA LEAVES 100GM,5,75,75,0,1
21-03-2025,"Grains, Flours & Dals",THICK POHA 500GM,4,40,35,5,1
21-03-2025,Snacks & Ready-to-Eat,PALLI LADDU 200GMS,14,90,80,10,1
21-03-2025,"Grains, Flours & Dals",SF OATS JUMBO ROLLED 500GM,4,249,249,0,1
21-03-2025,"Dry Fruits, Nuts & Seeds",ANJEER 250GM,2,400,360,40,1
21-03-2025,"Grains, Flours & Dals",UNPOLISHED TURDALL 1KG,4,240,210,30,1
21-03-2025,"Grains, Flours & Dals",RAGI FLOUR 1KG,4,80,70,10,1
21-03-2025,Snacks & Ready-to-Eat,BATANA NGT 70GMS,14,20,20,0,1
21-03-2025,Snacks & Ready-to-Eat,VD NUVVULU LADDU,14,100,100,0,1
21-03-2025,"Grains, Flours & Dals",Yellow jowar .F1 kg,4,110,100,10,1
21-03-2025,"Dry Fruits, Nuts & Seeds",PULMAKHANA 100 GM,2,180,170,10,1
21-03-2025,"Dry Fruits, Nuts & Seeds",Groundnuts 1 kg,2,190,165,25,1
21-03-2025,"Grains, Flours & Dals",DESI CHANA,4,50,50,0,2
21-03-2025,"Grains, Flours & Dals",SABDANA,4,80,70,10,2
21-03-2025,"Dry Fruits, Nuts & Seeds",YELLOW KISHMISH 250GM,2,130,110,20,1
21-03-2025,"Grains, Flours & Dals",Green gram 1 kg,4,150,130,20,1
21-03-2025,"Grains, Flours & Dals",Brown RICE 1KG,4,210,195,15,3
21-03-2025,General Household & Kitchenware,TEA CUP 1P,3,45,45,0,1
21-03-2025,"Grains, Flours & Dals",VYS.SP RICE 1 KG,4,280,260,20,4
21-03-2025,Snacks & Ready-to-Eat,SF NOODLES CLKASSIC MASALA,14,129,129,0,1
21-03-2025,Spices & Seasonings,Coriander seeds 200 gms,15,48,40,8,1
21-03-2025,Snacks & Ready-to-Eat,VD SAGOPAPAD 150GM,14,55,55,0,1
21-03-2025,"Dry Fruits, Nuts & Seeds",sabja seeds,2,80,70,10,1
21-03-2025,Sweeteners,NATURAL HONEY 1KG,16,560,480,80,1
21-03-2025,Sweeteners,YB Brown Sugar 1KG,16,140,140,0,1
21-03-2025,Misc,VD0009,8,200,200,0,2
21-03-2025,Snacks & Ready-to-Eat,SF COOKIES BANANA OATS,14,99,99,0,1
21-03-2025,Snacks & Ready-to-Eat,SD FINGER Millet with palm Jaggery 250gm,14,135,135,0,1
21-03-2025,"Grains, Flours & Dals",SL Idly Rava 1KG,4,65,55,10,1
21-03-2025,Spices & Seasonings,MIRYALU 50 GRMS,15,100,80,20,1
21-03-2025,Spices & Seasonings,SD Coriander Seeds Karam Powder 100GM,15,65,65,0,1
21-03-2025,Snacks & Ready-to-Eat,CHOCO BROWINE,14,40,40,0,2
21-03-2025,"Grains, Flours & Dals",SH TUR DAL 500GM,4,165,165,0,1
21-03-2025,Snacks & Ready-to-Eat,SD RAGI GAVVALU,14,95,95,0,1
21-03-2025,Spices & Seasonings,JEERA 250 gms,15,125,105,20,1
21-03-2025,"Grains, Flours & Dals",AISHWARYA SP 5KG,4,400,375,25,1
21-03-2025,Spices & Seasonings,EV Cumin Powder 50GM,15,61,61,0,1
21-03-2025,Snacks & Ready-to-Eat,VD GUMMADI VADIYAM,14,75,75,0,1
21-03-2025,Spices & Seasonings,AVALU 100GM,15,25,20,5,1
21-03-2025,Snacks & Ready-to-Eat,RSC ORANGE 100GMS,14,20,20,0,1
21-03-2025,"Dry Fruits, Nuts & Seeds",SD Mango cubes 100gm,2,45,45,0,1
21-03-2025,Beverages,REFRESH SHARBATH NORMAL,1,199,190,9,1
21-03-2025,Oils & Ghee,Groundnut oil 1 L,9,360,330,30,1
21-03-2025,Snacks & Ready-to-Eat,SD Thati thandra 200gm,14,150,150,0,1
21-03-2025,Spices & Seasonings,Chilli powder 500 gms,15,290,210,80,1
21-03-2025,Oils & Ghee,Sesame oil 1 L,9,590,560,30,1
21-03-2025,"Health, Wellness & Ayurvedic Products",RB Max Protein Choco Almond bar 50g,5,75,75,0,1
21-03-2025,"Grains, Flours & Dals",SRILATHA RICE RAVVA 500GM,4,35,35,0,1
21-03-2025,Pooja & Spiritual Items,GOPURAM KUKUMA 500GM,12,25,25,0,1
21-03-2025,"Grains, Flours & Dals",Multigrain 1 kg,4,100,85,15,1
21-03-2025,"Dry Fruits, Nuts & Seeds",PULMAKHANA 100 GM,2,180,170,10,1
21-03-2025,Snacks & Ready-to-Eat,Pani Poori Chips 250GM,14,50,40,10,1
21-03-2025,"Grains, Flours & Dals",BARLEY SEEDS 250GMS,4,40,35,5,1
21-03-2025,Baking & Cooking Aids,GONDH 50GRMS,0,50,40,10,1
21-03-2025,"Grains, Flours & Dals",RAGI FLOUR 1KG,4,80,70,10,1
21-03-2025,Snacks & Ready-to-Eat,SD Moringa with plam jaggery 250gm,14,135,135,0,1
21-03-2025,Snacks & Ready-to-Eat,SATHVI MIXED CHIKKI 200GM,14,120,100,20,1
21-03-2025,Snacks & Ready-to-Eat,VD DAHI MIRCHI(SALTED) 100GM,14,45,45,0,1
21-03-2025,Oils & Ghee,Sesame oil 500ml,9,295,280,15,1
21-03-2025,"Dry Fruits, Nuts & Seeds",FLAX SEEDS 250GM,2,60,50,10,1
21-03-2025,Oils & Ghee,Coconut oil 500 ml,9,440,400,40,2
21-03-2025,"Grains, Flours & Dals",URAD DALL,4,95,85,10,1
21-03-2025,"Grains, Flours & Dals",Wheat Flour 1 kg,4,70,60,10,1
21-03-2025,"Grains, Flours & Dals",Brown RICE 1KG,4,210,195,15,3
21-03-2025,"Grains, Flours & Dals",VGR RICE bag 1,4,1899,"1,650.00",249,1
21-03-2025,"Grains, Flours & Dals",SAMALU,4,170,130,40,1
21-03-2025,Snacks & Ready-to-Eat,SD Moringa with plam jaggery 250gm,14,135,135,0,1
21-03-2025,Snacks & Ready-to-Eat,SATHVI REGIVADA 200GM,14,80,60,20,1
21-03-2025,Snacks & Ready-to-Eat,SESAME CHIKKI,14,120,100,20,1
21-03-2025,"Health, Wellness & Ayurvedic Products",VAMU WATER,5,99,99,0,1
21-03-2025,Snacks & Ready-to-Eat,VD ARISELU 5 PIC,14,100,100,0,1
21-03-2025,Sweeteners,YB Brown Sugar 500GM,16,150,150,0,2
21-03-2025,"Grains, Flours & Dals",AISHWARYA SP 25KG,4,1999,"1,690.00",309,1
21-03-2025,Spices & Seasonings,YB Rock Salt 1KG,15,120,120,0,1
21-03-2025,"Grains, Flours & Dals",Sathya Javva Wheat Rava 500GM,4,95,95,0,1
21-03-2025,"Grains, Flours & Dals",Multigrain 1 kg,4,200,170,30,2
21-03-2025,Spices & Seasonings,Turmeric powder 250 gms,15,100,75,25,1
21-03-2025,Pooja & Spiritual Items,DASANGAM DHOOP POWDER 50GM,12,43,43,0,1
21-03-2025,"Grains, Flours & Dals",FLOUR CHARGE,4,84,84,0,7
21-03-2025,Snacks & Ready-to-Eat,DINNER PAPAD,14,80,80,0,1
21-03-2025,"Grains, Flours & Dals",BAJRA 1 KG,4,240,200,40,4
21-03-2025,Pooja & Spiritual Items,SWASTIK CAMPHORE,12,90,90,0,1
21-03-2025,"Health, Wellness & Ayurvedic Products",DWI EUCALYPTUS 8ML,5,80,80,0,1
21-03-2025,Misc,386627138,8,0,0,0,1
21-03-2025,Snacks & Ready-to-Eat,CHOCO BROWINE,14,20,20,0,1
21-03-2025,"Grains, Flours & Dals",Multigrain 1 kg,4,100,85,15,1
21-03-2025,Pooja & Spiritual Items,BALAJI BEL PHOOL STICKS 90GM,12,60,60,0,1
21-03-2025,Pooja & Spiritual Items,999 SINGAPORE DHOOP POW 50GM,12,35,35,0,1
21-03-2025,Pooja & Spiritual Items,V GUGGILAM 50GM,12,45,45,0,1
21-03-2025,"Grains, Flours & Dals",RAGI FLOUR 1KG,4,80,70,10,1
21-03-2025,Snacks & Ready-to-Eat,jeera papad,14,80,80,0,1
21-03-2025,"Dry Fruits, Nuts & Seeds",FLAX SEEDS 250GM,2,60,50,10,1
21-03-2025,"Grains, Flours & Dals",BAJRA 1 KG,4,60,50,10,1
21-03-2025,"Grains, Flours & Dals",JOWAR YELLOW 1 K,4,200,180,20,2
21-03-2025,"Grains, Flours & Dals",Black uluvalu 500 gms,4,90,70,20,1
21-03-2025,"Grains, Flours & Dals",ANDU KORRALU (Brown top .mlt) 500,4,130,110,20,1
21-03-2025,"Grains, Flours & Dals",RAGULU 1 KG,4,140,120,20,2
21-03-2025,"Grains, Flours & Dals",SAMALU (Little millet) 500 gms,4,85,65,20,1
21-03-2025,Pooja & Spiritual Items,GD Kumkum 50GM,12,30,30,0,1
21-03-2025,"Grains, Flours & Dals",RAGI FLOUR 500GRMS,4,80,70,10,2
21-03-2025,Snacks & Ready-to-Eat,Sprouted Ragi Biscuits 450GM,14,150,150,0,1
21-03-2025,"Grains, Flours & Dals",HS JOWAR IDLY RAWA,4,65,65,0,1
21-03-2025,"Grains, Flours & Dals",FLOUR CHARGE,4,70.8,70.8,0,5.9
21-03-2025,"Grains, Flours & Dals",SA WHITE JOWAR RAVA 500GM,4,69,69,0,1
21-03-2025,"Dry Fruits, Nuts & Seeds",SD Mango cubes 100gm,2,45,45,0,1
21-03-2025,"Grains, Flours & Dals",SL Idly Rava 1KG,4,65,55,10,1
21-03-2025,"Dry Fruits, Nuts & Seeds",nut powder,2,499,499,0,1
21-03-2025,Pooja & Spiritual Items,GD Ramayana Sandal 75GM,12,60,60,0,1
21-03-2025,"Dry Fruits, Nuts & Seeds",FLAX SEEDS 250GM,2,60,50,10,1
21-03-2025,"Dry Fruits, Nuts & Seeds",WATERMELON SEEDS 250GRM,2,320,280,40,1
21-03-2025,Personal Care & Cosmetics,GOW DURBAR 75G,10,60,60,0,1
21-03-2025,"Dry Fruits, Nuts & Seeds",PUMPKIN SEEDS 250GM,2,200,160,40,1
21-03-2025,Pooja & Spiritual Items,GD JASMINE 75GM,12,60,60,0,1
21-03-2025,Snacks & Ready-to-Eat,VD Pappu Chekkalu 190gm,14,60,60,0,1
21-03-2025,Snacks & Ready-to-Eat,VD PALLI CHIKKI,14,80,80,0,1
21-03-2025,"Grains, Flours & Dals",Arikalu (kodo),4,70,65,5,1
21-03-2025,"Grains, Flours & Dals",white Bobarlu 500 gms,4,80,75,5,1
21-03-2025,Pooja & Spiritual Items,GD TULASI 75GM,12,60,60,0,1
21-03-2025,"Grains, Flours & Dals",KORRALU (FOXTAIL M) 500GM,4,65,55,10,1
21-03-2025,Sweeteners,DATE POWDER,16,599,569,30,1
21-03-2025,Snacks & Ready-to-Eat,GB SALT COOKIES,14,60,55,5,1
21-03-2025,Spices & Seasonings,3M.MIRCHI POWDER,15,816,550,266,2
21-03-2025,Sweeteners,YB JAGGERY POWDER 500GMS,16,75,75,0,1
21-03-2025,Spices & Seasonings,GS Pink Rock Salt 1KG,15,120,120,0,1
21-03-2025,"Grains, Flours & Dals",RAGI FLOUR 500GRMS,4,40,35,5,1
21-03-2025,"Grains, Flours & Dals",SAMALU (Little millet) 500 gms,4,85,65,20,1
21-03-2025,"Grains, Flours & Dals",HS Ragi upma rava 500 gms,4,70,70,0,1
21-03-2025,"Dry Fruits, Nuts & Seeds",PLAIN PISTA 250GM,2,660,550,110,1
21-03-2025,"Dry Fruits, Nuts & Seeds",SUNFLOWER SEEDS 250GRM,2,150,130,20,1
21-03-2025,Snacks & Ready-to-Eat,Corn Chips 250GM,14,80,70,10,2
21-03-2025,"Grains, Flours & Dals",RAGI FLOUR 500GRMS,4,40,35,5,1
21-03-2025,"Grains, Flours & Dals",Wheat Flour 2 kgs,4,560,480,80,4
21-03-2025,Spices & Seasonings,Jeera 100GM,15,50,45,5,1
21-03-2025,"Grains, Flours & Dals",Wheat Rava M 500GM,4,66,60,6,2
21-03-2025,Oils & Ghee,Groundnut oil 1 L,9,360,330,30,1
21-03-2025,Sweeteners,MADHUR SUGAR 1KG,16,65,55,10,1
21-03-2025,Sweeteners,ACHU BELLAM 1KG,16,100,80,20,1
21-03-2025,Spices & Seasonings,SARVA CHAAT MASALA 100GM,15,85,85,0,1
21-03-2025,Snacks & Ready-to-Eat,PN JAGGERY BITES,14,135,135,0,1
21-03-2025,Spices & Seasonings,Coriander seeds 200 gms,15,48,40,8,1
21-03-2025,"Grains, Flours & Dals",JOWAR YELLOW 1 K,4,100,90,10,1
21-03-2025,Spices & Seasonings,Menthulu 250 gms,15,50,45,5,1
21-03-2025,"Grains, Flours & Dals",Idly Rava L 1KG,4,60,50,10,1
21-03-2025,Personal Care & Cosmetics,GARNIER CREME RICHE 70ML,10,135,135,0,3
21-03-2025,Personal Care & Cosmetics,REVIVE ANTI BACTERIA 50GM,10,20,20,0,1
21-03-2025,Oils & Ghee,Groundnut oil 1 L,9,360,330,30,1
21-03-2025,"Grains, Flours & Dals",THIN POHA 500GM,4,40,35,5,1
21-03-2025,Snacks & Ready-to-Eat,NGT CHATPATTA CHANA 90GM,14,25,25,0,1
21-03-2025,"Grains, Flours & Dals",Wheat Flour 1 kg,4,140,120,20,2
21-03-2025,Oils & Ghee,Safflower oil 1 L,9,440,400,40,1
21-03-2025,Oils & Ghee,Sesame oil 1 L,9,590,560,30,1
21-03-2025,"Grains, Flours & Dals",Multigrain 1 kg,4,100,85,15,1
21-03-2025,"Grains, Flours & Dals",White jowar.F 1 kg,4,200,160,40,2
21-03-2025,"Dry Fruits, Nuts & Seeds",Groundnuts 1 kg,2,190,165,25,1
21-03-2025,Snacks & Ready-to-Eat,RSC ORANGE 100GMS,14,20,20,0,1
21-03-2025,General Household & Kitchenware,B1 bowl,3,399,379.05,19.95,1
21-03-2025,"Grains, Flours & Dals",JOWAR UPMA RAVA,4,65,65,0,1
21-03-2025,Oils & Ghee,Flaxseed oil 500 ml,9,300,270,30,1
21-03-2025,"Grains, Flours & Dals",HS JOWAR IDLY RAWA,4,65,65,0,1
21-03-2025,"Grains, Flours & Dals",Green gram 500 gms,4,75,70,5,1
21-03-2025,Snacks & Ready-to-Eat,VD MANGO JELLY 250GRMS,14,80,80,0,1
21-03-2025,Snacks & Ready-to-Eat,SATHVI REGIVADA 200GM,14,80,60,20,1
21-03-2025,Snacks & Ready-to-Eat,ZEEDI,14,70,70,0,1
21-03-2025,Snacks & Ready-to-Eat,VD PALLI LADDU,14,160,160,0,2
21-03-2025,Snacks & Ready-to-Eat,GB SALT COOKIES,14,60,55,5,1
21-03-2025,Oils & Ghee,Sesame oil 500ml,9,295,280,15,1
21-03-2025,"Grains, Flours & Dals",White jowar.F 1 kg,4,100,80,20,1
21-03-2025,Snacks & Ready-to-Eat,VD PALLI CHIKKI,14,80,80,0,1
21-03-2025,"Grains, Flours & Dals",Wheat Flour 1 kg,4,70,60,10,1
21-03-2025,Beverages,BISLERI WATER 1L,1,20,20,0,1
21-03-2025,Oils & Ghee,Groundnut oil 1 L,9,360,330,30,1
21-03-2025,"Grains, Flours & Dals",Bajra Flour 1 kg,4,70,60,10,1
21-03-2025,Pooja & Spiritual Items,GD Sree Chandan 50GM,12,50,50,0,1
21-03-2025,Pooja & Spiritual Items,javadhu,12,60,60,0,1
21-03-2025,Oils & Ghee,Sesame oil 500ml,9,295,280,15,1
21-03-2025,Oils & Ghee,GANTASALA A2 COW GHEE 250ML,9,299,299,0,1
21-03-2025,"Health, Wellness & Ayurvedic Products",RB Max Protein Choco chips 55gm,5,50,50,0,1
21-03-2025,"Health, Wellness & Ayurvedic Products",RB Max Protein Choco Almond bar 50g,5,225,225,0,3
21-03-2025,"Dry Fruits, Nuts & Seeds",YB GRANMA NUTS,2,180,180,0,2
21-03-2025,Snacks & Ready-to-Eat,HS Ragi biscuits,14,50,50,0,1
21-03-2025,"Health, Wellness & Ayurvedic Products",MXP GRANOLA,5,449,399,50,1
21-03-2025,Oils & Ghee,Groundnut oil 1 L,9,360,330,30,1
21-03-2025,"Grains, Flours & Dals",Wheat Flour 1 kg,4,70,60,10,1
21-03-2025,Milk & Dairy,SANGAM CURD 450GM,7,38,38,0,1
21-03-2025,Milk & Dairy,BROWN EGGS 1P,7,84,72,12,6
21-03-2025,Snacks & Ready-to-Eat,NGT CHATPATTA CHANA 90GM,14,50,50,0,2
21-03-2025,"Grains, Flours & Dals",SAMALU,4,170,130,40,1
21-03-2025,"Grains, Flours & Dals",KORRALU (FOXTAIL M) 1KG,4,150,110,40,1
21-03-2025,"Grains, Flours & Dals",UDALU (Barnyard millet) 1 kg,4,140,115,25,1
21-03-2025,"Grains, Flours & Dals",Yellow jowar .F1 kg,4,110,100,10,1
21-03-2025,"Grains, Flours & Dals",White jowar.F 1 kg,4,100,80,20,1
21-03-2025,"Grains, Flours & Dals",ANDU KORRALU (Browntop.m) 1 kg,4,260,220,40,1
21-03-2025,"Grains, Flours & Dals",WHEAT 1 KG,4,300,250,50,5
21-03-2025,Milk & Dairy,HERITAGE TOTAL CURD 500GM,7,50,50,0,1
21-03-2025,Milk & Dairy,BROWN EGGS TRAY 30P,7,360,330,30,1
21-03-2025,Oils & Ghee,Freedom Rice Bran Oil 1L,9,388,360,28,2
21-03-2025,Spices & Seasonings,Menthulu 250 gms,15,50,45,5,1
21-03-2025,"Grains, Flours & Dals",KORRALU (FOXTAIL M) 500GM,4,65,55,10,1
21-03-2025,"Grains, Flours & Dals",CHANA DAL 500GM,4,70,60,10,1
21-03-2025,"Grains, Flours & Dals",FLOUR CHARGE,4,21.6,21.6,0,1.8
21-03-2025,"Grains, Flours & Dals",BAJRA 1 KG,4,30,25,5,0.5
21-03-2025,"Grains, Flours & Dals",JOWAR WHITE 1 KG,4,40,35,5,0.5
21-03-2025,Spices & Seasonings,Turmeric powder 250 gms,15,100,75,25,1
21-03-2025,"Grains, Flours & Dals",Arikalu (kodo),4,70,65,5,1
21-03-2025,"Grains, Flours & Dals",Green gram 1 kg,4,150,130,20,1
21-03-2025,"Dry Fruits, Nuts & Seeds",FLAX SEEDS 250GM,2,60,50,10,1
21-03-2025,Spices & Seasonings,Masala Karam 250 gms,15,130,120,10,1
21-03-2025,"Dry Fruits, Nuts & Seeds",PUMPKIN SEEDS 250GM,2,200,160,40,1
21-03-2025,Oils & Ghee,Coconut oil 500 ml,9,220,200,20,1
21-03-2025,Oils & Ghee,Sesame oil 500ml,9,295,280,15,1
21-03-2025,Household & Cleaning,PITAMBARI SHINING POWDER 200G,6,60,60,0,1
21-03-2025,"Grains, Flours & Dals",White jowar.F 1 kg,4,100,80,20,1
21-03-2025,Pooja & Spiritual Items,GD Aiswarya Deepam 700ML,12,195,195,0,1
21-03-2025,Pooja & Spiritual Items,SWATHI POOJA VATHULU,12,50,50,0,1
21-03-2025,Snacks & Ready-to-Eat,VD NUVVULU LADDU,14,80,80,0,1
21-03-2025,Spices & Seasonings,Jeera 100GM,15,50,45,5,1
21-03-2025,Milk & Dairy,BROWN EGGS 1P,7,84,72,12,6
21-03-2025,Spices & Seasonings,GS Pink Rock Salt 1KG,15,120,120,0,1
21-03-2025,"Grains, Flours & Dals",HS JOWAR IDLY RAWA,4,65,65,0,1
21-03-2025,Snacks & Ready-to-Eat,JUNNU POWDER 100GM,14,70,70,0,1
21-03-2025,"Grains, Flours & Dals",Wheat Flour 1 kg,4,70,60,10,1
21-03-2025,Pooja & Spiritual Items,AMRUTHA SURABHI,12,80,80,0,1
21-03-2025,Personal Care & Cosmetics,MD HERBAL HAIR SHAMPOO,10,175,175,0,1
21-03-2025,Spices & Seasonings,KALONJI SEEDS,15,90,80,10,1
21-03-2025,Spices & Seasonings,DURGA SALT CRYSTAL 1KG,15,25,25,0,1
21-03-2025,"Dry Fruits, Nuts & Seeds",PUTNALU 500GMS,2,180,152,28,2
21-03-2025,Personal Care & Cosmetics,UVIS LACTO TAN SOAP 100GM,10,99,99,0,1
21-03-2025,"Grains, Flours & Dals",CHANA DAL 500GM,4,280,240,40,4
21-03-2025,Pooja & Spiritual Items,GB Bharatha Woods 75GM,12,60,60,0,1
21-03-2025,"Grains, Flours & Dals",AISHWARYA SP 5KG,4,400,375,25,1
21-03-2025,Snacks & Ready-to-Eat,VD PALLI CHIKKI,14,80,80,0,1
21-03-2025,"Grains, Flours & Dals",SL Suji Rava 500GM,4,64,64,0,2
21-03-2025,Snacks & Ready-to-Eat,SD VAMU APPADALU 200GM,14,80,80,0,1
21-03-2025,Snacks & Ready-to-Eat,BB VERMICELLY 500GM,14,53,53,0,1
21-03-2025,Spices & Seasonings,Tamarind 500GM,15,160,130,30,1
21-03-2025,Spices & Seasonings,DRY MIECHI 200GM,15,160,120,40,2
21-03-2025,"Dry Fruits, Nuts & Seeds",Groundnuts 1 kg,2,190,165,25,1
21-03-2025,"Grains, Flours & Dals",BOMBAY RAVA,4,70,55,15,1
21-03-2025,Sweeteners,YB JAGGERY POWDER 500GMS,16,75,75,0,1
21-03-2025,Misc,GT0012,8,210,210,0,6
21-03-2025,"Grains, Flours & Dals",SRI LALITHA SONAMASOORI 5KG,4,880,740,140,2
21-03-2025,"Grains, Flours & Dals",DH URAD GOTA 1KG,4,215,190,25,1
21-03-2025,Pooja & Spiritual Items,HERBAL VETIVER STICK 20INC,12,45,45,0,1
21-03-2025,Snacks & Ready-to-Eat,jeera papad,14,80,80,0,1
21-03-2025,Pooja & Spiritual Items,GD Ramayana Sandal 75GM,12,60,60,0,1
21-03-2025,Snacks & Ready-to-Eat,ZEEDI,14,70,70,0,1
21-03-2025,Personal Care & Cosmetics,UVIS COW GHEE SOAP 100GM,10,85,85,0,1
21-03-2025,"Grains, Flours & Dals",RICE FLOUR 1KG,4,210,165,45,3
21-03-2025,"Grains, Flours & Dals",Chana Flour 1 kg,4,280,260,20,2
21-03-2025,Pooja & Spiritual Items,GD Bhagavatha Mallika 75GM,12,60,60,0,1
21-03-2025,Snacks & Ready-to-Eat,urban murmura,14,60,55,5,1
21-03-2025,Pooja & Spiritual Items,GD Sree Chandan 50GM,12,50,50,0,1
21-03-2025,Oils & Ghee,Groundnut oil 500ml,9,180,165,15,1
21-03-2025,Milk & Dairy,BROWN EGGS 1P,7,168,144,24,12
21-03-2025,Snacks & Ready-to-Eat,VD MANGO JELLY 250GRMS,14,80,80,0,1
21-03-2025,Snacks & Ready-to-Eat,VD Pappu Chekkalu 190gm,14,60,60,0,1
21-03-2025,Snacks & Ready-to-Eat,SD GINGER CANDY 200GM,14,115,115,0,1
21-03-2025,Personal Care & Cosmetics,UVIS SANDALWOOD POWDR 100gm,10,0,0,0,1
21-03-2025,Personal Care & Cosmetics,DWIBHASHI GULABA ARKA ROSA WATER,10,120,120,0,2
21-03-2025,Personal Care & Cosmetics,DWI ROSE WATER 120ML,10,90,90,0,1
21-03-2025,Snacks & Ready-to-Eat,BELLAM MINAPA SUNADULLU,14,360,360,0,2
21-03-2025,Beverages,REFRESH SHARBATH NORMAL,1,199,190,9,1
21-03-2025,Oils & Ghee,Flaxseed oil 500 ml,9,300,270,30,1
21-03-2025,Spices & Seasonings,Chilli powder 500 gms,15,290,210,80,1
21-03-2025,Snacks & Ready-to-Eat,BB VERMICELLI 1KG,14,98,93,5,1
21-03-2025,Spices & Seasonings,Turmeric powder 250 gms,15,100,75,25,1
21-03-2025,Spices & Seasonings,Turmeric powder 250 gms,15,100,75,25,1
21-03-2025,Spices & Seasonings,Menthulu 250 gms,15,50,45,5,1
21-03-2025,"Grains, Flours & Dals",MAATEJA rice 1 kg,4,360,345,15,5
21-03-2025,"Grains, Flours & Dals",SABDANA 500GM,4,90,70,20,1
21-03-2025,Milk & Dairy,BROWN EGGS 1P,7,280,240,40,20
21-03-2025,"Grains, Flours & Dals",VYS.SP.RICE BAG 1,4,1800,"1,650.00",150,1
21-03-2025,"Dry Fruits, Nuts & Seeds",SUNFLOWER SEEDS 250GRM,2,150,130,20,1
21-03-2025,Spices & Seasonings,NUVVULU 250GM,15,80,65,15,1
21-03-2025,Milk & Dairy,BROWN EGGS 1P,7,168,144,24,12
21-03-2025,"Grains, Flours & Dals",Wheat Flour 1 kg,4,70,60,10,1
21-03-2025,Spices & Seasonings,Turmeric powder 250 gms,15,100,75,25,1
21-03-2025,"Dry Fruits, Nuts & Seeds",PUMPKIN SEEDS 250GM,2,200,160,40,1
21-03-2025,"Grains, Flours & Dals",RICE FLOUR 1KG,4,70,55,15,1
21-03-2025,"Dry Fruits, Nuts & Seeds",FLAX SEEDS 250GM,2,60,50,10,1
21-03-2025,Oils & Ghee,Groundnut oil 1 L,9,360,330,30,1
21-03-2025,"Grains, Flours & Dals",MAATEJA rice 1 kg,4,720,690,30,10
21-03-2025,"Grains, Flours & Dals",sprouts 10 rps p,4,12,10,2,1
21-03-2025,Personal Care & Cosmetics,MD HERBAL HAIR SHAMPOO,10,300,300,0,1
21-03-2025,"Grains, Flours & Dals",Green gram 500 gms,4,75,70,5,1
21-03-2025,Snacks & Ready-to-Eat,GB SALT COOKIES,14,60,55,5,1
21-03-2025,"Grains, Flours & Dals",turdal 500 gms,4,110,85,25,1
20-03-2025,Household & Cleaning,UJALA LIQUID DETERGENT 800ML,6,150,150,0,1
20-03-2025,"Grains, Flours & Dals",split black gram 1 kg,4,180,170,10,1
20-03-2025,Milk & Dairy,SANGAM TONED MILK 500ML,7,30,30,0,1
20-03-2025,Snacks & Ready-to-Eat,ID IDLY DOSA BATTER,14,90,90,0,1
20-03-2025,Snacks & Ready-to-Eat,RSC ORANGE 100GMS,14,20,20,0,1
20-03-2025,Snacks & Ready-to-Eat,SS IDLY BATTER 1KG,14,60,60,0,1
20-03-2025,Pooja & Spiritual Items,GD SANDAL 150GM,12,110,110,0,1
20-03-2025,Snacks & Ready-to-Eat,VD PAPPU CHEGODI 200GM,14,60,60,0,1
20-03-2025,Snacks & Ready-to-Eat,RAJGIRA PEANUT CHIKKI,14,30,30,0,6
20-03-2025,Snacks & Ready-to-Eat,VD KOBARI LADDU,14,80,80,0,1
20-03-2025,"Grains, Flours & Dals",Multigrain 1 kg,4,200,170,30,2
20-03-2025,Snacks & Ready-to-Eat,RAJGIRA PEANUT CHIKKI 450GM,14,125,125,0,1
20-03-2025,"Health, Wellness & Ayurvedic Products",RB Max Protein Classic Crunchy,5,169,169,0,1
20-03-2025,"Grains, Flours & Dals",RAGULU 1 KG,4,140,120,20,2
20-03-2025,"Grains, Flours & Dals",RAGI FLOUR 500GRMS,4,40,35,5,1
20-03-2025,"Grains, Flours & Dals",SAMALU,4,170,130,40,1
20-03-2025,Personal Care & Cosmetics,DWI FOOT CARE 30G,10,90,90,0,1
20-03-2025,"Grains, Flours & Dals",RAGI FLOUR 1KG,4,80,70,10,1
20-03-2025,General Household & Kitchenware,good home,3,110,110,0,1
20-03-2025,"Grains, Flours & Dals",SAMALU,4,170,130,40,1
20-03-2025,Pooja & Spiritual Items,BALAJI GArden dhop sticks,12,105,90,15,1
20-03-2025,Spices & Seasonings,ROYAL SAFFRON,15,125,125,0,1
20-03-2025,"Grains, Flours & Dals",unpolished turdall500grms,4,120,110,10,1
20-03-2025,"Dry Fruits, Nuts & Seeds",Groundnuts 500 gms,2,95,85,10,1
20-03-2025,"Grains, Flours & Dals",Idly Rava L 1KG,4,60,50,10,1
20-03-2025,Milk & Dairy,HRITAGE TOTAL CURD 130GM,7,10,10,0,1
20-03-2025,"Grains, Flours & Dals",Wheat Flour 1 kg,4,70,60,10,1
20-03-2025,Personal Care & Cosmetics,dove h,10,72,72,0,1
20-03-2025,Personal Care & Cosmetics,dove 1,10,72,72,0,1
20-03-2025,Personal Care & Cosmetics,loreal cp,10,109,109,0,1
20-03-2025,Personal Care & Cosmetics,OVAL BODY LOOFAH,10,55,55,0,1
20-03-2025,Snacks & Ready-to-Eat,VD PALLI CHIKKI,14,80,80,0,1
20-03-2025,Spices & Seasonings,JEERA 250 gms,15,125,105,20,1
20-03-2025,Spices & Seasonings,Turmeric powder 250 gms,15,100,75,25,1
20-03-2025,Oils & Ghee,Sesame oil 1 L,9,590,560,30,1
20-03-2025,Oils & Ghee,Coconut oil 500 ml,9,220,200,20,1
20-03-2025,"Grains, Flours & Dals",turdal 1kg,4,220,170,50,1
20-03-2025,Spices & Seasonings,Vamu 100GM,15,60,50,10,1
20-03-2025,Spices & Seasonings,RED COPRA 500GM,15,170,148,22,1
20-03-2025,"Grains, Flours & Dals",DOCTOR RICE DIABETIC SFR 1KG,4,120,120,0,1
20-03-2025,Spices & Seasonings,Japatri 25GM,15,100,80,20,1
20-03-2025,Pooja & Spiritual Items,BANDA PUVVU 25GM 25GM,12,80,60,20,1
20-03-2025,Oils & Ghee,Sesame oil 1 L,9,590,560,30,1
20-03-2025,Oils & Ghee,Safflower oil 1 L,9,440,400,40,1
20-03-2025,Spices & Seasonings,MIRYALU 50 GRMS,15,100,80,20,1
20-03-2025,Misc,ROLL D C,8,70,45,25,1
20-03-2025,Snacks & Ready-to-Eat,VD KOBARI LADDU,14,80,80,0,1
20-03-2025,Oils & Ghee,Coconut oil 1 L,9,440,400,40,1
20-03-2025,Oils & Ghee,Groundnut oil 1 L,9,360,330,30,1
20-03-2025,Misc,VD0009,8,100,100,0,1
20-03-2025,Oils & Ghee,Groundnut oil 500ml,9,180,165,15,1
20-03-2025,Spices & Seasonings,Masala Karam 250 gms,15,130,120,10,1
20-03-2025,"Grains, Flours & Dals",URAD DALL,4,95,85,10,1
20-03-2025,"Grains, Flours & Dals",Wheat Flour 1 kg,4,70,60,10,1
20-03-2025,Snacks & Ready-to-Eat,CHOCO BROWINE,14,20,20,0,1
20-03-2025,"Dry Fruits, Nuts & Seeds",Groundnuts 500 gms,2,95,85,10,1
20-03-2025,Snacks & Ready-to-Eat,VD MINAPA VADIYAM,14,65,65,0,1
20-03-2025,"Grains, Flours & Dals",Wheat Rava M 500GM,4,33,30,3,1
20-03-2025,Oils & Ghee,Groundnut oil 1 L,9,720,660,60,2
20-03-2025,"Grains, Flours & Dals",Bombay Rava 500GM,4,70,60,10,2
20-03-2025,"Grains, Flours & Dals",Bombay Rava 500GM,4,70,60,10,2
20-03-2025,"Grains, Flours & Dals",Wheat Rava M 500GM,4,33,30,3,1
20-03-2025,Oils & Ghee,Groundnut oil 1 L,9,720,660,60,2
20-03-2025,Personal Care & Cosmetics,KHADI MIX FRUIT SOAP 125GM,10,80,80,0,1
20-03-2025,"Grains, Flours & Dals",Quinova 500 gms,4,110,100,10,1
20-03-2025,"Grains, Flours & Dals",UDALU (Barnyard millet) 1 kg,4,140,115,25,1
20-03-2025,Snacks & Ready-to-Eat,SD Thati thandra 200gm,14,150,150,0,1
20-03-2025,Snacks & Ready-to-Eat,VD MURUKU 175GM,14,60,60,0,1
20-03-2025,Snacks & Ready-to-Eat,VD PAPPU CHEGODI 200GM,14,120,120,0,2
20-03-2025,Snacks & Ready-to-Eat,VD ARISELU 5 PIC,14,100,100,0,1
20-03-2025,Snacks & Ready-to-Eat,KURNOOL MARMURA,14,70,55,15,1
20-03-2025,Snacks & Ready-to-Eat,VD Pappu Chekkalu 190gm,14,120,120,0,2
20-03-2025,Snacks & Ready-to-Eat,VD PALLI CHIKKI,14,160,160,0,2
20-03-2025,Pooja & Spiritual Items,SRI HARI KRISHNA DOOM 12PIC,12,80,80,0,1
20-03-2025,Snacks & Ready-to-Eat,VD Pappu Chekkalu 190gm,14,60,60,0,1
20-03-2025,Snacks & Ready-to-Eat,VD PALLI CHIKKI,14,80,80,0,1
20-03-2025,Snacks & Ready-to-Eat,VD ARISELU 5 PIC,14,100,100,0,1
20-03-2025,Snacks & Ready-to-Eat,SD Thati thandra 200gm,14,150,150,0,1
20-03-2025,Oils & Ghee,Safflower oil 1 L,9,440,400,40,1
20-03-2025,Oils & Ghee,Sesame oil 1 L,9,590,560,30,1
20-03-2025,Snacks & Ready-to-Eat,VD KOBARI LADDU,14,80,80,0,1
20-03-2025,Oils & Ghee,GANTASALA A2 COW GHEE 500ML,9,550,550,0,1
20-03-2025,Oils & Ghee,Sesame oil 1 L,9,590,560,30,1
20-03-2025,"Grains, Flours & Dals",White jowar.F 1 kg,4,200,160,40,2
20-03-2025,"Grains, Flours & Dals",SA WHITE JOWAR RAVA 500GM,4,69,69,0,1
20-03-2025,Oils & Ghee,Black Sesame oil 1 L,9,440,380,60,1
20-03-2025,Oils & Ghee,Groundnut oil 1 L,9,720,660,60,2
20-03-2025,Personal Care & Cosmetics,GOHNSONS BABY OIL 100ML,10,140,140,0,1
20-03-2025,"Grains, Flours & Dals",KORRALU (FOXTAIL M) 1KG,4,300,220,80,2
20-03-2025,"Grains, Flours & Dals",SAMALU,4,340,260,80,2
20-03-2025,"Grains, Flours & Dals",UDALU (Barnyard millet) 1 kg,4,280,230,50,2
20-03-2025,Snacks & Ready-to-Eat,JUNNU POWDER 100GM,14,210,210,0,3
20-03-2025,"Grains, Flours & Dals",Arikadu ( kodo),4,280,260,20,2
20-03-2025,Spices & Seasonings,KALONJI SEEDS,15,450,400,50,5
20-03-2025,Spices & Seasonings,LG 50GM,15,184,184,0,2
20-03-2025,"Grains, Flours & Dals",split black gram 1 kg,4,900,850,50,5
20-03-2025,"Grains, Flours & Dals",ANDU KORRALU (Browntop.m) 1 kg,4,520,440,80,2
20-03-2025,Spices & Seasonings,Avalu small 500 gms,15,120,120,0,1
20-03-2025,"Grains, Flours & Dals",White jowar.F 1 kg,4,100,80,20,1
20-03-2025,"Grains, Flours & Dals",KORRALU (FOXTAIL M) 500GM,4,65,55,10,1
20-03-2025,"Grains, Flours & Dals",Red Wheat Flour 1 kg,4,280,260,20,2
20-03-2025,"Grains, Flours & Dals",Chana Flour 500 gms,4,70,65,5,1
20-03-2025,"Grains, Flours & Dals",Wheat Rava M 1KG,4,65,55,10,1
20-03-2025,"Grains, Flours & Dals",RAGI FLOUR 1KG,4,80,70,10,1
20-03-2025,"Grains, Flours & Dals",Sathya Javva Wheat Rava 500GM,4,95,95,0,1
20-03-2025,"Dry Fruits, Nuts & Seeds",SABJA SEEDS 100GM,2,160,140,20,2
20-03-2025,Snacks & Ready-to-Eat,ELITE ELAICHI RUSK 200GM,14,35,35,0,1
20-03-2025,"Dry Fruits, Nuts & Seeds",SUNFLOWER SEEDS 250GRM,2,150,130,20,1
20-03-2025,"Dry Fruits, Nuts & Seeds",MAHA BEERA SEEDS 100GM,2,80,80,0,1
20-03-2025,"Dry Fruits, Nuts & Seeds",cashew,2,340,310,30,1
20-03-2025,"Dry Fruits, Nuts & Seeds",PUMPKIN SEEDS 250GM,2,200,160,40,1
20-03-2025,"Dry Fruits, Nuts & Seeds",ALMONDS 250GM,2,280,260,20,1
20-03-2025,"Dry Fruits, Nuts & Seeds",FLAX SEEDS 250GM,2,60,50,10,1
20-03-2025,"Grains, Flours & Dals",KORRALU (FOXTAIL M) 1KG,4,150,110,40,1
20-03-2025,"Grains, Flours & Dals",SAMALU,4,170,130,40,1
20-03-2025,"Grains, Flours & Dals",HS JOWAR IDLY RAWA,4,65,65,0,1
20-03-2025,"Grains, Flours & Dals",Red Wheat Flour 1 kg,4,140,130,10,1
20-03-2025,Spices & Seasonings,Lavangam 50GM,15,60,50,10,1
20-03-2025,Spices & Seasonings,NUVVULU 500GM,15,200,170,30,1
20-03-2025,Snacks & Ready-to-Eat,SS IDLY BATTER 1KG,14,60,60,0,1
20-03-2025,Personal Care & Cosmetics,COLGATE ACTIVE SALT,10,20,20,0,1
20-03-2025,Household & Cleaning,vim small,6,15,15,0,1
20-03-2025,"Dry Fruits, Nuts & Seeds",Groundnuts 500 gms,2,95,85,10,1
20-03-2025,"Dry Fruits, Nuts & Seeds",PULMAKHANA 100 GM,2,180,170,10,1
20-03-2025,Snacks & Ready-to-Eat,VD KOBARI LADDU,14,80,80,0,1
20-03-2025,Sweeteners,YB JAGGERY POWDER 500GMS,16,75,75,0,1
20-03-2025,Snacks & Ready-to-Eat,VD CORNFLAKES MIXTURE 175GM,14,60,60,0,1
20-03-2025,"Grains, Flours & Dals",JOWAR UPMA RAVA,4,75,75,0,1
20-03-2025,Oils & Ghee,Groundnut oil 5 L,9,1800,"1,600.00",200,1
20-03-2025,Milk & Dairy,BROWN EGGS TRAY 30P,7,720,660,60,2
20-03-2025,Snacks & Ready-to-Eat,VD PAPPU CHEGODI 200GM,14,60,60,0,1
20-03-2025,Snacks & Ready-to-Eat,KURNOOL MARMURA,14,70,55,15,1
20-03-2025,"Grains, Flours & Dals",Idly Rava L 1KG,4,60,50,10,1
20-03-2025,Snacks & Ready-to-Eat,VD Pappu Chekkalu 190gm,14,60,60,0,1
20-03-2025,"Grains, Flours & Dals",White jowar.F 1 kg,4,100,80,20,1
20-03-2025,Personal Care & Cosmetics,SVE KHADI ALOEVERA GEL 100GM,10,140,140,0,1
20-03-2025,Snacks & Ready-to-Eat,SATHVI REGIVADA 200GM,14,80,60,20,1
20-03-2025,Oils & Ghee,Sesame oil 1 L,9,590,560,30,1
20-03-2025,Oils & Ghee,BUFFALLO GHEE 500ML,9,410,370,40,1
20-03-2025,Oils & Ghee,Groundnut oil 1 L,9,720,660,60,2
20-03-2025,"Grains, Flours & Dals",SINGLE POLISH 1KG,4,650,650,0,10
20-03-2025,"Grains, Flours & Dals",UDALU (Barnyard millet) 1 kg,4,140,115,25,1
20-03-2025,"Grains, Flours & Dals",SAMALU,4,170,130,40,1
20-03-2025,"Dry Fruits, Nuts & Seeds",PUMPKIN SEEDS 250GM,2,200,160,40,1
20-03-2025,"Grains, Flours & Dals",Arikadu ( kodo),4,140,130,10,1
20-03-2025,"Grains, Flours & Dals",THICK POHA 1KG,4,80,70,10,1
20-03-2025,"Grains, Flours & Dals",Quinova 500 gms,4,110,100,10,1
20-03-2025,"Grains, Flours & Dals",white Bobarlu 500 gms,4,80,75,5,1
20-03-2025,"Grains, Flours & Dals",KORRALU (FOXTAIL M) 500GM,4,65,55,10,1
20-03-2025,"Grains, Flours & Dals",ANDU KORRALU (Browntop.m) 1 kg,4,260,220,40,1
20-03-2025,Spices & Seasonings,DURGA SALT CRYSTAL 1KG,15,25,25,0,1
20-03-2025,"Dry Fruits, Nuts & Seeds",FLAX SEEDS 250GM,2,60,50,10,1
20-03-2025,"Grains, Flours & Dals",turdal 1kg,4,220,170,50,1
20-03-2025,Oils & Ghee,Coconut oil 500 ml,9,220,200,20,1
20-03-2025,"Grains, Flours & Dals",SINGLE POLISH 1KG,4,325,325,0,5
20-03-2025,"Dry Fruits, Nuts & Seeds",Groundnuts 500 gms,2,95,85,10,1
20-03-2025,"Grains, Flours & Dals",Arikalu (kodo),4,70,65,5,1
20-03-2025,"Grains, Flours & Dals",PESARA PAPPU 1 KG,4,170,145,25,1
20-03-2025,Snacks & Ready-to-Eat,SATHVI REGIVADA 200GM,14,80,60,20,1
20-03-2025,"Dry Fruits, Nuts & Seeds",Putnalu 250GM,2,45,38,7,1
20-03-2025,"Grains, Flours & Dals",Wheat Rava S 1KG,4,65,55,10,1
20-03-2025,Snacks & Ready-to-Eat,SD Atreyapuram DRY Fruit ghee,14,150,150,0,1
20-03-2025,Oils & Ghee,Groundnut oil 1 L,9,360,330,30,1
20-03-2025,"Grains, Flours & Dals",Chana Flour 500 gms,4,140,130,10,2
20-03-2025,"Grains, Flours & Dals",White jowar.F 1 kg,4,200,160,40,2
20-03-2025,Milk & Dairy,HERITAGE TONED MILK 500ML,7,41,41,0,1
20-03-2025,Sweeteners,YB JAGGERY POWDER 500GMS,16,75,75,0,1
20-03-2025,Oils & Ghee,Coconut oil 1 L,9,440,400,40,1
20-03-2025,Snacks & Ready-to-Eat,MILLET NOODLES CURRY MASALA,14,129,129,0,1
20-03-2025,Oils & Ghee,Safflower oil 5 L,9,2200,"1,950.00",250,1
20-03-2025,Spices & Seasonings,GROUNDNUT KARAM POWDER,15,65,65,0,1
20-03-2025,"Grains, Flours & Dals",Wheat Rava M 500GM,4,33,30,3,1
20-03-2025,"Grains, Flours & Dals",JOWAR UPMA RAVA,4,75,75,0,1
20-03-2025,"Grains, Flours & Dals",Em kodo idli R 500G,4,129,129,0,1
20-03-2025,"Grains, Flours & Dals",HS JOWAR IDLY RAWA,4,65,65,0,1
20-03-2025,Oils & Ghee,Safflower oil 1 L,9,440,400,40,1
20-03-2025,Oils & Ghee,Groundnut oil 1 L,9,360,330,30,1
20-03-2025,Oils & Ghee,Groundnut oil 1 L,9,360,330,30,1
20-03-2025,Oils & Ghee,Coconut oil 500 ml,9,220,200,20,1
20-03-2025,Oils & Ghee,Sesame oil 1 L,9,590,560,30,1
20-03-2025,"Grains, Flours & Dals",Wheat Flour 1 kg,4,140,120,20,2
20-03-2025,"Grains, Flours & Dals",SPLIT BLACK GRAM 500 GM,4,90,85,5,1
20-03-2025,Milk & Dairy,HERITAGE TONED MILK 500ML,7,62,62,0,2
20-03-2025,Snacks & Ready-to-Eat,DOSA BATTER 1KG,14,60,60,0,1
20-03-2025,Milk & Dairy,HERITAGE TOTAL CURD 500GM,7,50,50,0,1
20-03-2025,Spices & Seasonings,AV Iodized Salt 1KG,15,28,25,3,1
20-03-2025,Spices & Seasonings,Chilli powder 500 gms,15,290,210,80,1
20-03-2025,Spices & Seasonings,Turmeric powder 250 gms,15,100,75,25,1
20-03-2025,"Health, Wellness & Ayurvedic Products",DWI BHRINGARAJA TAILAM 100ML,5,150,150,0,1
20-03-2025,Spices & Seasonings,Black Till 250GM,15,180,150,30,2
20-03-2025,Spices & Seasonings,SAJEERA,15,60,40,20,1
20-03-2025,Snacks & Ready-to-Eat,DINNER PAPAD,14,80,80,0,1
20-03-2025,"Grains, Flours & Dals",MIXED FLOUR,4,343,343,0,1
20-03-2025,Snacks & Ready-to-Eat,VD Minapa papad 200gm,14,120,120,0,2
20-03-2025,Spices & Seasonings,SATHVI ANASAPUVUU 25GM,15,90,65,25,1
20-03-2025,"Grains, Flours & Dals",WHEAT 1 KG,4,60,50,10,1
20-03-2025,"Dry Fruits, Nuts & Seeds",FLAX SEEDS 250GM,2,60,50,10,1
20-03-2025,Pooja & Spiritual Items,GD Aiswarya Deepam 700ML,12,195,195,0,1
20-03-2025,"Grains, Flours & Dals",RAGULU 1 KG,4,70,60,10,1
20-03-2025,Spices & Seasonings,GS Pink Rock Salt 1KG,15,240,240,0,2
20-03-2025,Sweeteners,YB JAGGERY POWDER 500GMS,16,75,75,0,1
20-03-2025,Spices & Seasonings,GREEN SOUNF,15,60,40,20,1
20-03-2025,Spices & Seasonings,JEERA 250 gms,15,250,210,40,2
20-03-2025,Household & Cleaning,PITAMBARI SHINING POWDER 200G,6,60,60,0,1
20-03-2025,Household & Cleaning,PITAMBARI,6,56,56,0,2
20-03-2025,Oils & Ghee,Groundnut oil 1 L,9,720,660,60,2
20-03-2025,"Grains, Flours & Dals",UNPOLISHED TURDALL 1KG,4,240,210,30,1
20-03-2025,"Grains, Flours & Dals",THIN POHA 500GM,4,40,35,5,1
20-03-2025,Milk & Dairy,SANGAM TONED MILK 500ML,7,60,60,0,2
20-03-2025,"Grains, Flours & Dals",VGR RICE 5 KGS,4,350,325,25,1
20-03-2025,"Grains, Flours & Dals",turdal 1kg,4,440,340,100,2
20-03-2025,"Grains, Flours & Dals",Wheat Flour 1 kg,4,280,240,40,4
20-03-2025,Oils & Ghee,Coconut oil 500 ml,9,220,200,20,1
20-03-2025,Spices & Seasonings,Chilli powder 500 gms,15,290,210,80,1
20-03-2025,Snacks & Ready-to-Eat,VD MANGO JELLY 250GRMS,14,80,80,0,1
20-03-2025,Oils & Ghee,BUFFALLO GHEE 500ML,9,410,370,40,1
20-03-2025,Snacks & Ready-to-Eat,VD PALLI CHIKKI,14,80,80,0,1
20-03-2025,Spices & Seasonings,GARAM MASALA 200GM,15,120,95,25,1
20-03-2025,Spices & Seasonings,NUVVULU 500GM,15,200,170,30,1
20-03-2025,Oils & Ghee,Sesame oil 1 L,9,1180,"1,120.00",60,2
20-03-2025,Oils & Ghee,Coconut oil 1 L,9,440,400,40,1
20-03-2025,Milk & Dairy,BROWN EGGS 1P,7,168,144,24,12
20-03-2025,Snacks & Ready-to-Eat,VD RICE MURUKU 150GM,14,100,100,0,2
20-03-2025,Sweeteners,SD PALM JAGGERY 500GM,16,200,200,0,1
20-03-2025,Snacks & Ready-to-Eat,VD Minapa papad 200gm,14,60,60,0,1
20-03-2025,"Grains, Flours & Dals",Green gram 1 kg,4,150,130,20,1
20-03-2025,Pooja & Spiritual Items,javadhu,12,60,60,0,1
20-03-2025,"Dry Fruits, Nuts & Seeds",SUNFLOWER SEEDS 250GRM,2,150,130,20,1
20-03-2025,Snacks & Ready-to-Eat,VD CORNFLAKES MIXTURE 175GM,14,60,60,0,1
20-03-2025,Spices & Seasonings,Tamarind 250GMS,15,80,65,15,1
20-03-2025,Spices & Seasonings,BIRYANI MASALA,15,15,15,0,1
20-03-2025,"Dry Fruits, Nuts & Seeds",FLAX SEEDS 250GM,2,60,50,10,1
20-03-2025,"Grains, Flours & Dals",RICE FLOUR 1KG,4,70,55,15,1
20-03-2025,"Grains, Flours & Dals",RAGI FLOUR 1KG,4,80,70,10,1
20-03-2025,Oils & Ghee,Groundnut oil 1 L,9,720,660,60,2
20-03-2025,"Grains, Flours & Dals",Wheat Flour 2 kgs,4,280,240,40,2
20-03-2025,Oils & Ghee,Sesame oil 1 L,9,590,560,30,1
20-03-2025,Oils & Ghee,Safflower oil 1 L,9,440,400,40,1
20-03-2025,Spices & Seasonings,PUTNALA KARAM POWDER 100GM,15,65,65,0,1
20-03-2025,"Grains, Flours & Dals",SAMALU,4,170,130,40,1
20-03-2025,Spices & Seasonings,Gasagasalu 50GM,15,130,110,20,1
20-03-2025,"Grains, Flours & Dals",SL Suji Rava 500GM,4,32,32,0,1
20-03-2025,Sweeteners,GS Organic Jaggery Powder 600GM,16,693,693,0,7
20-03-2025,"Grains, Flours & Dals",ANDU KORRALU (Brown top .mlt) 500,4,130,110,20,1
20-03-2025,"Grains, Flours & Dals",UDALU (Barnyard millet) 500 gms,4,70,60,10,1
20-03-2025,"Grains, Flours & Dals",Em jowar idly R 500G,4,75,75,0,1
20-03-2025,"Grains, Flours & Dals",SAMALU (Little millet) 500 gms,4,85,65,20,1
20-03-2025,Sweeteners,YB JAGGERY POWDER 500GMS,16,75,75,0,1
20-03-2025,"Grains, Flours & Dals",Arikalu (kodo),4,70,65,5,1
20-03-2025,"Grains, Flours & Dals",Urad dall 1 Kg,4,185,170,15,1
20-03-2025,Snacks & Ready-to-Eat,RSC ORANGE 100GMS,14,20,20,0,1
20-03-2025,"Grains, Flours & Dals",Green gram 1 kg,4,150,130,20,1
20-03-2025,General Household & Kitchenware,clay water bottle 1,3,265,251,14,1
20-03-2025,Milk & Dairy,BROWN EGGS TRAY 30P,7,360,330,30,1
20-03-2025,Oils & Ghee,Groundnut oil 5 L,9,1800,"1,600.00",200,1
20-03-2025,"Grains, Flours & Dals",Red Bobarlu 500 gms,4,95,85,10,1
20-03-2025,"Dry Fruits, Nuts & Seeds",SALTED PISTA 250GM,2,400,350,50,1
20-03-2025,"Dry Fruits, Nuts & Seeds",SATHVI CHIA SEEDS 100GM,2,100,80,20,1
20-03-2025,Oils & Ghee,Sesame oil 1 L,9,590,560,30,1
20-03-2025,Milk & Dairy,SANGAM CURD 450GM,7,76,76,0,2
20-03-2025,Spices & Seasonings,Coriander seeds 200 gms,15,48,40,8,1
20-03-2025,"Grains, Flours & Dals",White jowar.F 1 kg,4,100,80,20,1
19-03-2025,Pooja & Spiritual Items,GB Bharatha Woods 75GM,12,60,60,0,1
19-03-2025,Snacks & Ready-to-Eat,VD SAGOPAPAD 150GM,14,55,55,0,1
19-03-2025,"Grains, Flours & Dals",Wheat Flour 1 kg,4,140,120,20,2
19-03-2025,Snacks & Ready-to-Eat,PEANUT CHIKKI,14,44,44,0,2
19-03-2025,Snacks & Ready-to-Eat,IDLI &amp; DOSA BATTER .T,14,84,84,0,1
19-03-2025,Personal Care & Cosmetics,ROUND LOOFAH,10,65,65,0,1
19-03-2025,Personal Care & Cosmetics,OVAL BODY LOOFAH,10,55,55,0,1
19-03-2025,Snacks & Ready-to-Eat,VD PAPPU CHEGODI 200GM,14,60,60,0,1
19-03-2025,Snacks & Ready-to-Eat,VD MURMURA LADDU,14,50,50,0,1
19-03-2025,"Grains, Flours & Dals",unpolished turdall500grms,4,120,110,10,1
19-03-2025,"Grains, Flours & Dals",Red Chana 500 GM,4,75,60,15,1
19-03-2025,"Dry Fruits, Nuts & Seeds",ANJEER 250GM,2,400,360,40,1
19-03-2025,"Grains, Flours & Dals",Red Bobarlu 500 gms,4,95,85,10,1
19-03-2025,"Grains, Flours & Dals",VGR rice 1 kg,4,140,130,10,2
19-03-2025,Oils & Ghee,Groundnut oil 1 L,9,360,330,30,1
19-03-2025,"Health, Wellness & Ayurvedic Products",MD Bringaraj Choornam 100GM,5,80,80,0,1
19-03-2025,"Grains, Flours & Dals",Bajra Flour 1 kg,4,70,60,10,1
19-03-2025,"Grains, Flours & Dals",SL Idly Rava 1KG,4,65,55,10,1
19-03-2025,Spices & Seasonings,NUVVULU 250GM,15,80,65,15,1
19-03-2025,"Grains, Flours & Dals",RAGI FLOUR 500GRMS,4,40,35,5,1
19-03-2025,"Dry Fruits, Nuts & Seeds",Putnalu 250GM,2,45,38,7,1
19-03-2025,"Grains, Flours & Dals",White jowar.F 1 kg,4,50,40,10,0.5
19-03-2025,Personal Care & Cosmetics,SVE HIBISCUS SOAP,10,90,90,0,1
19-03-2025,Pooja & Spiritual Items,GD KUMKUM 50GM,12,30,30,0,1
19-03-2025,Pooja & Spiritual Items,GD Sree Chandan 50GM,12,50,50,0,1
19-03-2025,"Grains, Flours & Dals",SRILATHA RICE RAVVA 500GM,4,35,35,0,1
19-03-2025,"Grains, Flours & Dals",Sathya Javva Wheat Rava 500GM,4,95,95,0,1
19-03-2025,Personal Care & Cosmetics,COW DURBAR TURMERIC 50GM,10,50,50,0,2
19-03-2025,Snacks & Ready-to-Eat,VD BOONDI 175GM,14,60,60,0,1
19-03-2025,Snacks & Ready-to-Eat,VD PALLI LADDU,14,160,160,0,2
19-03-2025,Oils & Ghee,Groundnut oil 1 L,9,720,660,60,2
19-03-2025,"Grains, Flours & Dals",MAAGAANI SP RICE 20 KGS,4,2300,"1,960.00",340,1
19-03-2025,Snacks & Ready-to-Eat,ONION RINGS,14,50,50,0,1
19-03-2025,"Dry Fruits, Nuts & Seeds",PULMAKHANA 100 GM,2,180,170,10,1
19-03-2025,"Grains, Flours & Dals",Brown RICE 1KG,4,70,65,5,1
19-03-2025,"Grains, Flours & Dals",POORI ATTA 1KG,4,70,60,10,1
19-03-2025,"Dry Fruits, Nuts & Seeds",YELLOW KISHMISH 250GM,2,130,110,20,1
19-03-2025,Pooja & Spiritual Items,SWASTIK CAMPHORE,12,90,90,0,1
19-03-2025,"Grains, Flours & Dals",JOWAR WHITE 1 KG,4,80,70,10,1
19-03-2025,"Dry Fruits, Nuts & Seeds",Groundnuts 1 kg,2,190,165,25,1
19-03-2025,"Grains, Flours & Dals",BARLEY SEEDS 250GMS,4,40,35,5,1
19-03-2025,"Grains, Flours & Dals",SABDANA 500GM,4,90,70,20,1
19-03-2025,"Grains, Flours & Dals",RAGULU 1 KG,4,70,60,10,1
19-03-2025,"Dry Fruits, Nuts & Seeds",SUNFLOWER SEEDS 250GRM,2,150,130,20,1
19-03-2025,"Dry Fruits, Nuts & Seeds",SATHVI CHIA SEEDS 100GM,2,100,80,20,1
19-03-2025,"Grains, Flours & Dals",HS JOWAR IDLY RAWA,4,65,65,0,1
19-03-2025,"Grains, Flours & Dals",VGR RICE 5 KGS,4,350,325,25,1
19-03-2025,General Household & Kitchenware,MATCH BOX,3,20,20,0,1
19-03-2025,"Dry Fruits, Nuts & Seeds",PUMPKIN SEEDS 250GM,2,200,160,40,1
19-03-2025,Spices & Seasonings,NUVVULU 500GM,15,200,170,30,1
19-03-2025,"Dry Fruits, Nuts & Seeds",WATERMELON SEEDS 250GRM,2,320,280,40,1
19-03-2025,Sweeteners,YB Brown Sugar 1KG,16,140,140,0,1
19-03-2025,"Dry Fruits, Nuts & Seeds",cashew,2,340,310,30,1
19-03-2025,Snacks & Ready-to-Eat,IDLI &amp; DOSA BATTER .T,14,84,84,0,1
19-03-2025,"Grains, Flours & Dals",Wheat Flour 1 kg,4,490,420,70,7
19-03-2025,"Dry Fruits, Nuts & Seeds",SATHVI CHIA SEEDS 100GM,2,100,80,20,1
19-03-2025,Spices & Seasonings,LG 50GM,15,92,92,0,1
19-03-2025,Oils & Ghee,Sesame oil 1 L,9,590,560,30,1
19-03-2025,Spices & Seasonings,EV Chicken Masala 50GM,15,48,48,0,1
19-03-2025,"Grains, Flours & Dals",AISHWARYA SP 1KG,4,400,350,50,5
19-03-2025,Spices & Seasonings,MM CHAT MASALA,15,44,44,0,1
19-03-2025,Sweeteners,NATURAL HONEY 1KG,16,560,480,80,1
19-03-2025,"Grains, Flours & Dals",Wheat Flour 1 kg,4,350,300,50,5
19-03-2025,Oils & Ghee,Coconut oil 500 ml,9,220,200,20,1
19-03-2025,"Grains, Flours & Dals",VGR rice 1 kg,4,140,130,10,2
19-03-2025,Spices & Seasonings,Masala Karam 250 gms,15,130,120,10,1
19-03-2025,Spices & Seasonings,DURGA SALT CRYSTAL 1KG,15,25,25,0,1
19-03-2025,Oils & Ghee,Groundnut oil 1 L,9,360,330,30,1
19-03-2025,Spices & Seasonings,Chilli powder 500 gms,15,290,210,80,1
19-03-2025,Oils & Ghee,Sesame oil 1 L,9,590,560,30,1
19-03-2025,"Grains, Flours & Dals",HS JOWAR IDLY RAWA,4,65,65,0,1
19-03-2025,"Grains, Flours & Dals",Bajra Flour 500 gms,4,35,30,5,1
19-03-2025,"Grains, Flours & Dals",RAGULU 1 KG,4,35,30,5,0.5
19-03-2025,Oils & Ghee,Castor oil 200 ml,9,100,80,20,1
19-03-2025,Spices & Seasonings,NUVVULU 250GM,15,100,85,15,1
19-03-2025,Personal Care & Cosmetics,YB Bath Powder 200GM,10,100,100,0,1
19-03-2025,"Grains, Flours & Dals",VGR rice 1 kg,4,140,130,10,2
19-03-2025,"Health, Wellness & Ayurvedic Products",RB Max Protein Fruit &amp;Nut 50g,5,75,75,0,1
19-03-2025,"Grains, Flours & Dals",RAGI FLOUR 500GRMS,4,40,35,5,1
19-03-2025,Oils & Ghee,Coconut oil 500 ml,9,220,200,20,1
19-03-2025,Snacks & Ready-to-Eat,VD KOBARI LADDU,14,80,80,0,1
19-03-2025,Misc,VD0001,8,100,100,0,1
19-03-2025,Oils & Ghee,Groundnut oil 1 L,9,720,660,60,2
19-03-2025,Snacks & Ready-to-Eat,VD Minapa papad 200gm,14,60,60,0,1
19-03-2025,Spices & Seasonings,DRY MIECHI 200GM,15,80,60,20,1
19-03-2025,Snacks & Ready-to-Eat,SD Sesame laddu with dates250gm,14,135,135,0,1
19-03-2025,Sweeteners,Mishri 500GM,16,70,60,10,1
19-03-2025,Beverages,BRU GREEN LABEL 1.2G,1,48,48,0,24
19-03-2025,Snacks & Ready-to-Eat,KURNOOL MARMURA,14,70,55,15,1
19-03-2025,"Dry Fruits, Nuts & Seeds",BLACK KISMIS 250GM,2,175,140,35,1
19-03-2025,Milk & Dairy,BROWN EGGS 1P,7,84,72,12,6
19-03-2025,General Household & Kitchenware,WDN HDI PONGANALU,3,280,280,0,1
19-03-2025,Sweeteners,MISHRI D,16,40,30,10,1
19-03-2025,Snacks & Ready-to-Eat,VD MURMURA LADDU,14,50,50,0,1
19-03-2025,Spices & Seasonings,SD Curry Leaves Karam Powder 100GM,15,65,65,0,1
19-03-2025,Beverages,BISLERI 2 L,1,60,60,0,2
19-03-2025,Snacks & Ready-to-Eat,SD FINGER Millet with palm Jaggery 250gm,14,135,135,0,1
19-03-2025,Snacks & Ready-to-Eat,BATANA NGT 70GMS,14,20,20,0,1
19-03-2025,Sweeteners,ACHU BELLAM 1KG,16,100,80,20,1
19-03-2025,"Grains, Flours & Dals",CHANA DAL 500GM,4,70,60,10,1
19-03-2025,"Dry Fruits, Nuts & Seeds",Groundnuts 1 kg,2,190,165,25,1
19-03-2025,Spices & Seasonings,Tamarind 500GM,15,160,130,30,1
19-03-2025,Milk & Dairy,SANGAM TONED MILK 500ML,7,30,30,0,1
19-03-2025,Sweeteners,SUGAR 1KG,16,60,50,10,1
19-03-2025,Pooja & Spiritual Items,GB Bharatha Woods 75GM,12,60,60,0,1
19-03-2025,Snacks & Ready-to-Eat,GB SALT COOKIES,14,60,55,5,1
19-03-2025,"Grains, Flours & Dals",BASMATHI RICE 1KG,4,300,270,30,2
19-03-2025,"Grains, Flours & Dals",VGR rice 1 kg,4,350,325,25,5
19-03-2025,Spices & Seasonings,DURGA SALT CRYSTAL 1KG,15,50,50,0,2
19-03-2025,Spices & Seasonings,DRY MIECHI 200GM,15,80,60,20,1
19-03-2025,Spices & Seasonings,WHITE SESAME,15,75,75,0,1
19-03-2025,"Grains, Flours & Dals",VYS.SP RICE 1 KG,4,350,325,25,5
19-03-2025,"Grains, Flours & Dals",PN ORGANIC KALA CHANA 500GM,4,72,72,0,1
19-03-2025,"Health, Wellness & Ayurvedic Products",RB Max Protein Fruit &amp;Nut 50g,5,75,75,0,1
19-03-2025,Misc,ROLL D C,8,70,45,25,1
19-03-2025,"Grains, Flours & Dals",Wheat Flour 1 kg,4,140,120,20,2
19-03-2025,"Grains, Flours & Dals",DH URAD GOTA 1KG,4,430,380,50,2
19-03-2025,"Grains, Flours & Dals",turdal 1kg,4,220,170,50,1
19-03-2025,Snacks & Ready-to-Eat,RI Yogurt Berry Oats 35g,14,50,50,0,1
19-03-2025,"Grains, Flours & Dals",RAGI FLOUR 500GRMS,4,40,35,5,1
19-03-2025,Snacks & Ready-to-Eat,PEANUT CHIKKI,14,22,22,0,1
19-03-2025,Spices & Seasonings,Black Till 250GM,15,90,75,15,1
19-03-2025,"Grains, Flours & Dals",Chana Flour 500 gms,4,70,65,5,1
19-03-2025,"Grains, Flours & Dals",Yellow jowar .F1 kg,4,330,300,30,3
19-03-2025,"Grains, Flours & Dals",POORI ATTA 500GM,4,35,30,5,1
19-03-2025,Spices & Seasonings,SREE MARUTHI IDLY KARAM 200GM,15,60,60,0,1
19-03-2025,Milk & Dairy,HERITAGE BUTTERMILK,7,40,40,0,4
19-03-2025,Milk & Dairy,BROWN EGGS TRAY 30P,7,360,330,30,1
19-03-2025,"Grains, Flours & Dals",BOBBARA PAPPU 500GM,4,85,80,5,1
19-03-2025,"Grains, Flours & Dals",HS MULTI UPMA RAVA,4,65,65,0,1
19-03-2025,Snacks & Ready-to-Eat,SD Atreyapuram DRY Fruit ghee,14,150,150,0,1
19-03-2025,Oils & Ghee,Freedom Rice Bran Oil 1L,9,582,540,42,3
19-03-2025,Snacks & Ready-to-Eat,BATANA NGT 70GMS,14,20,20,0,1
19-03-2025,Sweeteners,SUGAR 1KG,16,60,50,10,1
19-03-2025,"Dry Fruits, Nuts & Seeds",sabja seeds,2,80,70,10,1
19-03-2025,Spices & Seasonings,Elaichi 25GM,15,145,120,25,1
19-03-2025,"Grains, Flours & Dals",Multigrain 1 kg,4,200,170,30,2
19-03-2025,Oils & Ghee,Groundnut oil 1 L,9,720,660,60,2
19-03-2025,Personal Care & Cosmetics,HERBAL BATH POWDER,10,160,160,0,1
19-03-2025,Spices & Seasonings,RED COPRA 250GMS,15,78,78,0,1
19-03-2025,Snacks & Ready-to-Eat,VD BOONDI 175GM,14,60,60,0,1
19-03-2025,"Dry Fruits, Nuts & Seeds",YELLOW KISHMISH 250GM,2,130,110,20,1
19-03-2025,"Grains, Flours & Dals",white Bobarlu 1 KG,4,170,150,20,1
19-03-2025,Snacks & Ready-to-Eat,VD NUVULLU CHIKKI,14,160,160,0,2
19-03-2025,"Grains, Flours & Dals",VYS.SP.RICE BAG 1,4,1800,"1,650.00",150,1
19-03-2025,Oils & Ghee,Safflower oil 1 L,9,440,400,40,1
19-03-2025,"Dry Fruits, Nuts & Seeds",sabja seeds,2,80,70,10,1
19-03-2025,Spices & Seasonings,AVALU 100GM,15,25,20,5,1
19-03-2025,"Grains, Flours & Dals",White jowar.F 1 kg,4,100,80,20,1
19-03-2025,"Grains, Flours & Dals",POORI ATTA 1KG,4,70,60,10,1
19-03-2025,"Grains, Flours & Dals",RAGI FLOUR 1KG,4,80,70,10,1
19-03-2025,"Dry Fruits, Nuts & Seeds",DRYDATES 250GM,2,150,120,30,1
19-03-2025,Milk & Dairy,HERITAGE BUTTERMILK,7,10,10,0,1
19-03-2025,Personal Care & Cosmetics,COLGATE ACTIVE SALT,10,20,20,0,1
19-03-2025,Spices & Seasonings,AV Iodized Salt 1KG,15,28,25,3,1
19-03-2025,"Grains, Flours & Dals",RICE FLOUR 1KG,4,70,55,15,1
19-03-2025,Baking & Cooking Aids,Baking Soda 50GM,0,20,15,5,1
19-03-2025,Snacks & Ready-to-Eat,NGT CHATPATTA CHANA 90GM,14,25,25,0,1
19-03-2025,"Dry Fruits, Nuts & Seeds",SALTED PISTA 250GM,2,400,350,50,1
19-03-2025,"Grains, Flours & Dals",White jowar.F 1 kg,4,100,80,20,1
19-03-2025,"Dry Fruits, Nuts & Seeds",sabja seeds,2,80,70,10,1
19-03-2025,Oils & Ghee,Groundnut oil 1 L,9,360,330,30,1
19-03-2025,Oils & Ghee,Safflower oil 1 L,9,880,800,80,2
19-03-2025,Oils & Ghee,Coconut oil 500 ml,9,440,400,40,2
19-03-2025,Spices & Seasonings,ER GARAM MASALA,15,5,5,0,1
19-03-2025,"Dry Fruits, Nuts & Seeds",SATHVI CHIA SEEDS 100GM,2,100,80,20,1
19-03-2025,Snacks & Ready-to-Eat,VD MURMURA LADDU,14,50,50,0,1
19-03-2025,Oils & Ghee,Groundnut oil 1 L,9,360,330,30,1
19-03-2025,Snacks & Ready-to-Eat,RITEBITE BLUEBERRY BLAST,14,50,50,0,1
19-03-2025,"Grains, Flours & Dals",MAAGAANI W RICE 5KGS,4,899,535,364,1
19-03-2025,"Grains, Flours & Dals",Bajra Flour 500 gms,4,35,30,5,1
19-03-2025,"Grains, Flours & Dals",RAGI FLOUR 500GRMS,4,40,35,5,1
19-03-2025,"Grains, Flours & Dals",Green gram 500 gms,4,75,70,5,1
19-03-2025,Snacks & Ready-to-Eat,VD PALLI CHIKKI,14,80,80,0,1
19-03-2025,"Dry Fruits, Nuts & Seeds",PULMAKHANA 100 GM,2,180,170,10,1
19-03-2025,Oils & Ghee,Groundnut oil 1 L,9,360,330,30,1
19-03-2025,Snacks & Ready-to-Eat,SD FINGER Millet with palm Jaggery 250gm,14,135,135,0,1
19-03-2025,Snacks & Ready-to-Eat,GS Instant Raagi Dosa Mix 400GM,14,99,99,0,1
19-03-2025,Oils & Ghee,Groundnut oil 1 L,9,360,330,30,1
19-03-2025,"Dry Fruits, Nuts & Seeds",SALTED PISTA 250GM,2,400,350,50,1
19-03-2025,Oils & Ghee,Safflower oil 1 L,9,440,400,40,1
19-03-2025,"Dry Fruits, Nuts & Seeds",PLAIN PISTA 250GM,2,660,550,110,1
19-03-2025,Snacks & Ready-to-Eat,VD ARISELU 5 PIC,14,100,100,0,1
19-03-2025,"Dry Fruits, Nuts & Seeds",MAHA BEERA SEEDS 100GM,2,60,60,0,1
19-03-2025,"Grains, Flours & Dals",PESARA PAPPU 1 KG,4,170,145,25,1
19-03-2025,Pooja & Spiritual Items,GD Aiswarya Deepam 700ML,12,195,195,0,1
19-03-2025,Oils & Ghee,Sesame oil 1 L,9,590,560,30,1
19-03-2025,"Grains, Flours & Dals",turdal 1kg,4,220,170,50,1
19-03-2025,Personal Care & Cosmetics,boroline,10,45,45,0,1
19-03-2025,Pooja & Spiritual Items,GOMATHA AGARBATHI,12,75,75,0,1
19-03-2025,Milk & Dairy,BROWN EGGS 1P,7,84,72,12,6
19-03-2025,Snacks & Ready-to-Eat,VD RIBBON PAKODI 175GM,14,60,60,0,1
19-03-2025,Sweeteners,Mishri 500GM,16,140,120,20,2
19-03-2025,"Grains, Flours & Dals",SRILALITHA MAIDA FLOUR 500G,4,32,32,0,1
19-03-2025,"Dry Fruits, Nuts & Seeds",sabja seeds,2,80,70,10,1
19-03-2025,Snacks & Ready-to-Eat,VD PALLI LADDU,14,80,80,0,1
19-03-2025,Snacks & Ready-to-Eat,VD SAGOPAPAD 150GM,14,55,55,0,1
19-03-2025,"Grains, Flours & Dals",Bombay Rava 500GM,4,35,30,5,1
19-03-2025,Snacks & Ready-to-Eat,GS Instant Brown Rice Dosa Mix 400 GM,14,240,240,0,2
19-03-2025,Milk & Dairy,BROWN EGGS TRAY 30P,7,360,330,30,1
19-03-2025,Oils & Ghee,Groundnut oil 5 L,9,1800,"1,600.00",200,1
19-03-2025,"Grains, Flours & Dals",Multigrain 1 kg,4,200,170,30,2
19-03-2025,Spices & Seasonings,Chilli powder 500 gms,15,290,210,80,1
19-03-2025,"Grains, Flours & Dals",ANDU KORRALU (Brown top .mlt) 500,4,130,110,20,1
19-03-2025,"Grains, Flours & Dals",White Chana 250 GM,4,60,50,10,1
19-03-2025,Spices & Seasonings,NUVVULU 500GM,15,160,130,30,1
19-03-2025,"Grains, Flours & Dals",Red uluvalu 250 gms,4,45,40,5,1
19-03-2025,"Grains, Flours & Dals",RAJMA 500GM,4,90,90,0,1
19-03-2025,"Grains, Flours & Dals",Red Bobarlu 500 gms,4,95,85,10,1
19-03-2025,Sweeteners,YB JAGGERY POWDER 500GMS,16,75,75,0,1
19-03-2025,"Grains, Flours & Dals",SAMALU,4,170,130,40,1
19-03-2025,"Grains, Flours & Dals",RAGI FLOUR 1KG,4,80,70,10,1
19-03-2025,Milk & Dairy,HERITAGE BUTTERMILK,7,10,10,0,1
19-03-2025,Beverages,MUA COFFEE EXT STRONG 250GM,1,140,140,0,1
19-03-2025,Sweeteners,NATURAL HONEY 1KG,16,560,480,80,1
19-03-2025,"Grains, Flours & Dals",KORRALU (FOXTAIL M) 1KG,4,150,110,40,1
19-03-2025,Sweeteners,YB Brown Sugar 1KG,16,140,140,0,1
19-03-2025,"Grains, Flours & Dals",SA YELLOW JOWAR RAVA 500GM,4,95,95,0,1
19-03-2025,"Grains, Flours & Dals",Green gram 1 kg,4,150,130,20,1
19-03-2025,"Health, Wellness & Ayurvedic Products",MORINGA LEAF POWDER M,5,80,75,5,1
19-03-2025,"Grains, Flours & Dals",white Bobarlu 500 gms,4,80,75,5,1
19-03-2025,"Grains, Flours & Dals",MAAGAANI SP RICE 20 KGS,4,2300,"1,960.00",340,1
19-03-2025,Milk & Dairy,BROWN EGGS TRAY 30P,7,360,330,30,1
19-03-2025,"Grains, Flours & Dals",SAMALU (Little millet) 1 kg,4,340,260,80,2
19-03-2025,"Grains, Flours & Dals",UDALU (Barnyard millet) 1 kg,4,280,230,50,2
19-03-2025,"Grains, Flours & Dals",RAGI FLOUR 1KG,4,160,140,20,2
19-03-2025,Milk & Dairy,BROWN EGGS 1P,7,140,120,20,10
19-03-2025,Oils & Ghee,OLEEV EXTRA VIRGIN 500ML,9,1100,"1,020.00",80,1
19-03-2025,Snacks & Ready-to-Eat,SD Atreyapuram DRY Fruit ghee,14,150,150,0,1
19-03-2025,Misc,VD0009,8,100,100,0,1
19-03-2025,Snacks & Ready-to-Eat,VD MIXTURE 175 GM,14,60,60,0,1
19-03-2025,Oils & Ghee,GANTASALA A2 COW GHEE 500ML,9,550,550,0,1
19-03-2025,Snacks & Ready-to-Eat,VD SANNAPUSA 175GM,14,60,60,0,1
19-03-2025,Snacks & Ready-to-Eat,VD BOONDI 175GM,14,60,60,0,1
19-03-2025,Snacks & Ready-to-Eat,GREEN FRIED batana,14,20,20,0,1
19-03-2025,"Grains, Flours & Dals",Red Wheat Flour 1 kg,4,140,130,10,1
19-03-2025,"Dry Fruits, Nuts & Seeds",sabja seeds,2,80,70,10,1
19-03-2025,Beverages,REFRESH SHARBATH NORMAL,1,199,190,9,1
19-03-2025,Snacks & Ready-to-Eat,VD MURMURA LADDU,14,50,50,0,1
19-03-2025,Snacks & Ready-to-Eat,NGT CHATPATTA CHANA 90GM,14,75,75,0,3
19-03-2025,"Grains, Flours & Dals",SA Sprouted Ragi Flour 500GM,4,69,69,0,1
19-03-2025,Spices & Seasonings,GS Pink Rock Salt 1KG,15,120,120,0,1
19-03-2025,"Grains, Flours & Dals",HS JOWAR IDLY RAWA,4,65,65,0,1
19-03-2025,Spices & Seasonings,DURGA SALT CRYSTAL 1KG,15,25,25,0,1
19-03-2025,Sweeteners,YB Brown Sugar 500GM,16,75,75,0,1
19-03-2025,"Grains, Flours & Dals",EM kodo upma R 500g,4,129,129,0,1
19-03-2025,"Grains, Flours & Dals",EM Foxtail idli r 500 g,4,327,327,0,3
19-03-2025,"Grains, Flours & Dals",AISHWARYA SP IDLY RAVA 1KG,4,120,66,54,1
19-03-2025,"Grains, Flours & Dals",Em little upma R 500g,4,129,129,0,1
19-03-2025,"Grains, Flours & Dals",DISANO ROLED OATS,4,395,395,0,1
19-03-2025,"Grains, Flours & Dals",Wheat Rava M 500GM,4,33,30,3,1
19-03-2025,"Grains, Flours & Dals",Bajra Flour 1 kg,4,70,60,10,1
19-03-2025,Milk & Dairy,BROWN EGGS TRAY 30P,7,360,330,30,1
19-03-2025,Spices & Seasonings,MM CHAT MASALA,15,44,44,0,1
19-03-2025,"Grains, Flours & Dals",turdal 1kg,4,220,195,25,1
19-03-2025,Milk & Dairy,HERITAGE BUTTERMILK,7,20,20,0,2
19-03-2025,"Grains, Flours & Dals",Wheat Flour 2 kgs,4,140,120,20,1
19-03-2025,Oils & Ghee,Sesame oil 1 L,9,590,560,30,1
19-03-2025,"Grains, Flours & Dals",rajgiri,4,44,44,0,2
19-03-2025,"Grains, Flours & Dals",RAGI FLOUR 500GRMS,4,40,35,5,1
19-03-2025,Spices & Seasonings,GS Pink Rock Salt 1KG,15,120,120,0,1
19-03-2025,Oils & Ghee,Safflower oil 1 L,9,440,400,40,1
19-03-2025,Snacks & Ready-to-Eat,BB VERMICELLI 1KG,14,95,90,5,1
19-03-2025,"Grains, Flours & Dals",White jowar.F 1 kg,4,100,80,20,1
19-03-2025,"Grains, Flours & Dals",PESARA PAPPU 1 KG,4,170,145,25,1
19-03-2025,"Grains, Flours & Dals",Chana Flour 500 gms,4,70,65,5,1
19-03-2025,General Household & Kitchenware,SIRIDHANYALU BOOK,3,200,180,20,1
19-03-2025,"Grains, Flours & Dals",unpolished turdall500grms,4,120,110,10,1
19-03-2025,Sweeteners,SUGAR 500 GM,16,30,25,5,1
19-03-2025,Oils & Ghee,Coconut oil 1 L,9,440,400,40,1
19-03-2025,"Grains, Flours & Dals",Multigrain 1 kg,4,100,85,15,1
19-03-2025,Sweeteners,YB JAGGERY POWDER 500GMS,16,75,75,0,1
19-03-2025,"Grains, Flours & Dals",KORRALU (FOXTAIL M) 500GM,4,65,55,10,1
19-03-2025,"Grains, Flours & Dals",Hs yellow jowar r 500g,4,198,198,0,2
19-03-2025,Snacks & Ready-to-Eat,BELLAM MINAPA SUNADULLU,14,180,180,0,1
19-03-2025,"Grains, Flours & Dals",Arikalu (kodo),4,70,65,5,1
19-03-2025,"Grains, Flours & Dals",ANDU KORRALU (Brown top .mlt) 500,4,130,110,20,1
19-03-2025,Sweeteners,SD PALM JAGGERY 500GM,16,200,200,0,1
19-03-2025,Spices & Seasonings,ROYAL SAFFRON,15,125,125,0,1
19-03-2025,Household & Cleaning,vim small,6,30,30,0,2
19-03-2025,Spices & Seasonings,BIRYANI MASALA,15,30,30,0,2
19-03-2025,"Grains, Flours & Dals",Multigrain 1 kg,4,200,170,30,2
19-03-2025,Snacks & Ready-to-Eat,NGT CHATPATTA CHANA 90GM,14,50,50,0,2
19-03-2025,Personal Care & Cosmetics,margo neem natural,10,180,180,0,1
19-03-2025,"Grains, Flours & Dals",Chana Flour 500 gms,4,140,130,10,2
19-03-2025,Snacks & Ready-to-Eat,GREEN FRIED batana,14,40,40,0,2
19-03-2025,Spices & Seasonings,Tamarind 500GM,15,160,130,30,1
19-03-2025,Snacks & Ready-to-Eat,BB VERMICELLY 500GM,14,53,53,0,1
19-03-2025,Pooja & Spiritual Items,rudraksha malla,12,25,25,0,1
19-03-2025,Spices & Seasonings,SAJEERA,15,60,40,20,1
19-03-2025,Spices & Seasonings,Turmeric powder 250 gms,15,100,75,25,1
19-03-2025,"Grains, Flours & Dals",CORN FLOUR,4,80,70,10,1
19-03-2025,Household & Cleaning,PITAMBARI SHINING POWDER 200G,6,60,60,0,1
19-03-2025,Spices & Seasonings,Dalchin Rolls 50GM,15,70,70,0,1
19-03-2025,Spices & Seasonings,SATHVI ANASAPUVUU 25GM,15,90,65,25,1
19-03-2025,"Grains, Flours & Dals",Urad dall 1 Kg,4,185,170,15,1
19-03-2025,Spices & Seasonings,Lavangam 50GM,15,60,50,10,1
19-03-2025,"Grains, Flours & Dals",Red uluvalu 250 gms,4,45,40,5,1
19-03-2025,"Dry Fruits, Nuts & Seeds",SATHVI CHIA SEEDS 100GM,2,100,80,20,1
19-03-2025,Snacks & Ready-to-Eat,SATHVI REGIVADA 200GM,14,160,120,40,2
19-03-2025,Pickles & Cooking Pastes,SD TAMARIND PICKLE,11,110,110,0,1
19-03-2025,"Dry Fruits, Nuts & Seeds",PUTNALU 500GMS,2,90,76,14,1
19-03-2025,General Household & Kitchenware,B3 BOWL,3,265,265,0,1
19-03-2025,"Dry Fruits, Nuts & Seeds",PRO ORG RAW PEANUTS 500GM,2,174,174,0,1
19-03-2025,"Grains, Flours & Dals",Chana Flour 500 gms,4,70,65,5,1
19-03-2025,Household & Cleaning,SURF EXCEL MATIC FL 1L,6,250,250,0,1
19-03-2025,"Health, Wellness & Ayurvedic Products",j s pnature,5,136,136,0,1
19-03-2025,Snacks & Ready-to-Eat,VD NUVVULU LADDU,14,80,80,0,1
19-03-2025,Spices & Seasonings,NUVVULU 250GM,15,100,85,15,1
19-03-2025,Personal Care & Cosmetics,COW DURBAR TURMERIC 50GM,10,25,25,0,1
19-03-2025,"Grains, Flours & Dals",RAGI FLOUR 500GRMS,4,40,35,5,1
19-03-2025,Spices & Seasonings,MIRYALU 50 GRMS,15,100,80,20,1
19-03-2025,Oils & Ghee,Sesame oil 500ml,9,295,280,15,1
19-03-2025,Pooja & Spiritual Items,GD KUMKUM 50GM,12,30,30,0,1
19-03-2025,Sweeteners,MISHRI 250 GM,16,35,30,5,1
19-03-2025,Snacks & Ready-to-Eat,HS Ragi biscuits,14,50,50,0,1
19-03-2025,Personal Care & Cosmetics,HERBAL BATH POWDER 200GM,10,80,80,0,1
19-03-2025,Pooja & Spiritual Items,AMRUTHA SURABHI,12,80,80,0,1
19-03-2025,"Grains, Flours & Dals",RAGI FLOUR 500GRMS,4,40,35,5,1
19-03-2025,"Grains, Flours & Dals",MAAGAANI LOW GI SP 1KG,4,149,125,24,1
19-03-2025,"Grains, Flours & Dals",Multigrain 1 kg,4,100,85,15,1
19-03-2025,General Household & Kitchenware,SIRIDHANYALU BOOK,3,200,180,20,1
19-03-2025,"Grains, Flours & Dals",FLOUR CHARGE,4,24,24,0,2
19-03-2025,Milk & Dairy,SANGAM TONED MILK 500ML,7,60,60,0,2
19-03-2025,Oils & Ghee,Groundnut oil 1 L,9,360,330,30,1
19-03-2025,"Grains, Flours & Dals",WHEAT 1 KG,4,120,100,20,2
19-03-2025,"Grains, Flours & Dals",AISHWARYA LOW GI RICE 5KG,4,700,525,175,1
19-03-2025,"Grains, Flours & Dals",HS JOWAR IDLY RAWA,4,65,65,0,1
19-03-2025,"Health, Wellness & Ayurvedic Products",SONAMUKHI,5,80,80,0,1
19-03-2025,"Health, Wellness & Ayurvedic Products",MH Millets Malt 1KG,5,400,380,20,1
19-03-2025,Spices & Seasonings,AVALU 100GM,15,25,20,5,1
19-03-2025,"Health, Wellness & Ayurvedic Products",MD Tulasi Leaf Powder 50GM,5,80,80,0,1
18-03-2025,Snacks & Ready-to-Eat,VD PALLI LADDU,14,80,80,0,1
18-03-2025,Snacks & Ready-to-Eat,VD ARISELU 5 PIC,14,100,100,0,1
18-03-2025,Snacks & Ready-to-Eat,Sprouted Ragi Biscuits 450GM,14,150,150,0,1
18-03-2025,Snacks & Ready-to-Eat,BELLAM MINAPA SUNADULLU,14,180,180,0,1
18-03-2025,Beverages,REFRESH SHARBATH NORMAL,1,199,190,9,1
18-03-2025,Milk & Dairy,BROWN EGGS TRAY 30P,7,360,330,30,1
18-03-2025,"Grains, Flours & Dals",MAAGAANI LOW GI SP L 1KG,4,120,105,15,1
18-03-2025,"Dry Fruits, Nuts & Seeds",Groundnuts 500 gms,2,95,85,10,1
18-03-2025,Milk & Dairy,BROWN EGGS 1P,7,140,120,20,10
18-03-2025,"Dry Fruits, Nuts & Seeds",ALMONDS 250GM,2,280,260,20,1
18-03-2025,"Grains, Flours & Dals",SL Idly Rava 1KG,4,65,55,10,1
18-03-2025,Oils & Ghee,Castor oil 200 ml,9,100,80,20,1
18-03-2025,"Grains, Flours & Dals",AISHWARYA SP 5KG,4,400,375,25,1
18-03-2025,"Grains, Flours & Dals",White jowar.F 1 kg,4,100,80,20,1
18-03-2025,Pooja & Spiritual Items,javadhu,12,60,60,0,1
18-03-2025,"Grains, Flours & Dals",JOWAR WHITE 1 KG,4,80,70,10,1
18-03-2025,"Dry Fruits, Nuts & Seeds",WALLNUTS 250GM,2,380,360,20,1
18-03-2025,"Dry Fruits, Nuts & Seeds",PUTNALU 500GMS,2,90,76,14,1
18-03-2025,"Grains, Flours & Dals",Green gram 1 kg,4,150,130,20,1
18-03-2025,"Dry Fruits, Nuts & Seeds",Groundnuts 1 kg,2,190,165,25,1
18-03-2025,"Grains, Flours & Dals",Chana Flour 500 gms,4,70,65,5,1
18-03-2025,"Grains, Flours & Dals",RAGI FLOUR 500GRMS,4,40,35,5,1
18-03-2025,Oils & Ghee,Coconut oil 500 ml,9,220,200,20,1
18-03-2025,"Grains, Flours & Dals",Wheat Flour 1 kg,4,210,180,30,3
18-03-2025,"Grains, Flours & Dals",DH URAD GOTA 1KG,4,215,190,25,1
18-03-2025,Spices & Seasonings,AVALU 250grms,15,60,60,0,1
18-03-2025,"Grains, Flours & Dals",RICE FLOUR 500 GM,4,35,28,7,1
18-03-2025,"Grains, Flours & Dals",turdal 500 gms,4,110,100,10,1
18-03-2025,Oils & Ghee,Groundnut oil 1 L,9,360,330,30,1
18-03-2025,"Grains, Flours & Dals",BARLEY SEEDS 250GMS,4,40,35,5,1
18-03-2025,"Grains, Flours & Dals",AISHWARYA SP 1KG,4,160,140,20,2
18-03-2025,"Grains, Flours & Dals",BASMATHI RICE 1KG,4,150,135,15,1
18-03-2025,Spices & Seasonings,AV Iodized Salt 1KG,15,28,25,3,1
18-03-2025,"Grains, Flours & Dals",SL Idly Rava 1KG,4,65,55,10,1
18-03-2025,Spices & Seasonings,dalchin chekka,15,50,40,10,1
18-03-2025,Spices & Seasonings,3M.MIRCHI POWDER,15,145,115,30,1
18-03-2025,"Grains, Flours & Dals",THICK POHA 1KG,4,160,140,20,2
18-03-2025,Oils & Ghee,Sesame oil 1 L,9,1180,"1,120.00",60,2
18-03-2025,"Grains, Flours & Dals",Urad dall 1 Kg,4,185,170,15,1
18-03-2025,"Dry Fruits, Nuts & Seeds",Groundnuts 1 kg,2,380,330,50,2
18-03-2025,"Grains, Flours & Dals",DESI CHANA,4,25,25,0,1
18-03-2025,"Grains, Flours & Dals",SL Idly Rava 1KG,4,130,110,20,2
18-03-2025,"Grains, Flours & Dals",Wheat Rava M 1KG,4,65,55,10,1
18-03-2025,"Dry Fruits, Nuts & Seeds",ALMONDS 250GM,2,280,260,20,1
18-03-2025,Baking & Cooking Aids,WEIKFIELD CUSTARD POWDER,0,43,43,0,1
18-03-2025,Spices & Seasonings,GREEN SOUNF,15,60,40,20,1
18-03-2025,Snacks & Ready-to-Eat,DISANO VERMICELLI 425 GM,14,50,50,0,1
18-03-2025,Sweeteners,MISHRI 250 GM,16,35,30,5,1
18-03-2025,"Dry Fruits, Nuts & Seeds",sabja seeds,2,80,70,10,1
18-03-2025,"Grains, Flours & Dals",Brown RICE 1KG,4,140,130,10,2
18-03-2025,Snacks & Ready-to-Eat,SD Ginger Candy 100g,14,60,60,0,1
18-03-2025,Pooja & Spiritual Items,GD Dhoop Cones 40GM,12,60,60,0,2
18-03-2025,"Grains, Flours & Dals",RAGI FLOUR 1KG,4,80,70,10,1
18-03-2025,Snacks & Ready-to-Eat,SD FINGER Millet with palm Jaggery 250gm,14,135,135,0,1
18-03-2025,Sweeteners,NATURAL HONEY 1KG,16,560,480,80,1
18-03-2025,Snacks & Ready-to-Eat,VD MURMURA LADDU,14,50,50,0,1
18-03-2025,"Grains, Flours & Dals",VGR rice 1 kg,4,140,130,10,2
18-03-2025,"Grains, Flours & Dals",AISHWARYA SP 1KG,4,400,350,50,5
18-03-2025,Snacks & Ready-to-Eat,VD SAGOPAPAD 150GM,14,55,55,0,1
18-03-2025,"Grains, Flours & Dals",SAMALU (Little millet) 500 gms,4,85,65,20,1
18-03-2025,"Grains, Flours & Dals",RAGI FLOUR 500GRMS,4,40,35,5,1
18-03-2025,"Grains, Flours & Dals",UDALU (Barnyard millet) 500 gms,4,70,60,10,1
18-03-2025,"Grains, Flours & Dals",RAGI FLOUR 1KG,4,80,70,10,1
18-03-2025,Spices & Seasonings,Menthulu 250 gms,15,50,45,5,1
18-03-2025,Snacks & Ready-to-Eat,SATHVI REGIVADA 200GM,14,80,60,20,1
18-03-2025,"Grains, Flours & Dals",SA Sprouted Ragi Flour 500GM,4,69,69,0,1
18-03-2025,Snacks & Ready-to-Eat,MB MULTIMILLET NOODLES 180GM,14,95,95,0,1
18-03-2025,Snacks & Ready-to-Eat,MB FOXTAIL MILLET NOODLES 180GM,14,95,95,0,1
18-03-2025,Personal Care & Cosmetics,WHISPER NIGHTS XL+ 45 PADS,10,480,480,0,1
18-03-2025,"Grains, Flours & Dals",UDALU (Barnyard millet) 1 kg,4,140,115,25,1
18-03-2025,"Grains, Flours & Dals",SAMALU (Little millet) 1 kg,4,170,130,40,1
18-03-2025,"Grains, Flours & Dals",Wheat Flour 5 kgs,4,350,300,50,1
18-03-2025,"Grains, Flours & Dals",ANDU KORRALU (Brown top .mlt) 500,4,130,110,20,1
18-03-2025,"Grains, Flours & Dals",Arikadu ( kodo),4,140,130,10,1
18-03-2025,Oils & Ghee,Safflower oil 1 L,9,440,400,40,1
18-03-2025,Spices & Seasonings,YB Rock Salt 1KG,15,240,240,0,2
18-03-2025,"Grains, Flours & Dals",SABDANA 500GM,4,90,70,20,1
18-03-2025,Household & Cleaning,SURF EXCEL MATIC FL 1L,6,195,195,0,1
18-03-2025,Spices & Seasonings,NUVVULU 250GM,15,100,85,15,1
18-03-2025,"Grains, Flours & Dals",Wheat Rava M 500GM,4,66,60,6,2
18-03-2025,"Grains, Flours & Dals",DISANO OATS 1KG,4,285,142.5,142.5,1
18-03-2025,"Dry Fruits, Nuts & Seeds",PUTNALU 500GMS,2,180,152,28,2
18-03-2025,Household & Cleaning,PITAMBARI SHINING POWDER 200G,6,120,120,0,2
18-03-2025,"Dry Fruits, Nuts & Seeds",Groundnuts 500 gms,2,190,170,20,2
18-03-2025,Pooja & Spiritual Items,SWASTIK CAMPHORE,12,180,180,0,2
18-03-2025,Household & Cleaning,TIDE DOUBLE POWER JASMINE &amp;ROSE,6,66,66,0,1
18-03-2025,Household & Cleaning,VIM SOAP,6,50,50,0,10
18-03-2025,"Grains, Flours & Dals",Chana Flour 500 gms,4,70,65,5,1
18-03-2025,Beverages,REFRESH SHARBATH SUGAR FREE,1,299,285,14,1
18-03-2025,Personal Care & Cosmetics,khadhi aleoera,10,0,0,0,1
18-03-2025,"Health, Wellness & Ayurvedic Products",MADDI NEEM OIL 100ML,5,100,100,0,1
18-03-2025,"Grains, Flours & Dals",BOMBAY RAVA,4,70,55,15,1
18-03-2025,Oils & Ghee,Castor oil 200 ml,9,100,80,20,1
18-03-2025,Snacks & Ready-to-Eat,ZEEDI,14,140,140,0,2
18-03-2025,Beverages,GANTASALA GREEN TEA 100GM,1,149,149,0,1
18-03-2025,Beverages,REFRESH SHARBATH NORMAL,1,199,190,9,1
18-03-2025,"Health, Wellness & Ayurvedic Products",MH Womens Malt 500GM,5,250,240,10,1
18-03-2025,Oils & Ghee,Groundnut oil 500ml,9,180,165,15,1
18-03-2025,General Household & Kitchenware,SIRIDHANYALU BOOK,3,200,180,20,1
18-03-2025,Oils & Ghee,Sesame oil 500ml,9,295,280,15,1
18-03-2025,Snacks & Ready-to-Eat,VD DAHI MIRCHI(SALTED) 100GM,14,45,45,0,1
18-03-2025,Snacks & Ready-to-Eat,MILLET PANCAKE CHOCOLATE,14,199,199,0,1
18-03-2025,"Grains, Flours & Dals",MELMEKER 250GMS,4,60,45,15,1
18-03-2025,Snacks & Ready-to-Eat,BB VERMICELLY 500GM,14,53,53,0,1
18-03-2025,"Grains, Flours & Dals",UNPOLISHED TURDALL 1KG,4,240,210,30,1
18-03-2025,"Grains, Flours & Dals",RAGI FLOUR 500GRMS,4,40,35,5,1
18-03-2025,"Grains, Flours & Dals",AISHWARYA LOW GI RICE 5KG,4,700,525,175,1
18-03-2025,"Grains, Flours & Dals",JOWAR UPMA RAVA,4,150,150,0,2
18-03-2025,Oils & Ghee,Safflower oil 1 L,9,440,400,40,1
18-03-2025,"Grains, Flours & Dals",HS JOWAR FLAKES 250GM 1+1,4,299,299,0,1
18-03-2025,"Grains, Flours & Dals",white Bobarlu 500 gms,4,80,75,5,1
18-03-2025,"Dry Fruits, Nuts & Seeds",Groundnuts 1 kg,2,190,165,25,1
18-03-2025,Spices & Seasonings,Turmeric powder 250 gms,15,200,150,50,2
18-03-2025,Snacks & Ready-to-Eat,VD DAHI MIRCHI(SALTED) 100GM,14,45,45,0,1
18-03-2025,Snacks & Ready-to-Eat,ELITE ELAICHI RUSK 200GM,14,35,35,0,1
18-03-2025,"Grains, Flours & Dals",RAGI FLOUR 500GRMS,4,40,35,5,1
18-03-2025,Snacks & Ready-to-Eat,NGT CHATPATTA CHANA 90GM,14,25,25,0,1
18-03-2025,"Grains, Flours & Dals",THICK POHA 500GM,4,80,70,10,2
18-03-2025,Snacks & Ready-to-Eat,VD MURMURA LADDU,14,50,50,0,1
18-03-2025,Spices & Seasonings,ROYAL SAFFRON,15,125,125,0,1
18-03-2025,"Grains, Flours & Dals",turdal 1kg,4,660,585,75,3
18-03-2025,Pooja & Spiritual Items,GD Aiswarya Deepam 700ML,12,390,390,0,2
18-03-2025,Oils & Ghee,Groundnut oil 5 L,9,1800,"1,600.00",200,1
18-03-2025,Spices & Seasonings,NUVVULU 250GM,15,100,85,15,1
18-03-2025,"Grains, Flours & Dals",Chana Flour 1 kg,4,140,130,10,1
18-03-2025,Spices & Seasonings,Coriander seeds 200 gms,15,48,40,8,1
18-03-2025,Spices & Seasonings,ROYAL SAFFRON 400GRMS,15,65,65,0,1
18-03-2025,Spices & Seasonings,DRY MIECHI 200GM,15,80,60,20,1
18-03-2025,Spices & Seasonings,JEERA 250 gms,15,125,105,20,1
18-03-2025,Spices & Seasonings,LG 50GM,15,276,276,0,3
18-03-2025,"Grains, Flours & Dals",Wheat Flour 1 kg,4,210,180,30,3
18-03-2025,Spices & Seasonings,MIRYALU 50 GRMS,15,200,160,40,2
18-03-2025,Spices & Seasonings,Tamarind 250GMS,15,80,65,15,1
18-03-2025,"Grains, Flours & Dals",Wheat Flour 1 kg,4,140,120,20,2
18-03-2025,Snacks & Ready-to-Eat,urban murmura,14,60,55,5,1
18-03-2025,Spices & Seasonings,Masala Karam 250 gms,15,130,120,10,1
18-03-2025,"Grains, Flours & Dals",Bajra Flour 1 kg,4,70,60,10,1
18-03-2025,"Grains, Flours & Dals",Chana Flour 500 gms,4,70,65,5,1
18-03-2025,"Grains, Flours & Dals",Em Foxtail upma r 500 g,4,109,109,0,1
18-03-2025,"Grains, Flours & Dals",Arikadu ( kodo),4,140,130,10,1
18-03-2025,"Grains, Flours & Dals",KORRALU (FOXTAIL M) 1KG,4,150,110,40,1
18-03-2025,Snacks & Ready-to-Eat,VD MULTI CHAKKA,14,110,110,0,1
18-03-2025,Spices & Seasonings,dalchin chekka,15,50,40,10,1
18-03-2025,"Grains, Flours & Dals",SAMALU,4,170,130,40,1
18-03-2025,"Grains, Flours & Dals",KORRALU (FOXTAIL M) 1KG,4,150,110,40,1
18-03-2025,"Grains, Flours & Dals",Arikadu ( kodo),4,140,130,10,1
18-03-2025,Snacks & Ready-to-Eat,SD Moringa with plam jaggery 250gm,14,135,135,0,1
18-03-2025,Oils & Ghee,Black Sesame oil 1 L,9,440,380,60,1
18-03-2025,Personal Care & Cosmetics,SVE KHADI CARROT GEL 100GM,10,145,145,0,1
18-03-2025,Spices & Seasonings,Masala Karam 250 gms,15,130,120,10,1
18-03-2025,Snacks & Ready-to-Eat,VD PALLI CHIKKI,14,80,80,0,1
18-03-2025,"Grains, Flours & Dals",Wheat Flour 1 kg,4,70,60,10,1
18-03-2025,Oils & Ghee,Sesame oil 1 L,9,590,560,30,1
18-03-2025,Spices & Seasonings,Tamarind 250GMS,15,80,65,15,1
18-03-2025,Oils & Ghee,Safflower oil 1 L,9,440,400,40,1
18-03-2025,Snacks & Ready-to-Eat,SD Aswagandha with palm Jaggery250Gm,14,135,135,0,1
18-03-2025,General Household & Kitchenware,CANDLE,3,60,60,0,2
18-03-2025,Snacks & Ready-to-Eat,FOXTAIL BIS,14,135,135,0,1
18-03-2025,Snacks & Ready-to-Eat,RAJGIRA PEANUT CHIKKI 450GM,14,250,250,0,2
18-03-2025,"Grains, Flours & Dals",Red Chana 250GM,4,35,30,5,1
18-03-2025,Beverages,BRU GREEN LABEL 1.2G,1,40,40,0,20
18-03-2025,"Dry Fruits, Nuts & Seeds",sabja seeds,2,80,70,10,1
18-03-2025,Pooja & Spiritual Items,bilwa patra,12,60,60,0,1
18-03-2025,"Grains, Flours & Dals",FLOUR CHARGE,4,12,12,0,1
18-03-2025,Snacks & Ready-to-Eat,OK MACARONI,14,120,120,0,1
18-03-2025,"Dry Fruits, Nuts & Seeds",PUMPKIN SEEDS 250GM,2,200,160,40,1
18-03-2025,Oils & Ghee,Castor oil 200 ml,9,100,80,20,1
18-03-2025,Sweeteners,NATURAL HONEY 1KG,16,560,480,80,1
18-03-2025,Misc,ROLL D C,8,70,45,25,1
18-03-2025,"Dry Fruits, Nuts & Seeds",PLAIN PISTA 250GM,2,660,550,110,1
18-03-2025,Oils & Ghee,GANTASALA A2 COW GHEE 250ML,9,299,299,0,1
18-03-2025,Snacks & Ready-to-Eat,JUNNU POWDER 100GM,14,70,70,0,1
18-03-2025,Snacks & Ready-to-Eat,VD MANGO JELLY 250GRMS,14,80,80,0,1
18-03-2025,"Grains, Flours & Dals",RAGULU 1 KG,4,70,60,10,1
18-03-2025,"Dry Fruits, Nuts & Seeds",SATHVI CHIA SEEDS 100GM,2,100,80,20,1
18-03-2025,Spices & Seasonings,Vamu 100GM,15,60,50,10,1
18-03-2025,"Health, Wellness & Ayurvedic Products",RB Max Protein Classic Creamy,5,169,169,0,1
18-03-2025,Spices & Seasonings,GS Pink Rock Salt 1KG,15,120,120,0,1
18-03-2025,Oils & Ghee,Coconut oil 500 ml,9,220,200,20,1
18-03-2025,Spices & Seasonings,PRO ORG FENUGREEK 200GM,15,75,75,0,1
18-03-2025,Snacks & Ready-to-Eat,SS IDLY BATTER 1KG,14,60,60,0,1
18-03-2025,Snacks & Ready-to-Eat,VD MURMURA LADDU,14,50,50,0,1
18-03-2025,Snacks & Ready-to-Eat,VD RED CHILLI RICEPAPAD 150GM,14,50,50,0,1
18-03-2025,"Grains, Flours & Dals",KORRALU (FOXTAIL M) 1KG,4,150,110,40,1
18-03-2025,"Grains, Flours & Dals",RAGI FLOUR 500GRMS,4,40,35,5,1
18-03-2025,Spices & Seasonings,ROYAL SAFFRON 400GRMS,15,65,65,0,1
18-03-2025,"Dry Fruits, Nuts & Seeds",sabja seeds,2,80,70,10,1
18-03-2025,Snacks & Ready-to-Eat,RINGS 200GM,14,30,30,0,1
18-03-2025,Sweeteners,Mishri 500GM,16,70,60,10,1
18-03-2025,Snacks & Ready-to-Eat,GB SALT COOKIES,14,120,110,10,2
18-03-2025,Oils & Ghee,Sesame oil 500ml,9,295,280,15,1
18-03-2025,Personal Care & Cosmetics,HEAD& SHOULDERS ANTI DANDRUFF,10,480,360,120,1
18-03-2025,Personal Care & Cosmetics,DOVE HAIR FALL RESCUE CONDITION,10,230,172.5,57.5,1
18-03-2025,"Grains, Flours & Dals",PESARA PAPPU 500GMS,4,85,75,10,1
18-03-2025,Spices & Seasonings,nalla karam powder,15,130,130,0,2
18-03-2025,"Grains, Flours & Dals",Wheat Flour 1 kg,4,70,60,10,1
18-03-2025,Personal Care & Cosmetics,MADDI HIBISCUS HAIR SHAMPOO 500ML,10,300,300,0,1
18-03-2025,"Grains, Flours & Dals",SA WHITE JOWAR RAVA 500GM,4,69,69,0,1
18-03-2025,"Grains, Flours & Dals",Wheat Flour 3 kgs,4,210,180,30,1
18-03-2025,"Grains, Flours & Dals",RAGI FLOUR 1KG,4,80,70,10,1
18-03-2025,"Grains, Flours & Dals",RAGI FLOUR 1KG,4,160,140,20,2
18-03-2025,"Grains, Flours & Dals",SL Idly Rava 1KG,4,195,165,30,3
18-03-2025,"Grains, Flours & Dals",Wheat Flour 500 gms,4,35,30,5,1
18-03-2025,"Grains, Flours & Dals",Quinova 500 gms,4,110,100,10,1
18-03-2025,"Grains, Flours & Dals",JOWAR WHITE 1 KG,4,80,70,10,1
18-03-2025,"Grains, Flours & Dals",PESARA PAPPU 500GMS,4,85,75,10,1
18-03-2025,"Grains, Flours & Dals",RAGULU 1 KG,4,70,60,10,1
18-03-2025,"Grains, Flours & Dals",RAGULU 1 KG,4,35,30,5,0.5
18-03-2025,"Grains, Flours & Dals",split green gram 500 gms,4,75,70,5,1
18-03-2025,"Grains, Flours & Dals",RED TURDAL 500GM,4,75,70,5,1
18-03-2025,Snacks & Ready-to-Eat,SD Thati thandra 200gm,14,150,150,0,1
18-03-2025,"Grains, Flours & Dals",Wheat Flour 2 kgs,4,140,120,20,1
18-03-2025,Oils & Ghee,Coconut oil 500 ml,9,220,200,20,1
18-03-2025,Oils & Ghee,Groundnut oil 1 L,9,360,330,30,1
18-03-2025,"Grains, Flours & Dals",Yellow jowar .F1 kg,4,110,100,10,1
18-03-2025,"Grains, Flours & Dals",Wheat Flour 2 kgs,4,140,120,20,1
18-03-2025,"Grains, Flours & Dals",BOMBAY RAVA,4,70,55,15,1
18-03-2025,Oils & Ghee,Coconut oil 500 ml,9,220,200,20,1
18-03-2025,"Grains, Flours & Dals",THICK POHA 1KG,4,80,70,10,1
18-03-2025,Snacks & Ready-to-Eat,HS Ragi biscuits,14,50,50,0,1
18-03-2025,Household & Cleaning,ROOPERI PITAMBARI SILVER 50ML,6,110,110,0,1
18-03-2025,Snacks & Ready-to-Eat,SF MILLET PANCAKE CLASSIC 150GM,14,149,149,0,1
18-03-2025,Pooja & Spiritual Items,GD Dhoop Cones 40GM,12,30,30,0,1
18-03-2025,"Grains, Flours & Dals",turdal 1kg,4,220,195,25,1
18-03-2025,Oils & Ghee,CASTOR OIL 200ML,9,100,80,20,1
18-03-2025,Snacks & Ready-to-Eat,RAJGIRA PEANUT CHIKKI 450GM,14,125,125,0,1
18-03-2025,Snacks & Ready-to-Eat,VD PALLI CHIKKI,14,80,80,0,1
18-03-2025,Personal Care & Cosmetics,OVAL BODY LOOFAH,10,55,55,0,1
18-03-2025,Sweeteners,MISHRI 250 GM,16,35,30,5,1
18-03-2025,Spices & Seasonings,ROYAL SAFFRON 400GRMS,15,65,65,0,1
18-03-2025,"Grains, Flours & Dals",Red Wheat Flour 1 kg,4,140,130,10,1
18-03-2025,Snacks & Ready-to-Eat,VD NUVULLU CHIKKI,14,80,80,0,1
18-03-2025,"Grains, Flours & Dals",THICK POHA 500GM,4,40,35,5,1
18-03-2025,Snacks & Ready-to-Eat,HS Ragi biscuits,14,50,50,0,1
18-03-2025,Snacks & Ready-to-Eat,ZEEDI,14,70,70,0,1
18-03-2025,"Grains, Flours & Dals",SINGLE POLISH 1KG,4,325,325,0,5
18-03-2025,Snacks & Ready-to-Eat,VD PALLI LADDU,14,80,80,0,1
18-03-2025,Snacks & Ready-to-Eat,Sprouted Ragi Biscuits 450GM,14,150,150,0,1
18-03-2025,Snacks & Ready-to-Eat,VD KOBARI LADDU,14,80,80,0,1
18-03-2025,"Grains, Flours & Dals",Wheat Flour 1 kg,4,70,60,10,1
18-03-2025,"Grains, Flours & Dals",RAGI FLOUR 500GRMS,4,40,35,5,1
18-03-2025,Snacks & Ready-to-Eat,NGT CHATPATTA CHANA 90GM,14,50,50,0,2
18-03-2025,Spices & Seasonings,Tamarind 250GMS,15,80,65,15,1
18-03-2025,"Grains, Flours & Dals",SL Idly Rava 1KG,4,130,110,20,2
18-03-2025,"Grains, Flours & Dals",Chana Flour 500 gms,4,70,65,5,1
18-03-2025,Sweeteners,SUGAR 1KG,16,60,50,10,1
18-03-2025,Snacks & Ready-to-Eat,GB SALT COOKIES,14,60,55,5,1
18-03-2025,Household & Cleaning,PITAMBARI SHINING POWDER 200G,6,60,60,0,1
18-03-2025,"Grains, Flours & Dals",White jowar.F 1 kg,4,200,160,40,2
18-03-2025,Oils & Ghee,Sesame oil 500ml,9,295,280,15,1
18-03-2025,Snacks & Ready-to-Eat,VD PALLI CHIKKI,14,80,80,0,1
18-03-2025,"Grains, Flours & Dals",RAGI FLOUR 500GRMS,4,80,70,10,2
18-03-2025,"Grains, Flours & Dals",Multigrain 1 kg,4,100,85,15,1
18-03-2025,Snacks & Ready-to-Eat,VD RICE SAGO PAPAD 150GM,14,55,55,0,1
18-03-2025,Milk & Dairy,HERITAGE TOTAL CURD 500GM,7,50,50,0,1
18-03-2025,Snacks & Ready-to-Eat,SS IDLY BATTER 1KG,14,60,60,0,1
18-03-2025,Spices & Seasonings,FLAXSEED KARAM,15,75,75,0,1
18-03-2025,Spices & Seasonings,SONTI 50GM,15,30,20,10,1
18-03-2025,Spices & Seasonings,KARAKAYA,15,50,30,20,1
18-03-2025,"Grains, Flours & Dals",RED TURDAL 500GM,4,75,70,5,1
18-03-2025,Spices & Seasonings,ROYAL SAFFRON 400GRMS,15,65,65,0,1
18-03-2025,"Grains, Flours & Dals",CHANA DAL 500GM,4,70,60,10,1
18-03-2025,"Grains, Flours & Dals",BARLEY SEEDS 250GMS,4,40,35,5,1
18-03-2025,"Dry Fruits, Nuts & Seeds",Putnalu 250GM,2,45,38,7,1
18-03-2025,"Grains, Flours & Dals",MAAGAANI LOW GI SP L 1KG,4,1200,"1,050.00",150,10
18-03-2025,"Dry Fruits, Nuts & Seeds",KAJU HALF 250GM,2,310,290,20,1
18-03-2025,"Grains, Flours & Dals",Em Multimillet idli r 500g,4,129,129,0,1
18-03-2025,Spices & Seasonings,ROYAL SAFFRON 400GRMS,15,130,130,0,2
18-03-2025,Snacks & Ready-to-Eat,MARMURA LADDU,14,50,50,0,1
18-03-2025,Sweeteners,YB FOREST HONEY 250GM,16,180,180,0,1
18-03-2025,"Dry Fruits, Nuts & Seeds",PUTNALU 500GMS,2,90,76,14,1
18-03-2025,"Grains, Flours & Dals",White jowar.F 1 kg,4,100,80,20,1
18-03-2025,Sweeteners,MISHRI 250 GM,16,35,30,5,1
18-03-2025,Spices & Seasonings,Menthulu 250 gms,15,50,45,5,1
18-03-2025,"Grains, Flours & Dals",Chana Flour 500 gms,4,210,195,15,3
18-03-2025,"Dry Fruits, Nuts & Seeds",sabja seeds,2,80,70,10,1
18-03-2025,"Grains, Flours & Dals",FLOUR CHARGE,4,36,36,0,3
18-03-2025,Misc,386627138,8,140,130,10,1
18-03-2025,"Grains, Flours & Dals",RAGI FLOUR 500GRMS,4,80,70,10,2
18-03-2025,"Grains, Flours & Dals",SRILATHA RICE RAVVA 500GM,4,35,35,0,1
18-03-2025,"Grains, Flours & Dals",Wheat Flour 2 kgs,4,140,120,20,1
18-03-2025,"Grains, Flours & Dals",Wheat Flour 1 kg,4,70,60,10,1
18-03-2025,"Grains, Flours & Dals",VL Sabdana 500GM,4,77,77,0,1
18-03-2025,Oils & Ghee,Safflower oil 1 L,9,440,400,40,1
18-03-2025,Oils & Ghee,Groundnut oil 1 L,9,1080,990,90,3
18-03-2025,Household & Cleaning,PITAMBARI,6,28,28,0,1
18-03-2025,"Grains, Flours & Dals",SL Idly Rava 1KG,4,130,110,20,2
18-03-2025,"Grains, Flours & Dals",MAIDA 1KG,4,70,60,10,1
18-03-2025,"Grains, Flours & Dals",CHANA DAL 1KG,4,420,360,60,3
18-03-2025,Pooja & Spiritual Items,GD Sree Chandan 50GM,12,50,50,0,1
18-03-2025,"Grains, Flours & Dals",SRILALITHA MAIDA FLOUR 500G,4,32,32,0,1
18-03-2025,"Grains, Flours & Dals",FLOUR CHARGE,4,108,108,0,9
18-03-2025,"Health, Wellness & Ayurvedic Products",ORGANIC MORINGA POWER 100GM,5,249,249,0,1
18-03-2025,"Health, Wellness & Ayurvedic Products",VAMU WATER,5,99,99,0,1
18-03-2025,Sweeteners,YB FOREST HONEY 250GM,16,180,180,0,1
18-03-2025,"Grains, Flours & Dals",KORRALU (FOXTAIL M) 500GM,4,65,55,10,1
18-03-2025,Milk & Dairy,BROWN EGGS 1P,7,84,72,12,6
18-03-2025,"Grains, Flours & Dals",RAGI FLOUR 500GRMS,4,40,35,5,1
18-03-2025,"Grains, Flours & Dals",ROXY POORI ATTA 1KG,4,150,150,0,2
18-03-2025,"Grains, Flours & Dals",Chana Flour 1 kg,4,280,260,20,2
18-03-2025,"Grains, Flours & Dals",Urad dall 1 Kg,4,185,170,15,1
18-03-2025,Oils & Ghee,BUFFALLO GHEE 500ML,9,820,740,80,2
18-03-2025,"Grains, Flours & Dals",AISHWARYA SP 25KG,4,1999,"1,690.00",309,1
18-03-2025,"Grains, Flours & Dals",AISHWARYA SP 1KG,4,40,35,5,0.5
18-03-2025,"Grains, Flours & Dals",SABDANA 500GM,4,90,70,20,1
18-03-2025,"Dry Fruits, Nuts & Seeds",ANJEER 250GM,2,800,720,80,2
18-03-2025,Oils & Ghee,Groundnut oil 1 L,9,1080,990,90,3
18-03-2025,Snacks & Ready-to-Eat,VD DRY FRUIT PUTHAREKULU,14,120,120,0,1
18-03-2025,Oils & Ghee,Groundnut oil 1 L,9,360,330,30,1
18-03-2025,Pooja & Spiritual Items,SWASTIK CAMPHOR 25GM,12,45,45,0,1
18-03-2025,Spices & Seasonings,THREE MANGO RAI 200G,15,42,42,0,1
18-03-2025,"Health, Wellness & Ayurvedic Products",MD Fenugreek Choornam 100GM,5,80,80,0,1
18-03-2025,Pooja & Spiritual Items,SWASTIK CAMPHORE,12,90,90,0,1
18-03-2025,Snacks & Ready-to-Eat,VD MINAPA MIRCHI PAPAD 195GM,14,120,120,0,2
18-03-2025,"Grains, Flours & Dals",Sathya Javva Wheat Rava 500GM,4,95,95,0,1
18-03-2025,Oils & Ghee,Groundnut oil 1 L,9,360,330,30,1
18-03-2025,Spices & Seasonings,GARAM MASALA 200GM,15,120,95,25,1
18-03-2025,Spices & Seasonings,Masala Karam 250 gms,15,130,120,10,1
18-03-2025,Spices & Seasonings,3M.MIRCHI POWDER,15,145,115,30,1
18-03-2025,Spices & Seasonings,Tamarind 250GMS,15,80,65,15,1
18-03-2025,Spices & Seasonings,DRY MIECHI 200GM,15,80,60,20,1
18-03-2025,Beverages,BISLERI 100ml,1,30,30,0,3
18-03-2025,Spices & Seasonings,DHANIYA POWDER 200GM,15,100,85,15,1
18-03-2025,"Grains, Flours & Dals",BASMATHI RICE 1KG,4,450,405,45,3
18-03-2025,Sweeteners,SUGAR 1KG,16,180,150,30,3
18-03-2025,"Grains, Flours & Dals",AISHWARYA SP 1KG,4,320,280,40,4
18-03-2025,Snacks & Ready-to-Eat,GROUNDNUT LADDU WITH DATES,14,135,135,0,1
18-03-2025,Snacks & Ready-to-Eat,BELLAM MINAPA SUNADULLU,14,180,180,0,1
18-03-2025,"Grains, Flours & Dals",Multigrain 1 kg,4,300,255,45,3
18-03-2025,"Health, Wellness & Ayurvedic Products",RB Max Protein Fruit &amp;Nut 50g,5,75,75,0,1
18-03-2025,Spices & Seasonings,Vamu 100GM,15,60,50,10,1
18-03-2025,Spices & Seasonings,Jeera 100GM,15,50,45,5,1
18-03-2025,"Grains, Flours & Dals",SH CHANA DAL 500GM,4,89,89,0,1
18-03-2025,"Grains, Flours & Dals",URAD DALL,4,95,85,10,1
18-03-2025,"Grains, Flours & Dals",PESARA PAPPU 500GMS,4,85,75,10,1
18-03-2025,"Dry Fruits, Nuts & Seeds",PRO ORG RAW PEANUTS 500GM,2,174,174,0,1
18-03-2025,"Grains, Flours & Dals",sf moong whole,4,122,122,0,1
18-03-2025,"Dry Fruits, Nuts & Seeds",cashew,2,340,310,30,1
18-03-2025,"Dry Fruits, Nuts & Seeds",DRYDATES 250GM,2,150,120,30,1
18-03-2025,"Dry Fruits, Nuts & Seeds",ALMONDS 250GM,2,280,260,20,1
17-03-2025,Personal Care & Cosmetics,ORAL B KIDS,10,25,25,0,1
17-03-2025,Oils & Ghee,Groundnut oil 1 L,9,720,660,60,2
17-03-2025,Spices & Seasonings,Chilli powder 500 gms,15,290,210,80,1
17-03-2025,"Grains, Flours & Dals",Brown RICE 1KG,4,70,65,5,1
17-03-2025,Personal Care & Cosmetics,DWIBHASHI GULABA ARKA ROSA WATER,10,60,60,0,1
17-03-2025,Sweeteners,YB JAGGERY POWDER 1KG,16,280,280,0,2
17-03-2025,Oils & Ghee,Groundnut oil 500ml,9,180,165,15,1
17-03-2025,Oils & Ghee,Sesame oil 1 L,9,590,560,30,1
17-03-2025,Snacks & Ready-to-Eat,VD MANGO JELLY 250GRMS,14,80,80,0,1
17-03-2025,"Health, Wellness & Ayurvedic Products",RB Max Protein Fruit &amp;Nut 50g,5,75,75,0,1
17-03-2025,Snacks & Ready-to-Eat,NGT CHATPATTA CHANA 90GM,14,25,25,0,1
17-03-2025,Spices & Seasonings,Chilli powder 500 gms,15,290,210,80,1
17-03-2025,Snacks & Ready-to-Eat,VD BELLAM GAVVALU 200GM,14,60,60,0,1
17-03-2025,Oils & Ghee,Coconut oil 500 ml,9,220,200,20,1
17-03-2025,General Household & Kitchenware,ODONIL JASMINE FRESH 150ML,3,120,120,0,1
17-03-2025,"Grains, Flours & Dals",AISHWARYA SP 5KG,4,400,375,25,1
17-03-2025,Snacks & Ready-to-Eat,PEANUT CHILLI,14,5,5,0,1
17-03-2025,Snacks & Ready-to-Eat,VD NUVULU LADDU 9PIC,14,100,100,0,1
17-03-2025,Snacks & Ready-to-Eat,VD SANNAPUSA 175GM,14,60,60,0,1
17-03-2025,Snacks & Ready-to-Eat,VD Pappu Chekkalu 190gm,14,60,60,0,1
17-03-2025,Oils & Ghee,Sesame oil 500ml,9,295,280,15,1
17-03-2025,Oils & Ghee,oleev pomace oil 1,9,1100,"1,100.00",0,1
17-03-2025,Snacks & Ready-to-Eat,MIGHTY PUFFS CHEDDAR CHEESE,14,25,25,0,1
17-03-2025,"Grains, Flours & Dals",White jowar.F 1 kg,4,100,80,20,1
17-03-2025,Snacks & Ready-to-Eat,VD ARISELU 5 PIC,14,100,100,0,1
17-03-2025,Spices & Seasonings,Turmeric powder 250 gms,15,100,75,25,1
17-03-2025,Sweeteners,ACHU BELLAM 1KG,16,100,80,20,1
17-03-2025,Oils & Ghee,Black Sesame oil 1 L,9,440,380,60,1
17-03-2025,General Household & Kitchenware,MATCH BOX,3,20,20,0,1
17-03-2025,Oils & Ghee,Mustard oil 500 ml,9,220,195,25,1
17-03-2025,Snacks & Ready-to-Eat,SATHVI REGIVADA 200GM,14,80,60,20,1
17-03-2025,Snacks & Ready-to-Eat,NGT CHATPATTA CHANA 90GM,14,25,25,0,1
17-03-2025,Spices & Seasonings,KALONJI SEEDS,15,90,80,10,1
17-03-2025,"Dry Fruits, Nuts & Seeds",DRYDATES YELLOW 250GM,2,135,120,15,1
17-03-2025,Snacks & Ready-to-Eat,SD Thati thandra 200gm,14,150,150,0,1
17-03-2025,Snacks & Ready-to-Eat,BATANA NGT 70GMS,14,40,40,0,2
17-03-2025,Oils & Ghee,Safflower oil 500 ml,9,220,200,20,1
17-03-2025,Snacks & Ready-to-Eat,VD PALLI LADDU,14,80,80,0,1
17-03-2025,Beverages,BRU GREEN LABEL 1.2G,1,48,48,0,24
17-03-2025,"Grains, Flours & Dals",YB CHITTIMUTYALU RICE 1KG,4,200,200,0,1
17-03-2025,"Grains, Flours & Dals",BASMATHI RICE 1KG,4,150,135,15,1
17-03-2025,Oils & Ghee,Sesame oil 5 L,9,2950,"2,750.00",200,1
17-03-2025,"Grains, Flours & Dals",BOMBAY RAVA,4,70,55,15,1
17-03-2025,Snacks & Ready-to-Eat,VD KOBARI LADDU,14,160,160,0,2
17-03-2025,Milk & Dairy,BROWN EGGS TRAY 30P,7,360,330,30,1
17-03-2025,Spices & Seasonings,NUVVULU 250GM,15,100,85,15,1
17-03-2025,Pooja & Spiritual Items,GD Bhagavatha Mallika 75GM,12,60,60,0,1
17-03-2025,"Dry Fruits, Nuts & Seeds",cashew,2,340,310,30,1
17-03-2025,Snacks & Ready-to-Eat,SD Ginger Candy 100g,14,60,60,0,1
17-03-2025,Pooja & Spiritual Items,SWASTIK CAMPHORE,12,90,90,0,1
17-03-2025,Oils & Ghee,Sesame oil 500ml,9,295,280,15,1
17-03-2025,"Grains, Flours & Dals",SPLIT BLACK GRAM 500 GM,4,90,85,5,1
17-03-2025,"Grains, Flours & Dals",BARLEY FLOUR 250GM,4,45,40,5,1
17-03-2025,"Dry Fruits, Nuts & Seeds",Groundnuts 500 gms,2,95,85,10,1
17-03-2025,Snacks & Ready-to-Eat,VD NUVULLU CHIKKI,14,80,80,0,1
17-03-2025,"Dry Fruits, Nuts & Seeds",Putnalu 250GM,2,45,38,7,1
17-03-2025,"Grains, Flours & Dals",Sathya Javva Wheat Rava 500GM,4,95,95,0,1
17-03-2025,Snacks & Ready-to-Eat,NGT CHATPATTA CHANA 90GM,14,25,25,0,1
17-03-2025,Pickles & Cooking Pastes,SD AMALA PICKLE,11,110,110,0,1
17-03-2025,Pickles & Cooking Pastes,SD LEMON PICKLE,11,110,110,0,1
17-03-2025,Snacks & Ready-to-Eat,urban murmura,14,60,55,5,1
17-03-2025,"Grains, Flours & Dals",UDALU (Barnyard millet) 1 kg,4,140,115,25,1
17-03-2025,"Grains, Flours & Dals",turdal 1kg,4,220,195,25,1
17-03-2025,Sweeteners,SUGAR 500 GM,16,30,25,5,1
17-03-2025,"Grains, Flours & Dals",idly/Dosa rice 1 kg,4,210,180,30,3
17-03-2025,Snacks & Ready-to-Eat,VD DAHI MIRCHI(SALTED) 100GM,14,45,45,0,1
17-03-2025,Pickles & Cooking Pastes,SD TOMATO PICKLE,11,110,110,0,1
17-03-2025,Snacks & Ready-to-Eat,VD PALLI CHIKKI,14,80,80,0,1
17-03-2025,"Grains, Flours & Dals",CHANA DAL 500GM,4,70,60,10,1
17-03-2025,Snacks & Ready-to-Eat,MB PEARL MILLET NOODLES 180GM,14,95,95,0,1
17-03-2025,Oils & Ghee,Groundnut oil 1 L,9,720,660,60,2
17-03-2025,Pickles & Cooking Pastes,SD MANGO PICKLE,11,110,110,0,1
17-03-2025,"Grains, Flours & Dals",RAGI FLOUR 1KG,4,80,70,10,1
17-03-2025,Sweeteners,GS A2 Buffalo Ghee 500ML,16,550,550,0,1
17-03-2025,"Grains, Flours & Dals",unpolished turdall500grms,4,120,110,10,1
17-03-2025,Sweeteners,MISHRI 250 GM,16,35,30,5,1
17-03-2025,"Grains, Flours & Dals",Wheat Flour 1 kg,4,70,60,10,1
17-03-2025,"Grains, Flours & Dals",Multigrain 1 kg,4,200,170,30,2
17-03-2025,Sweeteners,NATURAL HONEY 1KG,16,560,480,80,1
17-03-2025,"Grains, Flours & Dals",Chana Flour 500 gms,4,70,65,5,1
17-03-2025,"Grains, Flours & Dals",KORRALU (FOXTAIL M) 500GM,4,65,55,10,1
17-03-2025,"Grains, Flours & Dals",Wheat Flour 1 kg,4,70,60,10,1
17-03-2025,Oils & Ghee,cow ghee 500 ml,9,860,780,80,2
17-03-2025,Oils & Ghee,Coconut oil 1 L,9,440,400,40,1
17-03-2025,"Grains, Flours & Dals",THICK POHA 500GM,4,40,35,5,1
17-03-2025,Snacks & Ready-to-Eat,RINGS 200GM,14,30,30,0,1
17-03-2025,"Grains, Flours & Dals",Wheat Rava M 500GM,4,33,30,3,1
17-03-2025,"Grains, Flours & Dals",PESARA PAPPU 500GMS,4,85,75,10,1
17-03-2025,Oils & Ghee,Sesame oil 1 L,9,590,560,30,1
17-03-2025,Oils & Ghee,Safflower oil 1 L,9,440,400,40,1
17-03-2025,Snacks & Ready-to-Eat,Corn Chips 250GM,14,40,35,5,1
17-03-2025,Spices & Seasonings,SH CASSIA STICKS 50GM,15,75,75,0,1
17-03-2025,Oils & Ghee,Sesame oil 500ml,9,295,280,15,1
17-03-2025,Pooja & Spiritual Items,BALAJI SANDAL DHOOP STICKS 10STK,12,125,125,0,1
17-03-2025,"Grains, Flours & Dals",AISHWARYA SP 5KG,4,400,375,25,1
17-03-2025,Pooja & Spiritual Items,javadhu,12,60,60,0,1
17-03-2025,Snacks & Ready-to-Eat,VD MURMURA LADDU,14,50,50,0,1
17-03-2025,Oils & Ghee,Black Sesame oil 500 ml,9,220,190,30,1
17-03-2025,Oils & Ghee,Coconut oil 500 ml,9,220,200,20,1
17-03-2025,Snacks & Ready-to-Eat,VD RIBBON PAKODI 175GM,14,60,60,0,1
17-03-2025,Snacks & Ready-to-Eat,VD RICE MURUKU 150GM,14,50,50,0,1
17-03-2025,"Grains, Flours & Dals",SRILATHA RICE RAVVA 500GM,4,70,70,0,2
17-03-2025,Snacks & Ready-to-Eat,MILK BREAD,14,55,55,0,1
17-03-2025,Snacks & Ready-to-Eat,VD DAHI MIRCHI(SALTED) 100GM,14,45,45,0,1
17-03-2025,"Dry Fruits, Nuts & Seeds",BLACK KISMIS 250GM,2,175,140,35,1
17-03-2025,Spices & Seasonings,ROYAL SAFFRON 400GRMS,15,65,65,0,1
17-03-2025,"Grains, Flours & Dals",White jowar.F 1 kg,4,100,80,20,1
17-03-2025,Spices & Seasonings,Turmeric powder 250 gms,15,100,75,25,1
17-03-2025,"Grains, Flours & Dals",split green gram 1 kg,4,150,140,10,1
17-03-2025,Sweeteners,NATURAL HONEY 1KG,16,560,480,80,1
17-03-2025,General Household & Kitchenware,NIPPO,3,108,108,0,6
17-03-2025,Pooja & Spiritual Items,SWASTIK CAMPHOR 25GM,12,45,45,0,1
17-03-2025,Spices & Seasonings,Vamu 100GM,15,60,50,10,1
17-03-2025,"Grains, Flours & Dals",Wheat Flour 1 kg,4,70,60,10,1
17-03-2025,"Grains, Flours & Dals",Wheat Flour 1 kg,4,70,60,10,1
17-03-2025,"Grains, Flours & Dals",split black gram 1 kg,4,180,170,10,1
17-03-2025,"Grains, Flours & Dals",MELMEKER 250GMS,4,60,45,15,1
17-03-2025,Spices & Seasonings,SAJEERA,15,60,40,20,1
17-03-2025,Snacks & Ready-to-Eat,PEANUT CHIKKI,14,22,22,0,1
17-03-2025,"Health, Wellness & Ayurvedic Products",MD Aamlaki Choornam 100GM,5,100,100,0,1
17-03-2025,"Grains, Flours & Dals",Multigrain 1 kg,4,100,85,15,1
17-03-2025,"Grains, Flours & Dals",AISHWARYA SP 1KG,4,400,350,50,5
17-03-2025,Snacks & Ready-to-Eat,DOSA BATTER 1KG,14,60,60,0,1
17-03-2025,Spices & Seasonings,Turmeric powder 250 gms,15,100,75,25,1
17-03-2025,Sweeteners,Mishri 500GM,16,70,60,10,1
17-03-2025,Sweeteners,ACHU BELLAM 1KG,16,100,80,20,1
17-03-2025,"Grains, Flours & Dals",SAMALU,4,170,130,40,1
17-03-2025,"Grains, Flours & Dals",Arikadu ( kodo),4,140,130,10,1
17-03-2025,Spices & Seasonings,SREE MARUTHI IDLY KARAM 200GM,15,60,60,0,1
17-03-2025,"Grains, Flours & Dals",THICK POHA 1KG,4,80,70,10,1
17-03-2025,Spices & Seasonings,Tamarind 500GM,15,320,260,60,2
17-03-2025,Spices & Seasonings,EV Chicken Masala 50GM,15,48,48,0,1
17-03-2025,Spices & Seasonings,GARAM MASALA 200GM,15,240,190,50,2
17-03-2025,Spices & Seasonings,AV Iodized Salt 1KG,15,28,25,3,1
17-03-2025,Spices & Seasonings,BIRYANI LEAF 10GM,15,60,40,20,2
17-03-2025,Milk & Dairy,BROWN EGGS TRAY 30P,7,360,330,30,1
17-03-2025,Snacks & Ready-to-Eat,urban murmura,14,60,55,5,1
17-03-2025,Oils & Ghee,Groundnut oil 1 L,9,360,330,30,1
17-03-2025,Oils & Ghee,Safflower oil 500 ml,9,220,200,20,1
17-03-2025,Snacks & Ready-to-Eat,MILK BREAD,14,55,55,0,1
17-03-2025,Oils & Ghee,Coconut oil 1 L,9,440,400,40,1
17-03-2025,Oils & Ghee,Sesame oil 1 L,9,1180,"1,120.00",60,2
17-03-2025,Oils & Ghee,Groundnut oil 5 L,9,1800,"1,600.00",200,1
17-03-2025,Oils & Ghee,Groundnut oil 1 L,9,360,330,30,1
17-03-2025,Snacks & Ready-to-Eat,VD MURMURA LADDU,14,50,50,0,1
17-03-2025,Oils & Ghee,Safflower oil 1 L,9,440,400,40,1
17-03-2025,"Grains, Flours & Dals",UDALU (Barnyard millet) 500 gms,4,70,60,10,1
17-03-2025,"Grains, Flours & Dals",KORRALU (FOXTAIL M) 500GM,4,65,55,10,1
17-03-2025,"Grains, Flours & Dals",SINGLE POLISH 1KG,4,130,130,0,2
17-03-2025,Pooja & Spiritual Items,GD Camphor 50GM,12,115,115,0,1
17-03-2025,Pooja & Spiritual Items,GD Sree Chandan 50GM,12,50,50,0,1
17-03-2025,Snacks & Ready-to-Eat,VAKKALU,14,80,60,20,1
17-03-2025,Pooja & Spiritual Items,GD Aiswarya Deepam 700ML,12,195,195,0,1
17-03-2025,Misc,VD0009,8,100,100,0,1
17-03-2025,Baking & Cooking Aids,Baking Soda 50GM,0,20,15,5,1
17-03-2025,Spices & Seasonings,GD Turmeric 50GM,15,25,25,0,1
17-03-2025,Milk & Dairy,BROWN EGGS 1P,7,140,120,20,10
17-03-2025,Snacks & Ready-to-Eat,GANTASALA GINGER CANDY 200GM,14,115,115,0,1
17-03-2025,Pooja & Spiritual Items,GD KUMKUM 50GM,12,30,30,0,1
17-03-2025,"Grains, Flours & Dals",CORN FOUR 250GM,4,40,35,5,1
17-03-2025,Snacks & Ready-to-Eat,SF COOKIES CHOCO RAGI,14,99,99,0,1
17-03-2025,Snacks & Ready-to-Eat,VD PALLI LADDU,14,80,80,0,1
17-03-2025,Snacks & Ready-to-Eat,TILLI CHIKKI,14,5,5,0,1
17-03-2025,Misc,VD0009,8,100,100,0,1
17-03-2025,Spices & Seasonings,SH MUSTARD 100GM,15,30,30,0,1
17-03-2025,Oils & Ghee,cow ghee 500 ml,9,430,390,40,1
17-03-2025,Spices & Seasonings,Jeera 100GM,15,50,45,5,1
17-03-2025,Snacks & Ready-to-Eat,VD PAPPU CHEGODI 200GM,14,60,60,0,1
17-03-2025,Milk & Dairy,BROWN EGGS 1P,7,168,144,24,12
17-03-2025,"Grains, Flours & Dals",Em kodo idli R 500G,4,129,129,0,1
17-03-2025,Oils & Ghee,Coconut oil 500 ml,9,660,600,60,3
17-03-2025,"Grains, Flours & Dals",Em Multimillet idli r 500g,4,258,258,0,2
17-03-2025,Pooja & Spiritual Items,GD Dhoop Sticks 26GM,12,900,900,0,45
17-03-2025,"Grains, Flours & Dals",EM kodo upma R 500g,4,645,645,0,5
17-03-2025,Sweeteners,YB JAGGERY POWDER 1KG,16,140,140,0,1
17-03-2025,Snacks & Ready-to-Eat,SF MILLET NOODLES MILD MASALA 192GM,14,258,258,0,2
17-03-2025,Snacks & Ready-to-Eat,GS Instant Brown Rice Dosa Mix 400 GM,14,240,240,0,2
17-03-2025,"Grains, Flours & Dals",HS BARLEY FLAKES 250GM 1+1,4,238,238,0,2
17-03-2025,Snacks & Ready-to-Eat,GS Moongdal Dosa Mix 400GM,14,140,140,0,1
17-03-2025,Snacks & Ready-to-Eat,GS Instant Raagi Dosa Mix 400GM,14,198,198,0,2
17-03-2025,Snacks & Ready-to-Eat,INSTANT JOWAR DOSA MIX,14,240,240,0,2
17-03-2025,Snacks & Ready-to-Eat,SD Atreyapuram DRY Fruit ghee,14,150,150,0,1
17-03-2025,Snacks & Ready-to-Eat,VD MULTI CHAKKA,14,110,110,0,1
17-03-2025,Snacks & Ready-to-Eat,JUNNU POWDER 100GM,14,70,70,0,1
17-03-2025,Snacks & Ready-to-Eat,VD ARISELU 5 PIC,14,100,100,0,1
17-03-2025,"Grains, Flours & Dals",SPLIT BLACK GRAM 500 GM,4,90,85,5,1
17-03-2025,"Grains, Flours & Dals",unpolished turdall500grms,4,120,110,10,1
17-03-2025,"Grains, Flours & Dals",RED TURDAL 500GM,4,75,70,5,1
17-03-2025,"Grains, Flours & Dals",split green gram 500 gms,4,75,70,5,1
17-03-2025,Spices & Seasonings,SONTI 50GM,15,30,20,10,1
17-03-2025,Spices & Seasonings,Miriyalu 50GM,15,100,80,20,1
17-03-2025,Spices & Seasonings,dalchin chekka,15,50,40,10,1
17-03-2025,"Grains, Flours & Dals",chana dall,4,35,30,5,1
17-03-2025,Spices & Seasonings,Jeera 100GM,15,50,45,5,1
17-03-2025,Spices & Seasonings,GREEN SOUNF,15,60,40,20,1
17-03-2025,Spices & Seasonings,Vamu 100GM,15,60,50,10,1
17-03-2025,"Dry Fruits, Nuts & Seeds",SATHVI CHIA SEEDS 100GM,2,100,80,20,1
17-03-2025,"Health, Wellness & Ayurvedic Products",RB Peanut butter Peanuts Dark 40g,5,45,45,0,1
17-03-2025,"Grains, Flours & Dals",Arikadu ( kodo),4,140,130,10,1
17-03-2025,"Grains, Flours & Dals",ANDU KORRALU (Browntop.m) 1 kg,4,260,220,40,1
17-03-2025,"Health, Wellness & Ayurvedic Products",MORINGA LEAF POWDER M,5,80,75,5,1
17-03-2025,Spices & Seasonings,SWEET SOUNF,15,20,20,0,1
17-03-2025,"Grains, Flours & Dals",KORRALU (FOXTAIL M) 1KG,4,150,110,40,1
17-03-2025,"Grains, Flours & Dals",SAMALU,4,170,130,40,1
17-03-2025,"Grains, Flours & Dals",UDALU (Barnyard millet) 1 kg,4,140,115,25,1
17-03-2025,"Health, Wellness & Ayurvedic Products",MADDI NEEM OIL 100ML,5,60,60,0,1
17-03-2025,Oils & Ghee,Sesame oil 1 L,9,590,560,30,1
17-03-2025,"Grains, Flours & Dals",Chana Flour 500 gms,4,17.5,16.25,1.25,0.25
17-03-2025,"Grains, Flours & Dals",Multigrain 3 kgs,4,300,255,45,1
17-03-2025,Oils & Ghee,Groundnut oil 5 L,9,1800,"1,600.00",200,1
17-03-2025,Oils & Ghee,Sesame oil 1 L,9,590,560,30,1
17-03-2025,Oils & Ghee,Safflower oil 1 L,9,440,400,40,1
17-03-2025,"Grains, Flours & Dals",Wheat Flour 2 kgs,4,140,120,20,1
17-03-2025,Oils & Ghee,cow ghee 500 ml,9,410,370,40,1
17-03-2025,Snacks & Ready-to-Eat,VD CORNFLAKES MIXTURE 175GM,14,60,60,0,1
17-03-2025,"Health, Wellness & Ayurvedic Products",JAMBU SEED CHOORNAM 100GM,5,80,80,0,1
17-03-2025,Sweeteners,YB Brown Sugar 500GM,16,75,75,0,1
17-03-2025,Oils & Ghee,Sesame oil 500ml,9,295,280,15,1
17-03-2025,Oils & Ghee,Safflower oil 500 ml,9,220,200,20,1
17-03-2025,"Grains, Flours & Dals",Chana Flour 500 gms,4,70,65,5,1
17-03-2025,"Grains, Flours & Dals",Idly Rava L 1KG,4,60,50,10,1
17-03-2025,"Dry Fruits, Nuts & Seeds",PULMAKHANA 100 GM,2,180,170,10,1
17-03-2025,Snacks & Ready-to-Eat,VD KOBARI LADDU,14,80,80,0,1
17-03-2025,"Dry Fruits, Nuts & Seeds",Putnalu 250GM,2,45,38,7,1
17-03-2025,"Grains, Flours & Dals",Wheat Flour 1 kg,4,70,60,10,1
17-03-2025,"Grains, Flours & Dals",URAD DALL,4,95,85,10,1
17-03-2025,Milk & Dairy,HRITAGE TOTAL CURD 130GM,7,10,10,0,1
17-03-2025,Milk & Dairy,BROWN EGGS 1P,7,196,168,28,14
17-03-2025,Milk & Dairy,HERITAGE BUTTERMILK,7,20,20,0,2
17-03-2025,"Grains, Flours & Dals",turdal 500 gms,4,110,100,10,1
17-03-2025,"Dry Fruits, Nuts & Seeds",Groundnuts 1 kg,2,380,330,50,2
17-03-2025,Snacks & Ready-to-Eat,PEANUT CHIKKI 450GM,14,375,375,0,3
17-03-2025,Snacks & Ready-to-Eat,ELITE MILK RUSK 200GM,14,105,105,0,3
17-03-2025,Personal Care & Cosmetics,DWI NEEM TULSI SOAP 100GM,10,150,150,0,2
17-03-2025,Snacks & Ready-to-Eat,VD MULTI CHAKKA,14,330,330,0,3
17-03-2025,Snacks & Ready-to-Eat,SD Thati thandra 200gm,14,150,150,0,1
17-03-2025,Snacks & Ready-to-Eat,VD NUVULU PAPAD 200GM,14,200,200,0,2
17-03-2025,Personal Care & Cosmetics,OVAL BODY LOOFAH,10,55,55,0,1
17-03-2025,"Grains, Flours & Dals",SRILATHA RICE RAVVA 500GM,4,35,35,0,1
17-03-2025,Snacks & Ready-to-Eat,VD MANGO JELLY 250GRMS,14,80,80,0,1
17-03-2025,"Grains, Flours & Dals",RICE FLOUR 500 GM,4,35,28,7,1
17-03-2025,Oils & Ghee,Groundnut oil 1 L,9,360,330,30,1
17-03-2025,"Grains, Flours & Dals",Brown RICE 1KG,4,210,195,15,3
17-03-2025,Milk & Dairy,BROWN EGGS 1P,7,336,288,48,24
17-03-2025,Snacks & Ready-to-Eat,SD FINGER Millet with palm Jaggery 250gm,14,135,135,0,1
17-03-2025,Misc,VD0009,8,100,100,0,1
17-03-2025,Snacks & Ready-to-Eat,PEANUT CHIKKI,14,66,66,0,3
17-03-2025,"Grains, Flours & Dals",FLOUR CHARGE,4,39.6,39.6,0,3.3
17-03-2025,"Grains, Flours & Dals",Urad dall 1 Kg,4,370,340,30,2
17-03-2025,"Dry Fruits, Nuts & Seeds",Groundnuts 1 kg,2,380,330,50,2
17-03-2025,Snacks & Ready-to-Eat,urban murmura,14,60,55,5,1
17-03-2025,Oils & Ghee,Castor oil 200 ml,9,100,80,20,1
17-03-2025,Beverages,TAJ MAHAL 100GM,1,95,95,0,1
17-03-2025,Snacks & Ready-to-Eat,NGT CHATPATTA CHANA 90GM,14,40,40,0,2
17-03-2025,Milk & Dairy,HERITAGE TONED MILK 500ML,7,41,41,0,1
17-03-2025,"Dry Fruits, Nuts & Seeds",PULMAKHANA 100 GM,2,180,170,10,1
17-03-2025,"Grains, Flours & Dals",Red Wheat Flour 1 kg,4,140,130,10,1
17-03-2025,"Dry Fruits, Nuts & Seeds",MAHA BEERA SEEDS 100GM,2,60,60,0,1
17-03-2025,"Grains, Flours & Dals",Red Wheat Flour 1 kg,4,140,130,10,1
17-03-2025,"Grains, Flours & Dals",Green Batani 250GM,4,55,45,10,1
17-03-2025,"Grains, Flours & Dals",WHITE BATANI,4,40,30,10,1
17-03-2025,"Grains, Flours & Dals",SA WHITE JOWAR RAVA 500GM,4,69,69,0,1
17-03-2025,"Dry Fruits, Nuts & Seeds",PULMAKHANA 100 GM,2,180,170,10,1
17-03-2025,"Grains, Flours & Dals",White jowar.F 500 Gms,4,50,40,10,1
17-03-2025,Spices & Seasonings,THOKA MIRYALU 50GM,15,210,180,30,1
17-03-2025,"Dry Fruits, Nuts & Seeds",sabja seeds,2,80,70,10,1
17-03-2025,Snacks & Ready-to-Eat,MB SORGHUM NOODLES 180GM,14,95,95,0,1
17-03-2025,"Grains, Flours & Dals",BARLEY SEEDS 250GMS,4,80,70,10,2
17-03-2025,"Grains, Flours & Dals",DISANO OATS 1KG,4,285,142.5,142.5,1
17-03-2025,Snacks & Ready-to-Eat,VD MURMURA LADDU,14,50,50,0,1
17-03-2025,General Household & Kitchenware,WOODEN SPOON BIG,3,50,50,0,1
17-03-2025,"Dry Fruits, Nuts & Seeds",ALMONDS 250GM,2,280,260,20,1
17-03-2025,"Dry Fruits, Nuts & Seeds",SATHVI CHIA SEEDS 100GM,2,100,80,20,1
17-03-2025,Pickles & Cooking Pastes,SD BITTER GOURD PICKLE,11,110,110,0,1
17-03-2025,"Grains, Flours & Dals",SRI LALITHA SONAMASOORI 5KG,4,440,370,70,1
17-03-2025,Misc,VD0009,8,100,100,0,1
17-03-2025,Spices & Seasonings,AV Iodized Salt 1KG,15,28,25,3,1
17-03-2025,General Household & Kitchenware,ODONIL SANDAL BOQUET 220ML,3,169,169,0,1
17-03-2025,"Grains, Flours & Dals",Urad dall 1 Kg,4,185,170,15,1
17-03-2025,"Dry Fruits, Nuts & Seeds",Groundnuts 500 gms,2,95,85,10,1
17-03-2025,"Grains, Flours & Dals",UNPOLISHED TURDALL 1KG,4,240,210,30,1
17-03-2025,"Grains, Flours & Dals",SH CHANA DAL 500GM,4,89,89,0,1
17-03-2025,General Household & Kitchenware,odonil citrus fresh,3,169,169,0,1
17-03-2025,Spices & Seasonings,PRO ORG MUSTARD SMALL -RAI 200G,15,84,84,0,1
17-03-2025,Spices & Seasonings,PRO ORG CUMIN 100G,15,176,176,0,1
17-03-2025,Oils & Ghee,Sesame oil 1 L,9,590,560,30,1
17-03-2025,Oils & Ghee,Coconut oil 500 ml,9,440,400,40,2
17-03-2025,Snacks & Ready-to-Eat,SD FINGER Millet with palm Jaggery 250gm,14,135,135,0,1
17-03-2025,Snacks & Ready-to-Eat,BELLAM MINAPA SUNADULLU,14,180,180,0,1
17-03-2025,Oils & Ghee,Castor oil 200 ml,9,100,80,20,1
17-03-2025,Oils & Ghee,Sesame oil 500ml,9,295,280,15,1
17-03-2025,"Grains, Flours & Dals",SPLIT BLACK GRAM 500 GM,4,90,85,5,1
17-03-2025,"Grains, Flours & Dals",SRILATHA RICE RAVVA 500GM,4,70,70,0,2
17-03-2025,Oils & Ghee,Groundnut oil 1 L,9,360,330,30,1
17-03-2025,"Grains, Flours & Dals",MAAGAANI LOW GI SP L 1KG,4,360,315,45,3
17-03-2025,"Grains, Flours & Dals",KORRALU (FOXTAIL M) 1KG,4,150,110,40,1
17-03-2025,"Grains, Flours & Dals",BLACK GRAM 1KG,4,150,140,10,1
17-03-2025,"Grains, Flours & Dals",RAGULU 1 KG,4,70,60,10,1
17-03-2025,"Grains, Flours & Dals",Arikadu ( kodo),4,140,130,10,1
17-03-2025,"Grains, Flours & Dals",VL Sabdana 500GM,4,77,77,0,1
17-03-2025,"Grains, Flours & Dals",THICK POHA 500GM,4,40,35,5,1
17-03-2025,"Grains, Flours & Dals",Arikadu ( kodo),4,140,130,10,1
17-03-2025,Spices & Seasonings,GS Pink Rock Salt 1KG,15,120,120,0,1
17-03-2025,"Grains, Flours & Dals",ANDU KORRALU (Brown top .mlt) 500,4,130,110,20,1
17-03-2025,"Grains, Flours & Dals",KORRALU (FOXTAIL M) 1KG,4,150,110,40,1
17-03-2025,"Dry Fruits, Nuts & Seeds",WALLNUTS 250GM,2,380,360,20,1
17-03-2025,"Grains, Flours & Dals",BLACK GRAM 1KG,4,150,140,10,1
17-03-2025,"Grains, Flours & Dals",SA WHITE JOWAR RAVA 500GM,4,69,69,0,1
17-03-2025,Snacks & Ready-to-Eat,JUNNU POWDER 100GM,14,70,70,0,1
17-03-2025,"Dry Fruits, Nuts & Seeds",DRIED KIWI 200GM,2,145,130,15,1
17-03-2025,Oils & Ghee,Coconut oil 500 ml,9,440,400,40,2
17-03-2025,"Grains, Flours & Dals",THICK POHA 1KG,4,80,70,10,1
17-03-2025,Milk & Dairy,BROWN EGGS 1P,7,336,288,48,24
17-03-2025,"Grains, Flours & Dals",UDALU (Barnyard millet) 1 kg,4,140,115,25,1
17-03-2025,"Grains, Flours & Dals",SAMALU,4,170,130,40,1
17-03-2025,"Grains, Flours & Dals",KORRALU (FOXTAIL M) 1KG,4,300,220,80,2
17-03-2025,"Grains, Flours & Dals",Bombay Rava 500GM,4,35,30,5,1
17-03-2025,"Dry Fruits, Nuts & Seeds",Groundnuts 1 kg,2,190,165,25,1
17-03-2025,Snacks & Ready-to-Eat,SD JOWAR WITH PALM JAGGERY 250GM,14,135,121.5,0,1
17-03-2025,Snacks & Ready-to-Eat,SD Aswagandha with palm Jaggery250Gm,14,135,121.5,0,1
17-03-2025,"Dry Fruits, Nuts & Seeds",PUMPKIN SEEDS 250GM,2,200,144,40,1
17-03-2025,"Dry Fruits, Nuts & Seeds",FLAX SEEDS 250GM,2,60,45,10,1
17-03-2025,"Grains, Flours & Dals",Red uluvalu 500 gms,4,90,75,15,1
17-03-2025,"Grains, Flours & Dals",RAGI FLOUR 1KG,4,80,70,10,1
17-03-2025,"Grains, Flours & Dals",AISHWARYA SP 1KG,4,80,70,10,1
17-03-2025,"Grains, Flours & Dals",VGR rice 1 kg,4,140,130,10,2
17-03-2025,"Grains, Flours & Dals",Wheat Flour 2 kgs,4,140,120,20,1
17-03-2025,"Grains, Flours & Dals",AISHWARYA SP 25KG,4,1999,"1,690.00",309,1
17-03-2025,"Grains, Flours & Dals",AISHWARYA SP 25KG,4,1999,"1,690.00",309,1
17-03-2025,Oils & Ghee,Groundnut oil 1 L,9,360,330,30,1
17-03-2025,Snacks & Ready-to-Eat,murmura venk,14,50,45,5,1
17-03-2025,"Grains, Flours & Dals",THICK POHA 500GM,4,40,35,5,1
17-03-2025,"Grains, Flours & Dals",MAATEJA rice 10 kgs,4,720,690,30,1
17-03-2025,"Grains, Flours & Dals",VGR RICE 5 KGS,4,350,325,25,1
17-03-2025,"Health, Wellness & Ayurvedic Products",VAMU WATER,5,99,99,0,1
17-03-2025,Sweeteners,YB Brown Sugar 1KG,16,140,140,0,1
17-03-2025,"Grains, Flours & Dals",BASMATHI RICE 1KG,4,450,405,45,3
17-03-2025,"Grains, Flours & Dals",Urad dall 1 Kg,4,370,340,30,2
17-03-2025,"Grains, Flours & Dals",Yellow jowar .F1 kg,4,220,200,20,2
17-03-2025,Oils & Ghee,Groundnut oil 500ml,9,180,165,15,1
17-03-2025,Oils & Ghee,Coconut oil 500 ml,9,220,200,20,1
16-03-2025,"Grains, Flours & Dals",UNPOLISHED TURDALL 1KG,4,240,210,30,1
16-03-2025,Oils & Ghee,Sesame oil 1 L,9,590,560,30,1
16-03-2025,"Grains, Flours & Dals",Arikadu ( kodo),4,140,130,10,1
16-03-2025,"Grains, Flours & Dals",Wheat Flour 1 kg,4,140,120,20,2
16-03-2025,"Grains, Flours & Dals",THICK POHA 1KG,4,80,70,10,1
16-03-2025,Spices & Seasonings,Tamarind 500GM,15,160,130,30,1
16-03-2025,"Grains, Flours & Dals",SABDANA,4,40,35,5,1
16-03-2025,"Dry Fruits, Nuts & Seeds",PUTNALU 500GMS,2,90,76,14,1
16-03-2025,"Grains, Flours & Dals",BARLEY SEEDS 250GMS,4,40,35,5,1
16-03-2025,"Grains, Flours & Dals",Red Chana 250GM,4,70,60,10,2
16-03-2025,"Grains, Flours & Dals",JOWAR WHITE 1 KG,4,80,70,10,1
16-03-2025,"Grains, Flours & Dals",Idly Rava L 1KG,4,60,50,10,1
16-03-2025,"Grains, Flours & Dals",THIN POHA 500GM,4,80,70,10,2
16-03-2025,Snacks & Ready-to-Eat,Popcorn Seeds 250GM,14,45,40,5,1
16-03-2025,"Grains, Flours & Dals",turdal 1kg,4,220,195,25,1
16-03-2025,"Grains, Flours & Dals",KORRALU (FOXTAIL M) 1KG,4,150,110,40,1
16-03-2025,"Grains, Flours & Dals",SL Idly Rava 1KG,4,130,110,20,2
16-03-2025,Oils & Ghee,Groundnut oil 1 L,9,360,330,30,1
16-03-2025,Snacks & Ready-to-Eat,SD FINGER Millet with palm Jaggery 250gm,14,135,135,0,1
16-03-2025,"Grains, Flours & Dals",Multigrain 1 kg,4,100,85,15,1
16-03-2025,"Grains, Flours & Dals",Sathya Javva Wheat Rava 500GM,4,190,190,0,2
16-03-2025,"Grains, Flours & Dals",Wheat Rava S 1KG,4,65,55,10,1
16-03-2025,"Grains, Flours & Dals",Sathya Javva Wheat Rava 500GM,4,95,95,0,1
16-03-2025,Snacks & Ready-to-Eat,SD Vamu with palm jaggery 250gm,14,270,270,0,2
16-03-2025,"Grains, Flours & Dals",Wheat Flour 1 kg,4,70,60,10,1
16-03-2025,Oils & Ghee,Groundnut oil 1 L,9,1080,990,90,3
16-03-2025,Oils & Ghee,Groundnut oil 1 L,9,1800,"1,650.00",150,5
16-03-2025,Oils & Ghee,Safflower oil 1 L,9,440,400,40,1
16-03-2025,Spices & Seasonings,Menthulu 250 gms,15,50,45,5,1
16-03-2025,Spices & Seasonings,ROYAL SAFFRON 400GRMS,15,65,65,0,1
16-03-2025,Pooja & Spiritual Items,SWASTIK CAMPHORE,12,90,90,0,1
16-03-2025,Personal Care & Cosmetics,SVE SHIKAKAI SOAP 100GM,10,100,100,0,1
16-03-2025,"Grains, Flours & Dals",SRILATHA RICE RAVVA 500GM,4,70,70,0,2
16-03-2025,"Grains, Flours & Dals",Sathya Javva Wheat Rava 500GM,4,95,95,0,1
16-03-2025,Snacks & Ready-to-Eat,NGT CHATPATTA CHANA 90GM,14,25,25,0,1
16-03-2025,Spices & Seasonings,Elaichi 25GM,15,145,120,25,1
16-03-2025,"Grains, Flours & Dals",Wheat Flour 1 kg,4,70,60,10,1
16-03-2025,"Grains, Flours & Dals",Multigrain 1 kg,4,100,85,15,1
16-03-2025,"Dry Fruits, Nuts & Seeds",SD Mango cubes 100gm,2,45,45,0,1
16-03-2025,Snacks & Ready-to-Eat,PEANUT CHILLI,14,85,85,0,17
16-03-2025,Spices & Seasonings,BIRYANI LEAF 10GM,15,30,20,10,1
16-03-2025,Snacks & Ready-to-Eat,VD MURMURA LADDU,14,50,50,0,1
16-03-2025,Snacks & Ready-to-Eat,SD Ginger Candy 100g,14,60,60,0,1
16-03-2025,Household & Cleaning,vim small,6,30,30,0,2
16-03-2025,"Grains, Flours & Dals",EM Ragi upma R 500g,4,75,75,0,1
16-03-2025,Snacks & Ready-to-Eat,VD MURMURA LADDU,14,50,50,0,1
16-03-2025,Oils & Ghee,Coconut oil 500 ml,9,220,200,20,1
16-03-2025,Snacks & Ready-to-Eat,VD NUVULLU CHIKKI,14,80,80,0,1
16-03-2025,"Grains, Flours & Dals",RAGI FLOUR 500GRMS,4,40,35,5,1
16-03-2025,"Grains, Flours & Dals",Brown RICE 1KG,4,490,455,35,7
16-03-2025,Spices & Seasonings,RED COPRA 250GMS,15,85,74,11,1
16-03-2025,Personal Care & Cosmetics,KHADI ALMOND SOAP 125GM,10,70,70,0,1
16-03-2025,Snacks & Ready-to-Eat,BELLAM GHEE SUNIUNDALU 250,14,120,120,0,1
16-03-2025,Snacks & Ready-to-Eat,VD Pappu Chekkalu 190gm,14,60,60,0,1
16-03-2025,"Grains, Flours & Dals",RAGI FLOUR 500GRMS,4,40,35,5,1
16-03-2025,Snacks & Ready-to-Eat,VD MANGO JELLY 250GRMS,14,80,80,0,1
16-03-2025,Spices & Seasonings,Masala Karam 500 gms,15,260,240,20,1
16-03-2025,"Grains, Flours & Dals",THICK POHA 500GM,4,80,70,10,2
16-03-2025,"Dry Fruits, Nuts & Seeds",SH GROUNDNUT 500GM,2,163,130,33,1
16-03-2025,Snacks & Ready-to-Eat,urban murmura,14,60,55,5,1
16-03-2025,"Grains, Flours & Dals",Wheat Rava M 500GM,4,33,30,3,1
16-03-2025,Snacks & Ready-to-Eat,NGT CHATPATTA CHANA 90GM,14,25,25,0,1
16-03-2025,"Grains, Flours & Dals",Green gram 1 kg,4,150,130,20,1
16-03-2025,"Grains, Flours & Dals",CHANA DAL 500GM,4,70,60,10,1
16-03-2025,"Grains, Flours & Dals",White jowar.F 1 kg,4,200,160,40,2
16-03-2025,"Grains, Flours & Dals",Urad dall 1 Kg,4,185,170,15,1
16-03-2025,"Dry Fruits, Nuts & Seeds",Groundnuts 500 gms,2,95,85,10,1
16-03-2025,"Grains, Flours & Dals",white Bobarlu 500 gms,4,80,75,5,1
16-03-2025,"Grains, Flours & Dals",Green gram 1 kg,4,150,130,20,1
16-03-2025,Personal Care & Cosmetics,SVE SUNNI PINDI SCRUBSOAP 100GM,10,100,100,0,1
16-03-2025,"Grains, Flours & Dals",Red Chana 500 GM,4,75,60,15,1
16-03-2025,Personal Care & Cosmetics,SVE HIBISCUS SOAP,10,90,90,0,1
16-03-2025,"Grains, Flours & Dals",Bombay Rava 500GM,4,35,30,5,1
16-03-2025,"Grains, Flours & Dals",Red Bobarlu 500 gms,4,95,85,10,1
16-03-2025,"Grains, Flours & Dals",RAJMA 500GM,4,90,90,0,1
16-03-2025,Snacks & Ready-to-Eat,VD BELLAM GAVVALU 200GM,14,60,60,0,1
16-03-2025,"Health, Wellness & Ayurvedic Products",MADDI NEEM OIL 100ML,5,100,100,0,1
16-03-2025,Oils & Ghee,Coconut oil 500 ml,9,220,200,20,1
16-03-2025,Pooja & Spiritual Items,SWASTIK CAMPHORE,12,90,90,0,1
16-03-2025,Pooja & Spiritual Items,SRI HARI KRISHNA DOOM 12PIC,12,80,80,0,1
16-03-2025,Pooja & Spiritual Items,SWASTIK SAMBRANI 25 GRMS,12,20,0,20,1
16-03-2025,Snacks & Ready-to-Eat,VD Minapa papad 200gm,14,60,60,0,1
16-03-2025,"Grains, Flours & Dals",SA WHITE JOWAR RAVA 500GM,4,69,69,0,1
16-03-2025,"Grains, Flours & Dals",SA YELLOW JOWAR RAVA 500GM,4,95,95,0,1
16-03-2025,"Grains, Flours & Dals",JOWAR WHITE 1 KG,4,80,70,10,1
16-03-2025,Snacks & Ready-to-Eat,SF NOODLES CLKASSIC MASALA,14,129,129,0,1
16-03-2025,Spices & Seasonings,NUVVULU 500GM,15,160,130,30,1
16-03-2025,Sweeteners,Natural Honey 1 kg,16,560,480,80,1
16-03-2025,Snacks & Ready-to-Eat,VD BELLAM GAVVALU 200GM,14,60,60,0,1
16-03-2025,"Grains, Flours & Dals",Em Multimillet upma 500g,4,129,129,0,1
16-03-2025,Snacks & Ready-to-Eat,VD PAPPU CHEGODI 200GM,14,60,60,0,1
16-03-2025,Sweeteners,MISHRI 250 GM,16,35,30,5,1
16-03-2025,Pooja & Spiritual Items,GD Camphor 50GM,12,115,115,0,1
16-03-2025,Oils & Ghee,Groundnut oil 1 L,9,936,858,78,2.6
16-03-2025,"Grains, Flours & Dals",Wheat Flour 2 kgs,4,140,120,20,1
16-03-2025,Oils & Ghee,Sesame oil 1 L,9,590,560,30,1
16-03-2025,"Grains, Flours & Dals",Wheat Flour 1 kg,4,70,60,10,1
16-03-2025,"Grains, Flours & Dals",RED WHEAT 1 KG,4,390,360,30,3
16-03-2025,"Grains, Flours & Dals",WHEAT 1 KG,4,120,100,20,2
16-03-2025,Milk & Dairy,BROWN EGGS TRAY 30P,7,360,330,30,1
16-03-2025,Snacks & Ready-to-Eat,SF NOODLES CLKASSIC MASALA,14,129,129,0,1
16-03-2025,"Health, Wellness & Ayurvedic Products",RB Max Protein Choco Berry bar 50g,5,150,150,0,2
16-03-2025,Spices & Seasonings,DRY MIECHI 200GM,15,80,60,20,1
16-03-2025,"Grains, Flours & Dals",Idly Rava L 1KG,4,60,50,10,1
16-03-2025,Spices & Seasonings,ROYAL SAFFRON 400GRMS,15,65,65,0,1
16-03-2025,Personal Care & Cosmetics,UVIS BLACK HENNA 100GM,10,175,175,0,1
16-03-2025,"Grains, Flours & Dals",DH URAD GOTA 1KG,4,215,190,25,1
16-03-2025,Spices & Seasonings,3M.MIRCHI POWDER,15,145,115,30,1
16-03-2025,"Grains, Flours & Dals",Em Multimillet upma 500g,4,129,129,0,1
16-03-2025,"Grains, Flours & Dals",PESARA PAPPU 500GMS,4,85,75,10,1
16-03-2025,Snacks & Ready-to-Eat,MB FOXTAIL MILLET NOODLES 180GM,14,95,95,0,1
16-03-2025,"Grains, Flours & Dals",split green gram 1 kg,4,150,140,10,1
16-03-2025,"Dry Fruits, Nuts & Seeds",PUMPKIN SEEDS 250GM,2,200,160,40,1
16-03-2025,Spices & Seasonings,Lavangam 50GM,15,60,50,10,1
16-03-2025,"Grains, Flours & Dals",MELMEKER 250GMS,4,60,45,15,1
16-03-2025,"Dry Fruits, Nuts & Seeds",YELLOW KISHMISH 250GM,2,130,110,20,1
16-03-2025,"Grains, Flours & Dals",BARLEY FLOUR 250GM,4,45,40,5,1
16-03-2025,Spices & Seasonings,SATHVI ANASAPUVUU 25GM,15,90,65,25,1
16-03-2025,"Grains, Flours & Dals",RAGI FLOUR 500GRMS,4,40,35,5,1
16-03-2025,"Dry Fruits, Nuts & Seeds",SUNFLOWER SEEDS 250GRM,2,150,130,20,1
16-03-2025,"Grains, Flours & Dals",Wheat Flour 1 kg,4,70,60,10,1
16-03-2025,"Grains, Flours & Dals",RICE FLOUR 1KG,4,70,55,15,1
16-03-2025,Snacks & Ready-to-Eat,VD PALLI CHIKKI,14,80,80,0,1
16-03-2025,Spices & Seasonings,AVALU 100GM,15,25,20,5,1
16-03-2025,"Dry Fruits, Nuts & Seeds",SD Mango cubes 100gm,2,45,45,0,1
16-03-2025,"Dry Fruits, Nuts & Seeds",YELLOW KISHMISH 250GM,2,130,110,20,1
16-03-2025,Snacks & Ready-to-Eat,PEANUT CHILLI,14,20,20,0,4
16-03-2025,"Health, Wellness & Ayurvedic Products",MD Aamlaki Choornam 100GM,5,80,80,0,1
16-03-2025,"Grains, Flours & Dals",RAGULU 1 KG,4,35,30,5,0.5
16-03-2025,General Household & Kitchenware,WDN HDI PONGANALU,3,280,280,0,1
16-03-2025,Snacks & Ready-to-Eat,VD BELLAM GAVVALU 200GM,14,60,60,0,1
16-03-2025,Oils & Ghee,Coconut oil 500 ml,9,220,200,20,1
16-03-2025,"Grains, Flours & Dals",RAGI FLOUR 500GRMS,4,40,35,5,1
16-03-2025,"Grains, Flours & Dals",Multigrain 1 kg,4,100,85,15,1
16-03-2025,"Grains, Flours & Dals",THICK POHA 500GM,4,40,35,5,1
16-03-2025,Oils & Ghee,Groundnut oil 500ml,9,180,165,15,1
16-03-2025,"Grains, Flours & Dals",WHEAT 1 KG,4,30,25,5,0.5
16-03-2025,Spices & Seasonings,dalchin chekka,15,50,40,10,1
16-03-2025,"Health, Wellness & Ayurvedic Products",MXP CHOCO CLASSIC BAR,5,70,70,0,1
16-03-2025,Personal Care & Cosmetics,YB Bath Powder 200GM,10,100,100,0,1
16-03-2025,"Grains, Flours & Dals",Bombay Rava 500GM,4,35,30,5,1
16-03-2025,Beverages,GANTASALA GREEN TEA 100GM,1,149,149,0,1
16-03-2025,"Dry Fruits, Nuts & Seeds",cashew,2,340,310,30,1
16-03-2025,"Health, Wellness & Ayurvedic Products",MAX PROTEIN ALMOND BAR,5,80,80,0,1
16-03-2025,"Grains, Flours & Dals",Wheat Rava S 1KG,4,65,55,10,1
16-03-2025,"Grains, Flours & Dals",rajgiri,4,22,22,0,1
16-03-2025,Snacks & Ready-to-Eat,VD KOBARI LADDU,14,80,80,0,1
16-03-2025,Snacks & Ready-to-Eat,BLACK SESAME CHIKKI,14,20,20,0,2
16-03-2025,"Grains, Flours & Dals",PESARA PAPPU 500GMS,4,85,75,10,1
16-03-2025,Personal Care & Cosmetics,MD HERBAL HAIR SHAMPOO,10,300,300,0,1
16-03-2025,"Grains, Flours & Dals",BOMBAY RAVA,4,70,55,15,1
16-03-2025,"Grains, Flours & Dals",Wheat Rava S 1KG,4,65,55,10,1
16-03-2025,"Dry Fruits, Nuts & Seeds",SABJA SEEDS 100GM,2,80,70,10,1
16-03-2025,"Dry Fruits, Nuts & Seeds",SUNFLOWER SEEDS 250GRM,2,150,130,20,1
16-03-2025,Snacks & Ready-to-Eat,RI Yogurt Berry Oats 35g,14,90,90,0,2
16-03-2025,"Dry Fruits, Nuts & Seeds",ANJEER 250GM,2,400,360,40,1
16-03-2025,"Grains, Flours & Dals",EM Ragi idli R 500G,4,75,75,0,1
16-03-2025,"Grains, Flours & Dals",Wheat Flour 1 kg,4,70,60,10,1
16-03-2025,"Dry Fruits, Nuts & Seeds",WALNUT 250 GMS,2,320,290,30,1
16-03-2025,Oils & Ghee,Groundnut oil 1 L,9,720,660,60,2
16-03-2025,"Dry Fruits, Nuts & Seeds",WATERMELON SEEDS 250GRM,2,320,280,40,1
16-03-2025,"Dry Fruits, Nuts & Seeds",ALMONDS 250GM,2,560,520,40,2
16-03-2025,"Dry Fruits, Nuts & Seeds",PUMPKIN SEEDS 250GM,2,200,160,40,1
16-03-2025,"Dry Fruits, Nuts & Seeds",DRYDATES YELLOW 250GM,2,135,120,15,1
16-03-2025,"Dry Fruits, Nuts & Seeds",Groundnuts 1 kg,2,190,165,25,1
16-03-2025,Spices & Seasonings,JEERA 250 gms,15,125,105,20,1
16-03-2025,Pooja & Spiritual Items,SWASTIK CAMPHORE,12,180,180,0,2
16-03-2025,"Grains, Flours & Dals",EM Foxtail idli r 500 g,4,109,109,0,1
16-03-2025,"Grains, Flours & Dals",Chana Flour 500 gms,4,70,65,5,1
16-03-2025,"Grains, Flours & Dals",Arikalu (kodo),4,70,65,5,1
16-03-2025,Pickles & Cooking Pastes,SD CORINDER PICKLE,11,0,0,0,1
16-03-2025,"Grains, Flours & Dals",Quinova 500 gms,4,110,100,10,1
16-03-2025,"Grains, Flours & Dals",KORRALU (FOXTAIL M) 500GM,4,65,55,10,1
16-03-2025,General Household & Kitchenware,SIRIDHANYALU BOOK,3,200,180,20,1
16-03-2025,"Grains, Flours & Dals",SABDANA 500GM,4,90,70,20,1
16-03-2025,"Grains, Flours & Dals",SAMALU (Little millet) 500 gms,4,85,65,20,1
16-03-2025,Pickles & Cooking Pastes,SD TAMARIND PICKLE,11,110,110,0,1
16-03-2025,"Grains, Flours & Dals",UDALU (Barnyard millet) 500 gms,4,70,60,10,1
16-03-2025,"Grains, Flours & Dals",THICK POHA 1KG,4,80,70,10,1
16-03-2025,"Grains, Flours & Dals",Wheat Rava S 1KG,4,65,55,10,1
16-03-2025,"Grains, Flours & Dals",Sathya Javva Wheat Rava 500GM,4,95,95,0,1
16-03-2025,"Grains, Flours & Dals",PESARA PAPPU 500GMS,4,85,75,10,1
16-03-2025,"Grains, Flours & Dals",Urad dall 1 Kg,4,185,170,15,1
16-03-2025,"Grains, Flours & Dals",Em Multimillet idli r 500g,4,129,129,0,1
16-03-2025,Spices & Seasonings,ROYAL SAFFRON 400GRMS,15,65,65,0,1
16-03-2025,"Dry Fruits, Nuts & Seeds",PUTNALU 500GMS,2,90,76,14,1
16-03-2025,Sweeteners,SUGAR 1KG,16,60,50,10,1
16-03-2025,"Health, Wellness & Ayurvedic Products",RB Max Protein Choco Berry bar 50g,5,80,80,0,1
16-03-2025,"Grains, Flours & Dals",DESI CHANA,4,25,25,0,1
16-03-2025,Spices & Seasonings,DRY MIECHI 200GM,15,80,60,20,1
16-03-2025,"Grains, Flours & Dals",turdal 1kg,4,220,195,25,1
16-03-2025,Snacks & Ready-to-Eat,BATANA NGT 70GMS,14,60,60,0,3
16-03-2025,"Grains, Flours & Dals",Quinova 1 kg,4,440,390,50,2
16-03-2025,"Grains, Flours & Dals",RAGI FLOUR 500GRMS,4,80,70,10,2
16-03-2025,Beverages,REFRESH SHARBATH SUGAR FREE,1,299,285,14,1
16-03-2025,"Grains, Flours & Dals",BARLEY FLOUR 500GM,4,90,80,10,1
16-03-2025,Snacks & Ready-to-Eat,TILLI CHIKKI,14,125,125,0,1
16-03-2025,Snacks & Ready-to-Eat,GS INSTANT KORRA DOSA MIX 400GM,14,240,240,0,2
16-03-2025,"Grains, Flours & Dals",Chana Flour 500 gms,4,70,65,5,1
16-03-2025,Snacks & Ready-to-Eat,MASALA CHANA,14,25,25,0,1
16-03-2025,Snacks & Ready-to-Eat,VD NUVULLU CHIKKI,14,80,80,0,1
16-03-2025,Beverages,REFRESH SHARBATH SUGAR FREE,1,299,285,14,1
16-03-2025,Oils & Ghee,Groundnut oil 5 L,9,1800,"1,600.00",200,1
16-03-2025,"Dry Fruits, Nuts & Seeds",ALMONDS 250GM,2,280,260,20,1
16-03-2025,"Dry Fruits, Nuts & Seeds",BLACK KISMIS 250GM,2,175,140,35,1
16-03-2025,"Dry Fruits, Nuts & Seeds",WALLNUTS 250GM,2,380,360,20,1
16-03-2025,"Dry Fruits, Nuts & Seeds",SALTED PISTA 250GM,2,400,350,50,1
16-03-2025,Spices & Seasonings,ER GARAM MASALA,15,10,10,0,2
16-03-2025,Milk & Dairy,BROWN EGGS 1P,7,56,48,8,4
16-03-2025,Snacks & Ready-to-Eat,BATANA NGT 70GMS,14,20,20,0,1
16-03-2025,Pooja & Spiritual Items,SIVA JOOTHI 365 DEEPAPU,12,75,75,0,3
16-03-2025,Snacks & Ready-to-Eat,VD RED CHILLI RICEPAPAD 150GM,14,50,50,0,1
16-03-2025,"Grains, Flours & Dals",PESARA PAPPU 500GMS,4,85,75,10,1
16-03-2025,Oils & Ghee,Coconut oil 1 L,9,440,400,40,1
16-03-2025,Milk & Dairy,BROWN EGGS 1P,7,84,72,12,6
16-03-2025,Snacks & Ready-to-Eat,VD PALLI LADDU,14,80,80,0,1
16-03-2025,"Grains, Flours & Dals",JOWAR WHITE 1 KG,4,40,35,5,0.5
16-03-2025,"Grains, Flours & Dals",JOWAR YELLOW 1 K,4,50,45,5,0.5
16-03-2025,Pooja & Spiritual Items,SIVA JOOTHI 365 DEEPAPU,12,25,25,0,1
16-03-2025,"Grains, Flours & Dals",HS MULTI UPMA RAVA,4,65,65,0,1
16-03-2025,"Dry Fruits, Nuts & Seeds",PUMPKIN SEEDS 250GM,2,200,160,40,1
16-03-2025,Snacks & Ready-to-Eat,CHOCO BROWINE,14,20,20,0,1
16-03-2025,"Grains, Flours & Dals",Em kodo idli R 500G,4,129,129,0,1
16-03-2025,"Dry Fruits, Nuts & Seeds",DRIED KIWI 200GM,2,145,130,15,1
16-03-2025,"Dry Fruits, Nuts & Seeds",ANJEER 250GM,2,400,360,40,1
16-03-2025,Snacks & Ready-to-Eat,VD DASA DINUSULU,14,199,199,0,1
16-03-2025,Pooja & Spiritual Items,GD KUMKUM 50GM,12,30,30,0,1
16-03-2025,Snacks & Ready-to-Eat,MIGHTY PUFFS KHATTA METTA,14,50,50,0,2
16-03-2025,"Health, Wellness & Ayurvedic Products",RB Max Protein Choco Berry bar 50g,5,50,50,0,1
16-03-2025,Snacks & Ready-to-Eat,VD MULTI CHAKKA,14,220,220,0,2
16-03-2025,Snacks & Ready-to-Eat,VD MURMURA LADDU,14,50,50,0,1
16-03-2025,Snacks & Ready-to-Eat,BATANA NGT 70GMS,14,20,20,0,1
16-03-2025,Misc,VD0001,8,100,100,0,1
16-03-2025,"Dry Fruits, Nuts & Seeds",SATHVI CHIA SEEDS 100GM,2,100,80,20,1
16-03-2025,"Dry Fruits, Nuts & Seeds",sabja seeds,2,80,70,10,1
16-03-2025,Spices & Seasonings,DRY MIECHI 200GM,15,160,120,40,2
16-03-2025,"Grains, Flours & Dals",KORRALU (FOXTAIL M) 500GM,4,65,55,10,1
16-03-2025,Snacks & Ready-to-Eat,VD MULTI CHAKKA,14,110,110,0,1
16-03-2025,Snacks & Ready-to-Eat,SATHVI REGIVADA 200GM,14,80,60,20,1
16-03-2025,Oils & Ghee,Safflower oil 1 L,9,880,800,80,2
16-03-2025,Spices & Seasonings,Chilli powder 500 gms,15,290,210,80,1
16-03-2025,"Grains, Flours & Dals",Wheat Flour 1 kg,4,140,120,20,2
16-03-2025,Spices & Seasonings,Turmeric powder 250 gms,15,100,75,25,1
16-03-2025,"Grains, Flours & Dals",split green gram 500 gms,4,75,70,5,1
16-03-2025,"Grains, Flours & Dals",turdal 1kg,4,220,195,25,1
16-03-2025,Sweeteners,MADHUR SUGAR 1KG,16,65,55,10,1
16-03-2025,Oils & Ghee,Groundnut oil 1 L,9,720,660,60,2
16-03-2025,Snacks & Ready-to-Eat,CHOCO BROWINE,14,20,20,0,1
16-03-2025,"Health, Wellness & Ayurvedic Products",RB Max Protein Choco Almond bar 50g,5,75,75,0,1
16-03-2025,"Grains, Flours & Dals",Em kodo idli R 500G,4,129,129,0,1
16-03-2025,"Grains, Flours & Dals",Wheat Flour 1 kg,4,70,60,10,1
16-03-2025,"Dry Fruits, Nuts & Seeds",FLAX SEEDS 250GM,2,60,50,10,1
16-03-2025,"Dry Fruits, Nuts & Seeds",ALMONDS 250GM,2,280,260,20,1
16-03-2025,Misc,VD0009,8,100,100,0,1
16-03-2025,"Dry Fruits, Nuts & Seeds",sabja seeds,2,80,70,10,1
16-03-2025,"Grains, Flours & Dals",SA WHITE JOWAR RAVA 500GM,4,69,69,0,1
16-03-2025,Snacks & Ready-to-Eat,VD ARISELU 5 PIC,14,100,100,0,1
16-03-2025,"Grains, Flours & Dals",RED TURDAL 500GM,4,75,70,5,1
16-03-2025,Oils & Ghee,Sesame oil 500ml,9,295,280,15,1
16-03-2025,Snacks & Ready-to-Eat,VD NUVULU LADDU 9PIC,14,100,100,0,1
16-03-2025,Oils & Ghee,Groundnut oil 500ml,9,180,165,15,1
16-03-2025,Snacks & Ready-to-Eat,VD MURMURA LADDU,14,50,50,0,1
16-03-2025,"Grains, Flours & Dals",turdal 500 gms,4,110,100,10,1
16-03-2025,Baking & Cooking Aids,WEIKFIELD CUSTARD POWDER,0,43,43,0,1
16-03-2025,Household & Cleaning,SURF EXCEL QUICK WASH 500GM,6,99,99,0,1
16-03-2025,Pooja & Spiritual Items,GD SANDAL 150GM,12,110,110,0,1
16-03-2025,Oils & Ghee,Groundnut oil 1 L,9,360,330,30,1
16-03-2025,Pooja & Spiritual Items,GD Dhoop Cones 40GM,12,30,30,0,1
16-03-2025,"Grains, Flours & Dals",Wheat Rava M 500GM,4,33,30,3,1
16-03-2025,Household & Cleaning,ROOPERI PITAMBARI SILVER 50ML,6,110,110,0,1
16-03-2025,Milk & Dairy,SANGAM CURD 450GM,7,38,38,0,1
16-03-2025,Spices & Seasonings,Jeera 100GM,15,50,45,5,1
16-03-2025,Snacks & Ready-to-Eat,CHOCO BROWINE,14,20,20,0,1
16-03-2025,Oils & Ghee,Coconut oil 500 ml,9,220,200,20,1
16-03-2025,Snacks & Ready-to-Eat,PEANUT CHIKKI 450GM,14,125,125,0,1
16-03-2025,Beverages,RED LABEL 10R,1,10,10,0,1
16-03-2025,Oils & Ghee,Sesame oil 500ml,9,295,280,15,1
16-03-2025,"Grains, Flours & Dals",WHITE BATANI,4,40,30,10,1
16-03-2025,Snacks & Ready-to-Eat,SD JOWAR WITH PALM JAGGERY 250GM,14,135,135,0,1
16-03-2025,"Grains, Flours & Dals",Wheat Rava S 500GM,4,33,30,3,1
16-03-2025,Oils & Ghee,Sesame oil 1 L,9,590,560,30,1
16-03-2025,Oils & Ghee,Safflower oil 1 L,9,440,400,40,1
16-03-2025,Oils & Ghee,Coconut oil 1 L,9,880,800,80,2
16-03-2025,"Grains, Flours & Dals",RAGI FLOUR 500GRMS,4,40,35,5,1
16-03-2025,"Grains, Flours & Dals",SAMALU (Little millet) 500 gms,4,85,65,20,1
16-03-2025,Sweeteners,GS Organic Jaggery Powder 600GM,16,99,99,0,1
16-03-2025,Oils & Ghee,Coconut oil 1 L,9,440,400,40,1
16-03-2025,Household & Cleaning,PITAMBARI SHINING POWDER 200G,6,60,60,0,1
16-03-2025,Snacks & Ready-to-Eat,BD RED RICE NOODLES 200G,14,140,140,0,2
16-03-2025,Pooja & Spiritual Items,GD Aiswarya Deepam 700ML,12,585,585,0,3
16-03-2025,Oils & Ghee,Groundnut oil 1 L,9,360,330,30,1
16-03-2025,Sweeteners,ACHU BELLAM 1KG,16,100,80,20,1
16-03-2025,Pooja & Spiritual Items,GD Kailash 60 GM,12,60,60,0,1
16-03-2025,"Grains, Flours & Dals",turdal 1kg,4,220,195,25,1
16-03-2025,Oils & Ghee,Sesame oil 1 L,9,590,560,30,1
16-03-2025,Oils & Ghee,cow ghee 500 ml,9,430,390,40,1
16-03-2025,"Grains, Flours & Dals",Green gram 1 kg,4,150,130,20,1
16-03-2025,Sweeteners,MISHRI 250 GM,16,35,30,5,1
16-03-2025,Spices & Seasonings,Tamarind 500GM,15,160,130,30,1
16-03-2025,"Grains, Flours & Dals",SABDANA,4,40,35,5,1
16-03-2025,"Grains, Flours & Dals",BASMATHI RICE 1KG,4,150,135,15,1
16-03-2025,Snacks & Ready-to-Eat,VD DAHI MIRCHI(SALTED) 100GM,14,45,45,0,1
16-03-2025,Oils & Ghee,Sesame oil 500ml,9,295,280,15,1
16-03-2025,Snacks & Ready-to-Eat,VD BELLAM GAVVALU 200GM,14,60,60,0,1
16-03-2025,Spices & Seasonings,Masala Karam 500 gms,15,260,240,20,1
16-03-2025,Snacks & Ready-to-Eat,JUNNU POWDER 100GM,14,70,70,0,1
16-03-2025,Pickles & Cooking Pastes,SD MANGO TOKKU,11,110,110,0,1
16-03-2025,Household & Cleaning,TIDE LEMON &CHANDAN 1KG,6,85,85,0,1
16-03-2025,Snacks & Ready-to-Eat,DISANO VERMICELLI 425 GM,14,50,50,0,1
16-03-2025,"Grains, Flours & Dals",SRILATHA RICE RAVVA 500GM,4,35,35,0,1
16-03-2025,"Grains, Flours & Dals",PESARA PAPPU 500GMS,4,85,75,10,1
16-03-2025,Spices & Seasonings,Tamarind 250GMS,15,80,65,15,1
16-03-2025,"Grains, Flours & Dals",turdal 500 gms,4,110,100,10,1
16-03-2025,Oils & Ghee,Groundnut oil 500ml,9,180,165,15,1
16-03-2025,Baking & Cooking Aids,GONDH 50GRMS,0,50,40,10,1
16-03-2025,"Grains, Flours & Dals",Wheat Rava M 500GM,4,33,30,3,1
16-03-2025,Spices & Seasonings,AVALU 100GM,15,25,20,5,1
16-03-2025,"Dry Fruits, Nuts & Seeds",sabja seeds,2,80,70,10,1
16-03-2025,Spices & Seasonings,Gasagasalu 50GM,15,130,110,20,1
16-03-2025,Spices & Seasonings,SATHVI ANASAPUVUU 25GM,15,90,65,25,1
16-03-2025,"Grains, Flours & Dals",AISHWARYA SP 1KG,4,400,350,50,5
16-03-2025,Sweeteners,YB JAGGERY POWDER 1KG,16,280,280,0,2
16-03-2025,"Grains, Flours & Dals",Chana Flour 500 gms,4,70,65,5,1
16-03-2025,"Grains, Flours & Dals",Wheat Flour 1 kg,4,70,60,10,1
16-03-2025,Snacks & Ready-to-Eat,VD MANGO JELLY 250GRMS,14,160,160,0,2
16-03-2025,Spices & Seasonings,Jeera 100GM,15,50,45,5,1
16-03-2025,Snacks & Ready-to-Eat,MB LITTLE MILLET NOODLES 180G,14,95,95,0,1
16-03-2025,Pooja & Spiritual Items,GOMATHA AGARBATHI,12,75,75,0,1
16-03-2025,Oils & Ghee,Sesame oil 500ml,9,295,280,15,1
16-03-2025,Spices & Seasonings,ROYAL SAFFRON 400GRMS,15,65,65,0,1
16-03-2025,"Grains, Flours & Dals",WHITE BATANI 500GM,4,80,60,20,1
16-03-2025,"Health, Wellness & Ayurvedic Products",RB Max Protein Choco Berry bar 50g,5,75,75,0,1
16-03-2025,"Dry Fruits, Nuts & Seeds",Groundnuts 1 kg,2,190,165,25,1
16-03-2025,"Dry Fruits, Nuts & Seeds",Groundnuts 500 gms,2,95,85,10,1
16-03-2025,"Grains, Flours & Dals",split green gram 500 gms,4,75,70,5,1
16-03-2025,"Grains, Flours & Dals",PESARA PAPPU 1 KG,4,340,290,50,2
16-03-2025,"Grains, Flours & Dals",Wheat Flour 2 kgs,4,140,120,20,1
16-03-2025,"Grains, Flours & Dals",Em jowar idly R 500G,4,150,150,0,2
16-03-2025,"Grains, Flours & Dals",split green gram 1 kg,4,150,140,10,1
16-03-2025,Oils & Ghee,Groundnut oil 1 L,9,720,660,60,2
16-03-2025,Snacks & Ready-to-Eat,SD FINGER Millet with palm Jaggery 250gm,14,135,135,0,1
16-03-2025,"Dry Fruits, Nuts & Seeds",WALNUT 250 GMS,2,320,290,30,1
16-03-2025,Household & Cleaning,vim small,6,15,15,0,1
16-03-2025,"Grains, Flours & Dals",MELMEKER 250GMS,4,60,45,15,1
16-03-2025,"Dry Fruits, Nuts & Seeds",PULMAKHANA 100 GM,2,180,170,10,1
16-03-2025,Milk & Dairy,HERITAGE TONED MILK 500ML,7,62,62,0,2
16-03-2025,Snacks & Ready-to-Eat,VD DAHI MIRCHI(SALTED) 100GM,14,45,45,0,1
16-03-2025,Spices & Seasonings,SAJEERA,15,60,40,20,1
16-03-2025,"Grains, Flours & Dals",KORRALU (FOXTAIL M) 500GM,4,65,55,10,1
16-03-2025,Snacks & Ready-to-Eat,GB SALT COOKIES,14,60,55,5,1
16-03-2025,"Grains, Flours & Dals",idly/Dosa rice 1 kg,4,70,60,10,1
16-03-2025,"Grains, Flours & Dals",White jowar.F 500 Gms,4,50,40,10,1
16-03-2025,"Grains, Flours & Dals",SABDANA,4,40,35,5,1
16-03-2025,"Grains, Flours & Dals",THICK POHA 1KG,4,80,70,10,1
16-03-2025,"Grains, Flours & Dals",SAMALU (Little millet) 500 gms,4,85,65,20,1
16-03-2025,Snacks & Ready-to-Eat,VD NUVULLU CHIKKI,14,80,80,0,1
16-03-2025,Oils & Ghee,Coconut oil 500 ml,9,220,200,20,1
16-03-2025,Pooja & Spiritual Items,GOMATHA AGARBATHI,12,75,75,0,1
16-03-2025,Pooja & Spiritual Items,GD SANDAL 150GM,12,110,110,0,1
16-03-2025,Pooja & Spiritual Items,GD Aiswarya Deepam 700ML,12,195,195,0,1
16-03-2025,Pooja & Spiritual Items,GD Dhoop Cones 40GM,12,30,30,0,1
16-03-2025,Personal Care & Cosmetics,HERBAL BATH POWDER,10,160,160,0,1
16-03-2025,Spices & Seasonings,SAJEERA,15,60,40,20,1
16-03-2025,Spices & Seasonings,SATHVI ANASAPUVUU 25GM,15,90,65,25,1
16-03-2025,Oils & Ghee,Sesame oil 500ml,9,295,280,15,1
16-03-2025,"Grains, Flours & Dals",Idly Rava L 1KG,4,60,50,10,1
16-03-2025,Sweeteners,MISHRI 250 GM,16,35,30,5,1
16-03-2025,"Grains, Flours & Dals",Wheat Flour 1 kg,4,210,180,30,3
16-03-2025,Misc,ROLL D C,8,70,45,25,1
16-03-2025,"Dry Fruits, Nuts & Seeds",FLAX SEEDS 250GM,2,60,50,10,1
16-03-2025,Sweeteners,NATURAL HONEY 1KG,16,560,480,80,1
16-03-2025,"Grains, Flours & Dals",RAGI FLOUR 1KG,4,80,70,10,1
16-03-2025,"Grains, Flours & Dals",MAATEJA rice 1 kg,4,720,690,30,10
16-03-2025,Snacks & Ready-to-Eat,VD MULTI CHAKKA,14,220,220,0,2
16-03-2025,Snacks & Ready-to-Eat,urban murmura,14,120,110,10,2
16-03-2025,Snacks & Ready-to-Eat,SATHVI REGIVADA 200GM,14,160,120,40,2
16-03-2025,"Grains, Flours & Dals",JOWAR UPMA RAVA,4,75,75,0,1
16-03-2025,"Grains, Flours & Dals",RAGI FLOUR 500GRMS,4,80,70,10,2
16-03-2025,"Grains, Flours & Dals",Sathya Javva Wheat Rava 500GM,4,95,95,0,1
16-03-2025,"Grains, Flours & Dals",Arikalu (kodo),4,70,65,5,1
16-03-2025,Sweeteners,YB Brown Sugar 500GM,16,75,75,0,1
16-03-2025,Beverages,REFRESH SHARBATH NORMAL,1,199,190,9,1
16-03-2025,"Grains, Flours & Dals",SAMALU,4,170,130,40,1
16-03-2025,Sweeteners,SD PALM JAGGERY 500GM,16,200,200,0,1
16-03-2025,"Grains, Flours & Dals",KORRALU (FOXTAIL M) 1KG,4,150,110,40,1
16-03-2025,General Household & Kitchenware,SABEENA,3,30,30,0,2
16-03-2025,Spices & Seasonings,THREE MANGO MIRCH POWDER 500GM,15,275,275,0,1
16-03-2025,"Grains, Flours & Dals",SRILATHA RICE RAVVA 500GM,4,35,35,0,1
16-03-2025,"Grains, Flours & Dals",Wheat Flour 1 kg,4,280,240,40,4
16-03-2025,Spices & Seasonings,Vamu 100GM,15,120,100,20,2
16-03-2025,Oils & Ghee,Sesame oil 500ml,9,295,280,15,1
16-03-2025,Oils & Ghee,Sesame oil 500ml,9,295,280,15,1
16-03-2025,General Household & Kitchenware,SABEENA,3,30,30,0,2
16-03-2025,Spices & Seasonings,THREE MANGO MIRCH POWDER 500GM,15,475,475,0,1
16-03-2025,Spices & Seasonings,Vamu 100GM,15,120,100,20,2
16-03-2025,"Grains, Flours & Dals",Wheat Flour 1 kg,4,280,240,40,4
16-03-2025,"Grains, Flours & Dals",SRILATHA RICE RAVVA 500GM,4,35,35,0,1
16-03-2025,Snacks & Ready-to-Eat,ragi apadalu,14,90,85.5,0,1
16-03-2025,"Grains, Flours & Dals",UNPOLISHED TURDALL 1KG,4,720,598.5,90,3
16-03-2025,"Dry Fruits, Nuts & Seeds",SATHVI CHIA SEEDS 100GM,2,100,76,20,1
16-03-2025,Oils & Ghee,GANTASALA A2 COW GHEE 250ML,9,299,284.05,0,1
16-03-2025,"Grains, Flours & Dals",RAGULU 1 KG,4,14,11.4,2,0.2
16-03-2025,"Grains, Flours & Dals",DH URAD GOTA 1KG,4,430,361,50,2
16-03-2025,"Grains, Flours & Dals",Sathya Javva Wheat Rava 500GM,4,285,270.75,0,3
16-03-2025,Sweeteners,YB JAGGERY POWDER 500GMS,16,75,71.25,0,1
16-03-2025,"Grains, Flours & Dals",Wheat Flour 1 kg,4,70,57,10,1
16-03-2025,Snacks & Ready-to-Eat,NGT CHATPATTA CHANA 90GM,14,25,23.75,0,1
16-03-2025,Spices & Seasonings,GS Pink Rock Salt 1KG,15,240,228,0,2
16-03-2025,Oils & Ghee,Coconut oil 1 L,9,440,380,40,1
16-03-2025,Pickles & Cooking Pastes,DB Three Mango 1KG,11,28,23.75,3,1
16-03-2025,"Health, Wellness & Ayurvedic Products",AMLAKI CHOORNAM,5,100,95,0,1
16-03-2025,Spices & Seasonings,KALONJI SEEDS,15,90,76,10,1
16-03-2025,Spices & Seasonings,Marati Magga 50GM,15,130,104.5,20,1
16-03-2025,"Health, Wellness & Ayurvedic Products",VATTIVERU CHOORNAM,5,90,85.5,0,1
16-03-2025,Personal Care & Cosmetics,MESWAK 100GM,10,70,66.5,0,1
16-03-2025,Spices & Seasonings,Black Elaichi 25GM,15,75,61.75,10,1
16-03-2025,Snacks & Ready-to-Eat,SATHVI REGIVADA 200GM,14,80,57,20,1
16-03-2025,Sweeteners,GS Organic Jaggery Powder 600GM,16,99,94.05,0,1
16-03-2025,"Grains, Flours & Dals",PESARA PAPPU 500GMS,4,85,71.25,10,1
16-03-2025,Spices & Seasonings,NUVVULU 500GM,15,160,123.5,30,1
16-03-2025,Household & Cleaning,LIZOL FORAL CLEANER,6,116,110.2,0,1
16-03-2025,"Grains, Flours & Dals",SABDANA 500GM,4,90,66.5,20,1
16-03-2025,Spices & Seasonings,JEERA 250 gms,15,250,199.5,40,2
16-03-2025,Snacks & Ready-to-Eat,VD MINAPA VADIYAM,14,65,61.75,0,1
16-03-2025,"Dry Fruits, Nuts & Seeds",Groundnuts 1 kg,2,190,156.75,25,1
16-03-2025,"Grains, Flours & Dals",BAJRA 1 KG,4,12,9.5,2,0.2
16-03-2025,"Grains, Flours & Dals",WHITE BATANI 500GM,4,80,57,20,1
16-03-2025,"Grains, Flours & Dals",AISHWARYA SP 25KG,4,1999,"1,605.50",309,1
16-03-2025,Spices & Seasonings,Tamarind 500GM,15,320,247,60,2
16-03-2025,Sweeteners,MISHRI 250 GM,16,35,28.5,5,1
16-03-2025,"Grains, Flours & Dals",JOWAR WHITE 1 KG,4,16,13.3,2,0.2
16-03-2025,Spices & Seasonings,DRY MIECHI 200GM,15,80,57,20,1
16-03-2025,"Dry Fruits, Nuts & Seeds",FLAX SEEDS 1KG,2,48,38,8,0.2
16-03-2025,"Grains, Flours & Dals",Chana Flour 500 gms,4,140,123.5,10,2
16-03-2025,Spices & Seasonings,Turmeric powder 250 gms,15,200,142.5,50,2
16-03-2025,"Dry Fruits, Nuts & Seeds",SD Mango cubes 100gm,2,45,42.75,0,1
16-03-2025,"Grains, Flours & Dals",VGR rice 1 kg,4,140,123.5,10,2
16-03-2025,"Grains, Flours & Dals",split black gram 1 kg,4,360,323,20,2
16-03-2025,Misc,JOKER,8,20,19,0,10
16-03-2025,Snacks & Ready-to-Eat,VD DAHI MIRCHI(SALTED) 100GM,14,45,42.75,0,1
16-03-2025,"Grains, Flours & Dals",FLOUR CHARGE,4,124.8,118.56,0,10.4
16-03-2025,Personal Care & Cosmetics,UVIS SANDALWOOD POWDR 100gm,10,0,0,0,1
16-03-2025,Pooja & Spiritual Items,SWASTIK PURE CAMPHOR 50GM,12,180,171,0,2
16-03-2025,Sweeteners,SUGAR 1KG,16,60,47.5,10,1
16-03-2025,"Grains, Flours & Dals",AISHWARYA SP IDLY RAVA 1KG,4,240,125.4,108,2
16-03-2025,"Dry Fruits, Nuts & Seeds",PUTNALU 500GMS,2,90,72.2,14,1
16-03-2025,Oils & Ghee,Sesame oil 500ml,9,295,266,15,1
16-03-2025,"Dry Fruits, Nuts & Seeds",YELLOW KISHMISH 250GM,2,130,104.5,20,1
16-03-2025,Spices & Seasonings,Coriander seeds 200 gms,15,48,38,8,1
16-03-2025,Pooja & Spiritual Items,bilwa patra,12,60,57,0,1
16-03-2025,Snacks & Ready-to-Eat,Pani Poori Chips 250GM,14,50,38,10,1
16-03-2025,"Grains, Flours & Dals",White jowar.F 1 kg,4,200,152,40,2
16-03-2025,"Grains, Flours & Dals",PESARA PAPPU 1 KG,4,170,137.75,25,1
16-03-2025,General Household & Kitchenware,GOOD HOME,3,30,28.5,0,2
16-03-2025,Snacks & Ready-to-Eat,SH PUFFED RICE 500GM,14,55,52.25,0,1
16-03-2025,Beverages,BISLERI 100ml,1,20,19,0,2
16-03-2025,Snacks & Ready-to-Eat,VD Pappu Chekkalu 190gm,14,60,57,0,1
16-03-2025,"Dry Fruits, Nuts & Seeds",PULMAKHANA 100 GM,2,360,323,20,2
16-03-2025,Pooja & Spiritual Items,GD KUMKUM 50GM,12,30,28.5,0,1
16-03-2025,"Grains, Flours & Dals",PLAIN OATS 1KG,4,42,39.9,0,0.2
16-03-2025,Sweeteners,YB Brown Sugar 500GM,16,75,71.25,0,1
16-03-2025,"Dry Fruits, Nuts & Seeds",ALBUKARA 250GM,2,145,114,25,1
16-03-2025,"Dry Fruits, Nuts & Seeds",sabja seeds,2,160,133,20,2
16-03-2025,"Grains, Flours & Dals",CHANA DAL 500GM,4,210,171,30,3
16-03-2025,"Grains, Flours & Dals",Yellow jowar .F1 kg,4,110,95,10,1
16-03-2025,Spices & Seasonings,AVALU 250grms,15,120,114,0,2
16-03-2025,Snacks & Ready-to-Eat,ZEEDI,14,70,66.5,0,1
16-03-2025,Oils & Ghee,Groundnut oil 1 L,9,720,627,60,2
16-03-2025,"Grains, Flours & Dals",split green gram 1 kg,4,150,133,10,1
16-03-2025,"Grains, Flours & Dals",BARLEY SEEDS 1KG,4,32,26.6,4,0.2
16-03-2025,Pooja & Spiritual Items,BALAJI KEWDA STICKS 220GM,12,150,142.5,0,1
16-03-2025,Household & Cleaning,SURF EXCEL MATIC FL 1L,6,250,237.5,0,1
16-03-2025,Spices & Seasonings,TM MIRCH POWDER 200GM,15,163,154.85,0,1
16-03-2025,Pooja & Spiritual Items,NAGA SINDHURAM,12,40,38,0,1
16-03-2025,"Grains, Flours & Dals",SH RED POHA 500GM,4,170,161.5,0,2
16-03-2025,Oils & Ghee,Freedom Rice Bran Oil 1L,9,194,171,14,1
16-03-2025,Pooja & Spiritual Items,GD Aiswarya Deepam 700ML,12,195,185.25,0,1
16-03-2025,"Grains, Flours & Dals",SOYA BEANS 1KG,4,40,34.2,4,0.2
16-03-2025,Personal Care & Cosmetics,KHADI Neem Anti Dandruff Shampoo,10,199,189.05,0,1
16-03-2025,"Grains, Flours & Dals",RAGI FLOUR 1KG,4,160,133,20,2
16-03-2025,"Grains, Flours & Dals",PRO SOYA CHUNKS 200G,4,158,150.1,0,2
16-03-2025,Snacks & Ready-to-Eat,jeera papad,14,80,76,0,1
16-03-2025,Snacks & Ready-to-Eat,urban murmura,14,60,52.25,5,1
16-03-2025,"Grains, Flours & Dals",WHEAT 1 KG,4,240,190,40,4
16-03-2025,Personal Care & Cosmetics,COLGATE ACTIVE SALT,10,60,57,0,3
16-03-2025,Pooja & Spiritual Items,SWATHI POOJA VATHULU,12,90,85.5,0,3
16-03-2025,Misc,VD0009,8,100,95,0,1
16-03-2025,Snacks & Ready-to-Eat,SD Ginger Candy 100g,14,60,57,0,1
16-03-2025,Milk & Dairy,HERITAGE BUTTERMILK,7,40,38,0,4
16-03-2025,Household & Cleaning,vim small,6,15,14.25,0,1
16-03-2025,"Grains, Flours & Dals",RICE FLOUR 500 GM,4,35,26.6,7,1
16-03-2025,Snacks & Ready-to-Eat,OK PENNE 400GM,14,120,114,0,1
16-03-2025,Personal Care & Cosmetics,HERBAL BATH POWDER 200GM,10,160,152,0,2
16-03-2025,Sweeteners,GS JAGGERY NUGGETS 500GM,16,120,114,0,1
16-03-2025,"Health, Wellness & Ayurvedic Products",VICKS VAPORUB 25ML,5,115,109.25,0,1
16-03-2025,Spices & Seasonings,THREE MANGO MIRCH POWDER 500GM,15,475,451.25,0,1
16-03-2025,Spices & Seasonings,white miryalu,15,60,47.5,10,1
16-03-2025,"Grains, Flours & Dals",JOWAR WHITE 1 KG,4,400,350,50,5
16-03-2025,"Grains, Flours & Dals",JOWAR UPMA RAVA,4,75,75,0,1
16-03-2025,Oils & Ghee,Groundnut oil 1 L,9,360,330,30,1
16-03-2025,Oils & Ghee,Groundnut oil 1 L,9,360,330,30,1
16-03-2025,Oils & Ghee,Sesame oil 1 L,9,590,560,30,1
16-03-2025,"Grains, Flours & Dals",Multigrain 1 kg,4,100,85,15,1
16-03-2025,"Grains, Flours & Dals",Wheat Flour 1 kg,4,140,120,20,2
16-03-2025,Spices & Seasonings,DURGA SALT CRYSTAL 1KG,15,50,50,0,2
16-03-2025,Beverages,BRU GREEN LABEL 1.2G,1,12,12,0,6
16-03-2025,"Grains, Flours & Dals",JOWAR WHITE 1 KG,4,40,35,5,0.5
16-03-2025,Snacks & Ready-to-Eat,BROWN BREAD,14,55,55,0,1
16-03-2025,Milk & Dairy,BROWN EGGS TRAY 30P,7,360,330,30,1
16-03-2025,"Grains, Flours & Dals",Quinova 1 kg,4,220,195,25,1
16-03-2025,Snacks & Ready-to-Eat,NGT CHATPATTA CHANA 90GM,14,75,75,0,3
16-03-2025,"Grains, Flours & Dals",SA YELLOW JOWAR RAVA 500GM,4,95,95,0,1
16-03-2025,"Grains, Flours & Dals",YB CHITTIMUTYALU RICE 1KG,4,200,200,0,1
16-03-2025,Spices & Seasonings,AVALU 100GM,15,25,20,5,1
16-03-2025,Oils & Ghee,Safflower oil 500 ml,9,220,200,20,1
16-03-2025,Oils & Ghee,Groundnut oil 1 L,9,360,330,30,1
16-03-2025,"Grains, Flours & Dals",CHANA DAL 1KG,4,140,120,20,1
16-03-2025,Spices & Seasonings,Jeera 100GM,15,50,45,5,1
16-03-2025,"Grains, Flours & Dals",Multigrain 1 kg,4,200,170,30,2
16-03-2025,"Grains, Flours & Dals",RAGULU 1 KG,4,70,60,10,1
16-03-2025,Spices & Seasonings,Elaichi 25GM,15,145,120,25,1
16-03-2025,"Dry Fruits, Nuts & Seeds",SH GROUNDNUT 500GM,2,163,130,33,1
16-03-2025,Oils & Ghee,Coconut oil 500 ml,9,220,200,20,1
16-03-2025,Beverages,BISLERI WATER 1L,1,20,20,0,1
16-03-2025,Snacks & Ready-to-Eat,NGT CHATPATTA CHANA 90GM,14,100,100,0,4
16-03-2025,Personal Care & Cosmetics,COW DURBAR TURMERIC 50GM,10,25,25,0,1
16-03-2025,Pooja & Spiritual Items,GD KUMKUM 50GM,12,30,30,0,1
16-03-2025,"Health, Wellness & Ayurvedic Products",AMLA PACHAK,5,100,100,0,1
16-03-2025,Snacks & Ready-to-Eat,MILLET PANCAKE CHOCOLATE,14,199,199,0,1
16-03-2025,Oils & Ghee,Castor oil 200 ml,9,100,80,20,1
16-03-2025,Household & Cleaning,vim small,6,30,30,0,2
16-03-2025,Oils & Ghee,Groundnut oil 1 L,9,360,330,30,1
16-03-2025,Pooja & Spiritual Items,GD Aiswarya Deepam 700ML,12,195,195,0,1
16-03-2025,Snacks & Ready-to-Eat,SD Atreyapuram DRY Fruit ghee,14,150,150,0,1
16-03-2025,Snacks & Ready-to-Eat,VD MURMURA LADDU,14,50,50,0,1
16-03-2025,Oils & Ghee,Castor oil 200 ml,9,100,80,20,1
16-03-2025,"Grains, Flours & Dals",RAGI FLOUR 1KG,4,80,70,10,1
16-03-2025,Pooja & Spiritual Items,999 SINGAPORE DHOOP POW 50GM,12,35,35,0,1
16-03-2025,"Health, Wellness & Ayurvedic Products",MD Bringaraj Choornam 100GM,5,80,80,0,1
16-03-2025,"Grains, Flours & Dals",turdal 1kg,4,220,195,25,1
16-03-2025,Oils & Ghee,Sesame oil 1 L,9,590,560,30,1
16-03-2025,Oils & Ghee,oleev,9,120,120,0,1
16-03-2025,"Health, Wellness & Ayurvedic Products",MADDI NEEM OIL 100ML,5,100,100,0,1
16-03-2025,"Grains, Flours & Dals",UNPOLISHED TURDALL 1KG,4,240,210,30,1
16-03-2025,"Grains, Flours & Dals",Multigrain 1 kg,4,100,85,15,1
16-03-2025,"Health, Wellness & Ayurvedic Products",MD Satavari Choornam 50GM,5,90,90,0,1
16-03-2025,"Grains, Flours & Dals",Green gram 500 gms,4,75,70,5,1
16-03-2025,Spices & Seasonings,NUVVULU 500GM,15,160,130,30,1
16-03-2025,Spices & Seasonings,YB PINK ROCK SALT 1KG,15,120,120,0,1
16-03-2025,Spices & Seasonings,Black Till 250GM,15,90,75,15,1
16-03-2025,Snacks & Ready-to-Eat,Pani Poori Chips 250GM,14,50,40,10,1
16-03-2025,Snacks & Ready-to-Eat,VD Minapa papad 200gm,14,60,60,0,1
16-03-2025,"Grains, Flours & Dals",WHITE BATANI,4,40,30,10,1
16-03-2025,Snacks & Ready-to-Eat,VD BOONDI 175GM,14,60,60,0,1
16-03-2025,"Grains, Flours & Dals",Black gram 500 gms,4,150,140,10,2
16-03-2025,Household & Cleaning,PITAMBARI SHINING POWDER 200G,6,60,60,0,1
16-03-2025,"Grains, Flours & Dals",MELMEKER 250GMS,4,60,45,15,1
16-03-2025,"Grains, Flours & Dals",White jowar.F 1 kg,4,100,80,20,1
16-03-2025,"Grains, Flours & Dals",Red Chana 500 GM,4,75,60,15,1
16-03-2025,"Dry Fruits, Nuts & Seeds",PULMAKHANA 100 GM,2,180,170,10,1
16-03-2025,Oils & Ghee,Groundnut oil 1 L,9,360,330,30,1
16-03-2025,Oils & Ghee,Safflower oil 1 L,9,440,400,40,1
16-03-2025,Oils & Ghee,Safflower oil 1 L,9,440,400,40,1
16-03-2025,"Grains, Flours & Dals",Wheat Flour 1 kg,4,210,180,30,3
16-03-2025,"Dry Fruits, Nuts & Seeds",Groundnuts 1 kg,2,190,165,25,1
16-03-2025,Oils & Ghee,Groundnut oil 1 L,9,720,660,60,2
16-03-2025,Snacks & Ready-to-Eat,VD MURMURA LADDU,14,50,50,0,1
16-03-2025,Snacks & Ready-to-Eat,MILK BREAD,14,30,30,0,1
16-03-2025,Sweeteners,YB Palm Jaggery 250GM,16,200,200,0,1
16-03-2025,"Grains, Flours & Dals",Wheat Flour 1 kg,4,140,120,20,2
16-03-2025,Sweeteners,YB Brown Sugar 500GM,16,75,75,0,1
16-03-2025,"Grains, Flours & Dals",Brown RICE 1KG,4,210,195,15,3
16-03-2025,"Grains, Flours & Dals",MELMEKER 250GMS,4,60,45,15,1
16-03-2025,"Grains, Flours & Dals",MAATEJA rice 1 kg,4,72,69,3,1
16-03-2025,"Grains, Flours & Dals",RICE FLOUR 1KG,4,70,55,15,1
16-03-2025,"Grains, Flours & Dals",BOMBAY RAVA,4,70,55,15,1
16-03-2025,Snacks & Ready-to-Eat,SATHVI REGIVADA 200GM,14,160,120,40,2
15-03-2025,Oils & Ghee,GANTASALA A2 COW GHEE 500ML,9,550,550,0,1
15-03-2025,Milk & Dairy,BROWN EGGS 1P,7,84,72,12,6
15-03-2025,"Grains, Flours & Dals",Em Multimillet upma 500g,4,129,129,0,1
15-03-2025,"Grains, Flours & Dals",Em Little idli R 500g,4,129,129,0,1
15-03-2025,Pooja & Spiritual Items,javadhu,12,60,60,0,1
15-03-2025,Sweeteners,YB FOREST HONEY 250GM,16,180,180,0,1
15-03-2025,"Dry Fruits, Nuts & Seeds",SD Mango cubes 100gm,2,45,45,0,1
15-03-2025,Beverages,REFRESH SHARBATH SUGAR FREE,1,299,285,14,1
15-03-2025,"Grains, Flours & Dals",SAMALU (Little millet) 500 gms,4,85,65,20,1
15-03-2025,Snacks & Ready-to-Eat,VD MULTI CHAKKA,14,110,110,0,1
15-03-2025,Oils & Ghee,Groundnut oil 1 L,9,360,330,30,1
15-03-2025,Snacks & Ready-to-Eat,VD PALLI LADDU,14,80,80,0,1
15-03-2025,Snacks & Ready-to-Eat,RSC ORANGE 100GMS,14,20,20,0,1
15-03-2025,"Grains, Flours & Dals",KORRALU (FOXTAIL M) 500GM,4,65,55,10,1
15-03-2025,"Grains, Flours & Dals",White jowar.F 1 kg,4,100,80,20,1
15-03-2025,"Grains, Flours & Dals",Wheat Flour 3 kgs,4,210,180,30,1
15-03-2025,Pooja & Spiritual Items,GB Bharatha Woods 75GM,12,60,60,0,1
15-03-2025,"Grains, Flours & Dals",RAGI FLOUR 500GRMS,4,40,35,5,1
15-03-2025,Pooja & Spiritual Items,SHANKARS SWARNA YUG 60GM,12,60,60,0,1
15-03-2025,Pooja & Spiritual Items,GD Aiswarya Deepam 700ML,12,195,195,0,1
15-03-2025,Pooja & Spiritual Items,GD Bhagavatha Mallika 75GM,12,60,60,0,1
15-03-2025,Sweeteners,Mishri 500GM,16,70,60,10,1
15-03-2025,"Grains, Flours & Dals",Chana Flour 500 gms,4,70,65,5,1
15-03-2025,"Grains, Flours & Dals",Wheat Flour 1 kg,4,350,300,50,5
15-03-2025,Spices & Seasonings,GREEN SOUNF,15,60,40,20,1
15-03-2025,"Dry Fruits, Nuts & Seeds",PUMPKIN SEEDS 250GM,2,200,160,40,1
15-03-2025,"Dry Fruits, Nuts & Seeds",WATERMELON SEEDS 250GRM,2,320,280,40,1
15-03-2025,"Dry Fruits, Nuts & Seeds",cashew,2,340,310,30,1
15-03-2025,"Grains, Flours & Dals",THIN POHA 500GM,4,40,35,5,1
15-03-2025,"Dry Fruits, Nuts & Seeds",Groundnuts 500 gms,2,95,85,10,1
15-03-2025,Personal Care & Cosmetics,SEV TULASI SOAP 100GM,10,90,90,0,1
15-03-2025,"Dry Fruits, Nuts & Seeds",Putnalu 250GM,2,45,38,7,1
15-03-2025,"Dry Fruits, Nuts & Seeds",SUNFLOWER SEEDS 250GRM,2,150,130,20,1
15-03-2025,Oils & Ghee,cow ghee 500 ml,9,430,390,40,1
15-03-2025,Snacks & Ready-to-Eat,SATHVI REGIVADA 200GM,14,80,60,20,1
15-03-2025,Snacks & Ready-to-Eat,ANNAPURNA APPALAM,14,35,35,0,1
15-03-2025,Snacks & Ready-to-Eat,VD Minapa papad 200gm,14,90,90,0,1
15-03-2025,Snacks & Ready-to-Eat,BD RED RICE NOODLES 200G,14,70,70,0,1
15-03-2025,Snacks & Ready-to-Eat,SD VAMU APPADALU 200GM,14,80,80,0,1
15-03-2025,"Dry Fruits, Nuts & Seeds",PUMPKIN SEEDS 250GM,2,200,160,40,1
15-03-2025,"Health, Wellness & Ayurvedic Products",RB Max Protein Oats &Raisins 55gm,5,400,400,0,5
15-03-2025,"Dry Fruits, Nuts & Seeds",YB GRANMA NUTS,2,180,180,0,2
15-03-2025,"Dry Fruits, Nuts & Seeds",DRIED KIWI 200GM,2,145,130,15,1
15-03-2025,Beverages,REFRESH SHARBATH SUGAR FREE,1,299,285,14,1
15-03-2025,"Grains, Flours & Dals",MAAGAANI LOW GI SP 1KG,4,149,125,24,1
15-03-2025,Snacks & Ready-to-Eat,SF COOKIES CHOCO RAGI,14,99,99,0,1
15-03-2025,"Dry Fruits, Nuts & Seeds",MAHA BEERA SEEDS 100GM,2,60,60,0,1
15-03-2025,Snacks & Ready-to-Eat,VD PALLI LADDU,14,80,80,0,1
15-03-2025,"Health, Wellness & Ayurvedic Products",MD Neem Leaf Choornam 100GM,5,80,80,0,1
15-03-2025,Snacks & Ready-to-Eat,SATHVI REGIVADA 200GM,14,80,60,20,1
15-03-2025,"Grains, Flours & Dals",Wheat Flour 1 kg,4,140,120,20,2
15-03-2025,Sweeteners,MISHRI 250 GM,16,35,30,5,1
15-03-2025,"Dry Fruits, Nuts & Seeds",ALMONDS 250GM,2,280,260,20,1
15-03-2025,Snacks & Ready-to-Eat,MB FOXTAIL MILLET NOODLES 180GM,14,95,95,0,1
15-03-2025,"Grains, Flours & Dals",Em jowar idly R 500G,4,75,75,0,1
15-03-2025,"Grains, Flours & Dals",EM Ragi idli R 500G,4,75,75,0,1
15-03-2025,"Grains, Flours & Dals",Em Multimillet idli r 500g,4,129,129,0,1
15-03-2025,"Grains, Flours & Dals",KORRALU (FOXTAIL M) 1KG,4,150,110,40,1
15-03-2025,Snacks & Ready-to-Eat,SD KODO MILLET WITH PALM JAGGERY,14,135,135,0,1
15-03-2025,"Grains, Flours & Dals",UDALU (Barnyard millet) 1 kg,4,140,115,25,1
15-03-2025,"Grains, Flours & Dals",SAMALU,4,170,130,40,1
15-03-2025,"Grains, Flours & Dals",Arikadu ( kodo),4,140,130,10,1
15-03-2025,Snacks & Ready-to-Eat,SD JOWAR WITH PALM JAGGERY 250GM,14,135,135,0,1
15-03-2025,"Grains, Flours & Dals",DISANO OATS 1KG,4,285,285,0,1
15-03-2025,Milk & Dairy,BROWN EGGS TRAY 30P,7,360,330,30,1
15-03-2025,Snacks & Ready-to-Eat,SD Atreyapuram DRY Fruit ghee,14,150,150,0,1
15-03-2025,Snacks & Ready-to-Eat,BATANA NGT 70GMS,14,20,20,0,1
15-03-2025,Snacks & Ready-to-Eat,VD MIXTURE 175 GM,14,60,60,0,1
15-03-2025,Snacks & Ready-to-Eat,VD MANGO JELLY 250GRMS,14,80,80,0,1
15-03-2025,"Grains, Flours & Dals",SA Sprouted Ragi Flour 500GM,4,69,69,0,1
15-03-2025,"Health, Wellness & Ayurvedic Products",ORGANIC MORINGA POWER 100GM,5,498,498,0,2
15-03-2025,Snacks & Ready-to-Eat,SD Pumpkin Seeds With Dates 175gm,14,170,170,0,1
15-03-2025,Snacks & Ready-to-Eat,VD PESARA PAPAD 195GM,14,60,60,0,1
15-03-2025,Snacks & Ready-to-Eat,MB SORGHUM NOODLES 180GM,14,95,95,0,1
15-03-2025,Snacks & Ready-to-Eat,VD BOONDI 175GM,14,60,60,0,1
15-03-2025,"Grains, Flours & Dals",SA WHITE JOWAR RAVA 500GM,4,69,69,0,1
15-03-2025,"Grains, Flours & Dals",ANDU KORRALU (Browntop.m) 1 kg,4,260,220,40,1
15-03-2025,"Grains, Flours & Dals",Quinova 500 gms,4,110,100,10,1
15-03-2025,"Grains, Flours & Dals",Arikalu (kodo),4,70,65,5,1
15-03-2025,"Dry Fruits, Nuts & Seeds",sabja seeds,2,80,70,10,1
15-03-2025,"Grains, Flours & Dals",KORRALU (FOXTAIL M) 500GM,4,65,55,10,1
15-03-2025,"Grains, Flours & Dals",UDALU (Barnyard millet) 500 gms,4,70,60,10,1
15-03-2025,Oils & Ghee,Flaxseed oil 500 ml,9,300,270,30,1
15-03-2025,Beverages,REFRESH SHARBATH SUGAR FREE,1,299,285,14,1
15-03-2025,Oils & Ghee,Coconut oil 500 ml,9,220,200,20,1
15-03-2025,"Grains, Flours & Dals",AISHWARYA SP 5KG,4,400,375,25,1
15-03-2025,"Grains, Flours & Dals",Red Wheat Flour 1 kg,4,140,130,10,1
15-03-2025,"Grains, Flours & Dals",Bombay Rava 500GM,4,35,30,5,1
15-03-2025,Spices & Seasonings,AV Iodized Salt 1KG,15,28,25,3,1
15-03-2025,"Grains, Flours & Dals",Em jowar idly R 500G,4,75,75,0,1
15-03-2025,"Grains, Flours & Dals",Wheat Flour 1 kg,4,70,60,10,1
15-03-2025,"Grains, Flours & Dals",Arikadu ( kodo),4,140,130,10,1
15-03-2025,"Grains, Flours & Dals",ANDU KORRALU (Brown top .mlt) 500,4,130,110,20,1
15-03-2025,"Grains, Flours & Dals",Wheat Flour 1 kg,4,210,180,30,3
15-03-2025,"Health, Wellness & Ayurvedic Products",MD Rose Patals Choornam 30GM,5,90,90,0,1
15-03-2025,Personal Care & Cosmetics,DWIBHASHI GULABA ARKA ROSA WATER,10,60,60,0,1
15-03-2025,"Grains, Flours & Dals",SAMALU,4,170,130,40,1
15-03-2025,"Grains, Flours & Dals",RAGI FLOUR 1KG,4,80,70,10,1
15-03-2025,"Grains, Flours & Dals",UDALU (Barnyard millet) 1 kg,4,140,115,25,1
15-03-2025,"Health, Wellness & Ayurvedic Products",RB Max Protein Oats &Raisins 55gm,5,160,160,0,2
15-03-2025,Milk & Dairy,SANGAM TONED MILK 500ML,7,30,30,0,1
15-03-2025,Spices & Seasonings,SONTI 50GM,15,30,20,10,1
15-03-2025,"Grains, Flours & Dals",Urad dall 1 Kg,4,185,170,15,1
15-03-2025,"Grains, Flours & Dals",RAGI FLOUR 500GRMS,4,80,70,10,2
15-03-2025,Pooja & Spiritual Items,GOMATHA AGARBATHI,12,75,75,0,1
15-03-2025,Spices & Seasonings,GARAM MASALA 200GM,15,120,95,25,1
15-03-2025,Sweeteners,ACHU BELLAM 1KG,16,100,80,20,1
15-03-2025,"Dry Fruits, Nuts & Seeds",PUMPKIN SEEDS 250GM,2,200,160,40,1
15-03-2025,"Dry Fruits, Nuts & Seeds",WATERMELON SEEDS 250GRM,2,320,280,40,1
15-03-2025,"Dry Fruits, Nuts & Seeds",ALMONDS 250GM,2,280,260,20,1
15-03-2025,"Dry Fruits, Nuts & Seeds",cashew,2,340,310,30,1
15-03-2025,"Grains, Flours & Dals",Brown RICE 1KG,4,140,130,10,2
15-03-2025,Personal Care & Cosmetics,SVE RED SANDAL SOAP 100GM,10,90,90,0,1
15-03-2025,"Grains, Flours & Dals",UNPOLISHED TURDALL 1KG,4,240,210,30,1
15-03-2025,"Dry Fruits, Nuts & Seeds",SUNFLOWER SEEDS 250GRM,2,150,130,20,1
15-03-2025,Snacks & Ready-to-Eat,SD Flax seeds with dates 250gm,14,135,135,0,1
15-03-2025,Snacks & Ready-to-Eat,VD MANGO JELLY 250GRMS,14,160,160,0,2
15-03-2025,Snacks & Ready-to-Eat,SALTED PHALLI,14,50,50,0,2
15-03-2025,Pickles & Cooking Pastes,SD TOMATO PICKLE,11,110,110,0,1
15-03-2025,"Grains, Flours & Dals",BASMATHI RICE 1KG,4,150,135,15,1
15-03-2025,"Grains, Flours & Dals",FLOUR CHARGE,4,60,60,0,5
15-03-2025,"Grains, Flours & Dals",JOWAR WHITE 1 KG,4,320,280,40,4
15-03-2025,"Grains, Flours & Dals",JOWAR YELLOW 1 K,4,100,90,10,1
15-03-2025,Snacks & Ready-to-Eat,Pani Poori Chips 250GM,14,50,40,10,1
15-03-2025,"Grains, Flours & Dals",KORRALU (FOXTAIL M) 500GM,4,65,55,10,1
15-03-2025,"Grains, Flours & Dals",BARLEY SEEDS 250GMS,4,40,35,5,1
15-03-2025,Snacks & Ready-to-Eat,MILLET NOODLES CURRY MASALA,14,129,129,0,1
15-03-2025,"Grains, Flours & Dals",SAMALU (Little millet) 500 gms,4,85,65,20,1
15-03-2025,Snacks & Ready-to-Eat,SATHVI REGIVADA 200GM,14,160,120,40,2
15-03-2025,"Grains, Flours & Dals",RAGI FLOUR 500GRMS,4,40,35,5,1
15-03-2025,Sweeteners,Natural Honey 500 gms,16,280,240,40,1
15-03-2025,"Grains, Flours & Dals",Hs yellow jowar r 500g,4,99,99,0,1
15-03-2025,Snacks & Ready-to-Eat,HS JOWAR BISCUITS,14,50,50,0,1
15-03-2025,Oils & Ghee,Groundnut oil 1 L,9,360,330,30,1
15-03-2025,"Dry Fruits, Nuts & Seeds",PUMPKIN SEEDS 250GM,2,200,160,40,1
15-03-2025,Milk & Dairy,SANGAM TONED MILK 500ML,7,60,60,0,2
15-03-2025,"Grains, Flours & Dals",Green gram 1 kg,4,150,130,20,1
15-03-2025,Spices & Seasonings,Vamu 100GM,15,60,50,10,1
15-03-2025,Oils & Ghee,Flaxseed oil 500 ml,9,300,270,30,1
15-03-2025,"Dry Fruits, Nuts & Seeds",SUNFLOWER SEEDS 250GRM,2,150,130,20,1
15-03-2025,Milk & Dairy,HRITAGE TOTAL CURD 130GM,7,20,20,0,2
15-03-2025,Oils & Ghee,Coconut oil 500 ml,9,220,200,20,1
15-03-2025,"Dry Fruits, Nuts & Seeds",PUMPKIN SEEDS 250GM,2,200,160,40,1
15-03-2025,"Dry Fruits, Nuts & Seeds",ALMONDS 250GM,2,280,260,20,1
15-03-2025,Spices & Seasonings,THREE MANGO MIRCH POWDER 500GM,15,475,475,0,1
15-03-2025,"Health, Wellness & Ayurvedic Products",MH Millets Malt 500GM,5,200,190,10,1
15-03-2025,General Household & Kitchenware,SIRIDHANYALU BOOK,3,200,180,20,1
15-03-2025,"Grains, Flours & Dals",Green gram 1 kg,4,150,130,20,1
15-03-2025,"Grains, Flours & Dals",AISHWARYA SP 25KG,4,1999,"1,690.00",309,1
15-03-2025,"Grains, Flours & Dals",Chana Flour 500 gms,4,70,65,5,1
15-03-2025,"Grains, Flours & Dals",Urad dall 1 Kg,4,185,170,15,1
15-03-2025,"Grains, Flours & Dals",Wheat Rava S 1KG,4,65,55,10,1
15-03-2025,"Grains, Flours & Dals",Wheat Flour 1 kg,4,70,60,10,1
15-03-2025,Snacks & Ready-to-Eat,SD Flax seeds with dates 250gm,14,135,135,0,1
15-03-2025,Snacks & Ready-to-Eat,GS WHEAT GRASS BISCUITS 250GM,14,130,130,0,1
15-03-2025,Snacks & Ready-to-Eat,SD Moringa with plam jaggery 250gm,14,135,135,0,1
15-03-2025,Snacks & Ready-to-Eat,VD NUVULLU CHIKKI,14,80,80,0,1
15-03-2025,Snacks & Ready-to-Eat,VD KOBARI LADDU,14,80,80,0,1
15-03-2025,"Health, Wellness & Ayurvedic Products",AMLA PACHAK,5,100,100,0,1
15-03-2025,Snacks & Ready-to-Eat,SD JOWAR WITH PALM JAGGERY 250GM,14,135,135,0,1
15-03-2025,"Dry Fruits, Nuts & Seeds",ALBUKARA 250GM,2,145,120,25,1
15-03-2025,Snacks & Ready-to-Eat,FOXTAIL BIS,14,135,135,0,1
15-03-2025,Snacks & Ready-to-Eat,SD Aswagandha with palm Jaggery250Gm,14,135,135,0,1
15-03-2025,Snacks & Ready-to-Eat,SD KODO MILLET WITH PALM JAGGERY,14,135,135,0,1
15-03-2025,Snacks & Ready-to-Eat,SD FINGER Millet with palm Jaggery 250gm,14,135,135,0,1
15-03-2025,Beverages,REFRESH SHARBATH NORMAL,1,199,190,9,1
15-03-2025,"Grains, Flours & Dals",RAGI FLOUR 1KG,4,80,70,10,1
15-03-2025,"Dry Fruits, Nuts & Seeds",PUMPKIN SEEDS 250GM,2,200,160,40,1
15-03-2025,Sweeteners,MISHRI D,16,40,30,10,1
15-03-2025,"Grains, Flours & Dals",THICK POHA 500GM,4,40,35,5,1
15-03-2025,"Grains, Flours & Dals",chana dall,4,35,30,5,1
15-03-2025,"Grains, Flours & Dals",White jowar.F 1 kg,4,100,80,20,1
15-03-2025,Oils & Ghee,Sesame oil 500ml,9,295,280,15,1
15-03-2025,"Grains, Flours & Dals",RED TURDAL 500GM,4,75,70,5,1
15-03-2025,Spices & Seasonings,GS Pink Rock Salt 1KG,15,120,120,0,1
15-03-2025,"Grains, Flours & Dals",THICK POHA 500GM,4,40,35,5,1
15-03-2025,"Grains, Flours & Dals",PESARA PAPPU 500GMS,4,85,75,10,1
15-03-2025,Oils & Ghee,Coconut oil 500 ml,9,220,200,20,1
15-03-2025,"Grains, Flours & Dals",DH URAD GOTA 1KG,4,215,190,25,1
15-03-2025,Spices & Seasonings,DURGA SALT CRYSTAL 1KG,15,25,25,0,1
15-03-2025,Oils & Ghee,Safflower oil 500 ml,9,220,200,20,1
15-03-2025,Snacks & Ready-to-Eat,ANNAPURNA APPALAM,14,70,70,0,2
15-03-2025,Oils & Ghee,Sesame oil 500ml,9,295,280,15,1
15-03-2025,"Dry Fruits, Nuts & Seeds",Groundnuts 500 gms,2,95,85,10,1
15-03-2025,Snacks & Ready-to-Eat,GB SALT COOKIES,14,60,55,5,1
15-03-2025,Oils & Ghee,Sesame oil 500ml,9,295,280,15,1
15-03-2025,Milk & Dairy,ID PANEER,7,135,135,0,1
15-03-2025,Personal Care & Cosmetics,COLGATE ACTIVE SALT,10,20,20,0,1
15-03-2025,Snacks & Ready-to-Eat,VD RICE MURUKU 150GM,14,50,50,0,1
15-03-2025,"Grains, Flours & Dals",RAGI FLOUR 500GRMS,4,40,35,5,1
15-03-2025,"Grains, Flours & Dals",THICK POHA 500GM,4,40,35,5,1
15-03-2025,"Grains, Flours & Dals",Arikadu ( kodo),4,140,130,10,1
15-03-2025,Milk & Dairy,BROWN EGGS 1P,7,84,72,12,6
15-03-2025,"Grains, Flours & Dals",POORI ATTA 1KG,4,70,60,10,1
15-03-2025,"Dry Fruits, Nuts & Seeds",Groundnuts 1 kg,2,190,165,25,1
15-03-2025,"Grains, Flours & Dals",ANDU KORRALU (Browntop.m) 1 kg,4,260,220,40,1
15-03-2025,Sweeteners,YB JAGGERY POWDER 1KG,16,140,140,0,1
15-03-2025,"Grains, Flours & Dals",KORRALU (FOXTAIL M) 1KG,4,150,110,40,1
15-03-2025,"Grains, Flours & Dals",UDALU (Barnyard millet) 1 kg,4,140,115,25,1
15-03-2025,"Grains, Flours & Dals",SAMALU,4,170,130,40,1
15-03-2025,Oils & Ghee,Groundnut oil 1 L,9,360,330,30,1
15-03-2025,"Grains, Flours & Dals",Multigrain 1 kg,4,200,170,30,2
15-03-2025,"Grains, Flours & Dals",RAGI FLOUR 500GRMS,4,40,35,5,1
15-03-2025,"Grains, Flours & Dals",Wheat Flour 1 kg,4,70,60,10,1
15-03-2025,"Grains, Flours & Dals",WHEAT 1 KG,4,540,450,90,9
15-03-2025,Pooja & Spiritual Items,GD Dhoop Sticks 26GM,12,20,20,0,1
15-03-2025,Snacks & Ready-to-Eat,PEANUT CHILLI,14,5,5,0,1
15-03-2025,Snacks & Ready-to-Eat,PEANUT CHIKKI 450GM,14,125,125,0,1
15-03-2025,"Grains, Flours & Dals",FLOUR CHARGE,4,108,108,0,9
15-03-2025,"Grains, Flours & Dals",YB NAVARA RICE 500GM,4,100,100,0,1
15-03-2025,"Grains, Flours & Dals",Arikalu (kodo),4,70,65,5,1
15-03-2025,"Grains, Flours & Dals",Yellow jowar .F1 kg,4,110,100,10,1
15-03-2025,"Grains, Flours & Dals",JOWAR WHITE 1 KG,4,40,35,5,0.5
15-03-2025,"Health, Wellness & Ayurvedic Products",MH Millets Malt 500GM,5,200,190,10,1
15-03-2025,"Health, Wellness & Ayurvedic Products",chick protien solution,5,112,84,28,1
15-03-2025,Snacks & Ready-to-Eat,VD BELLAM GAVVALU 200GM,14,60,60,0,1
15-03-2025,"Grains, Flours & Dals",UDALU (Barnyard millet) 500 gms,4,70,60,10,1
15-03-2025,Snacks & Ready-to-Eat,NGT CHATPATTA CHANA 90GM,14,25,25,0,1
15-03-2025,Snacks & Ready-to-Eat,Corn Chips 250GM,14,40,35,5,1
15-03-2025,"Grains, Flours & Dals",Wheat Flour 1 kg,4,140,120,20,2
15-03-2025,Spices & Seasonings,Menthulu 250 gms,15,50,45,5,1
15-03-2025,"Grains, Flours & Dals",RAGI FLOUR 1KG,4,80,70,10,1
15-03-2025,Snacks & Ready-to-Eat,GS Moongdal Dosa Mix 400GM,14,140,140,0,1
15-03-2025,Snacks & Ready-to-Eat,VD NUVVULU LADDU,14,80,80,0,1
15-03-2025,Snacks & Ready-to-Eat,SALTED PHALLI,14,25,25,0,1
15-03-2025,Snacks & Ready-to-Eat,VD PALLI LADDU,14,80,80,0,1
15-03-2025,"Grains, Flours & Dals",Red Wheat Flour 1 kg,4,140,130,10,1
15-03-2025,"Dry Fruits, Nuts & Seeds",sabja seeds,2,80,70,10,1
15-03-2025,Snacks & Ready-to-Eat,SATHVI REGIVADA 200GM,14,80,60,20,1
15-03-2025,"Grains, Flours & Dals",JOWAR UPMA RAVA,4,75,75,0,1
15-03-2025,"Grains, Flours & Dals",RAGI FLOUR 500GRMS,4,40,35,5,1
15-03-2025,Oils & Ghee,Groundnut oil 1 L,9,360,330,30,1
15-03-2025,Milk & Dairy,BROWN EGGS TRAY 30P,7,360,330,30,1
15-03-2025,Snacks & Ready-to-Eat,jeera papad,14,80,80,0,1
15-03-2025,"Grains, Flours & Dals",SINGLE POLISH 1KG,4,325,325,0,5
15-03-2025,Snacks & Ready-to-Eat,VD MULTI CHAKKA,14,110,110,0,1
15-03-2025,Personal Care & Cosmetics,DWI ROSE WATER 120ML,10,90,90,0,1
15-03-2025,Oils & Ghee,Groundnut oil 1 L,9,360,330,30,1
15-03-2025,"Grains, Flours & Dals",Em Multimillet idli r 500g,4,258,258,0,2
15-03-2025,Milk & Dairy,BROWN EGGS 1P,7,210,180,30,15
15-03-2025,Personal Care & Cosmetics,HEART SHAPE LOOFAH,10,79,79,0,1
15-03-2025,Snacks & Ready-to-Eat,SATHVI REGIVADA 200GM,14,80,60,20,1
15-03-2025,"Grains, Flours & Dals",Multigrain 1 kg,4,100,85,15,1
15-03-2025,"Grains, Flours & Dals",RAGULU 1 KG,4,35,30,5,0.5
15-03-2025,"Grains, Flours & Dals",Em Multimillet idli r 500g,4,129,129,0,1
15-03-2025,"Grains, Flours & Dals",JOWAR WHITE 1 KG,4,40,35,5,0.5
15-03-2025,"Grains, Flours & Dals",Brown RICE 1KG,4,70,65,5,1
15-03-2025,General Household & Kitchenware,GOOD HOME,3,15,15,0,1
15-03-2025,"Grains, Flours & Dals",KORRALU (FOXTAIL M) 500GM,4,65,55,10,1
15-03-2025,"Grains, Flours & Dals",Arikalu (kodo),4,70,65,5,1
15-03-2025,"Grains, Flours & Dals",Urad dall 1 Kg,4,185,170,15,1
15-03-2025,"Grains, Flours & Dals",WHEAT 1 KG,4,240,200,40,4
15-03-2025,"Grains, Flours & Dals",Wheat Rava S 500GM,4,33,30,3,1
15-03-2025,"Grains, Flours & Dals",PESARA PAPPU 500GMS,4,85,75,10,1
15-03-2025,"Grains, Flours & Dals",UDALU (Barnyard millet) 500 gms,4,70,60,10,1
15-03-2025,Oils & Ghee,Sesame oil 1 L,9,590,560,30,1
15-03-2025,Oils & Ghee,Coconut oil 500 ml,9,440,400,40,2
15-03-2025,Oils & Ghee,Groundnut oil 1 L,9,360,330,30,1
15-03-2025,"Grains, Flours & Dals",White jowar.F 1 kg,4,200,160,40,2
15-03-2025,"Grains, Flours & Dals",Wheat Flour 1 kg,4,420,360,60,6
15-03-2025,"Grains, Flours & Dals",SRI LALITHA SONAMASOORI 5KG,4,440,370,70,1
15-03-2025,Spices & Seasonings,Chilli powder 500 gms,15,290,210,80,1
15-03-2025,"Grains, Flours & Dals",RAGI FLOUR 500GRMS,4,40,35,5,1
15-03-2025,"Grains, Flours & Dals",turdal 1kg,4,220,195,25,1
15-03-2025,Oils & Ghee,Groundnut oil 1 L,9,360,330,30,1
15-03-2025,"Grains, Flours & Dals",SINGLE POLISH 1KG,4,325,325,0,5
15-03-2025,"Grains, Flours & Dals",Quinova 500 gms,4,110,100,10,1
15-03-2025,"Grains, Flours & Dals",Green gram 1 kg,4,150,130,20,1
15-03-2025,"Grains, Flours & Dals",Wheat Flour 1 kg,4,70,60,10,1
15-03-2025,"Grains, Flours & Dals",UDALU (Barnyard millet) 1 kg,4,140,115,25,1
15-03-2025,"Grains, Flours & Dals",SINGLE POLISH 1KG,4,650,650,0,10
15-03-2025,Sweeteners,SD PALM JAGGERY 500GM,16,200,200,0,1
15-03-2025,Oils & Ghee,Freedom Rice Bran Oil 1L,9,165,165,0,1
15-03-2025,Oils & Ghee,Groundnut oil 500ml,9,180,165,15,1
15-03-2025,"Grains, Flours & Dals",SINGLE POLISH 1KG,4,130,130,0,2
15-03-2025,Sweeteners,Natural Honey 500 gms,16,280,240,40,1
15-03-2025,Spices & Seasonings,Turmeric powder 250 gms,15,100,75,25,1
15-03-2025,"Dry Fruits, Nuts & Seeds",PUTNALU 500GMS,2,90,76,14,1
15-03-2025,Spices & Seasonings,DRY MIECHI 200GM,15,80,60,20,1
15-03-2025,"Grains, Flours & Dals",Wheat Flour 2 kgs,4,140,120,20,1
15-03-2025,Snacks & Ready-to-Eat,MUTLGRAIN BREAD,14,70,70,0,1
15-03-2025,Milk & Dairy,BROWN EGGS 1P,7,168,144,24,12
15-03-2025,"Grains, Flours & Dals",SB Javva Wheat Ravva 500GM,4,190,190,0,2
15-03-2025,"Grains, Flours & Dals",VGR rice 1 kg,4,140,130,10,2
14-03-2025,"Grains, Flours & Dals",BASMATHI RICE 1KG,4,150,135,15,1
14-03-2025,Spices & Seasonings,SHAHI BIRYANI MASALA,15,42,42,0,1
14-03-2025,Snacks & Ready-to-Eat,Popcorn Seeds 250GM,14,45,40,5,1
14-03-2025,"Grains, Flours & Dals",Yellow jowar .F1 kg,4,110,100,10,1
14-03-2025,Pooja & Spiritual Items,GB Bharatha Woods 75GM,12,60,60,0,1
14-03-2025,"Grains, Flours & Dals",WHITE BATANI,4,40,30,10,1
14-03-2025,"Grains, Flours & Dals",Red Chana 250GM,4,35,30,5,1
14-03-2025,"Dry Fruits, Nuts & Seeds",Putnalu 250GM,2,45,38,7,1
14-03-2025,Spices & Seasonings,Tamarind 250GMS,15,80,65,15,1
14-03-2025,"Grains, Flours & Dals",Wheat Flour 1 kg,4,70,60,10,1
14-03-2025,"Grains, Flours & Dals",RAGULU 1 KG,4,70,60,10,1
14-03-2025,"Grains, Flours & Dals",Bombay Rava 500GM,4,35,30,5,1
14-03-2025,Pooja & Spiritual Items,GD Dhoop Cones 40GM,12,60,60,0,2
14-03-2025,Pooja & Spiritual Items,GD Aiswarya Deepam 700ML,12,195,195,0,1
14-03-2025,Personal Care & Cosmetics,COW DURBAR 7 HERBS SHAMPOO,10,125,125,0,1
14-03-2025,Personal Care & Cosmetics,UVIS COW GHEE SOAP 100GM,10,85,85,0,1
14-03-2025,"Grains, Flours & Dals",Chana Flour 500 gms,4,70,65,5,1
14-03-2025,"Grains, Flours & Dals",CORN FOUR 250GM,4,40,35,5,1
14-03-2025,Pooja & Spiritual Items,GD Kumkum 50GM,12,30,30,0,1
14-03-2025,Pooja & Spiritual Items,GOMATHA AGARBATHI,12,75,75,0,1
14-03-2025,"Grains, Flours & Dals",Wheat Flour 1 kg,4,140,120,20,2
14-03-2025,"Grains, Flours & Dals",Multigrain 1 kg,4,100,85,15,1
14-03-2025,"Health, Wellness & Ayurvedic Products",SAI DURGA MORINGA LEAVES 100GM,5,75,75,0,1
14-03-2025,"Grains, Flours & Dals",RAGI FLOUR 500GRMS,4,40,35,5,1
14-03-2025,Personal Care & Cosmetics,UVIS MULTANI MITTI PW 100GM,10,49,49,0,1
14-03-2025,Oils & Ghee,Safflower oil 1 L,9,440,400,40,1
14-03-2025,"Health, Wellness & Ayurvedic Products",PULIPIRI WARTS REMOVER 9GM,5,125,125,0,1
14-03-2025,Oils & Ghee,Castor oil 200 ml,9,100,80,20,1
14-03-2025,Oils & Ghee,Groundnut oil 1 L,9,360,330,30,1
14-03-2025,Snacks & Ready-to-Eat,VD PALLI CHIKKI,14,80,80,0,1
14-03-2025,"Grains, Flours & Dals",Arikalu (kodo),4,70,65,5,1
14-03-2025,"Grains, Flours & Dals",split green gram 500 gms,4,75,70,5,1
14-03-2025,"Grains, Flours & Dals",SAMALU (Little millet) 500 gms,4,85,65,20,1
14-03-2025,"Grains, Flours & Dals",UDALU (Barnyard millet) 500 gms,4,140,120,20,2
14-03-2025,"Grains, Flours & Dals",ANDU KORRALU (Brown top .mlt) 500,4,130,110,20,1
14-03-2025,Oils & Ghee,Groundnut oil 1 L,9,360,330,30,1
14-03-2025,Misc,VD0009,8,100,100,0,1
14-03-2025,"Dry Fruits, Nuts & Seeds",WATERMELON SEEDS 250GRM,2,320,280,40,1
14-03-2025,Spices & Seasonings,Gasagasalu 50GM,15,130,110,20,1
14-03-2025,"Grains, Flours & Dals",BASMATHI RICE 1KG,4,150,135,15,1
14-03-2025,Spices & Seasonings,Tamarind 250GMS,15,80,65,15,1
14-03-2025,"Grains, Flours & Dals",SRILATHA RICE RAVVA 500GM,4,70,70,0,2
14-03-2025,Spices & Seasonings,Jeera 100GM,15,50,45,5,1
14-03-2025,"Grains, Flours & Dals",Sathya Javva Wheat Rava 500GM,4,190,190,0,2
14-03-2025,Snacks & Ready-to-Eat,BATANA NGT 70GMS,14,20,20,0,1
14-03-2025,Milk & Dairy,HERITAGE TOTAL CURD 500GM,7,50,50,0,1
14-03-2025,"Grains, Flours & Dals",JOWAR WHITE 1 KG,4,80,70,10,1
14-03-2025,Milk & Dairy,SANGAM TONED MILK 500ML,7,60,60,0,2
14-03-2025,"Grains, Flours & Dals",KORRALU (FOXTAIL M) 500GM,4,65,55,10,1
14-03-2025,"Grains, Flours & Dals",Chana Flour 500 gms,4,70,65,5,1
14-03-2025,Spices & Seasonings,SWEET SOUNF,15,20,20,0,1
14-03-2025,Spices & Seasonings,Coriander seeds 200 gms,15,48,40,8,1
14-03-2025,"Dry Fruits, Nuts & Seeds",sabja seeds,2,80,70,10,1
14-03-2025,Pickles & Cooking Pastes,SD PULIHORA PASTE,11,120,120,0,1
14-03-2025,"Dry Fruits, Nuts & Seeds",YELLOW KISHMISH 250GM,2,130,110,20,1
14-03-2025,"Grains, Flours & Dals",WHITE BATANI,4,40,30,10,1
14-03-2025,Personal Care & Cosmetics,MD HERBAL HAIR SHAMPOO,10,300,300,0,1
14-03-2025,Spices & Seasonings,AV Iodized Salt 1KG,15,28,25,3,1
14-03-2025,Personal Care & Cosmetics,KHADI Charcoal Face Wash 200ML,10,235,235,0,1
14-03-2025,"Grains, Flours & Dals",VGR RICE bag 1,4,1899,"1,650.00",249,1
14-03-2025,Oils & Ghee,Groundnut oil 1 L,9,720,660,60,2
14-03-2025,"Grains, Flours & Dals",PRO ORG MEDIUM POHA 500G,4,78,78,0,1
14-03-2025,Personal Care & Cosmetics,MADDI ALOEVERA SHAMPOO 500ML,10,300,300,0,1
14-03-2025,Snacks & Ready-to-Eat,BATANA NGT 70GMS,14,20,20,0,1
14-03-2025,Snacks & Ready-to-Eat,VD DAHI MIRCHI(SALTED) 100GM,14,45,45,0,1
14-03-2025,"Grains, Flours & Dals",White jowar.F 1 kg,4,100,80,20,1
14-03-2025,Oils & Ghee,Sesame oil 500ml,9,295,280,15,1
14-03-2025,"Grains, Flours & Dals",POORI ATTA 500GM,4,35,30,5,1
14-03-2025,Snacks & Ready-to-Eat,Pani Poori Chips 250GM,14,50,40,10,1
14-03-2025,"Grains, Flours & Dals",PESARA PAPPU 500GMS,4,85,75,10,1
14-03-2025,"Grains, Flours & Dals",RAGI FLOUR 500GRMS,4,40,35,5,1
14-03-2025,Snacks & Ready-to-Eat,JUNNU POWDER 100GM,14,70,70,0,1
14-03-2025,Snacks & Ready-to-Eat,VD MANGO JELLY 250GRMS,14,80,80,0,1
14-03-2025,"Grains, Flours & Dals",COW B rice 5 kgs,4,360,345,15,1
14-03-2025,Oils & Ghee,GANTASALA A2 COW GHEE 500ML,9,550,550,0,1
14-03-2025,Snacks & Ready-to-Eat,SATHVI REGIVADA 200GM,14,80,60,20,1
14-03-2025,"Dry Fruits, Nuts & Seeds",SATHVI CHIA SEEDS 100GM,2,100,80,20,1
14-03-2025,Oils & Ghee,Coconut oil 500 ml,9,220,200,20,1
14-03-2025,General Household & Kitchenware,SABEENA,3,15,15,0,1
14-03-2025,"Dry Fruits, Nuts & Seeds",sabja seeds,2,80,70,10,1
14-03-2025,"Grains, Flours & Dals",white Bobarlu 500 gms,4,80,75,5,1
14-03-2025,Oils & Ghee,Groundnut oil 1 L,9,360,330,30,1
14-03-2025,Milk & Dairy,BROWN EGGS TRAY 30P,7,360,330,30,1
14-03-2025,Spices & Seasonings,Telaga Pindi 500GM,15,80,70,10,1
14-03-2025,Oils & Ghee,Groundnut oil 1 L,9,360,330,30,1
14-03-2025,"Grains, Flours & Dals",HS MULTI UPMA RAVA,4,65,65,0,1
14-03-2025,Spices & Seasonings,Tamarind 250GMS,15,80,65,15,1
14-03-2025,Pooja & Spiritual Items,GOMATHA AGARBATHI,12,75,75,0,1
14-03-2025,Spices & Seasonings,Masala Karam 500 gms,15,260,240,20,1
14-03-2025,"Grains, Flours & Dals",SA WHITE JOWAR RAVA 500GM,4,69,69,0,1
14-03-2025,"Dry Fruits, Nuts & Seeds",Groundnuts 1 kg,2,190,165,25,1
14-03-2025,"Grains, Flours & Dals",Green gram 1 kg,4,150,130,20,1
14-03-2025,"Grains, Flours & Dals",Em Foxtail upma r 500 g,4,109,109,0,1
14-03-2025,"Grains, Flours & Dals",AISHWARYA SP 5KG,4,400,375,25,1
14-03-2025,Snacks & Ready-to-Eat,SD FINGER Millet with palm Jaggery 250gm,14,135,135,0,1
14-03-2025,Oils & Ghee,Groundnut oil 1 L,9,720,660,60,2
14-03-2025,Oils & Ghee,Safflower oil 1 L,9,440,400,40,1
14-03-2025,Snacks & Ready-to-Eat,VD RIBBON PAKODI 175GM,14,60,60,0,1
14-03-2025,"Health, Wellness & Ayurvedic Products",RB Max Protein Classic Creamy,5,169,169,0,1
14-03-2025,Snacks & Ready-to-Eat,SD Sesame laddu with dates250gm,14,135,135,0,1
14-03-2025,Oils & Ghee,Groundnut oil 500ml,9,180,165,15,1
14-03-2025,Misc,VD0009,8,100,100,0,1
14-03-2025,Oils & Ghee,Groundnut oil 1 L,9,360,330,30,1
14-03-2025,Baking & Cooking Aids,GONDH 50GRMS,0,50,40,10,1
14-03-2025,"Grains, Flours & Dals",RAGULU 1 KG,4,70,60,10,1
14-03-2025,Oils & Ghee,Coconut oil 500 ml,9,220,200,20,1
14-03-2025,"Grains, Flours & Dals",VYS.SP RICE 1 KG,4,350,325,25,5
14-03-2025,"Grains, Flours & Dals",Bajra Flour 500 gms,4,35,30,5,1
14-03-2025,Snacks & Ready-to-Eat,Corn Chips 250GM,14,80,70,10,2
14-03-2025,"Grains, Flours & Dals",Yellow jowar.F 500 gms,4,55,50,5,1
14-03-2025,"Dry Fruits, Nuts & Seeds",Groundnuts 1 kg,2,190,165,25,1
14-03-2025,"Grains, Flours & Dals",PESARA PAPPU 1 KG,4,170,145,25,1
14-03-2025,"Grains, Flours & Dals",SABDANA,4,40,35,5,1
14-03-2025,"Grains, Flours & Dals",Urad dall 1 Kg,4,185,170,15,1
14-03-2025,"Grains, Flours & Dals",maida 500grms,4,35,30,5,1
14-03-2025,"Grains, Flours & Dals",CORN FOUR 250GM,4,40,35,5,1
14-03-2025,Oils & Ghee,Safflower oil 1 L,9,880,800,80,2
14-03-2025,"Grains, Flours & Dals",Wheat Flour 1 kg,4,70,60,10,1
14-03-2025,"Grains, Flours & Dals",Multigrain 1 kg,4,100,85,15,1
14-03-2025,"Dry Fruits, Nuts & Seeds",Putnalu 250GM,2,45,38,7,1
14-03-2025,Milk & Dairy,BROWN EGGS TRAY 30P,7,360,330,30,1
14-03-2025,Oils & Ghee,Groundnut oil 500ml,9,180,165,15,1
14-03-2025,Personal Care & Cosmetics,SVE KHADI ALOEVERA GEL 100GM,10,140,140,0,1
14-03-2025,Pooja & Spiritual Items,GD Dhoop Sticks 26GM,12,20,20,0,1
14-03-2025,"Health, Wellness & Ayurvedic Products",RAMA BALM 10ML,5,50,50,0,1
14-03-2025,Snacks & Ready-to-Eat,VD PALLI LADDU,14,80,80,0,1
14-03-2025,"Dry Fruits, Nuts & Seeds",Groundnuts 500 gms,2,95,85,10,1
14-03-2025,Personal Care & Cosmetics,MADDI BATH POWDER 400GM,10,150,150,0,1
14-03-2025,"Grains, Flours & Dals",CORN FLOUR,4,80,70,10,1
14-03-2025,"Dry Fruits, Nuts & Seeds",Groundnuts 1 kg,2,190,165,25,1
14-03-2025,Spices & Seasonings,DRY MIECHI 200GM,15,80,60,20,1
14-03-2025,"Grains, Flours & Dals",Wheat Flour 1 kg,4,70,60,10,1
14-03-2025,"Grains, Flours & Dals",MAIDA 1KG,4,70,60,10,1
14-03-2025,Pooja & Spiritual Items,GD Dhoop Cones 40GM,12,30,30,0,1
14-03-2025,"Grains, Flours & Dals",WHITE BATANI 500GM,4,80,60,20,1
14-03-2025,"Grains, Flours & Dals",RAJMA 500GM,4,90,90,0,1
14-03-2025,"Grains, Flours & Dals",RAGULU 1 KG,4,70,60,10,1
14-03-2025,Snacks & Ready-to-Eat,CHOCO BROWINE,14,20,20,0,1
14-03-2025,"Dry Fruits, Nuts & Seeds",SATHVI CHIA SEEDS 100GM,2,100,80,20,1
14-03-2025,Snacks & Ready-to-Eat,SATHVI REGIVADA 200GM,14,80,60,20,1
14-03-2025,Spices & Seasonings,KALONJI SEEDS,15,90,80,10,1
14-03-2025,Milk & Dairy,HERITAGE BUTTERMILK,7,20,20,0,2
14-03-2025,"Dry Fruits, Nuts & Seeds",sabja seeds,2,80,70,10,1
14-03-2025,Snacks & Ready-to-Eat,FOXTAIL BIS,14,135,135,0,1
14-03-2025,Personal Care & Cosmetics,MADDI BATH POWDER 400GM,10,150,150,0,1
14-03-2025,Snacks & Ready-to-Eat,VD SAGOPAPAD 150GM,14,55,55,0,1
14-03-2025,Milk & Dairy,SANGAM TONED MILK 500ML,7,30,30,0,1
14-03-2025,Snacks & Ready-to-Eat,VD DASA DINUSULU,14,199,199,0,1
14-03-2025,Snacks & Ready-to-Eat,SD DrybFruit LADDU WITH DATES 175GM,14,170,170,0,1
14-03-2025,Snacks & Ready-to-Eat,SD High Protein Laddu 175gm,14,190,190,0,1
14-03-2025,Oils & Ghee,Groundnut oil 500ml,9,180,165,15,1
14-03-2025,"Grains, Flours & Dals",split green gram 500 gms,4,75,70,5,1
14-03-2025,"Grains, Flours & Dals",Yellow jowar .F1 kg,4,220,200,20,2
14-03-2025,"Grains, Flours & Dals",White jowar.F 1 kg,4,100,80,20,1
14-03-2025,"Dry Fruits, Nuts & Seeds",sabja seeds,2,80,70,10,1
14-03-2025,"Grains, Flours & Dals",split black gram 1 kg,4,180,170,10,1
14-03-2025,Snacks & Ready-to-Eat,NGT CHATPATTA CHANA 90GM,14,50,50,0,2
14-03-2025,"Grains, Flours & Dals",Wheat Flour 1 kg,4,70,60,10,1
14-03-2025,"Grains, Flours & Dals",RAGI FLOUR 500GRMS,4,40,35,5,1
14-03-2025,"Grains, Flours & Dals",Wheat Rava S 1KG,4,65,55,10,1
14-03-2025,"Grains, Flours & Dals",Wheat Flour 1 kg,4,70,60,10,1
14-03-2025,Sweeteners,MADHUR SUGAR 1KG,16,65,55,10,1
14-03-2025,Oils & Ghee,Groundnut oil 1 L,9,360,330,30,1
14-03-2025,Snacks & Ready-to-Eat,PEANUT CHILLI,14,10,10,0,2
14-03-2025,"Grains, Flours & Dals",SL Suji Rava 500GM,4,32,32,0,1
14-03-2025,Spices & Seasonings,DRY MIECHI 200GM,15,80,60,20,1
14-03-2025,"Dry Fruits, Nuts & Seeds",Groundnuts 1 kg,2,380,330,50,2
14-03-2025,"Grains, Flours & Dals",Wheat Flour 1 kg,4,140,120,20,2
14-03-2025,Oils & Ghee,Groundnut oil 1 L,9,720,660,60,2
14-03-2025,Milk & Dairy,HERITAGE TOTAL CURD 500GM,7,50,50,0,1
14-03-2025,"Grains, Flours & Dals",RAGI FLOUR 1KG,4,160,140,20,2
14-03-2025,"Grains, Flours & Dals",SL Idly Rava 1KG,4,65,55,10,1
14-03-2025,Snacks & Ready-to-Eat,SD FINGER Millet with palm Jaggery 250gm,14,135,135,0,1
14-03-2025,"Grains, Flours & Dals",RAGI FLOUR 1KG,4,80,70,10,1
14-03-2025,"Grains, Flours & Dals",PESARA PAPPU 1 KG,4,170,145,25,1
14-03-2025,"Dry Fruits, Nuts & Seeds",SD Mango cubes 100gm,2,45,45,0,1
14-03-2025,"Grains, Flours & Dals",Wheat Flour 1 kg,4,70,60,10,1
14-03-2025,"Grains, Flours & Dals",Wheat Flour 2 kgs,4,140,120,20,1
14-03-2025,"Grains, Flours & Dals",VYS.SP.RICE BAG 1,4,1800,"1,650.00",150,1
14-03-2025,Oils & Ghee,Groundnut oil 5 L,9,1800,"1,600.00",200,1
14-03-2025,Sweeteners,SUGAR 1KG,16,60,50,10,1
14-03-2025,Household & Cleaning,PITAMBARI SHINING POWDER 200G,6,60,60,0,1
14-03-2025,"Grains, Flours & Dals",Em Multimillet idli r 500g,4,129,129,0,1
14-03-2025,"Grains, Flours & Dals",JOWAR WHITE 1 KG,4,80,70,10,1
14-03-2025,Oils & Ghee,Sesame oil 1 L,9,590,560,30,1
14-03-2025,Baking & Cooking Aids,SB COCOA POWDER 50GM,0,65,65,0,1
14-03-2025,"Grains, Flours & Dals",RAGULU 1 KG,4,70,60,10,1
14-03-2025,Snacks & Ready-to-Eat,MB FOXTAIL MILLET NOODLES 180GM,14,95,95,0,1
14-03-2025,Sweeteners,Natural Honey 500 gms,16,280,240,40,1
14-03-2025,Spices & Seasonings,PUTNALA KARAM POWDER 100GM,15,65,65,0,1
14-03-2025,"Dry Fruits, Nuts & Seeds",PUMPKIN SEEDS 250GM,2,200,160,40,1
14-03-2025,Oils & Ghee,Castor oil 200 ml,9,100,80,20,1
14-03-2025,"Dry Fruits, Nuts & Seeds",ALMONDS 250GM,2,280,260,20,1
14-03-2025,"Dry Fruits, Nuts & Seeds",WALNUT 250 GMS,2,320,290,30,1
14-03-2025,Snacks & Ready-to-Eat,SD Groundnut with palm jaggery 250gm,14,135,135,0,1
14-03-2025,"Grains, Flours & Dals",PESARA PAPPU 1 KG,4,340,290,50,2
14-03-2025,"Dry Fruits, Nuts & Seeds",YELLOW KISHMISH 250GM,2,130,110,20,1
14-03-2025,"Dry Fruits, Nuts & Seeds",CASHEW 250GM,2,340,310,30,1
14-03-2025,"Grains, Flours & Dals",BARLEY SEEDS 250GMS,4,40,35,5,1
14-03-2025,"Dry Fruits, Nuts & Seeds",SUNFLOWER SEEDS 250GRM,2,150,130,20,1
14-03-2025,Oils & Ghee,Coconut oil 500 ml,9,220,200,20,1
14-03-2025,Spices & Seasonings,Elaichi 25GM,15,145,120,25,1
14-03-2025,"Dry Fruits, Nuts & Seeds",PLAIN PISTA 250GM,2,660,550,110,1
14-03-2025,Spices & Seasonings,Telaga Pindi 250 GM,15,40,35,5,1
14-03-2025,"Dry Fruits, Nuts & Seeds",ALMONDS 250GM,2,280,260,20,1
14-03-2025,"Grains, Flours & Dals",Green gram 1 kg,4,150,130,20,1
14-03-2025,"Dry Fruits, Nuts & Seeds",CASHEW,2,680,590,90,1
14-03-2025,"Grains, Flours & Dals",Red Chana 500 GM,4,75,60,15,1
14-03-2025,"Dry Fruits, Nuts & Seeds",BLACK KISMIS 250GM,2,175,140,35,1
14-03-2025,Sweeteners,SUGAR 1KG,16,60,50,10,1
14-03-2025,"Grains, Flours & Dals",RAGI FLOUR 500GRMS,4,40,35,5,1
14-03-2025,Milk & Dairy,HERITAGE TOTAL CURD 500GM,7,100,100,0,2
14-03-2025,Snacks & Ready-to-Eat,PEANUT CHIKKI,14,44,44,0,2
14-03-2025,Oils & Ghee,Groundnut oil 1 L,9,360,330,30,1
14-03-2025,"Grains, Flours & Dals",BASMATHI RICE 1KG,4,150,135,15,1
14-03-2025,"Dry Fruits, Nuts & Seeds",Groundnuts 1 kg,2,190,165,25,1
14-03-2025,"Grains, Flours & Dals",POORI ATTA 500GM,4,35,30,5,1
14-03-2025,Snacks & Ready-to-Eat,NGT CHATPATTA CHANA 90GM,14,25,25,0,1
14-03-2025,Oils & Ghee,Groundnut oil 1 L,9,720,660,60,2
14-03-2025,"Grains, Flours & Dals",RAGI FLOUR 1KG,4,80,70,10,1
14-03-2025,"Grains, Flours & Dals",White jowar.F 1 kg,4,100,80,20,1
14-03-2025,"Grains, Flours & Dals",Chana Flour 500 gms,4,70,65,5,1
14-03-2025,Snacks & Ready-to-Eat,GANTASALA GINGER CANDY 200GM,14,115,115,0,1
14-03-2025,"Grains, Flours & Dals",White jowar.F 1 kg,4,100,80,20,1
14-03-2025,"Dry Fruits, Nuts & Seeds",Groundnuts 1 kg,2,190,165,25,1
14-03-2025,"Grains, Flours & Dals",maida 500grms,4,35,30,5,1
14-03-2025,Snacks & Ready-to-Eat,GROUNDNUT LADDU WITH DATES,14,135,135,0,1
14-03-2025,Spices & Seasonings,NUVVULU 500GM,15,160,130,30,1
14-03-2025,Snacks & Ready-to-Eat,SD Flax seeds with dates 250gm,14,135,135,0,1
14-03-2025,Sweeteners,GS Organic Jaggery Powder 600GM,16,99,99,0,1
14-03-2025,Oils & Ghee,Groundnut oil 1 L,9,360,330,30,1
14-03-2025,Snacks & Ready-to-Eat,VD MULTI CHAKKA,14,110,110,0,1
14-03-2025,Snacks & Ready-to-Eat,BELAM MENIPA SUNADULLU,14,180,180,0,1
14-03-2025,"Grains, Flours & Dals",SINGLE POLISH 1KG,4,650,650,0,10
14-03-2025,Snacks & Ready-to-Eat,SD Thati thandra 200gm,14,150,150,0,1
14-03-2025,Baking & Cooking Aids,GONDH 50GRMS,0,50,40,10,1
14-03-2025,Oils & Ghee,Groundnut oil 1 L,9,360,330,30,1
14-03-2025,Pooja & Spiritual Items,GB Bharatha Woods 75GM,12,60,60,0,1
14-03-2025,Pooja & Spiritual Items,SWASTIK CAMPHORE,12,90,90,0,1
14-03-2025,Snacks & Ready-to-Eat,GROUNDNUT LADDU WITH DATES,14,135,135,0,1
14-03-2025,Snacks & Ready-to-Eat,VD PALLI CHIKKI,14,80,80,0,1
14-03-2025,Personal Care & Cosmetics,boroline,10,45,45,0,1
14-03-2025,"Dry Fruits, Nuts & Seeds",SABJA SEEDS 100GM,2,80,70,10,1
14-03-2025,Snacks & Ready-to-Eat,SATHVI REGIVADA 200GM,14,160,120,40,2
14-03-2025,Oils & Ghee,Coconut oil 500 ml,9,220,200,20,1
14-03-2025,Oils & Ghee,Safflower oil 5 L,9,2200,"1,950.00",250,1
14-03-2025,Spices & Seasonings,AV Iodized Salt 1KG,15,28,25,3,1
14-03-2025,Spices & Seasonings,dalchin chekka,15,50,40,10,1
14-03-2025,"Grains, Flours & Dals",split black gram 500 gms,4,90,85,5,1
14-03-2025,Spices & Seasonings,SAJEERA,15,60,40,20,1
14-03-2025,Spices & Seasonings,Miriyalu 50GM,15,100,80,20,1
14-03-2025,Beverages,BRU GREEN LABEL 1.2G,1,10,10,0,5
14-03-2025,"Dry Fruits, Nuts & Seeds",PULMAKHANA 100 GM,2,180,170,10,1
14-03-2025,"Grains, Flours & Dals",POORI ATTA 1KG,4,70,60,10,1
14-03-2025,"Grains, Flours & Dals",White jowar.F 1 kg,4,100,80,20,1
14-03-2025,"Grains, Flours & Dals",JOWAR WHITE 1 KG,4,80,70,10,1
14-03-2025,Snacks & Ready-to-Eat,VD SANNAPUSA 175GM,14,60,60,0,1
14-03-2025,Snacks & Ready-to-Eat,VD MIXTURE 175 GM,14,60,60,0,1
14-03-2025,"Grains, Flours & Dals",Bajra Flour 1 kg,4,70,60,10,1
14-03-2025,"Dry Fruits, Nuts & Seeds",ANJEER 250GM,2,400,360,40,1
14-03-2025,"Grains, Flours & Dals",Wheat Rava S 1KG,4,65,55,10,1
14-03-2025,Oils & Ghee,Coconut oil 1 L,9,440,400,40,1
14-03-2025,Snacks & Ready-to-Eat,VD MINAPA VADIYAM,14,65,65,0,1
14-03-2025,"Dry Fruits, Nuts & Seeds",Groundnuts 1 kg,2,190,165,25,1
14-03-2025,"Grains, Flours & Dals",DESI CHANA,4,50,50,0,2
14-03-2025,Spices & Seasonings,Masala Karam 500 gms,15,260,240,20,1
14-03-2025,"Grains, Flours & Dals",Wheat Flour 2 kgs,4,420,360,60,3
14-03-2025,Milk & Dairy,BROWN EGGS TRAY 30P,7,720,660,60,2
14-03-2025,Oils & Ghee,Groundnut oil 1 L,9,360,330,30,1
14-03-2025,Oils & Ghee,Groundnut oil 500ml,9,180,165,15,1
14-03-2025,Oils & Ghee,Groundnut oil 1 L,9,360,330,30,1
14-03-2025,"Grains, Flours & Dals",PESARA PAPPU 1 KG,4,170,145,25,1
14-03-2025,Snacks & Ready-to-Eat,VD PALLI LADDU,14,160,160,0,2
14-03-2025,Snacks & Ready-to-Eat,GREEN FRIED batana,14,20,20,0,1
14-03-2025,Oils & Ghee,Safflower oil 1 L,9,440,400,40,1
14-03-2025,Beverages,REFRESH SHARBATH SUGAR FREE,1,299,285,14,1
14-03-2025,"Grains, Flours & Dals",UNPOLISHED TURDALL 1KG,4,240,210,30,1
14-03-2025,Snacks & Ready-to-Eat,NGT CHATPATTA CHANA 90GM,14,25,25,0,1
14-03-2025,"Grains, Flours & Dals",SAMALU (Little millet) 500 gms,4,85,65,20,1
14-03-2025,"Grains, Flours & Dals",UDALU (Barnyard millet) 500 gms,4,70,60,10,1
14-03-2025,"Grains, Flours & Dals",ANDU KORRALU (Brown top .mlt) 500,4,130,110,20,1
14-03-2025,"Grains, Flours & Dals",DISANO ROLED OATS,4,395,395,0,1
14-03-2025,"Grains, Flours & Dals",KORRALU (FOXTAIL M) 500GM,4,65,55,10,1
14-03-2025,"Grains, Flours & Dals",Arikalu (kodo),4,70,65,5,1
14-03-2025,Oils & Ghee,Safflower oil 1 L,9,440,400,40,1
14-03-2025,Oils & Ghee,Groundnut oil 1 L,9,360,330,30,1
14-03-2025,"Grains, Flours & Dals",SINGLE POLISH 1KG,4,650,650,0,10
14-03-2025,"Dry Fruits, Nuts & Seeds",PUTNALU 500GMS,2,90,76,14,1
14-03-2025,"Grains, Flours & Dals",Green gram 1 kg,4,150,130,20,1
14-03-2025,"Grains, Flours & Dals",split black gram 1 kg,4,180,170,10,1
14-03-2025,"Grains, Flours & Dals",THICK POHA 500GM,4,40,35,5,1
14-03-2025,"Dry Fruits, Nuts & Seeds",ANJEER 250GM,2,400,360,40,1
14-03-2025,"Dry Fruits, Nuts & Seeds",SALTED PISTA 250GM,2,400,350,50,1
14-03-2025,"Dry Fruits, Nuts & Seeds",FLAX SEEDS 250GM,2,60,50,10,1
14-03-2025,"Dry Fruits, Nuts & Seeds",cashew,2,340,310,30,1
14-03-2025,"Dry Fruits, Nuts & Seeds",PUMPKIN SEEDS 250GM,2,200,160,40,1
14-03-2025,"Dry Fruits, Nuts & Seeds",WALLNUTS 250GM,2,380,360,20,1
14-03-2025,"Dry Fruits, Nuts & Seeds",BLACK KISMIS 250GM,2,175,140,35,1
14-03-2025,Snacks & Ready-to-Eat,SD JOWAR WITH PALM JAGGERY 250GM,14,135,135,0,1
14-03-2025,"Grains, Flours & Dals",CHANA DAL 500GM,4,140,120,20,2
14-03-2025,"Grains, Flours & Dals",Idly Rava L 1KG,4,120,100,20,2
14-03-2025,"Dry Fruits, Nuts & Seeds",Groundnuts 1 kg,2,380,330,50,2
14-03-2025,"Dry Fruits, Nuts & Seeds",PUTNALU 500GMS,2,180,152,28,2
14-03-2025,"Grains, Flours & Dals",Wheat Flour 1 kg,4,140,120,20,2
14-03-2025,Oils & Ghee,Coconut oil 500 ml,9,220,200,20,1
14-03-2025,Spices & Seasonings,NUVVULU 500GM,15,400,340,60,2
14-03-2025,"Grains, Flours & Dals",turdal 1kg,4,440,390,50,2
14-03-2025,Spices & Seasonings,ROYAL SAFFRON,15,125,125,0,1
14-03-2025,Personal Care & Cosmetics,GOW DURBAR 75G,10,60,60,0,1
14-03-2025,"Dry Fruits, Nuts & Seeds",sabja seeds,2,160,140,20,2
14-03-2025,"Grains, Flours & Dals",Yellow jowar .F1 kg,4,110,100,10,1
14-03-2025,"Dry Fruits, Nuts & Seeds",MAHA BEERA SEEDS 100GM,2,240,240,0,4
14-03-2025,"Grains, Flours & Dals",Yellow jowar.F 500 gms,4,55,50,5,1
14-03-2025,"Dry Fruits, Nuts & Seeds",SATHVI CHIA SEEDS 100GM,2,300,240,60,3
14-03-2025,Oils & Ghee,Sesame oil 1 L,9,1770,"1,680.00",90,3
14-03-2025,Snacks & Ready-to-Eat,MB FOXTAIL MILLET NOODLES 180GM,14,190,190,0,2
14-03-2025,Sweeteners,Natural Honey 500 gms,16,280,240,40,1
14-03-2025,"Grains, Flours & Dals",Wheat Rava S 500GM,4,33,30,3,1
14-03-2025,"Grains, Flours & Dals",THICK POHA 500GM,4,40,35,5,1
14-03-2025,Oils & Ghee,Safflower oil 1 L,9,440,400,40,1
14-03-2025,"Grains, Flours & Dals",Wheat Rava S 1KG,4,65,55,10,1
14-03-2025,Snacks & Ready-to-Eat,VD NUVULLU CHIKKI,14,80,80,0,1
14-03-2025,Milk & Dairy,BROWN EGGS TRAY 30P,7,360,330,30,1
14-03-2025,Milk & Dairy,SANGAM TONED MILK 500ML,7,60,60,0,2
14-03-2025,"Grains, Flours & Dals",AISHWARYA SP 25KG,4,1999,"1,690.00",309,1
14-03-2025,"Grains, Flours & Dals",FLOUR CHARGE,4,138,138,0,11.5
14-03-2025,"Grains, Flours & Dals",BARLEY SEEDS 250GMS,4,40,35,5,1
14-03-2025,"Grains, Flours & Dals",THIN POHA 500GM,4,40,35,5,1
14-03-2025,"Dry Fruits, Nuts & Seeds",PUTNALU 500GMS,2,180,152,28,2
14-03-2025,Snacks & Ready-to-Eat,PEANUT CHILLI,14,10,10,0,2
14-03-2025,"Grains, Flours & Dals",FLOUR CHARGE,4,27.6,27.6,0,2.3
14-03-2025,Spices & Seasonings,ROYAL SAFFRON,15,125,125,0,1
14-03-2025,"Dry Fruits, Nuts & Seeds",ALMONDS 250GM,2,280,260,20,1
14-03-2025,Snacks & Ready-to-Eat,urban murmura,14,60,55,5,1
14-03-2025,Oils & Ghee,Groundnut oil 500ml,9,180,165,15,1
14-03-2025,Spices & Seasonings,AVALU 250grms,15,60,60,0,1
14-03-2025,Spices & Seasonings,Lavangam 50GM,15,60,50,10,1
14-03-2025,Oils & Ghee,Groundnut oil 1 L,9,360,330,30,1
14-03-2025,"Grains, Flours & Dals",turdal 1kg,4,220,195,25,1
14-03-2025,Misc,ROLL D C,8,70,45,25,1
14-03-2025,Baking & Cooking Aids,Baking Soda 50GM,0,20,15,5,1
14-03-2025,"Grains, Flours & Dals",Wheat Flour 1 kg,4,70,60,10,1
14-03-2025,Snacks & Ready-to-Eat,Corn Chips 250GM,14,40,35,5,1
14-03-2025,"Grains, Flours & Dals",KORRALU (FOXTAIL M) 500GM,4,65,55,10,1
14-03-2025,Spices & Seasonings,DRY MIECHI 200GM,15,80,60,20,1
14-03-2025,"Grains, Flours & Dals",split green gram 500 gms,4,75,70,5,1
14-03-2025,"Grains, Flours & Dals",Arikalu (kodo),4,70,65,5,1
14-03-2025,"Grains, Flours & Dals",idly/Dosa rice 1 kg,4,70,60,10,1
14-03-2025,"Grains, Flours & Dals",Chittimuthaylu rice 1 kg,4,160,140,20,1
14-03-2025,Oils & Ghee,Sesame oil 500ml,9,295,280,15,1
14-03-2025,Snacks & Ready-to-Eat,VD Pappu Chekkalu 190gm,14,60,60,0,1
14-03-2025,Snacks & Ready-to-Eat,VD PALLI CHIKKI,14,160,160,0,2
14-03-2025,Snacks & Ready-to-Eat,VD NUVULU LADDU 9PIC,14,180,180,0,1
14-03-2025,Snacks & Ready-to-Eat,VD PALLI LADDU,14,240,240,0,3
14-03-2025,Personal Care & Cosmetics,OVAL BODY LOOFAH,10,55,55,0,1
14-03-2025,"Health, Wellness & Ayurvedic Products",MXP CHOCO CLASSIC BAR,5,140,140,0,2
14-03-2025,Snacks & Ready-to-Eat,ZEEDI,14,210,210,0,3
14-03-2025,Snacks & Ready-to-Eat,VD KOBARI LADDU,14,240,240,0,3
14-03-2025,Snacks & Ready-to-Eat,SATHVI REGIVADA 200GM,14,80,60,20,1
13-03-2025,"Grains, Flours & Dals",SAMALU (Little millet) 500 gms,4,85,65,20,1
13-03-2025,"Grains, Flours & Dals",UDALU (Barnyard millet) 500 gms,4,70,60,10,1
13-03-2025,"Grains, Flours & Dals",Arikalu (kodo),4,70,65,5,1
13-03-2025,Personal Care & Cosmetics,COW DURBAR 7 HERBS SHAMPOO,10,125,125,0,1
13-03-2025,"Grains, Flours & Dals",RAGI FLOUR 1KG,4,80,70,10,1
13-03-2025,Pooja & Spiritual Items,GOMATHA AGARBATHI,12,75,75,0,1
13-03-2025,Oils & Ghee,GANTASALA A2 COW GHEE 250ML,9,299,299,0,1
13-03-2025,"Health, Wellness & Ayurvedic Products",ZINDA TILISMATH 5ML,5,70,70,0,1
13-03-2025,"Grains, Flours & Dals",SABDANA,4,40,35,5,1
13-03-2025,Personal Care & Cosmetics,SUNNUPINDI SOAP UVS,10,99,99,0,1
13-03-2025,Pooja & Spiritual Items,BALAJI GArden dhop sticks,12,0,0,0,1
13-03-2025,Oils & Ghee,Sesame oil 1 L,9,1180,"1,120.00",60,2
13-03-2025,"Grains, Flours & Dals",White Chana 250 GM,4,60,50,10,1
13-03-2025,"Grains, Flours & Dals",Arikalu (kodo),4,70,65,5,1
13-03-2025,"Grains, Flours & Dals",white Bobarlu 500 gms,4,80,75,5,1
13-03-2025,Beverages,BRU GREEN LABEL 1.2G,1,96,96,0,48
13-03-2025,Snacks & Ready-to-Eat,VD GUMMADI VADIYAM,14,75,75,0,1
13-03-2025,Household & Cleaning,PITAMBARI SHINING POWDER 200G,6,60,60,0,1
13-03-2025,Snacks & Ready-to-Eat,PEANUT CHILLI,14,10,10,0,2
13-03-2025,Snacks & Ready-to-Eat,VD MINAPA VADIYAM,14,65,65,0,1
13-03-2025,Snacks & Ready-to-Eat,RSC ORANGE 100GMS,14,20,20,0,1
13-03-2025,"Grains, Flours & Dals",Chittimuthaylu rice 1 kg,4,160,140,20,1
13-03-2025,Milk & Dairy,ID PANEER,7,135,135,0,1
13-03-2025,Snacks & Ready-to-Eat,SALTED PHALLI,14,25,25,0,1
13-03-2025,Snacks & Ready-to-Eat,millet noodles sf,14,35,35,0,1
13-03-2025,Spices & Seasonings,dalchin chekka,15,50,40,10,1
13-03-2025,Snacks & Ready-to-Eat,BB VERMICELLI 250GM,14,30,30,0,1
13-03-2025,Household & Cleaning,SRFR EXCEL,6,100,100,0,10
13-03-2025,Spices & Seasonings,Jeera 100GM,15,100,90,10,2
13-03-2025,"Grains, Flours & Dals",RAGI FLOUR 500GRMS,4,40,35,5,1
13-03-2025,"Grains, Flours & Dals",UNPOLISHED TURDALL 1KG,4,240,210,30,1
13-03-2025,"Grains, Flours & Dals",unpolished turdall500grms,4,240,220,20,2
13-03-2025,Sweeteners,SUGAR 500 GM,16,60,50,10,2
13-03-2025,Snacks & Ready-to-Eat,SF MIGHTY PUFFS,14,25,25,0,1
13-03-2025,Snacks & Ready-to-Eat,PEANUT CHILLI,14,10,10,0,2
13-03-2025,"Dry Fruits, Nuts & Seeds",FLAX SEEDS 250GM,2,120,100,20,2
13-03-2025,Snacks & Ready-to-Eat,BD BARELY NOODLES 200G,14,140,140,0,2
13-03-2025,"Grains, Flours & Dals",RAGI FLOUR 500GRMS,4,80,70,10,2
13-03-2025,"Grains, Flours & Dals",VYS.SP RICE 1 KG,4,350,325,25,5
13-03-2025,Oils & Ghee,Coconut oil 500 ml,9,220,200,20,1
13-03-2025,Snacks & Ready-to-Eat,MARMURA LADDU,14,80,60,20,1
13-03-2025,"Dry Fruits, Nuts & Seeds",PUTNALU 500GMS,2,90,76,14,1
13-03-2025,Snacks & Ready-to-Eat,VD DAHI MIRCHI(SALTED) 100GM,14,45,45,0,1
13-03-2025,"Grains, Flours & Dals",WHITE BATANI 500GM,4,80,60,20,1
13-03-2025,Snacks & Ready-to-Eat,SD FINGER Millet with palm Jaggery 250gm,14,135,135,0,1
13-03-2025,Baking & Cooking Aids,GONDH 50GRMS,0,50,40,10,1
13-03-2025,Spices & Seasonings,SD Curry Leaves Karam Powder 100GM,15,65,65,0,1
13-03-2025,"Dry Fruits, Nuts & Seeds",cashew,2,340,310,30,1
13-03-2025,Pickles & Cooking Pastes,SD MANGO PICKLE,11,110,110,0,1
13-03-2025,"Dry Fruits, Nuts & Seeds",FLAX SEEDS 250GM,2,60,50,10,1
13-03-2025,Oils & Ghee,Groundnut oil 1 L,9,360,330,30,1
13-03-2025,Milk & Dairy,SANGAM CURD 450GM,7,38,38,0,1
13-03-2025,Pickles & Cooking Pastes,SD RED CHILLI PICKLE,11,110,110,0,1
13-03-2025,Snacks & Ready-to-Eat,PEANUT CHIKKI 450GM,14,125,125,0,1
13-03-2025,Spices & Seasonings,DURGA SALT CRYSTAL 1KG,15,25,25,0,1
13-03-2025,"Grains, Flours & Dals",Idly Rava L 1KG,4,60,50,10,1
13-03-2025,Pooja & Spiritual Items,GD SANDAL 150GM,12,110,110,0,1
13-03-2025,Pooja & Spiritual Items,GD WOODS 150GM,12,110,110,0,1
13-03-2025,Spices & Seasonings,Telaga Pindi 500GM,15,80,70,10,1
13-03-2025,Sweeteners,GS JAGGERY NUGGETS 500GM,16,240,240,0,2
13-03-2025,Oils & Ghee,Groundnut oil 5 L,9,1800,"1,600.00",200,1
13-03-2025,Pooja & Spiritual Items,GD Aiswarya Deepam 700ML,12,390,390,0,2
13-03-2025,Oils & Ghee,Black Sesame oil 1 L,9,440,380,60,1
13-03-2025,Snacks & Ready-to-Eat,VD MANGO JELLY 250GRMS,14,80,80,0,1
13-03-2025,"Grains, Flours & Dals",ANDU KORRALU (Brown top .mlt) 500,4,130,110,20,1
13-03-2025,"Grains, Flours & Dals",Arikadu ( kodo),4,140,130,10,1
13-03-2025,Pooja & Spiritual Items,GD Sambrani Cup Dhoop 10 PC,12,96,96,0,1
13-03-2025,"Grains, Flours & Dals",UDALU (Barnyard millet) 1 kg,4,140,115,25,1
13-03-2025,"Grains, Flours & Dals",KORRALU (FOXTAIL M) 1KG,4,150,110,40,1
13-03-2025,"Grains, Flours & Dals",SAMALU,4,170,130,40,1
13-03-2025,"Grains, Flours & Dals",RAGI FLOUR 1KG,4,160,140,20,2
13-03-2025,Snacks & Ready-to-Eat,VD GUMMADI CHAKKA,14,130,130,0,1
13-03-2025,Snacks & Ready-to-Eat,VD NUVULLU CHIKKI,14,80,80,0,1
13-03-2025,Snacks & Ready-to-Eat,SATHVI REGIVADA 200GM,14,80,60,20,1
13-03-2025,Oils & Ghee,Sesame oil 1 L,9,590,560,30,1
13-03-2025,"Grains, Flours & Dals",Multigrain 1 kg,4,100,85,15,1
13-03-2025,"Grains, Flours & Dals",RAGI FLOUR 500GRMS,4,40,35,5,1
13-03-2025,Pooja & Spiritual Items,BALAJI BEL PHOOL STICKS 90GM,12,60,60,0,1
13-03-2025,"Dry Fruits, Nuts & Seeds",Putnalu 250GM,2,45,38,7,1
13-03-2025,"Grains, Flours & Dals",SRILATHA RICE RAVVA 500GM,4,35,35,0,1
13-03-2025,Oils & Ghee,Sesame oil 1 L,9,590,560,30,1
13-03-2025,Oils & Ghee,Safflower oil 1 L,9,440,400,40,1
13-03-2025,"Grains, Flours & Dals",Sathya Javva Wheat Rava 500GM,4,95,95,0,1
13-03-2025,Household & Cleaning,vim,6,60,60,0,1
13-03-2025,"Grains, Flours & Dals",Red Wheat Flour 1 kg,4,140,130,10,1
13-03-2025,Pooja & Spiritual Items,GD KASTHURI,12,60,60,0,1
13-03-2025,"Dry Fruits, Nuts & Seeds",BLACK KISMIS 250GM,2,175,140,35,1
13-03-2025,"Dry Fruits, Nuts & Seeds",YELLOW KISHMISH 250GM,2,130,110,20,1
13-03-2025,"Dry Fruits, Nuts & Seeds",WALLNUTS 250GM,2,380,360,20,1
13-03-2025,"Dry Fruits, Nuts & Seeds",cashew,2,340,310,30,1
13-03-2025,"Dry Fruits, Nuts & Seeds",PUMPKIN SEEDS 250GM,2,200,160,40,1
13-03-2025,"Dry Fruits, Nuts & Seeds",ALMONDS 250GM,2,280,260,20,1
13-03-2025,"Dry Fruits, Nuts & Seeds",PLAIN PISTA 250GM,2,1980,"1,650.00",330,3
13-03-2025,"Dry Fruits, Nuts & Seeds",SUNFLOWER SEEDS 250GRM,2,150,130,20,1
13-03-2025,"Grains, Flours & Dals",ANDU KORRALU (Brown top .mlt) 500,4,130,110,20,1
13-03-2025,"Grains, Flours & Dals",UDALU (Barnyard millet) 500 gms,4,70,60,10,1
13-03-2025,"Grains, Flours & Dals",SAMALU (Little millet) 500 gms,4,85,65,20,1
13-03-2025,"Grains, Flours & Dals",Arikalu (kodo),4,70,65,5,1
13-03-2025,"Grains, Flours & Dals",KORRALU (FOXTAIL M) 500GM,4,65,55,10,1
13-03-2025,General Household & Kitchenware,SIRIDHANYALU BOOK,3,200,180,20,1
13-03-2025,"Grains, Flours & Dals",RAGI FLOUR 500GRMS,4,40,35,5,1
13-03-2025,Baking & Cooking Aids,GONDH 50GRMS,0,50,40,10,1
13-03-2025,Oils & Ghee,Black Sesame oil 1 L,9,880,760,120,2
13-03-2025,Misc,VD0001,8,100,100,0,1
13-03-2025,"Dry Fruits, Nuts & Seeds",SD Mango cubes 100gm,2,45,45,0,1
13-03-2025,Snacks & Ready-to-Eat,CHOCO BROWINE,14,20,20,0,1
13-03-2025,Oils & Ghee,Coconut oil 500 ml,9,220,200,20,1
13-03-2025,Spices & Seasonings,GARAM MASALA 200GM,15,120,95,25,1
13-03-2025,Spices & Seasonings,Masala Karam 250 gms,15,130,120,10,1
13-03-2025,Snacks & Ready-to-Eat,millet noodles sf,14,35,35,0,1
13-03-2025,Spices & Seasonings,NUVVULU 500GM,15,200,170,30,1
13-03-2025,Oils & Ghee,Black Sesame oil 1 L,9,440,380,60,1
13-03-2025,"Grains, Flours & Dals",UDALU (Barnyard millet) 500 gms,4,70,60,10,1
13-03-2025,"Grains, Flours & Dals",ANDU KORRALU (Brown top .mlt) 500,4,130,110,20,1
13-03-2025,Oils & Ghee,Sesame oil 1 L,9,590,560,30,1
13-03-2025,"Grains, Flours & Dals",Arikalu (kodo),4,70,65,5,1
13-03-2025,"Grains, Flours & Dals",RAGI FLOUR 1KG,4,400,350,50,5
13-03-2025,Snacks & Ready-to-Eat,BATANA NGT 70GMS,14,20,20,0,1
13-03-2025,Snacks & Ready-to-Eat,GREEN FRIED BATANA,14,60,60,0,3
13-03-2025,Snacks & Ready-to-Eat,NGT CHATPATTA CHANA 90GM,14,25,25,0,1
13-03-2025,Snacks & Ready-to-Eat,VD NUVULLU CHIKKI,14,80,80,0,1
13-03-2025,Snacks & Ready-to-Eat,MARMURA LADDU,14,80,60,20,1
13-03-2025,Spices & Seasonings,SWEET SOUNF,15,20,20,0,1
13-03-2025,Snacks & Ready-to-Eat,VD MULTI CHAKKA,14,110,110,0,1
13-03-2025,Sweeteners,YB FOREST HONEY 250GM,16,360,360,0,2
13-03-2025,Spices & Seasonings,Japatri 25GM,15,100,80,20,1
13-03-2025,Snacks & Ready-to-Eat,SD Sesame laddu with dates250gm,14,135,135,0,1
13-03-2025,"Grains, Flours & Dals",Red Wheat Flour 1 kg,4,140,130,10,1
13-03-2025,Oils & Ghee,Sesame oil 500ml,9,295,280,15,1
13-03-2025,"Dry Fruits, Nuts & Seeds",MAHA BEERA SEEDS 100GM,2,60,60,0,1
13-03-2025,Snacks & Ready-to-Eat,SD JOWAR WITH PALM JAGGERY 250GM,14,135,135,0,1
13-03-2025,"Grains, Flours & Dals",Green Batani 250GM,4,55,45,10,1
13-03-2025,"Dry Fruits, Nuts & Seeds",chironji 50grms,2,200,160,40,1
13-03-2025,Oils & Ghee,Flaxseed oil 500 ml,9,300,270,30,1
13-03-2025,Snacks & Ready-to-Eat,SD Flax seeds with dates 250gm,14,135,135,0,1
13-03-2025,Spices & Seasonings,Lavangam 50GM,15,60,50,10,1
13-03-2025,Personal Care & Cosmetics,DWI MULTANI MITTI SOAP 100GM,10,75,75,0,1
13-03-2025,"Dry Fruits, Nuts & Seeds",FLAX SEEDS 250GM,2,60,50,10,1
13-03-2025,Snacks & Ready-to-Eat,BD RAGI NOODLES,14,75,75,0,1
13-03-2025,Oils & Ghee,Groundnut oil 500ml,9,180,165,15,1
13-03-2025,Oils & Ghee,Sesame oil 500ml,9,295,280,15,1
13-03-2025,"Dry Fruits, Nuts & Seeds",SD Mango cubes 100gm,2,45,45,0,1
13-03-2025,Snacks & Ready-to-Eat,GREEN FRIED batana,14,20,20,0,1
13-03-2025,Oils & Ghee,Mustard oil 500 ml,9,220,195,25,1
13-03-2025,"Grains, Flours & Dals",Green gram 500 gms,4,75,70,5,1
13-03-2025,Oils & Ghee,Safflower oil 1 L,9,440,400,40,1
13-03-2025,Oils & Ghee,Groundnut oil 1 L,9,360,330,30,1
13-03-2025,"Grains, Flours & Dals",Idly Rava L 1KG,4,60,50,10,1
13-03-2025,"Grains, Flours & Dals",Em Foxtail upma r 500 g,4,109,109,0,1
13-03-2025,"Grains, Flours & Dals",SA YELLOW JOWAR RAVA 500GM,4,95,95,0,1
13-03-2025,"Grains, Flours & Dals",EM kodo upma R 500g,4,129,129,0,1
13-03-2025,"Grains, Flours & Dals",SA WHITE JOWAR RAVA 500GM,4,69,69,0,1
13-03-2025,"Grains, Flours & Dals",Em Little idli R 500g,4,129,129,0,1
13-03-2025,Oils & Ghee,Groundnut oil 1 L,9,360,330,30,1
13-03-2025,Oils & Ghee,Black Sesame oil 500 ml,9,220,190,30,1
13-03-2025,"Grains, Flours & Dals",Em Little idli R 500g,4,129,129,0,1
13-03-2025,Spices & Seasonings,AVALU 250grms,15,60,60,0,1
13-03-2025,"Grains, Flours & Dals",Em jowar idly R 500G,4,75,75,0,1
13-03-2025,"Grains, Flours & Dals",EM Foxtail idli r 500 g,4,109,109,0,1
13-03-2025,Spices & Seasonings,Coriander seeds 200 gms,15,48,40,8,1
13-03-2025,Spices & Seasonings,JEERA 250 gms,15,250,210,40,2
13-03-2025,Spices & Seasonings,Chilli powder 500 gms,15,290,210,80,1
13-03-2025,"Grains, Flours & Dals",Wheat Flour 1 kg,4,70,60,10,1
13-03-2025,Spices & Seasonings,Elaichi 25GM,15,145,120,25,1
13-03-2025,Oils & Ghee,Sesame oil 1 L,9,1180,"1,120.00",60,2
13-03-2025,"Grains, Flours & Dals",UNPOLISHED TURDALL 1KG,4,240,210,30,1
13-03-2025,Spices & Seasonings,BIRYANI LEAF 10GM,15,30,20,10,1
13-03-2025,Personal Care & Cosmetics,ORAL B KIDS,10,25,25,0,1
13-03-2025,Household & Cleaning,comfort lily fresh,6,58,58,0,1
13-03-2025,"Grains, Flours & Dals",Chittimuthaylu rice 1 kg,4,160,140,20,1
13-03-2025,Household & Cleaning,SURF EXCEL MATIC TL 500ML,6,130,130,0,1
13-03-2025,"Dry Fruits, Nuts & Seeds",Groundnuts 1 kg,2,190,165,25,1
13-03-2025,"Grains, Flours & Dals",CHANA DAL 500GM,4,70,60,10,1
13-03-2025,Oils & Ghee,Sesame oil 1 L,9,1180,"1,120.00",60,2
13-03-2025,Oils & Ghee,Coconut oil 1 L,9,440,400,40,1
13-03-2025,"Grains, Flours & Dals",Multigrain 1 kg,4,200,170,30,2
13-03-2025,Snacks & Ready-to-Eat,VD CORNFLAKES MIXTURE 175GM,14,60,60,0,1
13-03-2025,"Grains, Flours & Dals",Green gram 1 kg,4,150,130,20,1
13-03-2025,Snacks & Ready-to-Eat,BELLAM MINAPA SUNADULLU,14,180,180,0,1
13-03-2025,"Health, Wellness & Ayurvedic Products",MH Millets Malt 1KG,5,2400,"2,280.00",120,6
13-03-2025,Oils & Ghee,Sesame oil 1 L,9,590,560,30,1
13-03-2025,"Grains, Flours & Dals",SRILATHA RICE RAVVA 500GM,4,70,70,0,2
13-03-2025,Snacks & Ready-to-Eat,NGT CHATPATTA CHANA 90GM,14,25,25,0,1
13-03-2025,"Grains, Flours & Dals",VYS.SP.RICE BAG 1,4,1800,"1,650.00",150,1
13-03-2025,Oils & Ghee,Sesame oil 1 L,9,590,560,30,1
13-03-2025,Snacks & Ready-to-Eat,GS Moongdal Dosa Mix 400GM,14,140,140,0,1
13-03-2025,"Grains, Flours & Dals",Em Little idli R 500g,4,129,129,0,1
13-03-2025,Snacks & Ready-to-Eat,ZEEDI,14,70,70,0,1
13-03-2025,"Grains, Flours & Dals",HS MULTI UPMA RAVA,4,65,65,0,1
13-03-2025,"Grains, Flours & Dals",Em Multimillet idli r 500g,4,129,129,0,1
13-03-2025,"Grains, Flours & Dals",EM Foxtail idli r 500 g,4,109,109,0,1
13-03-2025,"Grains, Flours & Dals",EM kodo upma R 500g,4,129,129,0,1
13-03-2025,Spices & Seasonings,SONTI 50GM,15,100,100,0,1
13-03-2025,"Health, Wellness & Ayurvedic Products",NEELI LEAF CHOORNAM,5,110,110,0,1
13-03-2025,"Health, Wellness & Ayurvedic Products",AMLAKI CHOORNAM,5,100,100,0,1
13-03-2025,"Health, Wellness & Ayurvedic Products",MD Mandara Leaf Powder 50GM,5,100,100,0,1
13-03-2025,Snacks & Ready-to-Eat,urban murmura,14,60,55,5,1
13-03-2025,Oils & Ghee,Groundnut oil 1 L,9,360,330,30,1
13-03-2025,Snacks & Ready-to-Eat,GREEN FRIED batana,14,20,20,0,1
13-03-2025,"Grains, Flours & Dals",Green gram 1 kg,4,150,130,20,1
13-03-2025,Spices & Seasonings,Tamarind 250GMS,15,80,65,15,1
13-03-2025,Personal Care & Cosmetics,UVIS MULTANI MITTI PW 100GM,10,49,49,0,1
13-03-2025,"Grains, Flours & Dals",Wheat Rava S 1KG,4,65,55,10,1
13-03-2025,"Grains, Flours & Dals",BOMBAY RAVA,4,70,55,15,1
13-03-2025,Personal Care & Cosmetics,UVIS ALOEVERA GEL,10,149,149,0,1
13-03-2025,Oils & Ghee,Groundnut oil 1 L,9,720,660,60,2
13-03-2025,"Grains, Flours & Dals",MELMEKER 250GMS,4,60,45,15,1
13-03-2025,"Dry Fruits, Nuts & Seeds",sabja seeds,2,80,70,10,1
13-03-2025,Sweeteners,YB JAGGERY POWDER 1KG,16,140,140,0,1
13-03-2025,Personal Care & Cosmetics,Soapnut 250GM,10,60,45,15,1
13-03-2025,"Dry Fruits, Nuts & Seeds",Groundnuts 1 kg,2,190,165,25,1
13-03-2025,"Grains, Flours & Dals",White jowar.F 1 kg,4,300,240,60,3
13-03-2025,"Grains, Flours & Dals",Wheat Flour 1 kg,4,140,120,20,2
13-03-2025,Spices & Seasonings,ROYAL SAFFRON,15,250,250,0,2
13-03-2025,"Grains, Flours & Dals",white Bobarlu 500 gms,4,80,75,5,1
13-03-2025,"Grains, Flours & Dals",BLACK GRAM 1KG,4,150,140,10,1
13-03-2025,Beverages,BRU GREEN LABEL 1.2G,1,48,48,0,24
13-03-2025,"Grains, Flours & Dals",white Bobarlu 500 gms,4,80,75,5,1
13-03-2025,"Grains, Flours & Dals",Urad dall 1 Kg,4,185,170,15,1
13-03-2025,"Grains, Flours & Dals",Green gram 1 kg,4,150,130,20,1
13-03-2025,"Dry Fruits, Nuts & Seeds",Groundnuts 1 kg,2,190,165,25,1
13-03-2025,Spices & Seasonings,Turmeric powder 250 gms,15,100,75,25,1
13-03-2025,"Grains, Flours & Dals",Black uluvalu 250 gms,4,45,35,10,1
13-03-2025,"Grains, Flours & Dals",RAJMA 250GM,4,55,45,10,1
13-03-2025,Spices & Seasonings,RED COPRA 500GM,15,170,148,22,1
13-03-2025,Spices & Seasonings,Masala Karam 250 gms,15,130,120,10,1
13-03-2025,"Grains, Flours & Dals",turdal 500 gms,4,110,100,10,1
13-03-2025,"Grains, Flours & Dals",Red Bobarlu 500 gms,4,95,85,10,1
13-03-2025,"Grains, Flours & Dals",Red uluvalu 250 gms,4,45,40,5,1
12-03-2025,Milk & Dairy,BROWN EGGS 1P,7,168,144,24,12
12-03-2025,"Dry Fruits, Nuts & Seeds",PLAIN PISTA 250GM,2,660,550,110,1
12-03-2025,"Dry Fruits, Nuts & Seeds",WALNUT ROUND 250GM,2,320,280,40,1
12-03-2025,"Dry Fruits, Nuts & Seeds",ALMONDS 250GM,2,280,260,20,1
12-03-2025,"Dry Fruits, Nuts & Seeds",cashew,2,340,310,30,1
12-03-2025,"Dry Fruits, Nuts & Seeds",WATERMELON SEEDS 250GRM,2,320,280,40,1
12-03-2025,"Dry Fruits, Nuts & Seeds",YB GRANMA NUTS,2,90,90,0,1
12-03-2025,"Grains, Flours & Dals",SAMALU,4,170,130,40,1
12-03-2025,"Dry Fruits, Nuts & Seeds",DRYDATES YELLOW 250GM,2,135,120,15,1
12-03-2025,Snacks & Ready-to-Eat,millet noodles sf,14,35,35,0,1
12-03-2025,"Grains, Flours & Dals",KORRALU (FOXTAIL M) 1KG,4,150,110,40,1
12-03-2025,General Household & Kitchenware,WOODEN SPOON BIG,3,40,40,0,1
12-03-2025,"Grains, Flours & Dals",UDALU (Barnyard millet) 1 kg,4,140,115,25,1
12-03-2025,Snacks & Ready-to-Eat,urban murmura,14,60,55,5,1
12-03-2025,Spices & Seasonings,RED COPRA 500GM,15,170,148,22,1
12-03-2025,Oils & Ghee,Groundnut oil 1 L,9,360,330,30,1
12-03-2025,"Grains, Flours & Dals",Bajra Flour 1 kg,4,70,60,10,1
12-03-2025,"Dry Fruits, Nuts & Seeds",DRYDATES 250GM,2,150,120,30,1
12-03-2025,Sweeteners,YB Brown Sugar 1KG,16,140,140,0,1
12-03-2025,Spices & Seasonings,Vamu 100GM,15,60,50,10,1
12-03-2025,"Grains, Flours & Dals",Multigrain 1 kg,4,100,85,15,1
12-03-2025,"Grains, Flours & Dals",ANDU KORRALU (Brown top .mlt) 500,4,130,110,20,1
12-03-2025,Oils & Ghee,Safflower oil 1 L,9,880,800,80,2
12-03-2025,Oils & Ghee,Mustard oil 500 ml,9,220,195,25,1
12-03-2025,Spices & Seasonings,Jeera 100GM,15,50,45,5,1
12-03-2025,"Grains, Flours & Dals",UDALU (Barnyard millet) 500 gms,4,70,60,10,1
12-03-2025,Spices & Seasonings,GS Pink Rock Salt 1KG,15,120,120,0,1
12-03-2025,"Grains, Flours & Dals",SAMALU (Little millet) 500 gms,4,85,65,20,1
12-03-2025,"Grains, Flours & Dals",Wheat Flour 1 kg,4,140,120,20,2
12-03-2025,Oils & Ghee,Coconut oil 500 ml,9,220,200,20,1
12-03-2025,Oils & Ghee,Sesame oil 1 L,9,1180,"1,120.00",60,2
12-03-2025,"Dry Fruits, Nuts & Seeds",SATHVI CHIA SEEDS 100GM,2,100,80,20,1
12-03-2025,"Grains, Flours & Dals",Green gram 500 gms,4,150,140,10,2
12-03-2025,Snacks & Ready-to-Eat,VD Minapa papad 200gm,14,60,60,0,1
12-03-2025,Snacks & Ready-to-Eat,MILLET PANCAKE CHOCOLATE,14,199,199,0,1
12-03-2025,"Dry Fruits, Nuts & Seeds",Groundnuts 500 gms,2,95,85,10,1
12-03-2025,"Grains, Flours & Dals",split urad dall 250 gms,4,45,40,5,1
12-03-2025,"Grains, Flours & Dals",split black gram 1 kg,4,180,170,10,1
12-03-2025,Oils & Ghee,BUFFALLO GHEE 500ML,9,410,370,40,1
12-03-2025,"Dry Fruits, Nuts & Seeds",Groundnuts 1 kg,2,190,165,25,1
12-03-2025,"Grains, Flours & Dals",Arikalu (kodo),4,70,65,5,1
12-03-2025,"Grains, Flours & Dals",ANDU KORRALU (Browntop.m) 1 kg,4,260,220,40,1
12-03-2025,"Grains, Flours & Dals",BASMATHI RICE 1KG,4,150,135,15,1
12-03-2025,"Grains, Flours & Dals",KORRALU (FOXTAIL M) 500GM,4,65,55,10,1
12-03-2025,"Dry Fruits, Nuts & Seeds",KAJU HALF 250GM,2,310,290,20,1
12-03-2025,"Grains, Flours & Dals",Red Wheat Flour 1 kg,4,280,260,20,2
12-03-2025,"Grains, Flours & Dals",Chana Flour 500 gms,4,70,65,5,1
12-03-2025,Spices & Seasonings,SAJEERA,15,60,40,20,1
12-03-2025,"Dry Fruits, Nuts & Seeds",sabja seeds,2,160,140,20,2
12-03-2025,"Grains, Flours & Dals",Black gram 500 gms,4,75,70,5,1
12-03-2025,Sweeteners,SD PALM JAGGERY 500GM,16,200,200,0,1
12-03-2025,Oils & Ghee,Coconut oil 1 L,9,440,400,40,1
12-03-2025,Spices & Seasonings,Telaga Pindi 250 GM,15,40,35,5,1
12-03-2025,"Grains, Flours & Dals",SRILATHA RICE RAVVA 500GM,4,35,35,0,1
12-03-2025,"Grains, Flours & Dals",VYS.SP RICE 1 KG,4,140,130,10,2
12-03-2025,"Grains, Flours & Dals",Wheat Flour 1 kg,4,70,60,10,1
12-03-2025,"Grains, Flours & Dals",VGR rice 1 kg,4,70,65,5,1
12-03-2025,"Grains, Flours & Dals",DESI CHANA,4,25,25,0,1
12-03-2025,"Dry Fruits, Nuts & Seeds",Groundnuts 500 gms,2,95,85,10,1
12-03-2025,Oils & Ghee,Groundnut oil 1 L,9,360,330,30,1
12-03-2025,"Dry Fruits, Nuts & Seeds",SD Mango cubes 200gm,2,90,90,0,1
12-03-2025,Spices & Seasonings,Masala Karam 250 gms,15,130,120,10,1
12-03-2025,Spices & Seasonings,Masala Karam 500 gms,15,260,240,20,1
12-03-2025,Pickles & Cooking Pastes,SD MANGO PICKLE,11,110,110,0,1
12-03-2025,Sweeteners,YB Brown Sugar 1KG,16,140,140,0,1
12-03-2025,Personal Care & Cosmetics,MADDI BATH POWDER 400GM,10,150,150,0,1
12-03-2025,Spices & Seasonings,Turmeric powder 250 gms,15,100,75,25,1
12-03-2025,"Grains, Flours & Dals",KORRALU (FOXTAIL M) 500GM,4,65,55,10,1
12-03-2025,"Dry Fruits, Nuts & Seeds",Groundnuts 1 kg,2,190,165,25,1
12-03-2025,"Grains, Flours & Dals",Brown RICE 1KG,4,140,130,10,2
12-03-2025,Sweeteners,YB JAGGERY POWDER 1KG,16,140,140,0,1
12-03-2025,Snacks & Ready-to-Eat,SD JOWAR WITH PALM JAGGERY 250GM,14,135,135,0,1
12-03-2025,"Grains, Flours & Dals",SAMALU (Little millet) 500 gms,4,85,65,20,1
12-03-2025,Snacks & Ready-to-Eat,SATHVI REGIVADA 200GM,14,80,60,20,1
12-03-2025,Oils & Ghee,Groundnut oil 1 L,9,360,330,30,1
12-03-2025,"Grains, Flours & Dals",RAGI FLOUR 1KG,4,80,70,10,1
12-03-2025,Oils & Ghee,Black Sesame oil 1 L,9,440,380,60,1
12-03-2025,Personal Care & Cosmetics,GOW DURBAR NAVA 100GM SOAP,10,120,120,0,3
12-03-2025,Snacks & Ready-to-Eat,VD MINAPA MIRCHI PAPAD 195GM,14,60,60,0,1
12-03-2025,Snacks & Ready-to-Eat,SF COOKIES CHOCO RAGI,14,99,99,0,1
12-03-2025,Snacks & Ready-to-Eat,SH PUFFED RICE 500GM,14,112,112,0,1
12-03-2025,"Dry Fruits, Nuts & Seeds",PUMPKIN SEEDS 250GM,2,200,160,40,1
12-03-2025,Snacks & Ready-to-Eat,HS Ragi biscuits,14,50,50,0,1
12-03-2025,Snacks & Ready-to-Eat,millet noodles sf,14,35,35,0,1
12-03-2025,Oils & Ghee,Groundnut oil 1 L,9,360,330,30,1
12-03-2025,"Dry Fruits, Nuts & Seeds",SUNFLOWER SEEDS 250GRM,2,150,130,20,1
12-03-2025,Spices & Seasonings,GREEN SOUNF,15,60,40,20,1
12-03-2025,Milk & Dairy,BROWN EGGS 1P,7,168,144,24,12
12-03-2025,"Grains, Flours & Dals",VYS.SP RICE 1 KG,4,70,65,5,1
12-03-2025,"Dry Fruits, Nuts & Seeds",SATHVI CHIA SEEDS 100GM,2,100,80,20,1
12-03-2025,Oils & Ghee,Safflower oil 1 L,9,440,400,40,1
12-03-2025,"Grains, Flours & Dals",EM Ragi idli R 500G,4,150,150,0,2
12-03-2025,Snacks & Ready-to-Eat,SATHVI REGIVADA 200GM,14,320,240,80,4
12-03-2025,Oils & Ghee,Sesame oil 1 L,9,590,560,30,1
12-03-2025,Oils & Ghee,Safflower oil 500 ml,9,220,200,20,1
12-03-2025,Oils & Ghee,Groundnut oil 1 L,9,1080,990,90,3
12-03-2025,"Grains, Flours & Dals",SH RED POHA 500GM,4,85,85,0,1
12-03-2025,"Grains, Flours & Dals",VYS.SP RICE 1 KG,4,70,65,5,1
12-03-2025,"Grains, Flours & Dals",AISHWARYA SP 1KG,4,80,70,10,1
12-03-2025,Beverages,BRU GREEN LABEL 1.2G,1,24,24,0,12
12-03-2025,"Grains, Flours & Dals",VGR RICE bag 1,4,1899,"1,650.00",249,1
12-03-2025,"Grains, Flours & Dals",VYS.SP RICE 1 KG,4,350,325,25,5
12-03-2025,"Grains, Flours & Dals",RAGI FLOUR 500GRMS,4,40,35,5,1
12-03-2025,"Grains, Flours & Dals",Wheat Flour 1 kg,4,140,120,20,2
12-03-2025,Snacks & Ready-to-Eat,SATHVI REGIVADA 200GM,14,80,60,20,1
12-03-2025,Pooja & Spiritual Items,SWASTIK CAMPHOR 10GM,12,20,20,0,1
12-03-2025,"Dry Fruits, Nuts & Seeds",sabja seeds,2,80,70,10,1
12-03-2025,"Grains, Flours & Dals",White jowar.F 1 kg,4,100,80,20,1
12-03-2025,"Grains, Flours & Dals",Wheat Rava S 500GM,4,33,30,3,1
12-03-2025,"Dry Fruits, Nuts & Seeds",FLAX SEEDS 250GM,2,60,50,10,1
12-03-2025,"Dry Fruits, Nuts & Seeds",PUMPKIN SEEDS 250GM,2,200,160,40,1
12-03-2025,Oils & Ghee,Groundnut oil 500ml,9,180,165,15,1
12-03-2025,"Dry Fruits, Nuts & Seeds",SUNFLOWER SEEDS 250GRM,2,150,130,20,1
12-03-2025,"Grains, Flours & Dals",KORRALU (FOXTAIL M) 500GM,4,65,55,10,1
12-03-2025,Baking & Cooking Aids,WEIKFIELD CUSTARD POWDER,0,43,43,0,1
12-03-2025,Snacks & Ready-to-Eat,SD Thati thandra 200gm,14,150,150,0,1
12-03-2025,Snacks & Ready-to-Eat,VD MINAPA VADIYAM,14,65,65,0,1
12-03-2025,Snacks & Ready-to-Eat,VD BOONDI 175GM,14,60,60,0,1
12-03-2025,Snacks & Ready-to-Eat,VD SANNAPUSA 175GM,14,60,60,0,1
12-03-2025,"Grains, Flours & Dals",SRILATHA RICE RAVVA 500GM,4,35,35,0,1
12-03-2025,"Dry Fruits, Nuts & Seeds",SUNFLOWER SEEDS 250GRM,2,150,130,20,1
12-03-2025,"Dry Fruits, Nuts & Seeds",ANJEER 250GM,2,400,360,40,1
12-03-2025,"Dry Fruits, Nuts & Seeds",WATERMELON SEEDS 250GRM,2,320,280,40,1
12-03-2025,"Dry Fruits, Nuts & Seeds",ALMONDS 250GM,2,280,260,20,1
12-03-2025,"Dry Fruits, Nuts & Seeds",PUMPKIN SEEDS 250GM,2,200,160,40,1
12-03-2025,"Dry Fruits, Nuts & Seeds",SD Mango cubes 100gm,2,45,45,0,1
12-03-2025,Milk & Dairy,SANGAM TONED MILK 500ML,7,30,30,0,1
12-03-2025,Snacks & Ready-to-Eat,VD PALLI CHIKKI,14,80,80,0,1
12-03-2025,"Dry Fruits, Nuts & Seeds",BLACK KISMIS 250GM,2,175,140,35,1
12-03-2025,"Dry Fruits, Nuts & Seeds",WALLNUTS 250GM,2,380,360,20,1
12-03-2025,"Dry Fruits, Nuts & Seeds",YELLOW KISHMISH 250GM,2,130,110,20,1
12-03-2025,"Dry Fruits, Nuts & Seeds",BLACK KISMIS 250GM,2,175,140,35,1
12-03-2025,"Dry Fruits, Nuts & Seeds",SALTED PISTA 250GM,2,400,350,50,1
12-03-2025,"Dry Fruits, Nuts & Seeds",ANJEER 250GM,2,400,360,40,1
12-03-2025,Snacks & Ready-to-Eat,VD NUVULLU CHIKKI,14,80,80,0,1
12-03-2025,"Dry Fruits, Nuts & Seeds",PUMPKIN SEEDS 250GM,2,200,160,40,1
12-03-2025,"Dry Fruits, Nuts & Seeds",cashew,2,340,310,30,1
12-03-2025,"Dry Fruits, Nuts & Seeds",ALMONDS 250GM,2,280,260,20,1
12-03-2025,"Grains, Flours & Dals",VGR RICE bag 1,4,1899,"1,650.00",249,1
12-03-2025,"Grains, Flours & Dals",SINGLE POLISH 1KG,4,195,195,0,3
12-03-2025,Personal Care & Cosmetics,UVIS RED SANDAL SOAP 100GM,10,85,85,0,1
12-03-2025,Snacks & Ready-to-Eat,SATHVI REGIVADA 200GM,14,320,240,80,4
12-03-2025,Spices & Seasonings,PURO Healthy Salt Crystal 1KG,15,135,135,0,1
12-03-2025,"Grains, Flours & Dals",VYS.SP.RICE BAG 1,4,1800,"1,650.00",150,1
12-03-2025,Milk & Dairy,BROWN EGGS TRAY 30P,7,360,330,30,1
12-03-2025,Oils & Ghee,Groundnut oil 1 L,9,360,330,30,1
12-03-2025,Snacks & Ready-to-Eat,MB FOXTAIL MILLET NOODLES 180GM,14,95,95,0,1
12-03-2025,"Grains, Flours & Dals",KORRALU (FOXTAIL M) 1KG,4,150,110,40,1
12-03-2025,"Grains, Flours & Dals",SAMALU (Little millet) 500 gms,4,85,65,20,1
12-03-2025,"Grains, Flours & Dals",Em jowar idly R 500G,4,75,75,0,1
12-03-2025,Snacks & Ready-to-Eat,FOXTAIL BIS,14,135,135,0,1
12-03-2025,Snacks & Ready-to-Eat,GREEN FRIED batana,14,20,20,0,1
12-03-2025,"Health, Wellness & Ayurvedic Products",GS Wheat Grass Powder 100GMS,5,349,349,0,1
12-03-2025,Snacks & Ready-to-Eat,SALTED PHALLI,14,130,130,0,2
12-03-2025,"Health, Wellness & Ayurvedic Products",MD Tulasi Leaf Powder 50GM,5,80,80,0,1
12-03-2025,Oils & Ghee,Black Sesame oil 500 ml,9,440,380,60,2
12-03-2025,Spices & Seasonings,AV Iodized Salt 1KG,15,28,25,3,1
12-03-2025,Oils & Ghee,Black Sesame oil 1 L,9,1320,"1,140.00",180,3
12-03-2025,Snacks & Ready-to-Eat,VD MANGO JELLY 250GRMS,14,80,80,0,1
12-03-2025,"Health, Wellness & Ayurvedic Products",DWI LAVANGA TAILA 20ML,5,120,120,0,2
12-03-2025,Snacks & Ready-to-Eat,VD NUVULU LADDU 9PIC,14,100,100,0,1
12-03-2025,Snacks & Ready-to-Eat,BATANA NGT 70GMS,14,60,60,0,3
12-03-2025,Snacks & Ready-to-Eat,VD DRY FRUIT PUTHAREKULU,14,480,480,0,4
12-03-2025,Pooja & Spiritual Items,javadhu 60,12,0,0,0,1
12-03-2025,"Health, Wellness & Ayurvedic Products",HARITHAKI CHOORNAM,5,60,60,0,1
12-03-2025,"Dry Fruits, Nuts & Seeds",DIANUTS 500GM,2,480,480,0,4
12-03-2025,"Grains, Flours & Dals",DOCTOR RICE DIABETIC SFR 1KG,4,1200,"1,200.00",0,10
12-03-2025,Oils & Ghee,Groundnut oil 1 L,9,720,660,60,2
12-03-2025,"Grains, Flours & Dals",SA YELLOW JOWAR RAVA 500GM,4,95,95,0,1
12-03-2025,"Grains, Flours & Dals",Arikalu (kodo),4,70,65,5,1
12-03-2025,"Grains, Flours & Dals",Quinova 500 gms,4,110,100,10,1
12-03-2025,"Dry Fruits, Nuts & Seeds",sabja seeds,2,80,70,10,1
12-03-2025,"Dry Fruits, Nuts & Seeds",MAHA BEERA SEEDS 100GM,2,60,60,0,1
12-03-2025,"Dry Fruits, Nuts & Seeds",ANJEER 250GM,2,400,360,40,1
12-03-2025,"Grains, Flours & Dals",Em kodo idli R 500G,4,129,129,0,1
12-03-2025,"Grains, Flours & Dals",UDALU (Barnyard millet) 500 gms,4,70,60,10,1
12-03-2025,"Grains, Flours & Dals",SAMALU (Little millet) 500 gms,4,85,65,20,1
12-03-2025,"Grains, Flours & Dals",ANDU KORRALU (Brown top .mlt) 500,4,130,110,20,1
12-03-2025,"Dry Fruits, Nuts & Seeds",FLAX SEEDS 250GM,2,60,50,10,1
12-03-2025,Milk & Dairy,HERITAGE BUTTERMILK,7,10,10,0,1
12-03-2025,"Grains, Flours & Dals",Em Little idli R 500g,4,129,129,0,1
12-03-2025,Milk & Dairy,HERITAGE BUTTERMILK,7,10,10,0,1
12-03-2025,"Grains, Flours & Dals",MELMEKER 250GMS,4,60,45,15,1
12-03-2025,"Grains, Flours & Dals",Arikalu (kodo),4,70,65,5,1
12-03-2025,Snacks & Ready-to-Eat,GREEN FRIED batana,14,20,20,0,1
12-03-2025,"Grains, Flours & Dals",SAMALU (Little millet) 500 gms,4,85,65,20,1
12-03-2025,"Grains, Flours & Dals",UDALU (Barnyard millet) 500 gms,4,70,60,10,1
12-03-2025,"Grains, Flours & Dals",ANDU KORRALU (Brown top .mlt) 500,4,130,110,20,1
12-03-2025,Snacks & Ready-to-Eat,VD GUMMADI CHAKKA,14,130,130,0,1
12-03-2025,"Grains, Flours & Dals",Wheat Flour 1 kg,4,140,120,20,2
12-03-2025,"Grains, Flours & Dals",Chana Flour 500 gms,4,70,65,5,1
12-03-2025,"Dry Fruits, Nuts & Seeds",Groundnuts 1 kg,2,190,165,25,1
12-03-2025,Spices & Seasonings,JEERA 250 gms,15,125,105,20,1
12-03-2025,Spices & Seasonings,Gasagasalu 50GM,15,260,220,40,2
12-03-2025,"Grains, Flours & Dals",turdal 1kg,4,440,390,50,2
12-03-2025,"Grains, Flours & Dals",SINGLE POLISH 1KG,4,325,325,0,5
12-03-2025,Personal Care & Cosmetics,GOW DURBAR 75G,10,60,60,0,1
12-03-2025,Spices & Seasonings,AVALU 250grms,15,60,60,0,1
12-03-2025,Oils & Ghee,Sesame oil 1 L,9,1180,"1,120.00",60,2
12-03-2025,Milk & Dairy,BROWN EGGS 1P,7,14,12,2,1
12-03-2025,"Grains, Flours & Dals",Multigrain 1 kg,4,100,85,15,1
12-03-2025,"Grains, Flours & Dals",Arikadu ( kodo),4,140,130,10,1
12-03-2025,Snacks & Ready-to-Eat,PEANUT CHIKKI 450GM,14,125,125,0,1
12-03-2025,"Grains, Flours & Dals",KORRALU (FOXTAIL M) 500GM,4,130,110,20,2
12-03-2025,"Grains, Flours & Dals",HS Multimillet idly R 500 gms,4,65,65,0,1
12-03-2025,Oils & Ghee,Groundnut oil 1 L,9,360,330,30,1
12-03-2025,Oils & Ghee,Groundnut oil 1 L,9,360,330,30,1
12-03-2025,Oils & Ghee,Sesame oil 1 L,9,590,560,30,1
12-03-2025,Spices & Seasonings,Chilli powder 500 gms,15,290,210,80,1
12-03-2025,Spices & Seasonings,Chilli powder 1 kg,15,580,420,160,1
12-03-2025,Pooja & Spiritual Items,BANDA PUVVU 25GM 25GM,12,80,60,20,1
12-03-2025,Pickles & Cooking Pastes,SD MANGO PICKLE,11,110,110,0,1
12-03-2025,Spices & Seasonings,MAMTA BLACK PEPPER POWDER,15,90,90,0,1
12-03-2025,Spices & Seasonings,Gasagasalu 50GM,15,130,110,20,1
12-03-2025,Spices & Seasonings,Chilli powder 500 gms,15,290,210,80,1
12-03-2025,Oils & Ghee,Coconut oil 500 ml,9,220,200,20,1
12-03-2025,Oils & Ghee,Groundnut oil 500ml,9,180,165,15,1
12-03-2025,"Dry Fruits, Nuts & Seeds",PUMPKIN SEEDS 250GM,2,200,160,40,1
12-03-2025,"Dry Fruits, Nuts & Seeds",WALNUT ROUND 250GM,2,320,280,40,1
12-03-2025,"Dry Fruits, Nuts & Seeds",SUNFLOWER SEEDS 250GRM,2,150,130,20,1
12-03-2025,Spices & Seasonings,Chilli powder 500 gms,15,290,210,80,1
12-03-2025,Spices & Seasonings,Turmeric powder 250 gms,15,100,75,25,1
12-03-2025,Household & Cleaning,HENKO STAIN CARE 500GM,6,79,79,0,1
12-03-2025,"Grains, Flours & Dals",Wheat Flour 5 kgs,4,350,300,50,1
12-03-2025,Sweeteners,YB Brown Sugar 500GM,16,150,150,0,2
12-03-2025,"Grains, Flours & Dals",Idly Rava L 1KG,4,60,50,10,1
12-03-2025,Household & Cleaning,MR WHITE 1KG,6,95,95,0,1
12-03-2025,Sweeteners,YB Brown Sugar 1KG,16,140,140,0,1
12-03-2025,Pooja & Spiritual Items,GD Dhoop Cones 40GM,12,60,60,0,2
12-03-2025,Household & Cleaning,VIM MAHA BAR,6,60,60,0,6
12-03-2025,"Grains, Flours & Dals",BOMBAY RAVA,4,70,55,15,1
12-03-2025,Milk & Dairy,BROWN EGGS 1P,7,168,144,24,12
12-03-2025,"Grains, Flours & Dals",Multigrain 1 kg,4,100,85,15,1
12-03-2025,Milk & Dairy,SANGAM FULL CREAM MILK 500ML,7,76,76,0,2
12-03-2025,Snacks & Ready-to-Eat,BB VERMICELLY 500GM,14,53,53,0,1
12-03-2025,"Dry Fruits, Nuts & Seeds",Groundnuts 1 kg,2,190,165,25,1
12-03-2025,Spices & Seasonings,RED COPRA 250GMS,15,85,74,11,1
12-03-2025,Snacks & Ready-to-Eat,VD Minapa papad 200gm,14,80,80,0,1
12-03-2025,Spices & Seasonings,Chilli powder 500 gms,15,290,210,80,1
12-03-2025,Spices & Seasonings,Tamarind 250GMS,15,80,65,15,1
12-03-2025,Oils & Ghee,GANTASALA A2 COW GHEE 250ML,9,598,598,0,2
12-03-2025,Snacks & Ready-to-Eat,VD BELLAM GAVVALU 200GM,14,60,60,0,1
12-03-2025,Milk & Dairy,HERITAGE TOTAL CURD 500GM,7,100,100,0,2
12-03-2025,Snacks & Ready-to-Eat,ZEEDI,14,70,70,0,1
12-03-2025,Snacks & Ready-to-Eat,VD MURMURA LADDU,14,50,50,0,1
12-03-2025,Oils & Ghee,Groundnut oil 1 L,9,360,330,30,1
12-03-2025,"Grains, Flours & Dals",turdal 1kg,4,220,195,25,1
12-03-2025,"Grains, Flours & Dals",AISHWARYA SP IDLY RAVA 1KG,4,120,66,54,1
12-03-2025,"Dry Fruits, Nuts & Seeds",PUTNALU 500GMS,2,90,76,14,1
12-03-2025,"Grains, Flours & Dals",AISHWARAYA IDLY RAVA 1KG,4,99,66,33,1
12-03-2025,Oils & Ghee,Sesame oil 1 L,9,590,560,30,1
12-03-2025,Snacks & Ready-to-Eat,NGT CHATPATTA CHANA 90GM,14,25,25,0,1
12-03-2025,Snacks & Ready-to-Eat,CHOCO BROWINE,14,20,20,0,1
12-03-2025,"Grains, Flours & Dals",RAGI FLOUR 500GRMS,4,40,35,5,1
12-03-2025,Snacks & Ready-to-Eat,SD Thati thandra 200gm,14,300,300,0,2
12-03-2025,Pooja & Spiritual Items,GD Ramayana Sandal 75GM,12,120,120,0,2
12-03-2025,Sweeteners,Natural Honey 500 gms,16,280,240,40,1
12-03-2025,Snacks & Ready-to-Eat,PEANUT CHILLI,14,15,15,0,3
12-03-2025,Pooja & Spiritual Items,bilwa patra,12,60,60,0,1
12-03-2025,Spices & Seasonings,SWEET SOUNF,15,20,20,0,1
12-03-2025,Pooja & Spiritual Items,GB Bharatha Woods 75GM,12,120,120,0,2
12-03-2025,"Grains, Flours & Dals",AISHWARYA SP 1KG,4,80,70,10,1
12-03-2025,"Grains, Flours & Dals",CHANADALL 250 GMS,4,35,30,5,1
12-03-2025,"Grains, Flours & Dals",Em Multimillet idli r 500g,4,129,129,0,1
12-03-2025,Spices & Seasonings,Coriander seeds 200 gms,15,48,40,8,1
12-03-2025,Snacks & Ready-to-Eat,NGT CHATPATTA CHANA 90GM,14,25,25,0,1
12-03-2025,Sweeteners,YB JAGGERY POWDER 500GMS,16,75,75,0,1
12-03-2025,"Dry Fruits, Nuts & Seeds",FLAX SEEDS 250GM,2,60,50,10,1
12-03-2025,Oils & Ghee,Groundnut oil 500ml,9,180,165,15,1
12-03-2025,"Grains, Flours & Dals",PRO ORG MEDIUM POHA 500G,4,78,78,0,1
11-03-2025,Pooja & Spiritual Items,GD Ramayana Sandal 75GM,12,60,60,0,1
11-03-2025,Snacks & Ready-to-Eat,VD JAGGERY GHEE 250GM,14,180,180,0,1
11-03-2025,Pooja & Spiritual Items,GD WOODS 150GM,12,110,110,0,1
11-03-2025,General Household & Kitchenware,knife 1,3,15,10,5,1
11-03-2025,Baking & Cooking Aids,WEIKFIELD CUSTARD POWDER,0,43,43,0,1
11-03-2025,Snacks & Ready-to-Eat,VD Minapa papad 200gm,14,60,60,0,1
11-03-2025,"Grains, Flours & Dals",RAGI FLOUR 500GRMS,4,40,35,5,1
11-03-2025,Snacks & Ready-to-Eat,VD MANGO JELLY 250GRMS,14,80,80,0,1
11-03-2025,Snacks & Ready-to-Eat,SATHVI REGIVADA 200GM,14,80,60,20,1
11-03-2025,Pooja & Spiritual Items,BALAJI BEL PHOOL STICKS 90GM,12,60,60,0,1
11-03-2025,"Grains, Flours & Dals",Em Little idli R 500g,4,129,129,0,1
11-03-2025,"Grains, Flours & Dals",EM Foxtail idli r 500 g,4,109,109,0,1
11-03-2025,"Grains, Flours & Dals",KORRALU (FOXTAIL M) 500GM,4,65,55,10,1
11-03-2025,"Dry Fruits, Nuts & Seeds",Groundnuts 500 gms,2,95,85,10,1
11-03-2025,Oils & Ghee,BUFFALLO GHEE 500ML,9,410,370,40,1
11-03-2025,Spices & Seasonings,Gasagasalu 50GM,15,130,110,20,1
11-03-2025,Sweeteners,SUGAR 1KG,16,60,50,10,1
11-03-2025,Spices & Seasonings,SREE MARUTHI IDLY KARAM 200GM,15,60,60,0,1
11-03-2025,"Grains, Flours & Dals",RAGI FLOUR 500GRMS,4,40,35,5,1
11-03-2025,"Grains, Flours & Dals",URAD DALL,4,95,85,10,1
11-03-2025,"Grains, Flours & Dals",SL Idly Rava 1KG,4,65,55,10,1
11-03-2025,Oils & Ghee,Groundnut oil 1 L,9,720,660,60,2
11-03-2025,"Grains, Flours & Dals",SH WHEAT DALIYA 500GM,4,60,60,0,1
11-03-2025,"Grains, Flours & Dals",Wheat Rava S 500GM,4,33,30,3,1
11-03-2025,Snacks & Ready-to-Eat,SD Ginger Candy 100g,14,60,60,0,1
11-03-2025,Snacks & Ready-to-Eat,SALTED PHALLI,14,25,25,0,1
11-03-2025,"Grains, Flours & Dals",SL Idly Rava 1KG,4,65,55,10,1
11-03-2025,"Dry Fruits, Nuts & Seeds",YB GRANMA NUTS,2,90,90,0,1
11-03-2025,"Grains, Flours & Dals",split black gram 1 kg,4,180,170,10,1
11-03-2025,Snacks & Ready-to-Eat,RAJGIRA PEANUT CHIKKI,14,40,40,0,8
11-03-2025,Snacks & Ready-to-Eat,VD BELLAM GAVVALU 200GM,14,60,60,0,1
11-03-2025,"Grains, Flours & Dals",White Chana 250 GM,4,60,50,10,1
11-03-2025,Oils & Ghee,cow ghee 500 ml,9,430,390,40,1
11-03-2025,Snacks & Ready-to-Eat,VD CORNFLAKES MIXTURE 175GM,14,60,60,0,1
11-03-2025,Oils & Ghee,Sesame oil 1 L,9,590,560,30,1
11-03-2025,Oils & Ghee,Groundnut oil 1 L,9,360,330,30,1
11-03-2025,Oils & Ghee,Black Sesame oil 500 ml,9,440,380,60,2
11-03-2025,"Grains, Flours & Dals",turdal 1kg,4,220,195,25,1
11-03-2025,Oils & Ghee,Groundnut oil 1 L,9,360,330,30,1
11-03-2025,Oils & Ghee,Safflower oil 1 L,9,440,400,40,1
11-03-2025,"Health, Wellness & Ayurvedic Products",RB Max Protein Chinese Manchurian,5,45,45,0,1
11-03-2025,Snacks & Ready-to-Eat,VD CORNFLAKES MIXTURE 175GM,14,60,60,0,1
11-03-2025,Snacks & Ready-to-Eat,VD MURUKU 175GM,14,60,60,0,1
11-03-2025,"Grains, Flours & Dals",Wheat Flour 1 kg,4,70,60,10,1
11-03-2025,"Grains, Flours & Dals",Sathya Javva Wheat Rava 500GM,4,190,190,0,2
11-03-2025,"Dry Fruits, Nuts & Seeds",sabja seeds,2,80,70,10,1
11-03-2025,Snacks & Ready-to-Eat,VD BOONDI 175GM,14,60,60,0,1
11-03-2025,"Grains, Flours & Dals",CHANA DAL 500GM,4,70,60,10,1
11-03-2025,Snacks & Ready-to-Eat,GB SALT COOKIES,14,120,110,10,2
11-03-2025,"Grains, Flours & Dals",WHITE BATANI,4,40,30,10,1
11-03-2025,Pooja & Spiritual Items,SWASTIK CAMPHORE,12,90,90,0,1
11-03-2025,Snacks & Ready-to-Eat,VD SANNAPUSA 175GM,14,60,60,0,1
11-03-2025,Personal Care & Cosmetics,MYSORE SANDAL SOAP 75G,10,84,84,0,2
11-03-2025,"Dry Fruits, Nuts & Seeds",YELLOW KISHMISH 250GM,2,130,110,20,1
11-03-2025,"Dry Fruits, Nuts & Seeds",CASHEW 250GM,2,340,310,30,1
11-03-2025,"Grains, Flours & Dals",UDALU (Barnyard millet) 1 kg,4,140,115,25,1
11-03-2025,"Grains, Flours & Dals",SAMALU,4,170,130,40,1
11-03-2025,"Dry Fruits, Nuts & Seeds",PUMPKIN SEEDS 250GM,2,200,160,40,1
11-03-2025,"Grains, Flours & Dals",KORRALU (FOXTAIL M) 1KG,4,150,110,40,1
11-03-2025,"Grains, Flours & Dals",RAGI FLOUR 1KG,4,80,70,10,1
11-03-2025,Snacks & Ready-to-Eat,VD GUMMADI CHAKKA,14,130,130,0,1
11-03-2025,"Grains, Flours & Dals",PESARA PAPPU 500GMS,4,85,75,10,1
11-03-2025,Milk & Dairy,SANGAM CURD 450GM,7,38,38,0,1
11-03-2025,"Grains, Flours & Dals",Arikadu ( kodo),4,140,130,10,1
11-03-2025,"Dry Fruits, Nuts & Seeds",SUNFLOWER SEEDS 250GRM,2,150,130,20,1
11-03-2025,Snacks & Ready-to-Eat,RAJGIRA PEANUT CHIKKI,14,5,5,0,1
11-03-2025,Snacks & Ready-to-Eat,SATHVI REGIVADA 200GM,14,80,60,20,1
11-03-2025,Milk & Dairy,BROWN EGGS 1P,7,168,144,24,12
11-03-2025,"Grains, Flours & Dals",SL Idly Rava 1KG,4,65,55,10,1
11-03-2025,Snacks & Ready-to-Eat,ZEEDI,14,70,70,0,1
11-03-2025,Misc,VD0009,8,100,100,0,1
11-03-2025,"Dry Fruits, Nuts & Seeds",Groundnuts 1 kg,2,190,165,25,1
11-03-2025,"Grains, Flours & Dals",SABDANA,4,40,35,5,1
11-03-2025,Snacks & Ready-to-Eat,VD SAGOPAPAD 150GM,14,55,55,0,1
11-03-2025,Snacks & Ready-to-Eat,VD RICE MURUKU 150GM,14,50,50,0,1
11-03-2025,"Grains, Flours & Dals",Multigrain 1 kg,4,100,85,15,1
11-03-2025,Oils & Ghee,Coconut oil 500 ml,9,220,200,20,1
11-03-2025,"Dry Fruits, Nuts & Seeds",PUMPKIN SEEDS 250GM,2,200,160,40,1
11-03-2025,"Grains, Flours & Dals",KORRALU (FOXTAIL M) 1KG,4,150,110,40,1
11-03-2025,"Grains, Flours & Dals",SAMALU,4,170,130,40,1
11-03-2025,Oils & Ghee,Groundnut oil 1 L,9,360,330,30,1
11-03-2025,"Grains, Flours & Dals",Hs yellow jowar r 500g,4,99,99,0,1
11-03-2025,Snacks & Ready-to-Eat,SALTED PHALLI,14,25,25,0,1
11-03-2025,Snacks & Ready-to-Eat,GREEN FRIED BATANA,14,20,20,0,1
11-03-2025,Snacks & Ready-to-Eat,VD CORNFLAKES MIXTURE 175GM,14,60,60,0,1
11-03-2025,Snacks & Ready-to-Eat,VD PALLI CHIKKI,14,80,80,0,1
11-03-2025,Snacks & Ready-to-Eat,SF COOKIES CHOCO RAGI,14,99,99,0,1
11-03-2025,Spices & Seasonings,Gasagasalu 50GM,15,130,110,20,1
11-03-2025,Spices & Seasonings,Miriyalu 50GM,15,200,160,40,2
11-03-2025,Spices & Seasonings,SAJEERA,15,60,40,20,1
11-03-2025,Spices & Seasonings,Lavangam 50GM,15,60,50,10,1
11-03-2025,Spices & Seasonings,Avalu small 250 gms,15,60,40,20,1
11-03-2025,"Grains, Flours & Dals",RAGULU 1 KG,4,70,60,10,1
11-03-2025,Oils & Ghee,Safflower oil 1 L,9,440,400,40,1
11-03-2025,Snacks & Ready-to-Eat,SATHVI REGIVADA 200GM,14,80,60,20,1
11-03-2025,Snacks & Ready-to-Eat,ELITE ELAICHI RUSK 200GM,14,35,35,0,1
11-03-2025,Misc,ROLL D C,8,70,45,25,1
11-03-2025,Spices & Seasonings,Jeera 100GM,15,100,90,10,2
11-03-2025,Spices & Seasonings,Elaichi 25GM,15,145,120,25,1
11-03-2025,"Dry Fruits, Nuts & Seeds",MAHA BEERA SEEDS 100GM,2,60,60,0,1
11-03-2025,"Grains, Flours & Dals",Green gram 1 kg,4,150,130,20,1
11-03-2025,"Grains, Flours & Dals",EM Foxtail idli r 500 g,4,109,109,0,1
11-03-2025,Oils & Ghee,Castor oil 200 ml,9,100,80,20,1
11-03-2025,Spices & Seasonings,NUVVULU 250GM,15,100,85,15,1
11-03-2025,Oils & Ghee,Groundnut oil 1 L,9,360,330,30,1
11-03-2025,"Grains, Flours & Dals",RAGI FLOUR 500GRMS,4,40,35,5,1
11-03-2025,"Grains, Flours & Dals",Multigrain 1 kg,4,100,85,15,1
11-03-2025,"Grains, Flours & Dals",Sathya Javva Wheat Rava 500GM,4,95,95,0,1
11-03-2025,"Grains, Flours & Dals",UDALU (Barnyard millet) 500 gms,4,70,60,10,1
11-03-2025,"Grains, Flours & Dals",Em jowar idly R 500G,4,75,75,0,1
11-03-2025,"Grains, Flours & Dals",Wheat Flour 1 kg,4,140,120,20,2
11-03-2025,"Grains, Flours & Dals",SAMALU (Little millet) 500 gms,4,85,65,20,1
11-03-2025,"Grains, Flours & Dals",Wheat Rava S 1KG,4,65,55,10,1
11-03-2025,"Grains, Flours & Dals",ANDU KORRALU (Brown top .mlt) 500,4,130,110,20,1
11-03-2025,"Grains, Flours & Dals",KORRALU (FOXTAIL M) 500GM,4,65,55,10,1
11-03-2025,"Grains, Flours & Dals",White jowar.F 1 kg,4,500,400,100,5
11-03-2025,Snacks & Ready-to-Eat,VD SANNAPUSA 175GM,14,60,60,0,1
11-03-2025,Snacks & Ready-to-Eat,RSC ORANGE 100GMS,14,20,20,0,1
11-03-2025,"Grains, Flours & Dals",Yellow jowar .F1 kg,4,330,300,30,3
11-03-2025,Snacks & Ready-to-Eat,VD BOONDI 175GM,14,60,60,0,1
11-03-2025,"Grains, Flours & Dals",KORRALU (FOXTAIL M) 1KG,4,150,110,40,1
11-03-2025,Snacks & Ready-to-Eat,VD MULTI CHAKKA,14,110,110,0,1
11-03-2025,"Grains, Flours & Dals",SL Idly Rava 1KG,4,65,55,10,1
11-03-2025,"Grains, Flours & Dals",RED WHEAT 1 KG,4,130,120,10,1
11-03-2025,"Grains, Flours & Dals",RAGULU 1 KG,4,70,60,10,1
11-03-2025,Snacks & Ready-to-Eat,SATHVI REGIVADA 200GM,14,80,60,20,1
11-03-2025,Snacks & Ready-to-Eat,VD RICE MURUKU 150GM,14,50,50,0,1
11-03-2025,"Grains, Flours & Dals",White jowar.F 1 kg,4,100,80,20,1
11-03-2025,"Grains, Flours & Dals",MELMEKER 250GMS,4,60,45,15,1
11-03-2025,"Grains, Flours & Dals",Chana Flour 500 gms,4,70,65,5,1
11-03-2025,Snacks & Ready-to-Eat,VD DAHI MIRCHI(SALTED) 100GM,14,45,45,0,1
11-03-2025,Snacks & Ready-to-Eat,PEANUT CHILLI,14,15,15,0,3
11-03-2025,Pooja & Spiritual Items,JAVADHU POWDER 2G,12,34,34,0,1
11-03-2025,"Grains, Flours & Dals",Yellow jowar.F 500 gms,4,55,50,5,1
11-03-2025,"Grains, Flours & Dals",Wheat Flour 1 kg,4,280,240,40,4
11-03-2025,"Grains, Flours & Dals",Multigrain 1 kg,4,100,85,15,1
11-03-2025,"Grains, Flours & Dals",SA Sprouted Ragi Flour 500GM,4,69,69,0,1
11-03-2025,Snacks & Ready-to-Eat,VD KOBARI LADDU,14,160,160,0,2
11-03-2025,"Dry Fruits, Nuts & Seeds",SATHVI CHIA SEEDS 100GM,2,100,80,20,1
11-03-2025,Snacks & Ready-to-Eat,VD NUVULU PAPAD 200GM,14,100,100,0,1
11-03-2025,"Grains, Flours & Dals",SAMALU,4,170,130,40,1
11-03-2025,"Grains, Flours & Dals",KORRALU (FOXTAIL M) 1KG,4,150,110,40,1
11-03-2025,Oils & Ghee,Castor oil 200 ml,9,100,80,20,1
11-03-2025,Snacks & Ready-to-Eat,BELLAM MINAPA SUNADULLU,14,180,180,0,1
11-03-2025,Personal Care & Cosmetics,HERBAL BATH POWDER 200GM,10,80,80,0,1
11-03-2025,Snacks & Ready-to-Eat,VD MANGO JELLY 250GRMS,14,80,80,0,1
11-03-2025,Oils & Ghee,Sesame oil 500ml,9,295,280,15,1
11-03-2025,"Health, Wellness & Ayurvedic Products",AMLA PACHAK,5,100,100,0,1
11-03-2025,Personal Care & Cosmetics,Soapnut 250GM,10,60,45,15,1
11-03-2025,Snacks & Ready-to-Eat,VD MURMURA LADDU,14,50,50,0,1
11-03-2025,Oils & Ghee,Groundnut oil 1 L,9,360,330,30,1
11-03-2025,"Grains, Flours & Dals",DESI CHANA,4,25,25,0,1
11-03-2025,Milk & Dairy,BROWN EGGS 1P,7,210,180,30,15
11-03-2025,Milk & Dairy,HRITAGE TOTAL CURD 130GM,7,10,10,0,1
11-03-2025,"Grains, Flours & Dals",THICK POHA 500GM,4,40,35,5,1
11-03-2025,Spices & Seasonings,PRO ORG CORIANDER WHOLE 100G,15,70,70,0,1
11-03-2025,"Health, Wellness & Ayurvedic Products",RB Max Protein Cheese&amp;,5,45,45,0,1
11-03-2025,"Grains, Flours & Dals",SAMALU (Little millet) 500 gms,4,85,65,20,1
11-03-2025,"Grains, Flours & Dals",Multigrain 1 kg,4,100,85,15,1
11-03-2025,"Grains, Flours & Dals",RAGI FLOUR 500GRMS,4,40,35,5,1
11-03-2025,Spices & Seasonings,NUVVULU 250GM,15,80,65,15,1
11-03-2025,Oils & Ghee,Groundnut oil 1 L,9,360,330,30,1
11-03-2025,Snacks & Ready-to-Eat,millet noodles sf,14,70,70,0,2
11-03-2025,"Dry Fruits, Nuts & Seeds",FLAX SEEDS 250GM,2,60,50,10,1
11-03-2025,"Grains, Flours & Dals",Em little upma R 500g,4,129,129,0,1
11-03-2025,Personal Care & Cosmetics,ES POCKET COMB,10,50,50,0,1
11-03-2025,Milk & Dairy,SANGAM TONED MILK 500ML,7,60,60,0,2
11-03-2025,Snacks & Ready-to-Eat,MIX MILLET NOODLES,14,150,150,0,2
11-03-2025,"Grains, Flours & Dals",Arikalu (kodo),4,70,65,5,1
11-03-2025,"Grains, Flours & Dals",GS BROWN RICE POHA 200GM,4,60,60,0,1
11-03-2025,"Grains, Flours & Dals",DESI CHANA,4,25,25,0,1
11-03-2025,"Grains, Flours & Dals",EM Foxtail idli r 500 g,4,109,109,0,1
11-03-2025,"Health, Wellness & Ayurvedic Products",RB Max Protein PERI PERI 60gm,5,45,45,0,1
11-03-2025,"Dry Fruits, Nuts & Seeds",sabja seeds,2,80,70,10,1
11-03-2025,Spices & Seasonings,YB PINK ROCK SALT 1KG,15,120,120,0,1
11-03-2025,Oils & Ghee,Coconut oil 1 L,9,440,400,40,1
11-03-2025,Snacks & Ready-to-Eat,DISANO VERMICELLI 425 GM,14,50,50,0,1
11-03-2025,Spices & Seasonings,GS Pink Rock Salt 1KG,15,120,120,0,1
11-03-2025,"Health, Wellness & Ayurvedic Products",RB Max Protein Cheese&amp;,5,45,45,0,1
11-03-2025,Oils & Ghee,Coconut oil 500 ml,9,220,200,20,1
11-03-2025,Sweeteners,Natural Honey 500 gms,16,280,240,40,1
11-03-2025,Oils & Ghee,Groundnut oil 1 L,9,720,660,60,2
11-03-2025,Oils & Ghee,Mustard oil 1 L,9,880,800,80,2
11-03-2025,Oils & Ghee,Groundnut oil 1 L,9,360,330,30,1
11-03-2025,Personal Care & Cosmetics,UVIS LACTO TAN SOAP 100GM,10,99,99,0,1
11-03-2025,"Grains, Flours & Dals",Wheat Flour 1 kg,4,70,60,10,1
11-03-2025,Oils & Ghee,Safflower oil 1 L,9,440,400,40,1
11-03-2025,Oils & Ghee,Sesame oil 1 L,9,590,560,30,1
11-03-2025,Personal Care & Cosmetics,MYSORE SANDAL BABY SOAP,10,45,45,0,1
11-03-2025,Oils & Ghee,Coconut oil 1 L,9,440,400,40,1
11-03-2025,Oils & Ghee,Sesame oil 1 L,9,590,560,30,1
11-03-2025,Oils & Ghee,Castor oil 200 ml,9,100,80,20,1
11-03-2025,Spices & Seasonings,SWEET SOUNF,15,20,20,0,1
11-03-2025,Oils & Ghee,Coconut oil 500 ml,9,220,200,20,1
11-03-2025,Snacks & Ready-to-Eat,VD KOBARI LADDU,14,160,160,0,2
11-03-2025,Sweeteners,GS JAGGERY NUGGETS 500GM,16,120,120,0,1
11-03-2025,Sweeteners,Natural Honey 500 gms,16,280,240,40,1
11-03-2025,Sweeteners,YB JAGGERY POWDER 500GMS,16,75,75,0,1
11-03-2025,"Grains, Flours & Dals",Wheat Flour 1 kg,4,140,120,20,2
11-03-2025,Personal Care & Cosmetics,MYSORE SANDAL BABY SOAP,10,45,45,0,1
11-03-2025,Spices & Seasonings,Masala Karam 250 gms,15,130,120,10,1
11-03-2025,Personal Care & Cosmetics,GOW DURBAR NAVA 100GM SOAP,10,80,80,0,2
11-03-2025,Oils & Ghee,Groundnut oil 1 L,9,1800,"1,650.00",150,5
11-03-2025,"Grains, Flours & Dals",Multigrain 1 kg,4,200,170,30,2
11-03-2025,"Grains, Flours & Dals",Wheat Flour 2 kgs,4,280,240,40,2
11-03-2025,Oils & Ghee,Sesame oil 1 L,9,1180,"1,120.00",60,2
11-03-2025,Spices & Seasonings,Chilli powder 1 kg,15,580,420,160,1
11-03-2025,Spices & Seasonings,SATHVI TURMERIC POWDER 500GM,15,180,130,50,1
11-03-2025,"Grains, Flours & Dals",URAD DALL,4,95,85,10,1
11-03-2025,"Grains, Flours & Dals",turdal 500 gms,4,110,100,10,1
11-03-2025,Sweeteners,MADHUR SUGAR 1KG,16,65,55,10,1
11-03-2025,Pooja & Spiritual Items,GD Dhoop Cones 40GM,12,30,30,0,1
11-03-2025,Snacks & Ready-to-Eat,SH PUFFED RICE 500GM,14,112,112,0,1
11-03-2025,"Dry Fruits, Nuts & Seeds",PULMAKHANA 100 GM,2,180,170,10,1
11-03-2025,"Grains, Flours & Dals",CHANA DAL 500GM,4,70,60,10,1
11-03-2025,"Dry Fruits, Nuts & Seeds",KAJU HALF 250GM,2,310,290,20,1
11-03-2025,"Health, Wellness & Ayurvedic Products",DETTOL PLASTER,5,7.5,7.5,0,3
11-03-2025,Pooja & Spiritual Items,GD KASTHURI,12,60,60,0,1
11-03-2025,Oils & Ghee,Sesame oil 5 L,9,2950,"2,750.00",200,1
11-03-2025,Snacks & Ready-to-Eat,MIGHTY PUFFS TOMATO,14,25,25,0,1
11-03-2025,"Dry Fruits, Nuts & Seeds",Putnalu 250GM,2,45,38,7,1
11-03-2025,"Dry Fruits, Nuts & Seeds",SATHVI CHIA SEEDS 100GM,2,100,80,20,1
11-03-2025,"Grains, Flours & Dals",chana dall,4,35,30,5,1
11-03-2025,Oils & Ghee,Groundnut oil 1 L,9,360,330,30,1
11-03-2025,Pooja & Spiritual Items,GD Sree Chandan 50GM,12,50,50,0,1
11-03-2025,Personal Care & Cosmetics,SUNNUPINDI SOAP UVS,10,99,99,0,1
11-03-2025,"Health, Wellness & Ayurvedic Products",MD Kasturi Pasupu Choornam 50GM,5,80,80,0,1
11-03-2025,Sweeteners,MADHUR SUGAR 1KG,16,65,55,10,1
11-03-2025,Spices & Seasonings,AV Iodized Salt 1KG,15,56,50,6,2
11-03-2025,Snacks & Ready-to-Eat,VD NUVULU CHEGODI 175GM,14,60,60,0,1
11-03-2025,Pickles & Cooking Pastes,SD MANGO PICKLE,11,110,110,0,1
11-03-2025,"Grains, Flours & Dals",turdal 500 gms,4,110,100,10,1
11-03-2025,Personal Care & Cosmetics,DWI SMARA SOAP 100GM,10,75,75,0,1
11-03-2025,General Household & Kitchenware,BLADE,3,12,12,0,1
11-03-2025,"Grains, Flours & Dals",Red Chana 250GM,4,35,30,5,1
11-03-2025,Personal Care & Cosmetics,MYSORE SANDAL,10,69,69,0,1
11-03-2025,Spices & Seasonings,Chilli powder 500 gms,15,290,210,80,1
11-03-2025,"Grains, Flours & Dals",PESARA PAPPU 500GMS,4,85,75,10,1
11-03-2025,Snacks & Ready-to-Eat,VD RIBBON PAKODI 175GM,14,60,60,0,1
11-03-2025,Spices & Seasonings,Tamarind 250GMS,15,80,65,15,1
11-03-2025,"Grains, Flours & Dals",Wheat Flour 1 kg,4,70,60,10,1
11-03-2025,"Grains, Flours & Dals",RAGI FLOUR 500GRMS,4,40,35,5,1
11-03-2025,Beverages,REFRESH SHARBATH SUGAR FREE,1,299,285,14,1
11-03-2025,Oils & Ghee,Sesame oil 500ml,9,295,280,15,1
11-03-2025,"Grains, Flours & Dals",Yellow jowar .F1 kg,4,110,100,10,1
11-03-2025,Spices & Seasonings,ROYAL SAFFRON 400GRMS,15,65,65,0,1
11-03-2025,"Grains, Flours & Dals",White jowar.F 1 kg,4,200,160,40,2
11-03-2025,"Grains, Flours & Dals",VGR rice 1 kg,4,350,325,25,5
11-03-2025,"Dry Fruits, Nuts & Seeds",Groundnuts 500 gms,2,95,85,10,1
11-03-2025,"Grains, Flours & Dals",turdal 1kg,4,220,195,25,1
11-03-2025,"Grains, Flours & Dals",THICK POHA 500GM,4,40,35,5,1
11-03-2025,"Grains, Flours & Dals",Wheat Rava S 1KG,4,65,55,10,1
11-03-2025,"Grains, Flours & Dals",Wheat Flour 1 kg,4,140,120,20,2
11-03-2025,Snacks & Ready-to-Eat,PEANUT CHILLI,14,50,50,0,10
11-03-2025,"Grains, Flours & Dals",SRILATHA RICE RAVVA 500GM,4,35,35,0,1
11-03-2025,"Grains, Flours & Dals",Wheat Flour 1 kg,4,70,60,10,1
11-03-2025,"Health, Wellness & Ayurvedic Products",RB FRUITS &amp;seeds Cranberries,5,45,45,0,1
11-03-2025,Snacks & Ready-to-Eat,Corn Chips 250GM,14,40,35,5,1
11-03-2025,Snacks & Ready-to-Eat,RI Yogurt Berry Oats 35g,14,45,45,0,1
11-03-2025,"Grains, Flours & Dals",White jowar.F 1 kg,4,100,80,20,1
11-03-2025,"Grains, Flours & Dals",RAGI FLOUR 1KG,4,80,70,10,1
11-03-2025,"Grains, Flours & Dals",Wheat Rava M 500GM,4,33,30,3,1
11-03-2025,Oils & Ghee,Castor oil 200 ml,9,100,80,20,1
11-03-2025,Oils & Ghee,Groundnut oil 1 L,9,360,330,30,1
11-03-2025,Spices & Seasonings,NUVVULU 500GM,15,160,130,30,1
11-03-2025,"Grains, Flours & Dals",Red uluvalu 250 gms,4,45,40,5,1
11-03-2025,Sweeteners,YB Brown Sugar 500GM,16,75,75,0,1
11-03-2025,"Grains, Flours & Dals",Chana Flour 500 gms,4,70,65,5,1
11-03-2025,Oils & Ghee,Sesame oil 500ml,9,295,280,15,1
11-03-2025,"Grains, Flours & Dals",KORRALU (FOXTAIL M) 500GM,4,65,55,10,1
11-03-2025,Oils & Ghee,Sesame oil 500ml,9,295,280,15,1
11-03-2025,Snacks & Ready-to-Eat,RAJGIRA PEANUT CHIKKI 450GM,14,125,125,0,1
11-03-2025,"Grains, Flours & Dals",Arikalu (kodo),4,70,65,5,1
11-03-2025,"Dry Fruits, Nuts & Seeds",SD Mango cubes 100gm,2,90,90,0,2
11-03-2025,"Grains, Flours & Dals",ANDU KORRALU (Brown top .mlt) 500,4,130,110,20,1
11-03-2025,"Grains, Flours & Dals",UDALU (Barnyard millet) 500 gms,4,70,60,10,1
11-03-2025,"Grains, Flours & Dals",SAMALU (Little millet) 500 gms,4,85,65,20,1
11-03-2025,Milk & Dairy,BROWN EGGS TRAY 30P,7,360,330,30,1
11-03-2025,Spices & Seasonings,sf jeera,15,120,120,0,1
11-03-2025,"Dry Fruits, Nuts & Seeds",Groundnuts 1 kg,2,190,165,25,1
11-03-2025,Spices & Seasonings,JEERA 250 gms,15,125,105,20,1
11-03-2025,Snacks & Ready-to-Eat,MB PEARL MILLET NOODLES 180GM,14,95,95,0,1
11-03-2025,Spices & Seasonings,DHANIYA POWDER 200GM,15,100,85,15,1
11-03-2025,"Grains, Flours & Dals",MELMEKER 250GMS,4,60,45,15,1
11-03-2025,"Dry Fruits, Nuts & Seeds",Groundnuts 1 kg,2,380,330,50,2
11-03-2025,"Grains, Flours & Dals",white Bobarlu 500 gms,4,80,75,5,1
11-03-2025,Spices & Seasonings,TATA SALT 1KG,15,30,30,0,1
11-03-2025,Snacks & Ready-to-Eat,VD PALLI CHIKKI,14,80,80,0,1
11-03-2025,Sweeteners,SUGAR 1KG,16,120,100,20,2
11-03-2025,Spices & Seasonings,SAMBAR POWDER 200GM,15,130,110,20,1
11-03-2025,"Grains, Flours & Dals",Green gram 1 kg,4,150,130,20,1
11-03-2025,Snacks & Ready-to-Eat,MB MULTIMILLET NOODLES 180GM,14,95,95,0,1
11-03-2025,"Grains, Flours & Dals",SABDANA 500GM,4,90,70,20,1
11-03-2025,"Grains, Flours & Dals",THICK POHA 500GM,4,40,35,5,1
11-03-2025,"Grains, Flours & Dals",Arikadu ( kodo),4,140,130,10,1
11-03-2025,Spices & Seasonings,Vamu 100GM,15,60,50,10,1
11-03-2025,"Grains, Flours & Dals",Red Bobarlu 500 gms,4,95,85,10,1
11-03-2025,Snacks & Ready-to-Eat,VD GUMMADI CHAKKA,14,130,130,0,1
11-03-2025,"Grains, Flours & Dals",RAJMA 500GM,4,90,90,0,1
11-03-2025,Sweeteners,GS Organic Jaggery Powder 600GM,16,99,99,0,1
11-03-2025,"Grains, Flours & Dals",SL Idly Rava 1KG,4,65,55,10,1
11-03-2025,Oils & Ghee,Groundnut oil 5 L,9,1800,"1,600.00",200,1
11-03-2025,"Grains, Flours & Dals",split green gram 1 kg,4,150,140,10,1
11-03-2025,"Grains, Flours & Dals",KORRALU (FOXTAIL M) 1KG,4,150,110,40,1
11-03-2025,Spices & Seasonings,Menthulu 500 gms,15,100,90,10,1
11-03-2025,Spices & Seasonings,GARAM MASALA 200GM,15,120,95,25,1
11-03-2025,"Grains, Flours & Dals",HS JOWAR FLAKES 250GM 1+1,4,119,119,0,1
11-03-2025,"Grains, Flours & Dals",turdal 1kg,4,220,195,25,1
11-03-2025,Spices & Seasonings,ROYAL SAFFRON,15,125,125,0,1
11-03-2025,"Grains, Flours & Dals",SAMALU,4,170,130,40,1
11-03-2025,Snacks & Ready-to-Eat,ZEEDI,14,70,70,0,1
11-03-2025,Oils & Ghee,Groundnut oil 1 L,9,360,330,30,1
11-03-2025,Spices & Seasonings,SD Curry Leaves Karam Powder 100GM,15,65,65,0,1
11-03-2025,Snacks & Ready-to-Eat,SD Thati thandra 200gm,14,150,150,0,1
11-03-2025,Pooja & Spiritual Items,GD JASMINE 75GM,12,60,60,0,1
11-03-2025,Milk & Dairy,HRITAGE TOTAL CURD 130GM,7,10,10,0,1
11-03-2025,"Grains, Flours & Dals",Wheat Flour 1 kg,4,70,60,10,1
11-03-2025,Snacks & Ready-to-Eat,VD GUMMADI CHAKKA,14,260,260,0,2
11-03-2025,Oils & Ghee,Coconut oil 1 L,9,440,400,40,1
11-03-2025,Snacks & Ready-to-Eat,VD MURUKU 175GM,14,60,60,0,1
11-03-2025,Spices & Seasonings,Chilli powder 500 gms,15,290,210,80,1
11-03-2025,"Dry Fruits, Nuts & Seeds",SUNFLOWER SEEDS 250GRM,2,150,130,20,1
11-03-2025,"Health, Wellness & Ayurvedic Products",RB Peanut butter Peanuts Dark 40g,5,45,45,0,1
11-03-2025,"Dry Fruits, Nuts & Seeds",WATERMELON SEEDS 250GRM,2,320,280,40,1
11-03-2025,"Dry Fruits, Nuts & Seeds",PUMPKIN SEEDS 250GM,2,200,160,40,1
11-03-2025,General Household & Kitchenware,WOODEN SPOON BIG,3,40,40,0,1
11-03-2025,"Dry Fruits, Nuts & Seeds",FLAX SEEDS 250GM,2,60,50,10,1
11-03-2025,"Dry Fruits, Nuts & Seeds",SD Mango cubes 200gm,2,90,90,0,1
11-03-2025,Beverages,BRU GREEN LABEL 1.2G,1,24,24,0,12
11-03-2025,"Grains, Flours & Dals",Brown RICE 1KG,4,140,130,10,2
11-03-2025,Spices & Seasonings,Turmeric powder 250 gms,15,100,75,25,1
11-03-2025,Spices & Seasonings,AVALU 100GM,15,25,20,5,1
11-03-2025,"Grains, Flours & Dals",VGR rice 1 kg,4,210,195,15,3
11-03-2025,Snacks & Ready-to-Eat,PEANUT CHILLI,14,20,20,0,4
11-03-2025,Oils & Ghee,Sesame oil 500ml,9,295,280,15,1
11-03-2025,Beverages,BRU GREEN LABEL 1.2G,1,48,48,0,24
11-03-2025,"Grains, Flours & Dals",Chana Flour 500 gms,4,70,65,5,1
11-03-2025,Oils & Ghee,Coconut oil 500 ml,9,220,200,20,1
11-03-2025,"Grains, Flours & Dals",Wheat Flour 1 kg,4,140,120,20,2
11-03-2025,"Grains, Flours & Dals",RICE FLOUR 500 GM,4,35,28,7,1
11-03-2025,Oils & Ghee,Groundnut oil 1 L,9,360,330,30,1
11-03-2025,"Grains, Flours & Dals",Bajra Flour 1 kg,4,70,60,10,1
11-03-2025,"Grains, Flours & Dals",WHEAT 1 KG,4,60,50,10,1
11-03-2025,"Grains, Flours & Dals",RAGI FLOUR 1KG,4,80,70,10,1
11-03-2025,"Grains, Flours & Dals",FLOUR CHARGE,4,24,24,0,2
11-03-2025,"Grains, Flours & Dals",BAJRA 1 KG,4,60,50,10,1
11-03-2025,"Grains, Flours & Dals",RED TURDAL 500GM,4,75,70,5,1
11-03-2025,Snacks & Ready-to-Eat,VD BOONDI 175GM,14,60,60,0,1
11-03-2025,"Grains, Flours & Dals",FLOUR CHARGE,4,84,84,0,7
11-03-2025,"Grains, Flours & Dals",Wheat Rava M 1KG,4,65,55,10,1
11-03-2025,"Grains, Flours & Dals",WHEAT 1 KG,4,300,250,50,5
11-03-2025,"Grains, Flours & Dals",RAGI FLOUR 1KG,4,160,140,20,2
11-03-2025,Snacks & Ready-to-Eat,NGT CHATPATTA CHANA 90GM,14,50,50,0,2
11-03-2025,Oils & Ghee,Coconut oil 500 ml,9,220,200,20,1
11-03-2025,"Grains, Flours & Dals",FLOUR CHARGE,4,60,60,0,5
11-03-2025,Pooja & Spiritual Items,DASANGAM DHOOP POWDER 50GM,12,43,43,0,1
11-03-2025,Personal Care & Cosmetics,HERBAL BATH POWDER 200GM,10,80,80,0,1
11-03-2025,Milk & Dairy,BROWN EGGS TRAY 30P,7,360,330,30,1
11-03-2025,Oils & Ghee,Coconut oil 1 L,9,440,400,40,1
11-03-2025,Snacks & Ready-to-Eat,Sprouted Ragi Biscuits 450GM,14,150,150,0,1
11-03-2025,Oils & Ghee,cow ghee 500 ml,9,430,390,40,1
11-03-2025,"Health, Wellness & Ayurvedic Products",MADDI HAIR OIL 100ML,5,130,130,0,1
11-03-2025,"Grains, Flours & Dals",FLOUR CHARGE,4,66,66,0,5.5
11-03-2025,"Grains, Flours & Dals",White jowar.F 1 kg,4,300,240,60,3
11-03-2025,"Grains, Flours & Dals",BAJRA 1 KG,4,15,12.5,2.5,0.25
11-03-2025,Snacks & Ready-to-Eat,MIGHTY PUFFS KHATTA METTA,14,50,50,0,2
11-03-2025,"Grains, Flours & Dals",SOYA BEANS 1KG,4,50,45,5,0.25
11-03-2025,"Grains, Flours & Dals",WHEAT 1 KG,4,300,250,50,5
11-03-2025,"Grains, Flours & Dals",THICK POHA 500GM,4,40,35,5,1
11-03-2025,Oils & Ghee,Safflower oil 1 L,9,440,400,40,1
11-03-2025,Pooja & Spiritual Items,BANDA PUVVU 25GM 25GM,12,80,60,20,1
11-03-2025,"Grains, Flours & Dals",RAGI FLOUR 500GRMS,4,40,35,5,1
11-03-2025,"Grains, Flours & Dals",Wheat Flour 1 kg,4,70,60,10,1
11-03-2025,"Dry Fruits, Nuts & Seeds",SATHVI CHIA SEEDS 100GM,2,100,80,20,1
11-03-2025,"Dry Fruits, Nuts & Seeds",SUNFLOWER SEEDS 250GRM,2,150,130,20,1
11-03-2025,"Dry Fruits, Nuts & Seeds",ANJEER 250GM,2,400,360,40,1
11-03-2025,Spices & Seasonings,Masala Karam 500 gms,15,260,240,20,1
11-03-2025,"Grains, Flours & Dals",Red uluvalu 250 gms,4,45,40,5,1
11-03-2025,Snacks & Ready-to-Eat,VD ARISELU 5 PIC,14,100,100,0,1
11-03-2025,"Grains, Flours & Dals",unpolished turdall500grms,4,120,110,10,1
11-03-2025,"Dry Fruits, Nuts & Seeds",sabja seeds,2,80,70,10,1
11-03-2025,"Grains, Flours & Dals",SABDANA,4,40,35,5,1
11-03-2025,"Grains, Flours & Dals",Chana Flour 500 gms,4,70,65,5,1
11-03-2025,Spices & Seasonings,ROYAL SAFFRON 400GRMS,15,65,65,0,1
11-03-2025,Household & Cleaning,PITAMBARI SHINING POWDER 200G,6,60,60,0,1
11-03-2025,Snacks & Ready-to-Eat,MAAGAANI M JOWAR PASTA 200GM,14,199,199,0,1
11-03-2025,"Dry Fruits, Nuts & Seeds",WATERMELON SEEDS 250GRM,2,320,280,40,1
11-03-2025,Pooja & Spiritual Items,GD Dhoop Cones 40GM,12,30,30,0,1
11-03-2025,"Dry Fruits, Nuts & Seeds",PUMPKIN SEEDS 250GM,2,200,160,40,1
11-03-2025,Oils & Ghee,Groundnut oil 1 L,9,360,330,30,1
11-03-2025,Baking & Cooking Aids,GONDH 50GRMS,0,50,40,10,1
11-03-2025,"Grains, Flours & Dals",RICE FLOUR 1KG,4,140,110,30,2
11-03-2025,Sweeteners,ACHUBELLAM 500GM,16,50,40,10,1
11-03-2025,"Grains, Flours & Dals",Multigrain 1 kg,4,300,255,45,3
11-03-2025,Milk & Dairy,BROWN EGGS 1P,7,140,120,20,10
11-03-2025,Spices & Seasonings,Jeera 100GM,15,50,45,5,1
11-03-2025,Pooja & Spiritual Items,BANDA PUVVU 25GM 25GM,12,80,60,20,1
11-03-2025,"Grains, Flours & Dals",Wheat Flour 1 kg,4,70,60,10,1
11-03-2025,"Grains, Flours & Dals",RAGI FLOUR 500GRMS,4,40,35,5,1
11-03-2025,Spices & Seasonings,NUVVULU 250GM,15,80,65,15,1
11-03-2025,Spices & Seasonings,Vamu 100GM,15,60,50,10,1
11-03-2025,Spices & Seasonings,Tamarind 250GMS,15,80,65,15,1
11-03-2025,"Grains, Flours & Dals",THICK POHA 500GM,4,40,35,5,1
11-03-2025,"Grains, Flours & Dals",SRILATHA RICE RAVVA 500GM,4,35,35,0,1
11-03-2025,"Grains, Flours & Dals",Green gram 500 gms,4,75,70,5,1
11-03-2025,"Grains, Flours & Dals",turdal 1kg,4,220,195,25,1
11-03-2025,"Grains, Flours & Dals",SL Idly Rava 1KG,4,130,110,20,2
11-03-2025,"Grains, Flours & Dals",turdal 500 gms,4,110,100,10,1
11-03-2025,"Grains, Flours & Dals",Chana Flour 500 gms,4,70,65,5,1
11-03-2025,Snacks & Ready-to-Eat,BD RED RICE NOODLES 200G,14,70,70,0,1
11-03-2025,"Grains, Flours & Dals",maida 500grms,4,35,30,5,1
11-03-2025,Snacks & Ready-to-Eat,MIX MILLET NOODLES,14,75,75,0,1
11-03-2025,"Grains, Flours & Dals",SPLIT BLACK GRAM 500 GM,4,180,170,10,2
11-03-2025,"Dry Fruits, Nuts & Seeds",Groundnuts 1 kg,2,190,165,25,1
11-03-2025,"Grains, Flours & Dals",Red Chana 250GM,4,35,30,5,1
11-03-2025,Spices & Seasonings,Menthulu 250 gms,15,50,45,5,1
11-03-2025,"Grains, Flours & Dals",Urad dall 1 Kg,4,185,170,15,1
11-03-2025,"Dry Fruits, Nuts & Seeds",Groundnuts 1 kg,2,190,165,25,1
11-03-2025,Snacks & Ready-to-Eat,NGT CHATPATTA CHANA 90GM,14,25,25,0,1
11-03-2025,"Dry Fruits, Nuts & Seeds",SATHVI CHIA SEEDS 100GM,2,100,80,20,1
11-03-2025,Oils & Ghee,Coconut oil 500 ml,9,220,200,20,1
11-03-2025,"Grains, Flours & Dals",RAGULU 1 KG,4,35,30,5,0.5
11-03-2025,"Grains, Flours & Dals",JOWAR WHITE 1 KG,4,20,17.5,2.5,0.25
11-03-2025,Oils & Ghee,Groundnut oil 500ml,9,180,165,15,1
11-03-2025,Oils & Ghee,DWI VATADATEL 50ML,9,155,155,0,1
11-03-2025,"Grains, Flours & Dals",KORRALU (FOXTAIL M) 1KG,4,37.5,27.5,10,0.25
11-03-2025,"Grains, Flours & Dals",turdal 1kg,4,220,195,25,1
11-03-2025,"Grains, Flours & Dals",VGR RICE bag 1,4,1899,"1,650.00",249,1
11-03-2025,"Grains, Flours & Dals",Brown rice 5 kgs,4,350,325,25,1
11-03-2025,Milk & Dairy,BROWN EGGS 1P,7,210,180,30,15
11-03-2025,Sweeteners,SD PALM JAGGERY 500GM,16,200,200,0,1
11-03-2025,Snacks & Ready-to-Eat,SD Ginger Candy 100g,14,60,60,0,1
11-03-2025,Snacks & Ready-to-Eat,SD JOWAR WITH PALM JAGGERY 250GM,14,135,135,0,1
11-03-2025,Snacks & Ready-to-Eat,MIGHTY PUFF,14,25,25,0,1
11-03-2025,Snacks & Ready-to-Eat,SF MIGHTY PUFFS,14,25,25,0,1
11-03-2025,"Grains, Flours & Dals",SA Sprouted Ragi Flour 500GM,4,69,69,0,1
11-03-2025,Sweeteners,YB JAGGERY POWDER 500GMS,16,150,150,0,2
11-03-2025,Snacks & Ready-to-Eat,millet cake,14,119,119,0,1
11-03-2025,"Grains, Flours & Dals",RAGI FLOUR 1KG,4,80,70,10,1
11-03-2025,"Grains, Flours & Dals",SINGLE POLISH 1KG,4,650,650,0,10
11-03-2025,"Grains, Flours & Dals",KORRALU (FOXTAIL M) 1KG,4,150,110,40,1
11-03-2025,"Grains, Flours & Dals",Wheat Flour 1 kg,4,70,60,10,1
11-03-2025,Oils & Ghee,cow ghee 500 ml,9,430,390,40,1
11-03-2025,Snacks & Ready-to-Eat,SD Moringa with plam jaggery 250gm,14,135,135,0,1
11-03-2025,"Grains, Flours & Dals",Wheat Rava S 1KG,4,65,55,10,1
11-03-2025,"Grains, Flours & Dals",split green gram 500 gms,4,75,70,5,1
11-03-2025,Milk & Dairy,BROWN EGGS TRAY 30P,7,360,330,30,1
11-03-2025,Oils & Ghee,Groundnut oil 1 L,9,360,330,30,1
11-03-2025,Spices & Seasonings,Chilli powder 500 gms,15,290,210,80,1
11-03-2025,Oils & Ghee,Coconut oil 1 L,9,440,400,40,1
11-03-2025,Oils & Ghee,Sesame oil 500ml,9,295,280,15,1
11-03-2025,Oils & Ghee,Sesame oil 500ml,9,295,280,15,1
11-03-2025,Sweeteners,Mishri 500GM,16,70,60,10,1
11-03-2025,"Dry Fruits, Nuts & Seeds",FLAX SEEDS 250GM,2,60,50,10,1
11-03-2025,"Grains, Flours & Dals",RICE FLOUR 500 GM,4,35,28,7,1
11-03-2025,Milk & Dairy,HERITAGE TOTAL CURD 500GM,7,50,50,0,1
11-03-2025,Oils & Ghee,Castor oil 200 ml,9,100,80,20,1
11-03-2025,Sweeteners,NATURAL HONEY 1KG,16,560,480,80,1
11-03-2025,Oils & Ghee,cow ghee 500 ml,9,430,390,40,1
11-03-2025,Oils & Ghee,Coconut oil 1 L,9,440,400,40,1
10-03-2025,"Health, Wellness & Ayurvedic Products",RB Max Protein Cheese&amp;,5,45,45,0,1
10-03-2025,"Grains, Flours & Dals",SRILATHA RICE RAVVA 500GM,4,35,35,0,1
10-03-2025,Snacks & Ready-to-Eat,VD BELLAM GAVVALU 200GM,14,60,60,0,1
10-03-2025,Spices & Seasonings,SAFE HARVEST FENNEL SANUF,15,110,110,0,1
10-03-2025,"Health, Wellness & Ayurvedic Products",RB Max Protein Chinese Manchurian,5,45,45,0,1
10-03-2025,"Health, Wellness & Ayurvedic Products",RB Max Protein Classic Creamy,5,169,169,0,1
10-03-2025,"Grains, Flours & Dals",unpolished turdall500grms,4,120,110,10,1
10-03-2025,Spices & Seasonings,ROYAL SAFFRON 400GRMS,15,65,65,0,1
10-03-2025,"Health, Wellness & Ayurvedic Products",RB Max Protein PERI PERI 60gm,5,45,45,0,1
10-03-2025,"Dry Fruits, Nuts & Seeds",SD Mango cubes 100gm,2,45,45,0,1
10-03-2025,Snacks & Ready-to-Eat,RITEBITE BLUEBERRY BLAST,14,50,50,0,1
10-03-2025,"Grains, Flours & Dals",PRO ORG KABULI CHANNA 500GM,4,196,196,0,1
10-03-2025,Spices & Seasonings,Coconut Powder 250GM,15,90,70,20,1
10-03-2025,"Grains, Flours & Dals",KORRALU (FOXTAIL M) 1KG,4,300,220,80,2
10-03-2025,Oils & Ghee,Groundnut oil 1 L,9,360,330,30,1
10-03-2025,"Grains, Flours & Dals",Arikadu ( kodo),4,140,130,10,1
10-03-2025,"Grains, Flours & Dals",JOWAR WHITE 1 KG,4,80,70,10,1
10-03-2025,"Grains, Flours & Dals",Green gram 1 kg,4,150,130,20,1
10-03-2025,"Dry Fruits, Nuts & Seeds",YELLOW KISHMISH 250GM,2,130,110,20,1
10-03-2025,Snacks & Ready-to-Eat,GB SALT COOKIES,14,60,55,5,1
10-03-2025,"Grains, Flours & Dals",Chana Flour 500 gms,4,70,65,5,1
10-03-2025,"Grains, Flours & Dals",Yellow jowar .F1 kg,4,110,100,10,1
10-03-2025,Snacks & Ready-to-Eat,ANNAPURNA APPALAM,14,35,35,0,1
10-03-2025,"Dry Fruits, Nuts & Seeds",ALMONDS 250GM,2,280,260,20,1
10-03-2025,"Grains, Flours & Dals",turdal 500 gms,4,110,100,10,1
10-03-2025,"Grains, Flours & Dals",PESARA PAPPU 500GMS,4,85,75,10,1
10-03-2025,"Grains, Flours & Dals",turdal 1kg,4,220,195,25,1
10-03-2025,"Grains, Flours & Dals",SL Idly Rava 1KG,4,130,110,20,2
10-03-2025,Snacks & Ready-to-Eat,SD FINGER Millet with palm Jaggery 250gm,14,135,135,0,1
10-03-2025,"Grains, Flours & Dals",Em Multimillet idli r 500g,4,129,129,0,1
10-03-2025,"Grains, Flours & Dals",Quinova 500 gms,4,110,100,10,1
10-03-2025,"Grains, Flours & Dals",JOWAR WHITE 1 KG,4,80,70,10,1
10-03-2025,"Grains, Flours & Dals",Arikalu (kodo),4,70,65,5,1
10-03-2025,"Grains, Flours & Dals",Wheat Rava M 500GM,4,33,30,3,1
10-03-2025,"Grains, Flours & Dals",Wheat Flour 1 kg,4,70,60,10,1
10-03-2025,"Grains, Flours & Dals",Wheat Flour 1 kg,4,70,60,10,1
10-03-2025,Snacks & Ready-to-Eat,MIGHTY PUFF,14,25,25,0,1
10-03-2025,"Grains, Flours & Dals",HS MULTI UPMA RAVA,4,65,65,0,1
10-03-2025,"Grains, Flours & Dals",HS Multimillet idly R 500 gms,4,65,65,0,1
10-03-2025,"Grains, Flours & Dals",RAGI FLOUR 1KG,4,80,70,10,1
10-03-2025,Snacks & Ready-to-Eat,ELITE MILK RUSK 200GM,14,35,35,0,1
10-03-2025,Sweeteners,Mishri 500GM,16,70,60,10,1
10-03-2025,"Health, Wellness & Ayurvedic Products",RB Max Protein PERI PERI 60gm,5,45,45,0,1
10-03-2025,"Grains, Flours & Dals",DESI CHANA,4,25,25,0,1
10-03-2025,Snacks & Ready-to-Eat,MIGHTY PUFFS TOMATO,14,25,25,0,1
10-03-2025,"Dry Fruits, Nuts & Seeds",Groundnuts 500 gms,2,95,85,10,1
10-03-2025,Beverages,BRU GREEN LABEL 1.2G,1,24,24,0,12
10-03-2025,"Dry Fruits, Nuts & Seeds",FLAX SEEDS 250GM,2,60,50,10,1
10-03-2025,Snacks & Ready-to-Eat,SD Atreyapuram DRY Fruit ghee,14,150,150,0,1
10-03-2025,Oils & Ghee,Groundnut oil 1 L,9,720,660,60,2
10-03-2025,Oils & Ghee,Safflower oil 1 L,9,440,400,40,1
10-03-2025,Oils & Ghee,Coconut oil 1 L,9,440,400,40,1
10-03-2025,"Grains, Flours & Dals",UDALU (Barnyard millet) 500 gms,4,70,60,10,1
10-03-2025,"Grains, Flours & Dals",SAMALU (Little millet) 500 gms,4,85,65,20,1
10-03-2025,"Grains, Flours & Dals",Em jowar idly R 500G,4,75,75,0,1
10-03-2025,"Grains, Flours & Dals",SPLIT BLACK GRAM 500 GM,4,90,85,5,1
10-03-2025,"Grains, Flours & Dals",Arikalu (kodo),4,70,65,5,1
10-03-2025,"Grains, Flours & Dals",KORRALU (FOXTAIL M) 1KG,4,150,110,40,1
10-03-2025,Snacks & Ready-to-Eat,BROWN BREAD,14,55,55,0,1
10-03-2025,"Grains, Flours & Dals",Wheat Flour 1 kg,4,70,60,10,1
10-03-2025,Milk & Dairy,BROWN EGGS 1P,7,84,72,12,6
10-03-2025,"Grains, Flours & Dals",RAGI FLOUR 500GRMS,4,40,35,5,1
10-03-2025,Snacks & Ready-to-Eat,VD BELLAM GAVVALU 200GM,14,60,60,0,1
10-03-2025,"Grains, Flours & Dals",Wheat Flour 1 kg,4,70,60,10,1
10-03-2025,Snacks & Ready-to-Eat,MILLET NOODLES CURRY MASALA,14,129,129,0,1
10-03-2025,Spices & Seasonings,SREE MARUTHI IDLY KARAM 200GM,15,60,60,0,1
10-03-2025,Snacks & Ready-to-Eat,VD NUVVULU LADDU,14,80,80,0,1
10-03-2025,Snacks & Ready-to-Eat,MILLET PANCAKE CHOCOLATE,14,199,199,0,1
10-03-2025,"Grains, Flours & Dals",Chana Flour 500 gms,4,70,65,5,1
10-03-2025,"Grains, Flours & Dals",BAJRA 1 KG,4,60,50,10,1
10-03-2025,"Grains, Flours & Dals",JOWAR WHITE 1 KG,4,80,70,10,1
10-03-2025,Spices & Seasonings,Coriander seeds 200 gms,15,48,40,8,1
10-03-2025,"Grains, Flours & Dals",SABDANA,4,40,35,5,1
10-03-2025,Spices & Seasonings,SD Garlic Karam Powder 100GM,15,65,65,0,1
10-03-2025,Milk & Dairy,BROWN EGGS 1P,7,84,72,12,6
10-03-2025,"Grains, Flours & Dals",Red Bobarlu 500 gms,4,95,85,10,1
10-03-2025,"Grains, Flours & Dals",MAGGANI RICE 5KG,4,525,525,0,1
10-03-2025,"Grains, Flours & Dals",MAAGAANI SP RICE 5KGS,4,649,560,89,1
10-03-2025,Milk & Dairy,BROWN EGGS 1P,7,84,72,12,6
10-03-2025,"Grains, Flours & Dals",Red Bobarlu 500 gms,4,95,85,10,1
10-03-2025,Snacks & Ready-to-Eat,NGT CHATPATTA CHANA 90GM,14,25,25,0,1
10-03-2025,"Grains, Flours & Dals",Wheat Flour 1 kg,4,70,60,10,1
10-03-2025,"Grains, Flours & Dals",Multigrain 1 kg,4,100,85,15,1
10-03-2025,Snacks & Ready-to-Eat,BATANA NGT 70GMS,14,20,20,0,1
10-03-2025,Personal Care & Cosmetics,Soapnut 500GM,10,120,90,30,1
10-03-2025,Oils & Ghee,Groundnut oil 1 L,9,360,330,30,1
10-03-2025,Snacks & Ready-to-Eat,ZEEDI,14,70,70,0,1
10-03-2025,Oils & Ghee,Castor oil 200 ml,9,100,80,20,1
10-03-2025,"Grains, Flours & Dals",SATHVI BARELY SEEDS 500GMS,4,180,140,40,2
10-03-2025,"Dry Fruits, Nuts & Seeds",MAHA BEERA SEEDS 100GM,2,120,120,0,2
10-03-2025,"Grains, Flours & Dals",BARLEY FLOUR 250GM,4,90,80,10,2
10-03-2025,Household & Cleaning,VIM SOAP,6,20,20,0,4
10-03-2025,"Grains, Flours & Dals",POORI ATTA 500GM,4,35,30,5,1
10-03-2025,"Grains, Flours & Dals",Wheat Flour 1 kg,4,140,120,20,2
10-03-2025,Milk & Dairy,SANGAM FULL CREAM MILK 500ML,7,38,38,0,1
10-03-2025,Snacks & Ready-to-Eat,RAJGIRA PEANUT CHIKKI,14,50,50,0,10
10-03-2025,Snacks & Ready-to-Eat,VD NUVULLU CHIKKI,14,80,80,0,1
10-03-2025,Spices & Seasonings,LG 50GM,15,92,92,0,1
10-03-2025,Sweeteners,Natural Honey 500 gms,16,280,240,40,1
10-03-2025,Oils & Ghee,Freedom Rice Bran Oil 1L,9,194,180,14,1
10-03-2025,"Dry Fruits, Nuts & Seeds",PUMPKIN SEEDS 250GM,2,200,160,40,1
10-03-2025,"Grains, Flours & Dals",Chana Flour 500 gms,4,70,65,5,1
10-03-2025,"Dry Fruits, Nuts & Seeds",Groundnuts 500 gms,2,95,85,10,1
10-03-2025,Snacks & Ready-to-Eat,BB VERMICELLI 1KG,14,95,90,5,1
10-03-2025,Snacks & Ready-to-Eat,BB VERMICELLY 500GM,14,53,53,0,1
10-03-2025,"Dry Fruits, Nuts & Seeds",WALLNUTS 250GM,2,380,360,20,1
10-03-2025,"Dry Fruits, Nuts & Seeds",KAJU HALF 250GM,2,310,290,20,1
10-03-2025,"Grains, Flours & Dals",Wheat Flour 1 kg,4,70,60,10,1
10-03-2025,"Grains, Flours & Dals",Em Multimillet upma 500g,4,129,129,0,1
10-03-2025,"Dry Fruits, Nuts & Seeds",PLAIN PISTA 250GM,2,660,550,110,1
10-03-2025,"Dry Fruits, Nuts & Seeds",ANJEER 250GM,2,400,360,40,1
10-03-2025,"Grains, Flours & Dals",AISHWARYA MOONGDAL RICE,4,140,84,56,1
10-03-2025,"Dry Fruits, Nuts & Seeds",ALMONDS 250GM,2,280,260,20,1
10-03-2025,"Grains, Flours & Dals",Wheat Rava M 500GM,4,66,60,6,2
10-03-2025,Snacks & Ready-to-Eat,millet noodles sf,14,70,70,0,2
10-03-2025,Milk & Dairy,BROWN EGGS TRAY 30P,7,360,330,30,1
10-03-2025,"Grains, Flours & Dals",Green gram 1 kg,4,150,130,20,1
10-03-2025,"Dry Fruits, Nuts & Seeds",PULMAKHANA 100 GM,2,180,170,10,1
10-03-2025,Snacks & Ready-to-Eat,RSC ORANGE 100GMS,14,20,20,0,1
10-03-2025,"Grains, Flours & Dals",KORRALU (FOXTAIL M) 500GM,4,65,55,10,1
10-03-2025,"Grains, Flours & Dals",White jowar.F 1 kg,4,100,80,20,1
10-03-2025,Spices & Seasonings,Vamu 100GM,15,60,50,10,1
10-03-2025,"Grains, Flours & Dals",SAMALU (Little millet) 500 gms,4,85,65,20,1
10-03-2025,"Grains, Flours & Dals",RAGI FLOUR 500GRMS,4,40,35,5,1
10-03-2025,Oils & Ghee,Safflower oil 1 L,9,880,800,80,2
10-03-2025,Oils & Ghee,Groundnut oil 1 L,9,720,660,60,2
10-03-2025,Milk & Dairy,BROWN EGGS 1P,7,168,144,24,12
10-03-2025,"Grains, Flours & Dals",Wheat Flour 1 kg,4,70,60,10,1
10-03-2025,"Grains, Flours & Dals",Multigrain 1 kg,4,200,170,30,2
10-03-2025,"Grains, Flours & Dals",Wheat Flour 3 kgs,4,210,180,30,1
10-03-2025,Snacks & Ready-to-Eat,VD DAHI MIRCHI(SALTED) 100GM,14,45,45,0,1
10-03-2025,Sweeteners,Mishri 500GM,16,70,60,10,1
10-03-2025,"Grains, Flours & Dals",Chana Flour 500 gms,4,70,65,5,1
10-03-2025,"Grains, Flours & Dals",MELMEKER 250GMS,4,60,45,15,1
10-03-2025,Spices & Seasonings,DURGA SALT CRYSTAL 1KG,15,25,25,0,1
10-03-2025,"Grains, Flours & Dals",Wheat Flour 1 kg,4,140,120,20,2
10-03-2025,Spices & Seasonings,GS Pink Rock Salt 1KG,15,120,120,0,1
10-03-2025,"Grains, Flours & Dals",AISHWARYA MOONGDAL RICE,4,140,84,56,1
10-03-2025,Spices & Seasonings,Tamarind 250GMS,15,80,65,15,1
10-03-2025,"Grains, Flours & Dals",THICK POHA 1KG,4,80,70,10,1
10-03-2025,"Grains, Flours & Dals",Sathya Javva Wheat Rava 500GM,4,95,95,0,1
10-03-2025,"Grains, Flours & Dals",RED TURDAL 500GM,4,75,70,5,1
10-03-2025,"Grains, Flours & Dals",Red Chana 250GM,4,35,30,5,1
10-03-2025,"Dry Fruits, Nuts & Seeds",Groundnuts 500 gms,2,95,85,10,1
10-03-2025,Oils & Ghee,Safflower oil 500 ml,9,220,200,20,1
10-03-2025,Oils & Ghee,Sesame oil 500ml,9,295,280,15,1
10-03-2025,Spices & Seasonings,AVALU 100GM,15,25,20,5,1
10-03-2025,"Dry Fruits, Nuts & Seeds",YELLOW KISHMISH 250GM,2,130,110,20,1
10-03-2025,Pooja & Spiritual Items,GD Dhoop Sticks 26GM,12,60,60,0,3
10-03-2025,"Grains, Flours & Dals",JOWAR WHITE 1 KG,4,80,70,10,1
10-03-2025,Pooja & Spiritual Items,GD Aiswarya Deepam 700ML,12,195,195,0,1
10-03-2025,"Grains, Flours & Dals",Wheat Flour 2 kgs,4,280,240,40,2
10-03-2025,Oils & Ghee,Sesame oil 1 L,9,590,560,30,1
10-03-2025,"Grains, Flours & Dals",Wheat Flour 500 gms,4,70,60,10,2
10-03-2025,Snacks & Ready-to-Eat,NGT CHATPATTA CHANA 90GM,14,25,25,0,1
10-03-2025,General Household & Kitchenware,GOOD HOME,3,30,30,0,2
10-03-2025,Oils & Ghee,Groundnut oil 1 L,9,360,330,30,1
10-03-2025,Oils & Ghee,Groundnut oil 1 L,9,360,330,30,1
10-03-2025,Oils & Ghee,Sesame oil 1 L,9,590,560,30,1
10-03-2025,"Grains, Flours & Dals",Em jowar idly R 500G,4,75,75,0,1
10-03-2025,Sweeteners,YB JAGGERY POWDER 500GMS,16,75,75,0,1
10-03-2025,"Grains, Flours & Dals",JOWAR UPMA RAVA,4,300,300,0,4
10-03-2025,Oils & Ghee,Safflower oil 1 L,9,440,400,40,1
10-03-2025,"Grains, Flours & Dals",White jowar.F 1 kg,4,100,80,20,1
10-03-2025,Spices & Seasonings,DHANIYA POWDER 200GM,15,200,170,30,2
10-03-2025,"Dry Fruits, Nuts & Seeds",Groundnuts 1 kg,2,380,330,50,2
10-03-2025,"Dry Fruits, Nuts & Seeds",Groundnuts 500 gms,2,95,85,10,1
10-03-2025,Spices & Seasonings,DRY MIECHI 200GM,15,80,60,20,1
10-03-2025,Beverages,BRU GREEN LABEL 1.2G,1,48,48,0,24
10-03-2025,"Grains, Flours & Dals",Bombay Rava 500GM,4,35,30,5,1
10-03-2025,Pooja & Spiritual Items,GD Aiswarya Deepam 700ML,12,195,195,0,1
10-03-2025,"Grains, Flours & Dals",URAD DALL,4,95,85,10,1
10-03-2025,Pooja & Spiritual Items,BALAJI SAFFRON DHOOP STICKS 10STK,12,105,105,0,1
10-03-2025,"Grains, Flours & Dals",SAMALU (Little millet) 500 gms,4,85,65,20,1
10-03-2025,"Grains, Flours & Dals",Em Multimillet upma 500g,4,129,129,0,1
10-03-2025,"Grains, Flours & Dals",UDALU (Barnyard millet) 500 gms,4,70,60,10,1
10-03-2025,"Grains, Flours & Dals",BARLEY SEEDS 250GMS,4,40,35,5,1
10-03-2025,"Grains, Flours & Dals",SA WHITE JOWAR RAVA 500GM,4,69,69,0,1
10-03-2025,"Grains, Flours & Dals",KORRALU (FOXTAIL M) 500GM,4,65,55,10,1
10-03-2025,"Grains, Flours & Dals",Em Multimillet idli r 500g,4,129,129,0,1
10-03-2025,"Grains, Flours & Dals",Arikalu (kodo),4,70,65,5,1
10-03-2025,Snacks & Ready-to-Eat,SD FINGER Millet with palm Jaggery 250gm,14,135,135,0,1
10-03-2025,Snacks & Ready-to-Eat,VD RIBBON PAKODI 175GM,14,60,60,0,1
10-03-2025,Snacks & Ready-to-Eat,MIGHTY PUFF,14,25,25,0,1
10-03-2025,"Grains, Flours & Dals",Chana Flour 500 gms,4,70,65,5,1
10-03-2025,Sweeteners,YB FOREST HONEY 250GM,16,180,180,0,1
10-03-2025,Spices & Seasonings,SWEET SOUNF,15,20,20,0,1
10-03-2025,Snacks & Ready-to-Eat,VD MINAPA VADIYAM,14,65,65,0,1
10-03-2025,"Grains, Flours & Dals",BARLEY SEEDS 250GMS,4,40,35,5,1
10-03-2025,Snacks & Ready-to-Eat,VD DAHI MIRCHI(SALTED) 100GM,14,45,45,0,1
10-03-2025,"Grains, Flours & Dals",Chana Flour 500 gms,4,70,65,5,1
10-03-2025,Personal Care & Cosmetics,UVIS ROSEWATER 100ML,10,49,49,0,1
10-03-2025,Baking & Cooking Aids,GONDH 50GRMS,0,50,40,10,1
10-03-2025,Personal Care & Cosmetics,UVIS MULTANI MITTI PW 100GM,10,49,49,0,1
10-03-2025,Snacks & Ready-to-Eat,SF VERMICELLI,14,139,139,0,1
10-03-2025,"Grains, Flours & Dals",Sathya Javva Wheat Rava 500GM,4,95,95,0,1
10-03-2025,Oils & Ghee,Safflower oil 500 ml,9,220,200,20,1
10-03-2025,"Grains, Flours & Dals",Arikalu (kodo),4,70,65,5,1
10-03-2025,"Grains, Flours & Dals",ANDU KORRALU (Brown top .mlt) 500,4,130,110,20,1
10-03-2025,Oils & Ghee,Coconut oil 500 ml,9,220,200,20,1
10-03-2025,Oils & Ghee,Sesame oil 1 L,9,590,560,30,1
10-03-2025,Pooja & Spiritual Items,GD Dhoop Sticks 26GM,12,20,20,0,1
10-03-2025,Spices & Seasonings,kasturi methi,15,60,60,0,1
10-03-2025,Sweeteners,Natural Honey 500 gms,16,280,240,40,1
10-03-2025,Oils & Ghee,Groundnut oil 1 L,9,360,330,30,1
10-03-2025,"Dry Fruits, Nuts & Seeds",Groundnuts 500 gms,2,95,85,10,1
10-03-2025,"Health, Wellness & Ayurvedic Products",MORINGA LEAF POWDER M,5,80,75,5,1
10-03-2025,"Grains, Flours & Dals",Idly Rava L 1KG,4,60,50,10,1
10-03-2025,Oils & Ghee,Sesame oil 1 L,9,590,560,30,1
10-03-2025,Oils & Ghee,Safflower oil 1 L,9,440,400,40,1
10-03-2025,"Grains, Flours & Dals",RAGI FLOUR 1KG,4,80,70,10,1
10-03-2025,"Grains, Flours & Dals",RAGI FLOUR 1KG,4,80,70,10,1
10-03-2025,"Dry Fruits, Nuts & Seeds",DIANUTS 500GM,2,120,120,0,1
10-03-2025,Spices & Seasonings,NUVVULU 250GM,15,100,85,15,1
10-03-2025,"Grains, Flours & Dals",DOCTOR RICE DIABETIC SFR 1KG,4,120,120,0,1
10-03-2025,"Grains, Flours & Dals",Wheat Flour 1 kg,4,70,60,10,1
10-03-2025,Oils & Ghee,Coconut oil 500 ml,9,220,200,20,1
10-03-2025,"Health, Wellness & Ayurvedic Products",RB Max Protein Cheese&amp;,5,45,45,0,1
10-03-2025,Household & Cleaning,vim dish liquid,6,55,55,0,1
09-03-2025,"Dry Fruits, Nuts & Seeds",SUNFLOWER SEEDS 250GRM,2,150,130,20,1
09-03-2025,Beverages,RED LABEL 10R,1,20,20,0,2
09-03-2025,General Household & Kitchenware,NIPPO,3,36,36,0,2
09-03-2025,"Grains, Flours & Dals",SINGLE POLISH 1KG,4,325,325,0,5
09-03-2025,Snacks & Ready-to-Eat,SD FINGER Millet with palm Jaggery 250gm,14,135,135,0,1
09-03-2025,"Grains, Flours & Dals",RAGI FLOUR 500GRMS,4,40,35,5,1
09-03-2025,"Grains, Flours & Dals",MAAGAANI SP RICE 20 KGS,4,2300,"1,960.00",340,1
09-03-2025,Snacks & Ready-to-Eat,SD KODO MILLET WITH PALM JAGGERY,14,135,135,0,1
09-03-2025,Snacks & Ready-to-Eat,VD GUMMADI CHAKKA,14,130,130,0,1
09-03-2025,Beverages,REFRESH SHARBATH SUGAR FREE,1,299,285,14,1
09-03-2025,Spices & Seasonings,Tamarind 250GMS,15,80,65,15,1
09-03-2025,Snacks & Ready-to-Eat,SD JOWAR WITH PALM JAGGERY 250GM,14,135,135,0,1
09-03-2025,Personal Care & Cosmetics,SANTOOR,10,120,100,20,1
09-03-2025,Oils & Ghee,Groundnut oil 1 L,9,1080,990,90,3
09-03-2025,Snacks & Ready-to-Eat,SD FINGER Millet with palm Jaggery 250gm,14,135,135,0,1
09-03-2025,"Grains, Flours & Dals",Wheat Flour 1 kg,4,140,120,20,2
09-03-2025,Oils & Ghee,Coconut oil 500 ml,9,220,200,20,1
09-03-2025,"Grains, Flours & Dals",VGR rice 1 kg,4,70,65,5,1
09-03-2025,Spices & Seasonings,Turmeric powder 250 gms,15,100,75,25,1
09-03-2025,"Grains, Flours & Dals",WHITE BATANI,4,40,30,10,1
09-03-2025,"Grains, Flours & Dals",SPLIT BLACK GRAM 500 GM,4,90,85,5,1
09-03-2025,"Grains, Flours & Dals",Red Chana 250GM,4,35,30,5,1
09-03-2025,"Dry Fruits, Nuts & Seeds",PULMAKHANA 100 GM,2,180,170,10,1
09-03-2025,"Grains, Flours & Dals",Green Batani 250GM,4,55,45,10,1
09-03-2025,"Grains, Flours & Dals",RED TURDAL 500GM,4,75,70,5,1
09-03-2025,Oils & Ghee,Sesame oil 500ml,9,295,280,15,1
09-03-2025,Oils & Ghee,Groundnut oil 500ml,9,180,165,15,1
09-03-2025,"Grains, Flours & Dals",BOBBARA PAPPU 500GM,4,85,80,5,1
09-03-2025,"Grains, Flours & Dals",DISANO OATS 1KG,4,285,142.5,142.5,1
09-03-2025,"Grains, Flours & Dals",Red uluvalu 250 gms,4,45,40,5,1
09-03-2025,"Grains, Flours & Dals",Wheat Rava S 1KG,4,65,65,0,1
09-03-2025,"Grains, Flours & Dals",Wheat Flour 1 kg,4,140,120,20,2
09-03-2025,"Grains, Flours & Dals",White Chana 250 GM,4,60,50,10,1
09-03-2025,Oils & Ghee,Sesame oil 1 L,9,590,560,30,1
09-03-2025,"Grains, Flours & Dals",chana dall,4,35,30,5,1
09-03-2025,"Grains, Flours & Dals",Wheat Flour 1 kg,4,280,240,40,4
09-03-2025,"Grains, Flours & Dals",Wheat Flour 500 gms,4,35,30,5,1
09-03-2025,"Grains, Flours & Dals",RAGI FLOUR 500GRMS,4,40,35,5,1
09-03-2025,"Grains, Flours & Dals",Multigrain 1 kg,4,100,85,15,1
09-03-2025,"Grains, Flours & Dals",Wheat Flour 1 kg,4,70,60,10,1
09-03-2025,"Grains, Flours & Dals",Idly Rava L 1KG,4,60,50,10,1
09-03-2025,"Grains, Flours & Dals",Bombay Rava 500GM,4,35,30,5,1
09-03-2025,"Grains, Flours & Dals",RAGI FLOUR 1KG,4,80,70,10,1
09-03-2025,"Grains, Flours & Dals",SRI LALITHA SONAMASOORI 5KG,4,440,370,70,1
09-03-2025,"Grains, Flours & Dals",VYS.SP.RICE BAG 1,4,1800,"1,650.00",150,1
09-03-2025,Oils & Ghee,Safflower oil 1 L,9,1320,"1,200.00",120,3
09-03-2025,"Grains, Flours & Dals",Wheat Flour 1 kg,4,140,120,20,2
09-03-2025,"Grains, Flours & Dals",RAGI FLOUR 500GRMS,4,40,35,5,1
09-03-2025,"Grains, Flours & Dals",PESARA PAPPU 500GMS,4,85,75,10,1
09-03-2025,Oils & Ghee,Safflower oil 1 L,9,880,800,80,2
09-03-2025,Snacks & Ready-to-Eat,NGT CHATPATTA CHANA 90GM,14,25,25,0,1
09-03-2025,"Grains, Flours & Dals",HS Ragi upma rava 500 gms,4,70,70,0,1
09-03-2025,Spices & Seasonings,MIRYALU 50 GRMS,15,100,80,20,1
09-03-2025,"Grains, Flours & Dals",Red Bobarlu 1 kg,4,190,170,20,1
09-03-2025,"Grains, Flours & Dals",turdal 1kg,4,440,390,50,2
09-03-2025,Oils & Ghee,Groundnut oil 1 L,9,720,660,60,2
09-03-2025,"Grains, Flours & Dals",split green gram 1 kg,4,150,140,10,1
09-03-2025,"Health, Wellness & Ayurvedic Products",AMLAMRUT AMLA MASALA CANDY,5,95,95,0,1
09-03-2025,"Grains, Flours & Dals",BARLEY SEEDS 1KG,4,80,70,10,0.5
09-03-2025,"Grains, Flours & Dals",Wheat Rava M 500GM,4,33,30,3,1
09-03-2025,"Grains, Flours & Dals",RICE FLOUR 500 GM,4,35,28,7,1
09-03-2025,"Grains, Flours & Dals",MAAGAANI LOW GI SP L 1KG,4,120,105,15,1
09-03-2025,Snacks & Ready-to-Eat,urban murmura,14,60,55,5,1
09-03-2025,Spices & Seasonings,ROYAL SAFFRON,15,125,125,0,1
09-03-2025,Snacks & Ready-to-Eat,VD Minapa papad 200gm,14,120,120,0,2
09-03-2025,"Grains, Flours & Dals",BASMATHI RICE 1KG,4,150,135,15,1
09-03-2025,"Grains, Flours & Dals",Red Chana 250GM,4,35,30,5,1
09-03-2025,"Dry Fruits, Nuts & Seeds",Groundnuts 500 gms,2,95,85,10,1
09-03-2025,Spices & Seasonings,Menthulu 250 gms,15,50,45,5,1
09-03-2025,"Grains, Flours & Dals",split black gram 1 kg,4,180,170,10,1
09-03-2025,Spices & Seasonings,AVALU 100GM,15,25,20,5,1
09-03-2025,Spices & Seasonings,SAJEERA,15,60,40,20,1
09-03-2025,"Grains, Flours & Dals",Chana Flour 500 gms,4,70,65,5,1
09-03-2025,Pooja & Spiritual Items,SWASTIK CAMPHORE,12,90,90,0,1
09-03-2025,Personal Care & Cosmetics,ORGANIC SPONGE LOOFAH,10,70,70,0,1
09-03-2025,"Grains, Flours & Dals",split black gram 1 kg,4,180,170,10,1
09-03-2025,"Grains, Flours & Dals",SL Suji Rava 500GM,4,64,64,0,2
09-03-2025,Oils & Ghee,Sesame oil 500ml,9,295,280,15,1
09-03-2025,Sweeteners,Mishri 500GM,16,140,120,20,2
09-03-2025,Personal Care & Cosmetics,OVAL BODY LOOFAH,10,55,55,0,1
09-03-2025,Snacks & Ready-to-Eat,MIGHTY PUFFS CHEDDAR CHEESE,14,25,25,0,1
09-03-2025,"Grains, Flours & Dals",SPLIT BLACK GRAM 500 GM,4,90,85,5,1
09-03-2025,"Grains, Flours & Dals",THICK POHA 1KG,4,80,70,10,1
09-03-2025,Oils & Ghee,GANTASALA A2 COW GHEE 500ML,9,550,550,0,1
09-03-2025,Spices & Seasonings,Chilli powder 500 gms,15,290,210,80,1
09-03-2025,Oils & Ghee,Groundnut oil 1 L,9,1080,990,90,3
09-03-2025,Snacks & Ready-to-Eat,SD FINGER Millet with palm Jaggery 250gm,14,135,135,0,1
09-03-2025,"Grains, Flours & Dals",HS RAGI Idly rava 500 gms,4,70,70,0,1
09-03-2025,Oils & Ghee,Safflower oil 500 ml,9,220,200,20,1
09-03-2025,"Grains, Flours & Dals",Multigrain 1 kg,4,100,85,15,1
09-03-2025,Snacks & Ready-to-Eat,NGT CHATPATTA CHANA 90GM,14,25,25,0,1
09-03-2025,Snacks & Ready-to-Eat,JUNNU POWDER 100GM,14,70,70,0,1
09-03-2025,"Dry Fruits, Nuts & Seeds",Putnalu 250GM,2,45,38,7,1
09-03-2025,"Grains, Flours & Dals",Red uluvalu 250 gms,4,45,40,5,1
09-03-2025,Spices & Seasonings,Lavangam 50GM,15,60,50,10,1
09-03-2025,"Health, Wellness & Ayurvedic Products",MH Millets Malt 500GM,5,200,190,10,1
09-03-2025,Snacks & Ready-to-Eat,PEANUT CHIKKI 450GM,14,125,125,0,1
09-03-2025,"Grains, Flours & Dals",Green Batani 250GM,4,55,45,10,1
09-03-2025,"Grains, Flours & Dals",Black gram 500 gms,4,75,70,5,1
09-03-2025,Snacks & Ready-to-Eat,JUNNU POWDER 100GM,14,140,140,0,2
09-03-2025,Snacks & Ready-to-Eat,Corn Chips 250GM,14,40,35,5,1
09-03-2025,Snacks & Ready-to-Eat,VD CORNFLAKES MIXTURE 175GM,14,60,60,0,1
09-03-2025,Snacks & Ready-to-Eat,VD ATUKULU MIXTURE 175GM,14,60,60,0,1
09-03-2025,"Grains, Flours & Dals",Red Bobarlu 1 kg,4,190,170,20,1
09-03-2025,"Grains, Flours & Dals",Red Chana 250GM,4,35,30,5,1
09-03-2025,"Grains, Flours & Dals",SINGLE POLISH 1KG,4,195,195,0,3
09-03-2025,Snacks & Ready-to-Eat,SD FINGER Millet with palm Jaggery 250gm,14,135,135,0,1
09-03-2025,"Grains, Flours & Dals",turdal 1kg,4,220,195,25,1
09-03-2025,"Grains, Flours & Dals",Wheat Flour 1 kg,4,490,420,70,7
09-03-2025,Spices & Seasonings,Masala Karam 500 gms,15,260,240,20,1
09-03-2025,Spices & Seasonings,Masala Karam 500 gms,15,260,240,20,1
09-03-2025,Snacks & Ready-to-Eat,BLACK SESAME CHIKKI,14,10,10,0,2
09-03-2025,Spices & Seasonings,Coriander seeds 200 gms,15,48,40,8,1
09-03-2025,Spices & Seasonings,Turmeric powder 250 gms,15,100,75,25,1
09-03-2025,"Grains, Flours & Dals",VYS.SP.RICE BAG 1,4,1800,"1,650.00",150,1
09-03-2025,"Dry Fruits, Nuts & Seeds",SALTED PISTA 250GM,2,400,350,50,1
09-03-2025,Spices & Seasonings,Avalu small 250 gms,15,60,40,20,1
09-03-2025,"Grains, Flours & Dals",Red Bobarlu 500 gms,4,95,85,10,1
09-03-2025,Spices & Seasonings,Tamarind 250GMS,15,160,130,30,2
09-03-2025,"Dry Fruits, Nuts & Seeds",FLAX SEEDS 250GM,2,60,50,10,1
09-03-2025,Spices & Seasonings,Menthulu 500 gms,15,100,90,10,1
09-03-2025,"Grains, Flours & Dals",Bombay Rava 500GM,4,35,30,5,1
09-03-2025,"Grains, Flours & Dals",turdal 1kg,4,220,195,25,1
09-03-2025,"Grains, Flours & Dals",KORRALU (FOXTAIL M) 1KG,4,150,110,40,1
09-03-2025,"Grains, Flours & Dals",SL Idly Rava 1KG,4,325,275,50,5
09-03-2025,General Household & Kitchenware,MATCH BOX,3,20,20,0,1
09-03-2025,"Grains, Flours & Dals",SAMALU,4,170,130,40,1
09-03-2025,"Grains, Flours & Dals",BLACK GRAM 1KG,4,150,140,10,1
09-03-2025,"Dry Fruits, Nuts & Seeds",PUTNALU 500GMS,2,90,76,14,1
09-03-2025,Sweeteners,Mishri 500GM,16,70,60,10,1
09-03-2025,Spices & Seasonings,Coriander seeds 200 gms,15,96,80,16,2
09-03-2025,"Dry Fruits, Nuts & Seeds",ROASTED FLAXSEED,2,75,75,0,1
09-03-2025,Sweeteners,SUGAR 500 GM,16,30,25,5,1
09-03-2025,"Dry Fruits, Nuts & Seeds",Groundnuts 1 kg,2,190,165,25,1
09-03-2025,"Grains, Flours & Dals",CHANA DAL 500GM,4,70,60,10,1
09-03-2025,Spices & Seasonings,JEERA 250 gms,15,125,105,20,1
09-03-2025,Household & Cleaning,VIM SOAP,6,100,100,0,20
09-03-2025,"Grains, Flours & Dals",split black gram 1 kg,4,180,170,10,1
09-03-2025,Oils & Ghee,Sesame oil 500ml,9,295,280,15,1
09-03-2025,"Grains, Flours & Dals",JOWAR UPMA RAVA,4,150,150,0,2
09-03-2025,"Grains, Flours & Dals",Wheat Flour 1 kg,4,140,120,20,2
09-03-2025,Snacks & Ready-to-Eat,PEANUT CHIKKI,14,44,44,0,2
09-03-2025,"Grains, Flours & Dals",HS Multimillet idly R 500 gms,4,65,65,0,1
09-03-2025,"Grains, Flours & Dals",SINGLE POLISH 1KG,4,65,65,0,1
09-03-2025,"Grains, Flours & Dals",FLOUR CHARGE,4,12,12,0,1
09-03-2025,"Grains, Flours & Dals",MAAGAANI W RICE 1KG,4,139,110,29,1
09-03-2025,"Grains, Flours & Dals",JOWAR WHITE 1 KG,4,40,35,5,0.5
09-03-2025,"Grains, Flours & Dals",JOWAR YELLOW 1 K,4,50,45,5,0.5
09-03-2025,"Dry Fruits, Nuts & Seeds",SATHVI CHIA SEEDS 100GM,2,100,80,20,1
09-03-2025,"Grains, Flours & Dals",SABDANA 500GM,4,90,70,20,1
09-03-2025,"Dry Fruits, Nuts & Seeds",Putnalu 250GM,2,45,38,7,1
09-03-2025,Snacks & Ready-to-Eat,VD BELLAM GAVVALU 200GM,14,60,60,0,1
09-03-2025,"Dry Fruits, Nuts & Seeds",SATHVI CHIA SEEDS 100GM,2,100,80,20,1
09-03-2025,Oils & Ghee,Coconut oil 500 ml,9,220,200,20,1
09-03-2025,Household & Cleaning,SCOTCH BRITE,6,80,80,0,1
09-03-2025,General Household & Kitchenware,SABEENA,3,15,15,0,1
09-03-2025,Snacks & Ready-to-Eat,VD NUVVULU LADDU,14,160,160,0,2
09-03-2025,Spices & Seasonings,Turmeric powder 250 gms,15,100,75,25,1
09-03-2025,"Grains, Flours & Dals",Urad dall 1 Kg,4,185,170,15,1
09-03-2025,Personal Care & Cosmetics,ORGANIC SPONGE LOOFAH,10,70,70,0,1
09-03-2025,Snacks & Ready-to-Eat,RSC ORANGE 100GMS,14,20,20,0,1
09-03-2025,Spices & Seasonings,SONTI 50GM,15,100,90,10,1
09-03-2025,Snacks & Ready-to-Eat,SD Thati thandra 200gm,14,150,150,0,1
09-03-2025,"Dry Fruits, Nuts & Seeds",SD Mango cubes 200gm,2,90,90,0,1
09-03-2025,"Health, Wellness & Ayurvedic Products",MD Ashwagandha Choornam 100GM,5,170,170,0,1
09-03-2025,"Health, Wellness & Ayurvedic Products",MD Triphala Chorrnam 100GM,5,80,80,0,1
09-03-2025,Oils & Ghee,Castor oil 200 ml,9,100,80,20,1
09-03-2025,Snacks & Ready-to-Eat,millet noodles sf,14,35,35,0,1
09-03-2025,Personal Care & Cosmetics,MD Soapnut Choornam 100GM,10,80,80,0,1
09-03-2025,"Grains, Flours & Dals",KORRALU (FOXTAIL M) 500GM,4,65,55,10,1
09-03-2025,"Grains, Flours & Dals",Brown RICE 1KG,4,700,650,50,10
09-03-2025,Household & Cleaning,comfort lily fresh,6,58,58,0,1
09-03-2025,Oils & Ghee,Groundnut oil 1 L,9,720,660,60,2
09-03-2025,"Grains, Flours & Dals",Idly Rava L 1KG,4,120,100,20,2
09-03-2025,Snacks & Ready-to-Eat,DOSA BATTER 1KG,14,70,70,0,1
09-03-2025,"Health, Wellness & Ayurvedic Products",MH Millets Malt 500GM,5,400,380,20,2
09-03-2025,Spices & Seasonings,Turmeric powder 250 gms,15,100,75,25,1
09-03-2025,Pooja & Spiritual Items,GD JASMINE 75GM,12,60,60,0,1
09-03-2025,Spices & Seasonings,Masala Karam 500 gms,15,520,480,40,2
09-03-2025,Beverages,REFRESH SHARBATH NORMAL,1,199,190,9,1
09-03-2025,Household & Cleaning,HERBAL MOSQUITO REP BS 100ML,6,240,240,0,1
09-03-2025,Snacks & Ready-to-Eat,OK MACARONI,14,120,120,0,1
09-03-2025,Sweeteners,MISHRI 250 GM,16,35,30,5,1
09-03-2025,Beverages,BRU GREEN LABEL 1.2G,1,28,28,0,14
09-03-2025,Spices & Seasonings,Black Till 250GM,15,90,75,15,1
09-03-2025,Oils & Ghee,Coconut oil 1 L,9,440,400,40,1
09-03-2025,Oils & Ghee,Sesame oil 1 L,9,590,560,30,1
09-03-2025,Pooja & Spiritual Items,GOMATHA AGARBATHI,12,75,75,0,1
09-03-2025,Snacks & Ready-to-Eat,BELLAM MINAPA SUNADULLU,14,180,180,0,1
09-03-2025,"Grains, Flours & Dals",SAMALU,4,170,130,40,1
09-03-2025,Spices & Seasonings,DRY MIECHI 200GM,15,80,60,20,1
09-03-2025,Snacks & Ready-to-Eat,GREEN FRIED batana,14,20,20,0,1
09-03-2025,"Grains, Flours & Dals",Arikalu (kodo),4,70,65,5,1
09-03-2025,"Grains, Flours & Dals",Red Chana 500 GM,4,75,60,15,1
09-03-2025,"Grains, Flours & Dals",KORRALU (FOXTAIL M) 500GM,4,65,55,10,1
09-03-2025,Beverages,BISLERI 100ml,1,10,10,0,1
09-03-2025,General Household & Kitchenware,K1 KADAI,3,315,299.25,15.75,1
09-03-2025,Snacks & Ready-to-Eat,Popcorn Seeds 250GM,14,45,40,5,1
09-03-2025,General Household & Kitchenware,SIRIDHANYALU BOOK,3,200,180,20,1
09-03-2025,"Grains, Flours & Dals",FLOUR CHARGE,4,36,36,0,3
09-03-2025,"Dry Fruits, Nuts & Seeds",BLACK KISMIS 250GM,2,175,140,35,1
09-03-2025,"Grains, Flours & Dals",JOWAR WHITE 1 KG,4,80,70,10,1
09-03-2025,"Grains, Flours & Dals",White jowar.F 1 kg,4,300,240,60,3
09-03-2025,"Grains, Flours & Dals",Wheat Flour 1 kg,4,140,120,20,2
09-03-2025,"Grains, Flours & Dals",MAATEJA rice 5 kg,4,360,345,15,1
09-03-2025,"Dry Fruits, Nuts & Seeds",PUMPKIN SEEDS 250GM,2,400,320,80,2
09-03-2025,"Grains, Flours & Dals",White jowar.F 1 kg,4,100,80,20,1
09-03-2025,"Grains, Flours & Dals",Bajra Flour 500 gms,4,35,30,5,1
09-03-2025,"Grains, Flours & Dals",SRILATHA RICE RAVVA 500GM,4,35,35,0,1
09-03-2025,"Grains, Flours & Dals",RAGI FLOUR 500GRMS,4,40,35,5,1
09-03-2025,"Grains, Flours & Dals",Wheat Rava S 500GM,4,33,30,3,1
09-03-2025,"Grains, Flours & Dals",SL Suji Rava 500GM,4,32,32,0,1
09-03-2025,"Grains, Flours & Dals",SH WHITE POHA 500GM,4,56,56,0,1
09-03-2025,Pooja & Spiritual Items,bilwa patra,12,60,60,0,1
09-03-2025,Oils & Ghee,Sesame oil 500ml,9,295,280,15,1
09-03-2025,Snacks & Ready-to-Eat,VD MINAPA VADIYAM,14,65,65,0,1
09-03-2025,Spices & Seasonings,Black Till 250GM,15,180,150,30,2
09-03-2025,General Household & Kitchenware,B2 bowl,3,315,299.25,15.75,1
09-03-2025,Spices & Seasonings,Menthulu 500 gms,15,100,90,10,1
09-03-2025,Sweeteners,Natural Honey 500 gms,16,280,240,40,1
09-03-2025,Snacks & Ready-to-Eat,HS Ragi biscuits,14,50,50,0,1
09-03-2025,Snacks & Ready-to-Eat,BATANA NGT 70GMS,14,20,20,0,1
09-03-2025,Snacks & Ready-to-Eat,SF COOKIES CHOCO RAGI,14,99,99,0,1
09-03-2025,"Grains, Flours & Dals",SA YELLOW JOWAR RAVA 500GM,4,95,95,0,1
09-03-2025,Snacks & Ready-to-Eat,TILLI CHIKKI,14,20,20,0,4
09-03-2025,"Dry Fruits, Nuts & Seeds",SD Mango cubes 100gm,2,45,45,0,1
09-03-2025,"Dry Fruits, Nuts & Seeds",WALLNUTS 250GM,2,380,360,20,1
09-03-2025,Snacks & Ready-to-Eat,MIGHTY PUFFS TOMATO,14,25,25,0,1
09-03-2025,"Health, Wellness & Ayurvedic Products",MD Mandara Leaf Powder 50GM,5,100,100,0,1
09-03-2025,Snacks & Ready-to-Eat,Corn Chips 250GM,14,40,35,5,1
09-03-2025,Oils & Ghee,Safflower oil 1 L,9,440,400,40,1
09-03-2025,Oils & Ghee,Groundnut oil 500ml,9,180,165,15,1
09-03-2025,Spices & Seasonings,ROYAL SAFFRON 400GRMS,15,65,65,0,1
09-03-2025,Oils & Ghee,Sesame oil 1 L,9,590,560,30,1
09-03-2025,Sweeteners,YB JAGGERY POWDER 500GMS,16,150,150,0,2
09-03-2025,Oils & Ghee,Groundnut oil 1 L,9,360,330,30,1
09-03-2025,Oils & Ghee,Sesame oil 500ml,9,295,280,15,1
09-03-2025,Oils & Ghee,Safflower oil 1 L,9,440,400,40,1
09-03-2025,Snacks & Ready-to-Eat,VD GUMMADI CHAKKA,14,260,260,0,2
09-03-2025,Personal Care & Cosmetics,BIOTIQUE FRESH HENNA S&C 120ML,10,99,99,0,1
09-03-2025,Snacks & Ready-to-Eat,VD VAMUPUSA 175GM,14,120,120,0,2
09-03-2025,Snacks & Ready-to-Eat,VD NUVULU CHEGODI 175GM,14,120,120,0,2
09-03-2025,Oils & Ghee,Groundnut oil 1 L,9,360,330,30,1
09-03-2025,"Dry Fruits, Nuts & Seeds",Groundnuts 1 kg,2,190,165,25,1
09-03-2025,"Dry Fruits, Nuts & Seeds",PUTNALU 500GMS,2,90,76,14,1
09-03-2025,"Grains, Flours & Dals",DESI CHANA,4,25,25,0,1
09-03-2025,Spices & Seasonings,SWEET SOUNF,15,20,20,0,1
09-03-2025,Snacks & Ready-to-Eat,GB SALT COOKIES,14,60,55,5,1
09-03-2025,"Grains, Flours & Dals",KORRALU (FOXTAIL M) 500GM,4,65,55,10,1
09-03-2025,Spices & Seasonings,Masala Karam 250 gms,15,130,120,10,1
09-03-2025,"Dry Fruits, Nuts & Seeds",Groundnuts 500 gms,2,95,85,10,1
09-03-2025,Snacks & Ready-to-Eat,VD RIBBON PAKODI 175GM,14,60,60,0,1
09-03-2025,Snacks & Ready-to-Eat,VD NUVULU CHEGODI 175GM,14,60,60,0,1
09-03-2025,Oils & Ghee,Groundnut oil 1 L,9,360,330,30,1
09-03-2025,"Grains, Flours & Dals",split green gram 500 gms,4,75,70,5,1
09-03-2025,Snacks & Ready-to-Eat,GANTASALA GINGER CANDY 200GM,14,105,105,0,1
09-03-2025,Snacks & Ready-to-Eat,GB SALT COOKIES,14,60,55,5,1
09-03-2025,Snacks & Ready-to-Eat,SD Ginger Candy 100g,14,60,60,0,1
09-03-2025,Sweeteners,Natural Honey 500 gms,16,280,240,40,1
09-03-2025,"Grains, Flours & Dals",RAGI FLOUR 1KG,4,80,70,10,1
09-03-2025,"Grains, Flours & Dals",White jowar.F 1 kg,4,100,80,20,1
09-03-2025,"Grains, Flours & Dals",Multigrain 1 kg,4,100,85,15,1
09-03-2025,"Grains, Flours & Dals",White jowar.F 1 kg,4,200,160,40,2
09-03-2025,"Grains, Flours & Dals",FLOUR CHARGE,4,32.4,32.4,0,2.7
09-03-2025,Snacks & Ready-to-Eat,VD Minapa papad 200gm,14,60,60,0,1
09-03-2025,"Dry Fruits, Nuts & Seeds",Groundnuts 1 kg,2,190,165,25,1
09-03-2025,Snacks & Ready-to-Eat,GB SALT COOKIES,14,60,55,5,1
09-03-2025,"Grains, Flours & Dals",POORI ATTA 500GM,4,35,30,5,1
09-03-2025,Oils & Ghee,BUFFALLO GHEE 500ML,9,410,370,40,1
09-03-2025,"Grains, Flours & Dals",White jowar.F 1 kg,4,200,160,40,2
09-03-2025,"Grains, Flours & Dals",Green gram 1 kg,4,150,130,20,1
09-03-2025,"Grains, Flours & Dals",Chana Flour 1 kg,4,280,260,20,2
09-03-2025,Household & Cleaning,MONKEY 555,6,160,160,0,1
09-03-2025,Oils & Ghee,Groundnut oil 1 L,9,720,660,60,2
09-03-2025,"Grains, Flours & Dals",RICE FLOUR 1KG,4,140,110,30,2
09-03-2025,Spices & Seasonings,PRO SESAME 200GM,15,142,142,0,1
09-03-2025,Snacks & Ready-to-Eat,DISANO VERMICELLI 425 GM,14,50,50,0,1
09-03-2025,Spices & Seasonings,Chilli powder 1 kg,15,580,420,160,1
09-03-2025,Spices & Seasonings,Elaichi 25GM,15,145,120,25,1
09-03-2025,Pooja & Spiritual Items,GOMATHA AGARBATHI,12,75,75,0,1
09-03-2025,Sweeteners,GS Organic Jaggery Powder 600GM,16,198,198,0,2
09-03-2025,Spices & Seasonings,Chilli powder 500 gms,15,290,210,80,1
09-03-2025,Oils & Ghee,Safflower oil 1 L,9,1320,"1,200.00",120,3
09-03-2025,Spices & Seasonings,YB Rock Salt 1KG,15,120,120,0,1
09-03-2025,"Grains, Flours & Dals",BOMBAY RAVA,4,70,55,15,1
09-03-2025,"Grains, Flours & Dals",Multigrain 1 kg,4,200,170,30,2
09-03-2025,"Grains, Flours & Dals",Wheat Flour 1 kg,4,140,120,20,2
09-03-2025,Spices & Seasonings,Turmeric powder 250 gms,15,100,75,25,1
09-03-2025,Sweeteners,SUGAR 1KG,16,60,50,10,1
09-03-2025,Spices & Seasonings,RED COPRA 250GMS,15,85,74,11,1
09-03-2025,Pooja & Spiritual Items,GD Aiswarya Deepam 700ML,12,195,195,0,1
09-03-2025,"Grains, Flours & Dals",turdal 1kg,4,220,195,25,1
09-03-2025,"Health, Wellness & Ayurvedic Products",RB Max Protein Salt & Caramel Bar 50g,5,150,150,0,2
09-03-2025,Oils & Ghee,Sesame oil 1 L,9,590,560,30,1
09-03-2025,"Grains, Flours & Dals",Wheat Flour 1 kg,4,140,120,20,2
09-03-2025,Spices & Seasonings,Turmeric powder 250 gms,15,200,150,50,2
09-03-2025,"Grains, Flours & Dals",Urad dall 1 Kg,4,370,340,30,2
09-03-2025,"Dry Fruits, Nuts & Seeds",PUTNALU 500GMS,2,90,76,14,1
09-03-2025,"Grains, Flours & Dals",Black gram 500 gms,4,75,70,5,1
09-03-2025,"Grains, Flours & Dals",Red Wheat Flour 1 kg,4,140,130,10,1
09-03-2025,Spices & Seasonings,JEERA 250 gms,15,125,105,20,1
09-03-2025,"Grains, Flours & Dals",CHANA DAL 500GM,4,70,60,10,1
09-03-2025,"Dry Fruits, Nuts & Seeds",Groundnuts 1 kg,2,190,165,25,1
09-03-2025,"Grains, Flours & Dals",SPLIT BLACK GRAM 500 GM,4,90,85,5,1
09-03-2025,Sweeteners,SUGAR 1KG,16,60,50,10,1
09-03-2025,Spices & Seasonings,Avalu big 250 gms,15,60,60,0,1
09-03-2025,Spices & Seasonings,LG 50GM,15,92,92,0,1
09-03-2025,"Grains, Flours & Dals",URAD DALL,4,95,85,10,1
09-03-2025,"Grains, Flours & Dals",UNPOLISHED TURDALL 1KG,4,240,210,30,1
09-03-2025,"Grains, Flours & Dals",Yellow jowar.F 500 gms,4,55,50,5,1
09-03-2025,"Grains, Flours & Dals",RAGI FLOUR 1KG,4,80,70,10,1
09-03-2025,Oils & Ghee,Groundnut oil 1 L,9,360,330,30,1
09-03-2025,Snacks & Ready-to-Eat,BD RAGI NOODLES,14,75,75,0,1
09-03-2025,"Grains, Flours & Dals",SAMALU,4,170,130,40,1
09-03-2025,"Grains, Flours & Dals",KORRALU (FOXTAIL M) 1KG,4,150,110,40,1
09-03-2025,Snacks & Ready-to-Eat,VD NUVVULU LADDU,14,80,80,0,1
09-03-2025,Milk & Dairy,HERITAGE TOTAL CURD 500GM,7,50,50,0,1
09-03-2025,"Grains, Flours & Dals",UDALU (Barnyard millet) 500 gms,4,70,60,10,1
09-03-2025,"Grains, Flours & Dals",Multigrain 1 kg,4,100,85,15,1
09-03-2025,Snacks & Ready-to-Eat,BD PEARL MILLET NOODLES 200G,14,70,70,0,1
09-03-2025,Snacks & Ready-to-Eat,GB SALT COOKIES,14,60,55,5,1
09-03-2025,Snacks & Ready-to-Eat,VD NUVVULU LADDU,14,80,80,0,1
09-03-2025,Snacks & Ready-to-Eat,VD CORNFLAKES MIXTURE 175GM,14,60,60,0,1
09-03-2025,Spices & Seasonings,NUVVULU 250GM,15,80,65,15,1
09-03-2025,Snacks & Ready-to-Eat,VD CORNFLAKES MIXTURE 175GM,14,60,60,0,1
09-03-2025,Oils & Ghee,cow ghee 500 ml,9,430,390,40,1
09-03-2025,"Grains, Flours & Dals",split green gram 500 gms,4,75,70,5,1
09-03-2025,"Dry Fruits, Nuts & Seeds",SD Mango cubes 100gm,2,45,45,0,1
09-03-2025,Oils & Ghee,BUFFALLO GHEE 500ML,9,410,370,40,1
09-03-2025,Snacks & Ready-to-Eat,GB SALT COOKIES,14,60,55,5,1
09-03-2025,"Grains, Flours & Dals",JOWAR WHITE 1 KG,4,80,70,10,1
09-03-2025,"Grains, Flours & Dals",BAJRA 1 KG,4,30,25,5,0.5
09-03-2025,"Dry Fruits, Nuts & Seeds",Groundnuts 500 gms,2,95,85,10,1
09-03-2025,Household & Cleaning,LIZOL CITRUS 625ML,6,45,45,0,1
09-03-2025,Snacks & Ready-to-Eat,VD NUVVULU LADDU,14,80,80,0,1
09-03-2025,"Grains, Flours & Dals",PRO ORG MEDIUM POHA 500G,4,78,78,0,1
09-03-2025,"Grains, Flours & Dals",Bombay Rava 500GM,4,35,30,5,1
09-03-2025,"Grains, Flours & Dals",Multigrain 1 kg,4,200,170,30,2
09-03-2025,"Grains, Flours & Dals",SAMALU (Little millet) 500 gms,4,85,65,20,1
09-03-2025,Oils & Ghee,Safflower oil 1 L,9,880,800,80,2
09-03-2025,"Grains, Flours & Dals",KORRALU (FOXTAIL M) 500GM,4,65,55,10,1
09-03-2025,"Grains, Flours & Dals",Arikalu (kodo),4,70,65,5,1
09-03-2025,"Grains, Flours & Dals",Em Multimillet idli r 500g,4,516,516,0,4
09-03-2025,Snacks & Ready-to-Eat,RSC ORANGE 100GMS,14,40,40,0,2
09-03-2025,Snacks & Ready-to-Eat,RAGI LADDU,14,120,120,0,1
09-03-2025,Sweeteners,SUGAR 1KG,16,60,50,10,1
09-03-2025,Snacks & Ready-to-Eat,VD PALLI CHIKKI,14,80,80,0,1
09-03-2025,Sweeteners,YB Brown Sugar 500GM,16,75,75,0,1
09-03-2025,Snacks & Ready-to-Eat,SD FINGER Millet with palm Jaggery 250gm,14,135,135,0,1
09-03-2025,Spices & Seasonings,Menthulu 500 gms,15,100,90,10,1
09-03-2025,"Dry Fruits, Nuts & Seeds",ALMONDS 250GM,2,280,260,20,1
09-03-2025,"Grains, Flours & Dals",SAMALU,4,170,130,40,1
09-03-2025,Spices & Seasonings,Lavangam 50GM,15,60,50,10,1
09-03-2025,"Grains, Flours & Dals",KORRALU (FOXTAIL M) 1KG,4,150,110,40,1
09-03-2025,"Grains, Flours & Dals",Bajra Flour 1 kg,4,70,60,10,1
09-03-2025,Snacks & Ready-to-Eat,VD BELLAM GAVVALU 200GM,14,60,60,0,1
09-03-2025,"Dry Fruits, Nuts & Seeds",ANJEER 250GM,2,400,360,40,1
09-03-2025,Oils & Ghee,Sesame oil 1 L,9,590,560,30,1
09-03-2025,Snacks & Ready-to-Eat,VD GUMMADI CHAKKA,14,260,260,0,2
09-03-2025,"Grains, Flours & Dals",Multigrain 1 kg,4,200,170,30,2
09-03-2025,"Grains, Flours & Dals",THIN POHA 500GM,4,40,35,5,1
09-03-2025,Snacks & Ready-to-Eat,BD KODO MILLET NOODLES 200GM,14,75,75,0,1
09-03-2025,"Grains, Flours & Dals",RAGI FLOUR 1KG,4,80,70,10,1
09-03-2025,"Dry Fruits, Nuts & Seeds",YB GRANMA NUTS,2,90,90,0,1
09-03-2025,"Health, Wellness & Ayurvedic Products",RB Max Protein NUTS &SEEDS 55gm,5,50,50,0,1
09-03-2025,"Health, Wellness & Ayurvedic Products",RB Max Protein Choco chips 55gm,5,50,50,0,1
09-03-2025,Spices & Seasonings,Tamarind 250GMS,15,80,65,15,1
09-03-2025,Snacks & Ready-to-Eat,SF COOKIES CHOCO RAGI,14,99,99,0,1
09-03-2025,Spices & Seasonings,Menthulu 250 gms,15,50,45,5,1
09-03-2025,"Grains, Flours & Dals",Chana Flour 500 gms,4,70,65,5,1
09-03-2025,Snacks & Ready-to-Eat,VD DAHI MIRCHI(SALTED) 100GM,14,45,45,0,1
09-03-2025,Snacks & Ready-to-Eat,GB SALT COOKIES,14,60,55,5,1
09-03-2025,"Dry Fruits, Nuts & Seeds",SD Mango cubes 200gm,2,90,90,0,1
09-03-2025,Oils & Ghee,Groundnut oil 1 L,9,360,330,30,1
09-03-2025,"Grains, Flours & Dals",RAGI FLOUR 1KG,4,80,70,10,1
09-03-2025,Snacks & Ready-to-Eat,NGT CHATPATTA CHANA 90GM,14,50,50,0,2
09-03-2025,"Grains, Flours & Dals",Sathya Javva Wheat Rava 500GM,4,285,285,0,3
09-03-2025,"Grains, Flours & Dals",Urad dall 1 Kg,4,185,170,15,1
09-03-2025,"Grains, Flours & Dals",CHANA DAL 500GM,4,70,60,10,1
09-03-2025,"Dry Fruits, Nuts & Seeds",Groundnuts 1 kg,2,570,495,75,3
09-03-2025,"Grains, Flours & Dals",turdal 1kg,4,220,195,25,1
09-03-2025,Snacks & Ready-to-Eat,PEANUT CHIKKI,14,44,44,0,2
09-03-2025,Oils & Ghee,Coconut oil 500 ml,9,220,200,20,1
09-03-2025,Snacks & Ready-to-Eat,JUNNU POWDER 100GM,14,70,70,0,1
09-03-2025,Milk & Dairy,HERITAGE TONED MILK 500ML,7,31,31,0,1
09-03-2025,"Dry Fruits, Nuts & Seeds",Groundnuts 500 gms,2,95,85,10,1
09-03-2025,Sweeteners,MISHRI 250 GM,16,35,30,5,1
09-03-2025,Oils & Ghee,Groundnut oil 1 L,9,360,330,30,1
09-03-2025,Spices & Seasonings,Chilli powder 500 gms,15,290,210,80,1
09-03-2025,"Grains, Flours & Dals",URAD DALL,4,95,85,10,1
09-03-2025,Milk & Dairy,SANGAM FULL CREAM MILK 500ML,7,76,76,0,2
09-03-2025,Oils & Ghee,Sesame oil 1 L,9,590,560,30,1
09-03-2025,"Grains, Flours & Dals",RAGULU 1 KG,4,70,60,10,1
09-03-2025,Snacks & Ready-to-Eat,SD JOWAR WITH PALM JAGGERY 250GM,14,135,135,0,1
09-03-2025,"Grains, Flours & Dals",JOWAR YELLOW 1 K,4,50,45,5,0.5
09-03-2025,"Grains, Flours & Dals",PLAIN OATS 1KG,4,105,105,0,0.5
09-03-2025,Snacks & Ready-to-Eat,SD FINGER Millet with palm Jaggery 250gm,14,135,135,0,1
09-03-2025,"Grains, Flours & Dals",HS Multimillet idly R 500 gms,4,65,65,0,1
09-03-2025,"Grains, Flours & Dals",Hs yellow jowar r 500g,4,99,99,0,1
09-03-2025,"Grains, Flours & Dals",RICE FLOUR 500 GM,4,35,28,7,1
09-03-2025,Spices & Seasonings,AV Iodized Salt 1KG,15,28,25,3,1
09-03-2025,"Health, Wellness & Ayurvedic Products",MXP GRANOLA,5,449,399,50,1
09-03-2025,"Grains, Flours & Dals",Wheat Flour 1 kg,4,70,60,10,1
09-03-2025,Spices & Seasonings,GS Pink Rock Salt 1KG,15,120,120,0,1
09-03-2025,"Health, Wellness & Ayurvedic Products",RB Max Protein Choco Crunchy 500g,5,399,399,0,1
09-03-2025,"Dry Fruits, Nuts & Seeds",PULMAKHANA 100 GM,2,180,170,10,1
09-03-2025,Snacks & Ready-to-Eat,Pani Poori Chips 250GM,14,50,40,10,1
09-03-2025,Oils & Ghee,Coconut oil 1 L,9,880,800,80,2
09-03-2025,Oils & Ghee,Safflower oil 1 L,9,440,400,40,1
09-03-2025,"Grains, Flours & Dals",RAGI FLOUR 500GRMS,4,40,35,5,1
09-03-2025,Spices & Seasonings,NUVVULU 250GM,15,80,65,15,1
09-03-2025,"Grains, Flours & Dals",MELMEKER 250GMS,4,60,45,15,1
09-03-2025,Snacks & Ready-to-Eat,PEANUT CHILLI,14,30,30,0,6
09-03-2025,"Dry Fruits, Nuts & Seeds",Groundnuts 500 gms,2,95,85,10,1
09-03-2025,Snacks & Ready-to-Eat,PEANUT CHILLI,14,25,25,0,5
09-03-2025,"Grains, Flours & Dals",Multigrain 1 kg,4,100,85,15,1
09-03-2025,Spices & Seasonings,NUVVULU 500GM,15,160,130,30,1
09-03-2025,"Grains, Flours & Dals",RAGI FLOUR 500GRMS,4,40,35,5,1
09-03-2025,Sweeteners,YB JAGGERY POWDER 500GMS,16,75,75,0,1
09-03-2025,Oils & Ghee,Safflower oil 1 L,9,440,400,40,1
09-03-2025,Spices & Seasonings,Tamarind 250GMS,15,160,130,30,2
09-03-2025,"Grains, Flours & Dals",Wheat Flour 1 kg,4,140,120,20,2
09-03-2025,Spices & Seasonings,Chilli powder 500 gms,15,290,210,80,1
09-03-2025,Oils & Ghee,Groundnut oil 1 L,9,720,660,60,2
09-03-2025,Sweeteners,MADHUR SUGAR 1KG,16,65,55,10,1
09-03-2025,Pooja & Spiritual Items,GD Aiswarya Deepam 700ML,12,195,195,0,1
09-03-2025,"Grains, Flours & Dals",VGR rice 1 kg,4,140,130,10,2
09-03-2025,"Grains, Flours & Dals",White jowar.F 1 kg,4,100,80,20,1
09-03-2025,Snacks & Ready-to-Eat,VD PALLI CHIKKI,14,80,80,0,1
09-03-2025,Spices & Seasonings,DRY MIECHI 200GM,15,80,60,20,1
09-03-2025,"Health, Wellness & Ayurvedic Products",MH Millets Malt 500GM,5,400,380,20,2
09-03-2025,"Dry Fruits, Nuts & Seeds",Groundnuts 1 kg,2,190,165,25,1
09-03-2025,Snacks & Ready-to-Eat,VD GUMMADI CHAKKA,14,130,130,0,1
09-03-2025,Snacks & Ready-to-Eat,SESAME CHIKKI,14,120,100,20,1
09-03-2025,Snacks & Ready-to-Eat,VD NUVULU CHEGODI 175GM,14,60,60,0,1
09-03-2025,Beverages,TAJ MAHAL 250GM,1,235,235,0,1
09-03-2025,Sweeteners,YB JAGGERY POWDER 500GMS,16,150,150,0,2
09-03-2025,"Grains, Flours & Dals",Wheat Flour 1 kg,4,210,180,30,3
09-03-2025,"Grains, Flours & Dals",White jowar.F 1 kg,4,300,240,60,3
09-03-2025,Milk & Dairy,HERITAGE TONED MILK 500ML,7,31,31,0,1
09-03-2025,Snacks & Ready-to-Eat,SS IDLY BATTER 1KG,14,120,120,0,2
09-03-2025,Milk & Dairy,HERITAGE BUTTERMILK,7,20,20,0,2
09-03-2025,Oils & Ghee,Groundnut oil 500ml,9,180,165,15,1
09-03-2025,Snacks & Ready-to-Eat,VD BELLAM GAVVALU 200GM,14,60,60,0,1
09-03-2025,Snacks & Ready-to-Eat,VD VAMUPUSA 175GM,14,60,60,0,1
09-03-2025,"Grains, Flours & Dals",Sathya Javva Wheat Rava 500GM,4,95,95,0,1
09-03-2025,Snacks & Ready-to-Eat,WHOLE WHEAT BREAD,14,55,55,0,1
09-03-2025,Snacks & Ready-to-Eat,CHOCO BROWINE,14,60,60,0,3
09-03-2025,"Grains, Flours & Dals",white Bobarlu 1 KG,4,170,150,20,1
09-03-2025,"Grains, Flours & Dals",PESARA PAPPU 500GMS,4,85,75,10,1
09-03-2025,"Grains, Flours & Dals",Sathya Javva Wheat Rava 500GM,4,95,95,0,1
09-03-2025,"Grains, Flours & Dals",THICK POHA 500GM,4,40,35,5,1
09-03-2025,"Grains, Flours & Dals",Wheat Rava S 1KG,4,65,55,10,1
09-03-2025,Baking & Cooking Aids,Baking Soda 50GM,0,20,15,5,1
09-03-2025,Snacks & Ready-to-Eat,VD NUVVULU LADDU,14,80,80,0,1
09-03-2025,"Grains, Flours & Dals",turdal 500 gms,4,220,200,20,2
09-03-2025,"Grains, Flours & Dals",BARLEY SEEDS 250GMS,4,80,70,10,2
09-03-2025,Spices & Seasonings,Menthulu 250 gms,15,150,135,15,3
09-03-2025,Snacks & Ready-to-Eat,SH PUFFED RICE 500GM,14,112,112,0,1
09-03-2025,"Dry Fruits, Nuts & Seeds",sabja seeds,2,80,70,10,1
09-03-2025,"Grains, Flours & Dals",AISHWARYA SP 25KG,4,1999,"1,690.00",309,1
09-03-2025,"Grains, Flours & Dals",Urad dall 500 gms,4,190,170,20,2
09-03-2025,"Grains, Flours & Dals",Green gram 1 kg,4,150,130,20,1
09-03-2025,Spices & Seasonings,Tamarind 500GM,15,160,130,30,1
09-03-2025,"Dry Fruits, Nuts & Seeds",Groundnuts 500 gms,2,190,170,20,2
09-03-2025,"Health, Wellness & Ayurvedic Products",DWI BHRINGARAJA TAILAM 100ML,5,150,150,0,1
09-03-2025,"Grains, Flours & Dals",SABDANA,4,40,35,5,1
09-03-2025,Snacks & Ready-to-Eat,DOSA BATTER 1KG,14,60,60,0,1
09-03-2025,"Grains, Flours & Dals",idly/Dosa rice 1 kg,4,70,60,10,1
09-03-2025,Snacks & Ready-to-Eat,Pani Poori Chips 250GM,14,50,40,10,1
09-03-2025,Snacks & Ready-to-Eat,VD SAGOPAPAD 150GM,14,110,110,0,2
09-03-2025,Beverages,BRU GREEN LABEL 1.2G,1,96,96,0,48
09-03-2025,Spices & Seasonings,SAMBAR POWDER 200GM,15,130,110,20,1
09-03-2025,Pooja & Spiritual Items,SWASTIK CAMPHORE,12,90,90,0,1
09-03-2025,Personal Care & Cosmetics,NEEM SOAP 100GM,10,100,100,0,1
09-03-2025,Snacks & Ready-to-Eat,VD RICE MURUKU 150GM,14,50,50,0,1
09-03-2025,"Grains, Flours & Dals",THICK POHA 500GM,4,40,35,5,1
09-03-2025,Oils & Ghee,Sesame oil 1 L,9,590,560,30,1
09-03-2025,Pooja & Spiritual Items,GOTHAM AGARABATHI 200GM,12,75,75,0,1
09-03-2025,Oils & Ghee,Safflower oil 1 L,9,440,400,40,1
09-03-2025,"Grains, Flours & Dals",rajgiri,4,44,44,0,2
09-03-2025,Oils & Ghee,Coconut oil 500 ml,9,220,200,20,1
09-03-2025,"Dry Fruits, Nuts & Seeds",PLAIN PISTA 250GM,2,660,550,110,1
09-03-2025,Snacks & Ready-to-Eat,PEANUT CHIKKI,14,44,44,0,2
09-03-2025,"Grains, Flours & Dals",SL Idly Rava 1KG,4,65,55,10,1
09-03-2025,Beverages,MARWADI CHAI 100GM,1,75,75,0,1
09-03-2025,"Grains, Flours & Dals",SAMALU,4,170,130,40,1
09-03-2025,"Grains, Flours & Dals",HS JOWAR FLAKES 250GM 1+1,4,238,238,0,2
09-03-2025,Pooja & Spiritual Items,SWATHI POOJA VATHULU,12,30,30,0,1
09-03-2025,"Grains, Flours & Dals",SL Idly Rava 1KG,4,65,55,10,1
09-03-2025,"Grains, Flours & Dals",Urad dall 1 Kg,4,185,170,15,1
09-03-2025,Spices & Seasonings,Chilli powder 500 gms,15,290,210,80,1
09-03-2025,"Grains, Flours & Dals",Multigrain 1 kg,4,200,170,30,2
09-03-2025,"Health, Wellness & Ayurvedic Products",SAI DURGA MORINGA LEAVES 100GM,5,150,150,0,2
09-03-2025,Sweeteners,YB JAGGERY POWDER 500GMS,16,75,75,0,1
09-03-2025,"Grains, Flours & Dals",Wheat Rava S 1KG,4,65,55,10,1
09-03-2025,Oils & Ghee,Groundnut oil 5 L,9,1800,"1,600.00",200,1
09-03-2025,"Grains, Flours & Dals",Idly Rava L 1KG,4,60,50,10,1
09-03-2025,"Dry Fruits, Nuts & Seeds",Groundnuts 1 kg,2,190,165,25,1
09-03-2025,"Grains, Flours & Dals",Green gram 1 kg,4,150,130,20,1
09-03-2025,"Grains, Flours & Dals",SPLIT BLACK GRAM 500 GM,4,90,85,5,1
09-03-2025,Pooja & Spiritual Items,GD Dhoop Sticks 26GM,12,40,40,0,2
09-03-2025,"Grains, Flours & Dals",PESARA PAPPU 1 KG,4,170,145,25,1
09-03-2025,"Dry Fruits, Nuts & Seeds",PUTNALU 500GMS,2,90,76,14,1
09-03-2025,"Grains, Flours & Dals",YB CHITTIMUTYALU RICE 1KG,4,200,200,0,1
09-03-2025,Household & Cleaning,SURF EXCEL MATIC TL 500ML,6,130,130,0,1
09-03-2025,"Grains, Flours & Dals",Idly Rava L 1KG,4,60,50,10,1
09-03-2025,Pooja & Spiritual Items,bilwa patra,12,60,60,0,1
09-03-2025,"Grains, Flours & Dals",Urad dall 1 Kg,4,185,170,15,1
09-03-2025,Beverages,BRU GREEN LABEL 1.2G,1,40,40,0,20
09-03-2025,Oils & Ghee,BUFFALLO GHEE 500ML,9,410,370,40,1
09-03-2025,"Grains, Flours & Dals",Green Batani 250GM,4,55,45,10,1
09-03-2025,Pooja & Spiritual Items,GB Bharatha Woods 75GM,12,60,60,0,1
09-03-2025,"Grains, Flours & Dals",RAJMA 500GM,4,90,90,0,1
09-03-2025,Spices & Seasonings,Jeera 100GM,15,50,45,5,1
09-03-2025,"Dry Fruits, Nuts & Seeds",PLAIN PISTA 250GM,2,660,550,110,1
09-03-2025,General Household & Kitchenware,B4 BOWL,3,160,160,0,1
09-03-2025,"Grains, Flours & Dals",Wheat Rava S 1KG,4,65,55,10,1
09-03-2025,"Grains, Flours & Dals",UNPOLISHED TURDALL 1KG,4,480,420,60,2
09-03-2025,"Grains, Flours & Dals",URAD DALL,4,95,85,10,1
09-03-2025,Household & Cleaning,vim dish liquid,6,55,55,0,1
09-03-2025,"Grains, Flours & Dals",Wheat Flour 1 kg,4,210,180,30,3
09-03-2025,Oils & Ghee,Black Sesame oil 500 ml,9,660,570,90,3
09-03-2025,Oils & Ghee,Safflower oil 5 L,9,2200,"1,950.00",250,1
09-03-2025,Snacks & Ready-to-Eat,urban murmura,14,60,55,5,1
09-03-2025,Spices & Seasonings,pickle chili powder,15,180,165,15,1
09-03-2025,Spices & Seasonings,Menthulu 250 gms,15,50,45,5,1
09-03-2025,Spices & Seasonings,AVALU 100GM,15,50,40,10,2
09-03-2025,Oils & Ghee,Sesame oil 500ml,9,295,280,15,1
09-03-2025,Oils & Ghee,Sesame oil 500ml,9,295,280,15,1
09-03-2025,Snacks & Ready-to-Eat,TILLI CHIKKI,14,125,125,0,1
09-03-2025,Snacks & Ready-to-Eat,PEANUT CHIKKI 450GM,14,125,125,0,1
09-03-2025,Snacks & Ready-to-Eat,VD GUMMADI VADIYAM,14,75,75,0,1
09-03-2025,"Grains, Flours & Dals",Wheat Flour 1 kg,4,70,60,10,1
09-03-2025,Snacks & Ready-to-Eat,SD Moringa with plam jaggery 250gm,14,135,135,0,1
09-03-2025,Snacks & Ready-to-Eat,VD MANGO JELLY 250GRMS,14,80,80,0,1
09-03-2025,"Grains, Flours & Dals",SINGLE POLISH 1KG,4,325,325,0,5
09-03-2025,Personal Care & Cosmetics,MADDI BATH POWDER 400GM,10,150,150,0,1
09-03-2025,"Grains, Flours & Dals",KORRALU (FOXTAIL M) 500GM,4,65,55,10,1
09-03-2025,"Grains, Flours & Dals",Arikalu (kodo),4,70,65,5,1
09-03-2025,"Grains, Flours & Dals",Multigrain 1 kg,4,300,255,45,3
09-03-2025,"Grains, Flours & Dals",UDALU (Barnyard millet) 500 gms,4,70,60,10,1
09-03-2025,Snacks & Ready-to-Eat,VD VAMUPUSA 175GM,14,60,60,0,1
09-03-2025,"Grains, Flours & Dals",SAMALU (Little millet) 500 gms,4,85,65,20,1
09-03-2025,Oils & Ghee,Coconut oil 500 ml,9,220,200,20,1
09-03-2025,Snacks & Ready-to-Eat,SD FINGER Millet with palm Jaggery 250gm,14,135,135,0,1
09-03-2025,"Grains, Flours & Dals",MAATEJA rice 1 kg,4,144,138,6,2
09-03-2025,"Grains, Flours & Dals",SINGLE POLISH 1KG,4,130,130,0,2
09-03-2025,Snacks & Ready-to-Eat,MP CHOCO ALMOND COOKIE,14,120,120,0,2
09-03-2025,Milk & Dairy,SANGAM TONED MILK 500ML,7,30,30,0,1
09-03-2025,Oils & Ghee,Safflower oil 1 L,9,440,400,40,1
09-03-2025,Oils & Ghee,GANTASALA A2 COW GHEE 500ML,9,550,550,0,1
09-03-2025,Snacks & Ready-to-Eat,GS WHEAT GRASS BISCUITS 250GM,14,130,130,0,1
09-03-2025,Personal Care & Cosmetics,WOW FACE WASH 150ML,10,399,399,0,1
09-03-2025,Misc,VD0009,8,100,100,0,1
09-03-2025,"Grains, Flours & Dals",Arikalu (kodo),4,70,65,5,1
09-03-2025,Snacks & Ready-to-Eat,ANNAPURNA APPALAM,14,35,35,0,1
09-03-2025,"Grains, Flours & Dals",SABDANA,4,40,35,5,1
09-03-2025,Snacks & Ready-to-Eat,RINGS 200GM,14,30,30,0,1
09-03-2025,"Dry Fruits, Nuts & Seeds",Groundnuts 1 kg,2,190,165,25,1
09-03-2025,"Grains, Flours & Dals",split black gram 1 kg,4,540,510,30,3
09-03-2025,Spices & Seasonings,Coriander seeds 200 gms,15,48,40,8,1
09-03-2025,"Grains, Flours & Dals",PESARA PAPPU 500GMS,4,85,75,10,1
09-03-2025,"Grains, Flours & Dals",Wheat Flour 1 kg,4,140,120,20,2
09-03-2025,Oils & Ghee,Groundnut oil 1 L,9,360,330,30,1
09-03-2025,Household & Cleaning,comfort lily fresh,6,58,58,0,1
09-03-2025,"Grains, Flours & Dals",SL Idly Rava 1KG,4,65,55,10,1
09-03-2025,"Grains, Flours & Dals",Wheat Rava S 500GM,4,33,30,3,1
09-03-2025,Household & Cleaning,vim small,6,30,30,0,2
09-03-2025,Household & Cleaning,HERBAL TOLET CLEANER 500ML,6,330,330,0,2
09-03-2025,Oils & Ghee,Freedom Rice Bran Oil 1L,9,194,180,14,1
09-03-2025,Spices & Seasonings,Tamarind 250GMS,15,80,65,15,1
09-03-2025,"Grains, Flours & Dals",URAD DALL,4,95,85,10,1
08-03-2025,Spices & Seasonings,Masala Karam 500 gms,15,260,240,20,1
08-03-2025,Snacks & Ready-to-Eat,VD ARISELU 5 PIC,14,100,100,0,1
08-03-2025,Snacks & Ready-to-Eat,SD Atreyapuram DRY Fruit ghee,14,150,150,0,1
08-03-2025,Beverages,BISLERI SODA 750ML,1,20,20,0,1
08-03-2025,"Grains, Flours & Dals",AISHWARYA SP 5KG,4,400,375,25,1
08-03-2025,"Dry Fruits, Nuts & Seeds",PULMAKHANA 100 GM,2,360,340,20,2
08-03-2025,"Grains, Flours & Dals",SABDANA,4,40,35,5,1
08-03-2025,"Grains, Flours & Dals",Chana Flour 500 gms,4,70,65,5,1
08-03-2025,Spices & Seasonings,Turmeric powder 250 gms,15,100,75,25,1
08-03-2025,"Grains, Flours & Dals",JOWAR WHITE 1 KG,4,80,70,10,1
08-03-2025,"Grains, Flours & Dals",Red Chana 250GM,4,35,30,5,1
08-03-2025,"Grains, Flours & Dals",split black gram 1 kg,4,360,340,20,2
08-03-2025,"Dry Fruits, Nuts & Seeds",YELLOW KISHMISH 250GM,2,130,110,20,1
08-03-2025,"Grains, Flours & Dals",Idly Rava L 1KG,4,120,100,20,2
08-03-2025,Pooja & Spiritual Items,bilwa patra,12,60,60,0,1
08-03-2025,"Grains, Flours & Dals",BASMATHI RICE 1KG,4,150,135,15,1
08-03-2025,"Grains, Flours & Dals",Green gram 1 kg,4,150,130,20,1
08-03-2025,"Dry Fruits, Nuts & Seeds",SALTED PISTA 250GM,2,400,350,50,1
08-03-2025,"Grains, Flours & Dals",Wheat Flour 1 kg,4,140,120,20,2
08-03-2025,Spices & Seasonings,YB Rock Salt 1KG,15,120,120,0,1
08-03-2025,Oils & Ghee,Groundnut oil 1 L,9,720,660,60,2
08-03-2025,"Grains, Flours & Dals",RAGI FLOUR 1KG,4,80,70,10,1
08-03-2025,"Dry Fruits, Nuts & Seeds",PUMPKIN SEEDS 250GM,2,200,160,40,1
08-03-2025,Oils & Ghee,Groundnut oil 1 L,9,360,330,30,1
08-03-2025,Oils & Ghee,Castor oil 200 ml,9,100,80,20,1
08-03-2025,Snacks & Ready-to-Eat,BATANA NGT 70GMS,14,20,20,0,1
08-03-2025,"Health, Wellness & Ayurvedic Products",DWI LAVANGA TAILA 20ML,5,60,60,0,1
08-03-2025,Sweeteners,MISHRI 250 GM,16,35,30,5,1
08-03-2025,"Grains, Flours & Dals",DESI CHANA,4,25,25,0,1
08-03-2025,"Grains, Flours & Dals",Multigrain 1 kg,4,100,85,15,1
08-03-2025,"Grains, Flours & Dals",HS Jowar upma rava 500 gms,4,65,65,0,1
08-03-2025,"Grains, Flours & Dals",HS Multimillet upma r 500g,4,65,65,0,1
08-03-2025,Snacks & Ready-to-Eat,SESAME CHIKKI,14,120,100,20,1
08-03-2025,Pooja & Spiritual Items,NAGA SINDHURAM,12,40,40,0,1
08-03-2025,Snacks & Ready-to-Eat,FOXTAIL NOODLES,14,75,75,0,1
08-03-2025,"Grains, Flours & Dals",SAMALU,4,170,130,40,1
08-03-2025,Sweeteners,SD Palm Jaggery 500GM,16,200,200,0,1
08-03-2025,"Grains, Flours & Dals",KORRALU (FOXTAIL M) 1KG,4,150,110,40,1
08-03-2025,Snacks & Ready-to-Eat,VD RED CHILLI RICEPAPAD 150GM,14,50,50,0,1
08-03-2025,"Grains, Flours & Dals",AISHWARYA RICE RAVA SP 500GRMS,4,60,42,18,1
08-03-2025,"Grains, Flours & Dals",Em little upma R 500g,4,129,129,0,1
08-03-2025,"Grains, Flours & Dals",Arikadu ( kodo),4,140,130,10,1
08-03-2025,Snacks & Ready-to-Eat,VD SAGOPAPAD 150GM,14,55,55,0,1
08-03-2025,"Grains, Flours & Dals",BLACK GRAM 1KG,4,150,140,10,1
08-03-2025,Oils & Ghee,Groundnut oil 5 L,9,1800,"1,600.00",200,1
08-03-2025,"Health, Wellness & Ayurvedic Products",RB Max Protein Classic Crunchy,5,169,169,0,1
08-03-2025,"Grains, Flours & Dals",Sathya Javva Wheat Rava 500GM,4,95,95,0,1
08-03-2025,"Grains, Flours & Dals",THICK POHA 500GM,4,40,35,5,1
08-03-2025,Snacks & Ready-to-Eat,Corn Chips 250GM,14,40,35,5,1
08-03-2025,"Grains, Flours & Dals",SRILATHA RICE RAVVA 500GM,4,35,35,0,1
08-03-2025,Spices & Seasonings,DURGA SALT CRYSTAL 1KG,15,50,50,0,2
08-03-2025,"Grains, Flours & Dals",Yellow jowar .F1 kg,4,110,100,10,1
08-03-2025,Milk & Dairy,SANGAM TONED MILK 500ML,7,150,150,0,5
08-03-2025,"Grains, Flours & Dals",RAGI FLOUR 1KG,4,80,70,10,1
08-03-2025,Oils & Ghee,Groundnut oil 1 L,9,720,660,60,2
08-03-2025,"Grains, Flours & Dals",Multigrain 1 kg,4,100,85,15,1
08-03-2025,Snacks & Ready-to-Eat,GB SALT COOKIES,14,60,55,5,1
08-03-2025,"Grains, Flours & Dals",Multigrain 5 kgs,4,500,425,75,1
08-03-2025,"Grains, Flours & Dals",RAGI FLOUR 1KG,4,80,70,10,1
08-03-2025,Baking & Cooking Aids,WEIKFIELD CUSTARD POWDER,0,43,43,0,1
08-03-2025,Pooja & Spiritual Items,BALAJI BEL PHOOL DHOOP STICKS 10STK,12,70,70,0,1
08-03-2025,"Grains, Flours & Dals",White jowar.F 1 kg,4,100,80,20,1
08-03-2025,"Dry Fruits, Nuts & Seeds",Groundnuts 500 gms,2,95,85,10,1
08-03-2025,Personal Care & Cosmetics,swastik gulab,10,73,73,0,1
08-03-2025,"Grains, Flours & Dals",SRILATHA RICE RAVVA 500GM,4,35,35,0,1
08-03-2025,Snacks & Ready-to-Eat,VD VAMUPUSA 175GM,14,120,120,0,2
08-03-2025,Snacks & Ready-to-Eat,VD ATUKULU MIXTURE 175GM,14,60,60,0,1
08-03-2025,Snacks & Ready-to-Eat,NGT CHATPATTA CHANA 90GM,14,25,25,0,1
08-03-2025,"Grains, Flours & Dals",BOMBAY RAVA,4,70,55,15,1
08-03-2025,Snacks & Ready-to-Eat,VD CORNFLAKES MIXTURE 175GM,14,60,60,0,1
08-03-2025,"Grains, Flours & Dals",Wheat Rava M 500GM,4,33,30,3,1
08-03-2025,Snacks & Ready-to-Eat,VD MIXTURE 175 GM,14,120,120,0,2
08-03-2025,"Grains, Flours & Dals",RAGI FLOUR 1KG,4,80,70,10,1
08-03-2025,"Grains, Flours & Dals",SABDANA,4,40,35,5,1
08-03-2025,Snacks & Ready-to-Eat,PEANUT CHILLI,14,50,50,0,10
08-03-2025,Snacks & Ready-to-Eat,GREEN FRIED batana,14,20,20,0,1
08-03-2025,"Grains, Flours & Dals",POORI ATTA 500GM,4,70,60,10,2
08-03-2025,Snacks & Ready-to-Eat,ANNAPURNA APPALAM,14,35,35,0,1
08-03-2025,Sweeteners,YB JAGGERY POWDER 500GMS,16,75,75,0,1
08-03-2025,Spices & Seasonings,SH MUSTARD 100GM,15,30,30,0,1
08-03-2025,Spices & Seasonings,Masala Karam 250 gms,15,130,120,10,1
08-03-2025,Personal Care & Cosmetics,KHADI Amla Bringaraj Shampoo 200ML,10,220,220,0,1
08-03-2025,"Grains, Flours & Dals",SABDANA,4,40,35,5,1
08-03-2025,"Dry Fruits, Nuts & Seeds",MAHA BEERA SEEDS 100GM,2,60,60,0,1
08-03-2025,Sweeteners,SUGAR 1KG,16,60,50,10,1
08-03-2025,Snacks & Ready-to-Eat,SF COOKIES CHOCO RAGI,14,99,99,0,1
08-03-2025,Spices & Seasonings,KALONJI SEEDS,15,90,80,10,1
08-03-2025,"Dry Fruits, Nuts & Seeds",SALTED PISTA 250GM,2,400,350,50,1
08-03-2025,Snacks & Ready-to-Eat,RAJGIRA PEANUT CHIKKI,14,20,20,0,4
08-03-2025,"Grains, Flours & Dals",RAGULU 1 KG,4,140,120,20,2
08-03-2025,Spices & Seasonings,NUVVULU 500GM,15,160,130,30,1
08-03-2025,Spices & Seasonings,Vamu 100GM,15,60,50,10,1
08-03-2025,"Grains, Flours & Dals",Em Multimillet upma 500g,4,258,258,0,2
08-03-2025,"Grains, Flours & Dals",Wheat Rava S 1KG,4,65,55,10,1
08-03-2025,Snacks & Ready-to-Eat,WHITE SESAME CHIKKI,14,10,10,0,1
08-03-2025,"Dry Fruits, Nuts & Seeds",Groundnuts 1 kg,2,380,340,40,2
08-03-2025,"Grains, Flours & Dals",split black gram 1 kg,4,360,340,20,2
08-03-2025,"Grains, Flours & Dals",BASMATHI RICE 1KG,4,150,135,15,1
08-03-2025,Sweeteners,YB JAGGERY POWDER 500GMS,16,75,75,0,1
08-03-2025,Snacks & Ready-to-Eat,VD MANGO JELLY 250GRMS,14,80,80,0,1
08-03-2025,"Dry Fruits, Nuts & Seeds",FLAX SEEDS 250GM,2,60,50,10,1
08-03-2025,"Grains, Flours & Dals",Chana Flour 500 gms,4,70,65,5,1
08-03-2025,Snacks & Ready-to-Eat,SALTED PHALLI,14,65,65,0,1
08-03-2025,"Grains, Flours & Dals",BARLEY FLOUR 500GM,4,90,80,10,1
08-03-2025,Snacks & Ready-to-Eat,SALTED PHALLI,14,195,195,0,3
08-03-2025,Snacks & Ready-to-Eat,VD PALLI LADDU,14,160,160,0,2
08-03-2025,Snacks & Ready-to-Eat,PEANUT CHILLI,14,5,5,0,1
08-03-2025,Snacks & Ready-to-Eat,MILLET PANCAKE CHOCOLATE,14,199,199,0,1
08-03-2025,Snacks & Ready-to-Eat,VD PALLI CHIKKI,14,160,160,0,2
08-03-2025,Sweeteners,GS A2 Buffalo Ghee 500ML,16,550,550,0,1
08-03-2025,Snacks & Ready-to-Eat,RAJGIRA PEANUT CHIKKI,14,5,5,0,1
08-03-2025,Spices & Seasonings,PURO Healthy Salt Crystal 1KG,15,135,135,0,1
08-03-2025,"Grains, Flours & Dals",turdal 1kg,4,220,195,25,1
08-03-2025,Snacks & Ready-to-Eat,VD PALLI LADDU,14,80,80,0,1
08-03-2025,"Dry Fruits, Nuts & Seeds",PULMAKHANA 100 GM,2,180,170,10,1
08-03-2025,Sweeteners,MISHRI 250 GM,16,35,30,5,1
08-03-2025,Spices & Seasonings,Turmeric powder 250 gms,15,100,75,25,1
08-03-2025,Sweeteners,YB Brown Sugar 500GM,16,75,75,0,1
08-03-2025,Spices & Seasonings,Menthulu 250 gms,15,50,45,5,1
08-03-2025,"Dry Fruits, Nuts & Seeds",PULMAKHANA 100 GM,2,180,170,10,1
08-03-2025,Milk & Dairy,BROWN EGGS 1P,7,168,144,24,12
08-03-2025,Oils & Ghee,Castor oil 200 ml,9,100,80,20,1
08-03-2025,Personal Care & Cosmetics,KAIPO SANDALWOOD SOAP 100GM,10,60,60,0,1
08-03-2025,"Dry Fruits, Nuts & Seeds",DRYDATES YELLOW 250GM,2,135,120,15,1
08-03-2025,Oils & Ghee,Groundnut oil 1 L,9,360,330,30,1
08-03-2025,Oils & Ghee,Groundnut oil 1 L,9,360,330,30,1
08-03-2025,"Grains, Flours & Dals",Urad dall 1 Kg,4,185,170,15,1
08-03-2025,Pooja & Spiritual Items,GD KUMKUM 50GM,12,30,30,0,1
08-03-2025,"Grains, Flours & Dals",AISHWARYA SP 1KG,4,80,70,10,1
08-03-2025,"Grains, Flours & Dals",VYS.SP.RICE 5 KGS,4,350,325,25,1
08-03-2025,Spices & Seasonings,Jeera 100GM,15,50,45,5,1
08-03-2025,Spices & Seasonings,GD Turmeric 50GM,15,25,25,0,1
08-03-2025,Oils & Ghee,Safflower oil 1 L,9,440,400,40,1
08-03-2025,"Dry Fruits, Nuts & Seeds",Putnalu 250GM,2,45,38,7,1
08-03-2025,Milk & Dairy,SANGAM CURD 450GM,7,38,38,0,1
08-03-2025,Spices & Seasonings,pickle chili powder,15,180,165,15,1
08-03-2025,Spices & Seasonings,Masala Karam 250 gms,15,130,120,10,1
08-03-2025,Spices & Seasonings,Coconut Powder 250GM,15,90,90,0,1
08-03-2025,Sweeteners,MISHRI D,16,40,30,10,1
08-03-2025,Snacks & Ready-to-Eat,NGT CHATPATTA CHANA 90GM,14,25,25,0,1
08-03-2025,"Grains, Flours & Dals",POORI ATTA 500GM,4,35,30,5,1
08-03-2025,"Grains, Flours & Dals",BASMATHI RICE 1KG,4,150,135,15,1
08-03-2025,"Dry Fruits, Nuts & Seeds",PULMAKHANA 100 GM,2,180,170,10,1
08-03-2025,Snacks & Ready-to-Eat,PEANUT CHIKKI 450GM,14,125,125,0,1
08-03-2025,Personal Care & Cosmetics,MADDI BATH POWDER 400GM,10,150,150,0,1
08-03-2025,"Grains, Flours & Dals",Yellow jowar .F1 kg,4,330,300,30,3
08-03-2025,"Dry Fruits, Nuts & Seeds",DRYDATES YELLOW 250GM,2,135,120,15,1
08-03-2025,Snacks & Ready-to-Eat,VD NUVULU CHEGODI 175GM,14,120,120,0,2
08-03-2025,"Health, Wellness & Ayurvedic Products",MD Aamlaki Choornam 100GM,5,160,160,0,2
08-03-2025,Snacks & Ready-to-Eat,VD MURUKU 175GM,14,60,60,0,1
08-03-2025,Snacks & Ready-to-Eat,CHOCO BROWINE,14,40,40,0,2
08-03-2025,Spices & Seasonings,GREEN SOUNF,15,240,160,80,4
08-03-2025,"Grains, Flours & Dals",RAGI FLOUR 500GRMS,4,40,35,5,1
08-03-2025,"Grains, Flours & Dals",Em Multimillet upma 500g,4,129,129,0,1
08-03-2025,"Dry Fruits, Nuts & Seeds",SUNFLOWER SEEDS 250GRM,2,150,130,20,1
08-03-2025,"Grains, Flours & Dals",UDALU (Barnyard millet) 500 gms,4,70,60,10,1
08-03-2025,Sweeteners,MISHRI 250 GM,16,35,30,5,1
08-03-2025,"Grains, Flours & Dals",Arikalu (kodo),4,70,65,5,1
08-03-2025,"Dry Fruits, Nuts & Seeds",YELLOW KISHMISH 250GM,2,130,110,20,1
08-03-2025,"Grains, Flours & Dals",Yellow jowar .F1 kg,4,110,100,10,1
08-03-2025,"Dry Fruits, Nuts & Seeds",PUMPKIN SEEDS 250GM,2,200,160,40,1
08-03-2025,"Grains, Flours & Dals",SAMALU,4,170,130,40,1
08-03-2025,"Dry Fruits, Nuts & Seeds",WATERMELON SEEDS 250GRM,2,320,280,40,1
08-03-2025,"Grains, Flours & Dals",KORRALU (FOXTAIL M) 1KG,4,150,110,40,1
08-03-2025,Snacks & Ready-to-Eat,SF MILLET PANCAKE CLASSIC 150GM,14,149,149,0,1
08-03-2025,"Health, Wellness & Ayurvedic Products",RB Max Protein Oats &Raisins 55gm,5,50,50,0,1
08-03-2025,"Health, Wellness & Ayurvedic Products",RB Max Protein Choco chips 55gm,5,50,50,0,1
08-03-2025,Snacks & Ready-to-Eat,VD CORNFLAKES MIXTURE 175GM,14,60,60,0,1
08-03-2025,"Grains, Flours & Dals",Idly Rava L 1KG,4,120,100,20,2
08-03-2025,Snacks & Ready-to-Eat,SF MIGHTY PUFFS,14,25,25,0,1
08-03-2025,Snacks & Ready-to-Eat,GB SALT COOKIES,14,60,55,5,1
08-03-2025,Household & Cleaning,PITAMBARI SHINING POWDER 200G,6,60,60,0,1
08-03-2025,Spices & Seasonings,JEERA 250 gms,15,125,105,20,1
08-03-2025,"Dry Fruits, Nuts & Seeds",Groundnuts 1 kg,2,380,340,40,2
08-03-2025,Spices & Seasonings,Menthulu 250 gms,15,100,90,10,2
08-03-2025,"Grains, Flours & Dals",Idly Rava L 1KG,4,120,100,20,2
08-03-2025,"Grains, Flours & Dals",Urad dall 1 Kg,4,555,510,45,3
08-03-2025,"Grains, Flours & Dals",Chana Flour 500 gms,4,70,65,5,1
08-03-2025,Spices & Seasonings,Turmeric powder 250 gms,15,100,75,25,1
08-03-2025,Spices & Seasonings,Coriander seeds 200 gms,15,48,40,8,1
08-03-2025,Sweeteners,SUGAR 1KG,16,180,150,30,3
08-03-2025,"Grains, Flours & Dals",PESARA PAPPU 1 KG,4,170,145,25,1
08-03-2025,"Grains, Flours & Dals",Green Batani 250GM,4,55,45,10,1
08-03-2025,Spices & Seasonings,ROYAL SAFFRON 400GRMS,15,65,65,0,1
08-03-2025,Spices & Seasonings,Tamarind 500GM,15,160,130,30,1
08-03-2025,Spices & Seasonings,DRY MIECHI 200GM,15,80,60,20,1
08-03-2025,"Grains, Flours & Dals",CHANA DAL 500GM,4,70,60,10,1
08-03-2025,Spices & Seasonings,DURGA SALT CRYSTAL 1KG,15,50,50,0,2
08-03-2025,Pooja & Spiritual Items,GD Ramayana Sandal 75GM,12,60,60,0,1
08-03-2025,"Grains, Flours & Dals",Wheat Rava M 500GM,4,33,30,3,1
08-03-2025,Pooja & Spiritual Items,GOW DURBAR GEETHA CAMPHOR,12,60,60,0,1
08-03-2025,Snacks & Ready-to-Eat,VD NUVVULU LADDU,14,80,80,0,1
08-03-2025,Household & Cleaning,comfort lily fresh,6,58,58,0,1
08-03-2025,Spices & Seasonings,dalchin chekka,15,50,40,10,1
08-03-2025,"Grains, Flours & Dals",turdal 1kg,4,440,390,50,2
08-03-2025,Sweeteners,GS JAGGERY NUGGETS 500GM,16,120,120,0,1
08-03-2025,Oils & Ghee,Groundnut oil 1 L,9,720,660,60,2
08-03-2025,Pooja & Spiritual Items,BALAJI BEL PHOOL STICKS 90GM,12,60,60,0,1
08-03-2025,"Grains, Flours & Dals",Wheat Flour 1 kg,4,70,60,10,1
08-03-2025,"Dry Fruits, Nuts & Seeds",SALTED PISTA 250GM,2,400,350,50,1
08-03-2025,"Grains, Flours & Dals",BOMBAY RAVA,4,70,55,15,1
08-03-2025,"Dry Fruits, Nuts & Seeds",Putnalu 250GM,2,45,38,7,1
08-03-2025,"Grains, Flours & Dals",Wheat Flour 2 kgs,4,140,120,20,1
08-03-2025,"Grains, Flours & Dals",Green gram 500 gms,4,75,70,5,1
08-03-2025,"Health, Wellness & Ayurvedic Products",RB FRUITS &amp;seeds Cranberries,5,45,45,0,1
08-03-2025,"Grains, Flours & Dals",RAGI FLOUR 500GRMS,4,40,35,5,1
08-03-2025,Snacks & Ready-to-Eat,SD DrybFruit LADDU WITH DATES 175GM,14,170,170,0,1
08-03-2025,"Dry Fruits, Nuts & Seeds",SALTED PISTA 250GM,2,400,350,50,1
08-03-2025,Oils & Ghee,Groundnut oil 1 L,9,720,660,60,2
08-03-2025,"Grains, Flours & Dals",Chana Flour 500 gms,4,70,65,5,1
08-03-2025,"Grains, Flours & Dals",Green gram 500 gms,4,75,70,5,1
08-03-2025,Spices & Seasonings,YB Rock Salt 1KG,15,120,120,0,1
08-03-2025,"Grains, Flours & Dals",RAGULU 1 KG,4,350,300,50,5
08-03-2025,"Grains, Flours & Dals",SAMALU,4,170,130,40,1
08-03-2025,Snacks & Ready-to-Eat,VD RICE SAGO PAPAD 150GM,14,55,55,0,1
08-03-2025,"Grains, Flours & Dals",KORRALU (FOXTAIL M) 1KG,4,150,110,40,1
08-03-2025,"Grains, Flours & Dals",JOWAR WHITE 1 KG,4,80,70,10,1
08-03-2025,"Grains, Flours & Dals",BAJRA 1 KG,4,60,50,10,1
08-03-2025,"Grains, Flours & Dals",Black uluvalu 500 gms,4,180,140,40,2
08-03-2025,"Grains, Flours & Dals",Arikalu (kodo),4,70,65,5,1
08-03-2025,Spices & Seasonings,RED COPRA 250GMS,15,85,74,11,1
08-03-2025,"Grains, Flours & Dals",CORN FLOUR,4,80,70,10,1
08-03-2025,"Grains, Flours & Dals",SPLIT BLACK GRAM 500 GM,4,90,85,5,1
08-03-2025,Spices & Seasonings,DURGA SALT CRYSTAL 1KG,15,25,25,0,1
08-03-2025,"Dry Fruits, Nuts & Seeds",CASHEW 250GM,2,340,310,30,1
08-03-2025,Spices & Seasonings,Japatri 25GM,15,100,80,20,1
08-03-2025,Spices & Seasonings,Menthulu 250 gms,15,50,45,5,1
08-03-2025,"Dry Fruits, Nuts & Seeds",MAHA BEERA SEEDS 100GM,2,60,60,0,1
08-03-2025,"Grains, Flours & Dals",KORRALU (FOXTAIL M) 500GM,4,65,55,10,1
08-03-2025,"Grains, Flours & Dals",Red Wheat Flour 1 kg,4,140,130,10,1
08-03-2025,"Grains, Flours & Dals",ANDU KORRALU (Brown top .mlt) 500,4,130,110,20,1
08-03-2025,Spices & Seasonings,SH BAY LEAF / TEJ PATTA 30GM,15,35,35,0,1
08-03-2025,"Grains, Flours & Dals",Wheat Flour 1 kg,4,70,60,10,1
08-03-2025,"Grains, Flours & Dals",Multigrain 1 kg,4,100,85,15,1
08-03-2025,Spices & Seasonings,Jeera 100GM,15,50,45,5,1
08-03-2025,Snacks & Ready-to-Eat,VD GUMMADI CHAKKA,14,130,130,0,1
08-03-2025,"Grains, Flours & Dals",UDALU (Barnyard millet) 500 gms,4,70,60,10,1
08-03-2025,Spices & Seasonings,Tamarind 250GMS,15,80,65,15,1
08-03-2025,Snacks & Ready-to-Eat,MAAGAANI M JOWAR PASTA 200GM,14,398,398,0,2
08-03-2025,"Dry Fruits, Nuts & Seeds",DIANUTS 500GM,2,120,120,0,1
08-03-2025,"Grains, Flours & Dals",RICE FLOUR 1KG,4,140,110,30,2
08-03-2025,"Health, Wellness & Ayurvedic Products",MD Neem Leaf Choornam 100GM,5,80,80,0,1
08-03-2025,Spices & Seasonings,Tamalapaku Karam Powder 100GM,15,80,80,0,1
08-03-2025,"Grains, Flours & Dals",HS Multimillet upma r 500g,4,65,65,0,1
08-03-2025,"Grains, Flours & Dals",HS Multimillet idly R 500 gms,4,65,65,0,1
08-03-2025,"Grains, Flours & Dals",Multigrain 1 kg,4,200,170,30,2
08-03-2025,Oils & Ghee,cow ghee 500 ml,9,430,390,40,1
08-03-2025,Spices & Seasonings,GS Pink Rock Salt 1KG,15,120,120,0,1
08-03-2025,"Grains, Flours & Dals",HS Multimillet idly R 500 gms,4,260,260,0,4
08-03-2025,Oils & Ghee,Groundnut oil 1 L,9,360,330,30,1
08-03-2025,"Grains, Flours & Dals",Green Batani 500GM,4,110,90,20,1
08-03-2025,"Dry Fruits, Nuts & Seeds",Groundnuts 1 kg,2,190,170,20,1
08-03-2025,"Grains, Flours & Dals",PESARA PAPPU 1 KG,4,170,145,25,1
08-03-2025,"Grains, Flours & Dals",Quinova 500 gms,4,110,100,10,1
08-03-2025,Snacks & Ready-to-Eat,GREEN FRIED batana,14,20,20,0,1
08-03-2025,"Dry Fruits, Nuts & Seeds",PULMAKHANA 100 GM,2,180,170,10,1
08-03-2025,Snacks & Ready-to-Eat,NGT CHATPATTA CHANA 90GM,14,25,25,0,1
08-03-2025,"Grains, Flours & Dals",COW B RICE 10 KGS,4,720,690,30,1
08-03-2025,Spices & Seasonings,YB Rock Salt 1KG,15,120,120,0,1
08-03-2025,"Grains, Flours & Dals",UDALU (Barnyard millet) 500 gms,4,70,60,10,1
08-03-2025,"Grains, Flours & Dals",SAMALU,4,170,130,40,1
08-03-2025,"Grains, Flours & Dals",Arikalu (kodo),4,70,65,5,1
08-03-2025,Snacks & Ready-to-Eat,SH PUFFED RICE 500GM,14,112,112,0,1
08-03-2025,Oils & Ghee,Safflower oil 500 ml,9,220,200,20,1
08-03-2025,Spices & Seasonings,GS Pink Rock Salt 1KG,15,120,120,0,1
08-03-2025,Oils & Ghee,cow ghee 500 ml,9,430,390,40,1
08-03-2025,"Grains, Flours & Dals",HS Multimillet idly R 500 gms,4,130,130,0,2
08-03-2025,"Grains, Flours & Dals",MAAGAANI SP RICE 20 KGS,4,2300,"1,960.00",340,1
08-03-2025,Spices & Seasonings,JEERA 250 gms,15,125,105,20,1
08-03-2025,Snacks & Ready-to-Eat,SF COOKIES CHOCO RAGI,14,99,99,0,1
08-03-2025,"Grains, Flours & Dals",SH WHITE POHA 500GM,4,75,75,0,1
08-03-2025,"Dry Fruits, Nuts & Seeds",SD Mango cubes 100gm,2,45,45,0,1
08-03-2025,Pooja & Spiritual Items,GB Bharatha Woods 75GM,12,60,60,0,1
08-03-2025,"Grains, Flours & Dals",MELMEKER 250GMS,4,60,45,15,1
08-03-2025,Pooja & Spiritual Items,bilwa patra,12,60,60,0,1
08-03-2025,"Grains, Flours & Dals",MAAGAANI SP RICE 5KGS,4,649,560,89,1
08-03-2025,Snacks & Ready-to-Eat,RINGS 200GM,14,30,30,0,1
08-03-2025,Sweeteners,SD PALM JAGGERY 500GM,16,200,200,0,1
08-03-2025,Pooja & Spiritual Items,GD Ramayana Sandal 75GM,12,60,60,0,1
08-03-2025,Snacks & Ready-to-Eat,VD CORNFLAKES MIXTURE 175GM,14,60,60,0,1
08-03-2025,Spices & Seasonings,Avalu small 250 gms,15,60,40,20,1
08-03-2025,Spices & Seasonings,SREE MARUTHI IDLY KARAM 200GM,15,60,60,0,1
08-03-2025,"Grains, Flours & Dals",White jowar.F 1 kg,4,200,160,40,2
08-03-2025,"Grains, Flours & Dals",RAGI FLOUR 1KG,4,80,70,10,1
08-03-2025,"Dry Fruits, Nuts & Seeds",PUMPKIN SEEDS 250GM,2,200,160,40,1
08-03-2025,Spices & Seasonings,dalchin chekka,15,50,40,10,1
08-03-2025,"Grains, Flours & Dals",turdal 1kg,4,220,195,25,1
08-03-2025,Spices & Seasonings,Jeera 100GM,15,50,45,5,1
08-03-2025,"Grains, Flours & Dals",PESARA PAPPU 1 KG,4,170,145,25,1
08-03-2025,Snacks & Ready-to-Eat,SD JOWAR WITH PALM JAGGERY 250GM,14,135,135,0,1
08-03-2025,Oils & Ghee,Groundnut oil 1 L,9,360,330,30,1
08-03-2025,Snacks & Ready-to-Eat,SATHVI REGIVADA 200GM,14,160,120,40,2
08-03-2025,"Grains, Flours & Dals",RAGI FLOUR 500GRMS,4,40,35,5,1
08-03-2025,Pooja & Spiritual Items,AMRUTHA SURABHI,12,160,160,0,2
08-03-2025,Spices & Seasonings,Tamarind 250GMS,15,80,65,15,1
08-03-2025,"Grains, Flours & Dals",Wheat Flour 1 kg,4,140,120,20,2
08-03-2025,Snacks & Ready-to-Eat,VD CORNFLAKES MIXTURE 175GM,14,60,60,0,1
08-03-2025,Spices & Seasonings,SV Pepper Rasam 100GM,15,80,80,0,1
08-03-2025,"Grains, Flours & Dals",RAGI FLOUR 500GRMS,4,80,70,10,2
08-03-2025,"Dry Fruits, Nuts & Seeds",SATHVI CHIA SEEDS 100GM,2,100,80,20,1
08-03-2025,Pooja & Spiritual Items,SWASTIK PURE CAMPHOR 50GM,12,180,180,0,2
08-03-2025,Snacks & Ready-to-Eat,BLACK SESAME CHIKKI,14,5,5,0,1
08-03-2025,"Grains, Flours & Dals",POORI ATTA 500GM,4,70,60,10,2
08-03-2025,Beverages,BISLERI 100ml,1,10,10,0,1
08-03-2025,Pooja & Spiritual Items,SWASTIK CAMPHORE,12,90,90,0,1
08-03-2025,"Grains, Flours & Dals",Green gram 1 kg,4,150,130,20,1
08-03-2025,Snacks & Ready-to-Eat,VD Minapa papad 200gm,14,60,60,0,1
08-03-2025,Snacks & Ready-to-Eat,VD BOONDI 175GM,14,60,60,0,1
08-03-2025,Spices & Seasonings,DRY MIECHI 200GM,15,80,60,20,1
08-03-2025,Snacks & Ready-to-Eat,ZEEDI,14,70,70,0,1
08-03-2025,Snacks & Ready-to-Eat,VD RICE SAGO PAPAD 150GM,14,55,55,0,1
08-03-2025,"Grains, Flours & Dals",VGR RICE bag 1,4,1899,"1,650.00",249,1
08-03-2025,"Grains, Flours & Dals",RICE FLOUR 1KG,4,70,55,15,1
08-03-2025,Spices & Seasonings,ROYAL SAFFRON,15,125,125,0,1
08-03-2025,"Dry Fruits, Nuts & Seeds",SD Mango cubes 200gm,2,90,90,0,1
08-03-2025,Pooja & Spiritual Items,SWATHI POOJA VATHULU,12,90,90,0,3
08-03-2025,Pooja & Spiritual Items,GD Aiswarya Deepam 700ML,12,195,195,0,1
08-03-2025,Oils & Ghee,Coconut oil 500 ml,9,220,200,20,1
08-03-2025,Snacks & Ready-to-Eat,CHOCO BROWINE,14,40,40,0,2
08-03-2025,Snacks & Ready-to-Eat,NGT CHATPATTA CHANA 90GM,14,60,60,0,3
08-03-2025,"Dry Fruits, Nuts & Seeds",ALMONDS 250GM,2,280,260,20,1
08-03-2025,Spices & Seasonings,NUVVULU 250GM,15,100,85,15,1
08-03-2025,Snacks & Ready-to-Eat,VD RICE SAGO PAPAD 150GM,14,55,55,0,1
08-03-2025,Oils & Ghee,Groundnut oil 1 L,9,720,660,60,2
08-03-2025,Baking & Cooking Aids,GONDH 50GRMS,0,50,40,10,1
08-03-2025,Snacks & Ready-to-Eat,ZEEDI,14,70,70,0,1
08-03-2025,Oils & Ghee,BUFFALLO GHEE 500ML,9,410,370,40,1
08-03-2025,Oils & Ghee,Sesame oil 500ml,9,295,280,15,1
08-03-2025,"Grains, Flours & Dals",Idly Rava L 1KG,4,180,150,30,3
08-03-2025,"Dry Fruits, Nuts & Seeds",Groundnuts 1 kg,2,190,170,20,1
08-03-2025,"Grains, Flours & Dals",CHANA DAL 500GM,4,70,60,10,1
08-03-2025,Sweeteners,SUGAR 1KG,16,60,50,10,1
08-03-2025,Spices & Seasonings,Tamarind 500GM,15,160,130,30,1
08-03-2025,"Grains, Flours & Dals",Green gram 1 kg,4,150,130,20,1
08-03-2025,General Household & Kitchenware,GOOD HOME,3,15,15,0,1
08-03-2025,"Grains, Flours & Dals",Urad dall 1 Kg,4,370,340,30,2
08-03-2025,Spices & Seasonings,JEERA 250 gms,15,125,105,20,1
08-03-2025,"Grains, Flours & Dals",THIN POHA 500GM,4,40,35,5,1
08-03-2025,"Dry Fruits, Nuts & Seeds",PUTNALU 500GMS,2,180,152,28,2
08-03-2025,"Grains, Flours & Dals",PESARA PAPPU 500GMS,4,85,75,10,1
08-03-2025,"Grains, Flours & Dals",Wheat Rava S 1KG,4,130,110,20,2
08-03-2025,Spices & Seasonings,Avalu small 250 gms,15,60,40,20,1
08-03-2025,"Grains, Flours & Dals",White Chana 250 GM,4,60,50,10,1
08-03-2025,"Grains, Flours & Dals",BOMBAY RAVA,4,140,110,30,2
08-03-2025,"Grains, Flours & Dals",RAGI FLOUR 1KG,4,160,140,20,2
08-03-2025,Household & Cleaning,vim small,6,45,45,0,3
08-03-2025,Spices & Seasonings,AV Iodized Salt 1KG,15,28,25,3,1
08-03-2025,Pooja & Spiritual Items,GD Dhoop Cones 40GM,12,30,30,0,1
08-03-2025,"Grains, Flours & Dals",turdal 1kg,4,440,390,50,2
08-03-2025,Sweeteners,KAMAL JAGGERY 500GM,16,40,40,0,1
08-03-2025,Pooja & Spiritual Items,GD Aiswarya Deepam 700ML,12,195,195,0,1
08-03-2025,"Dry Fruits, Nuts & Seeds",PULMAKHANA 100 GM,2,180,170,10,1
08-03-2025,Oils & Ghee,Sesame oil 500ml,9,295,280,15,1
08-03-2025,"Grains, Flours & Dals",RAGI FLOUR 500GRMS,4,40,35,5,1
08-03-2025,Spices & Seasonings,Tamarind 250GMS,15,80,65,15,1
08-03-2025,Snacks & Ready-to-Eat,VD DASA DINUSULU,14,199,199,0,1
08-03-2025,"Grains, Flours & Dals",COW B rice 1 kg,4,144,138,6,2
08-03-2025,"Dry Fruits, Nuts & Seeds",ALMONDS 250GM,2,280,260,20,1
08-03-2025,Sweeteners,YB Brown Sugar 1KG,16,140,140,0,1
08-03-2025,"Health, Wellness & Ayurvedic Products",MADDI NEEM OIL 100ML,5,100,100,0,1
08-03-2025,Milk & Dairy,SANGAM FULL CREAM MILK 500ML,7,38,38,0,1
08-03-2025,Milk & Dairy,SANGAM TONED MILK 500ML,7,30,30,0,1
08-03-2025,Snacks & Ready-to-Eat,RSC ORANGE 100GMS,14,20,20,0,1
08-03-2025,Pooja & Spiritual Items,SWASTIK CAMPHOR 10GM,12,20,20,0,1
08-03-2025,Snacks & Ready-to-Eat,RSC ORANGE 100GMS,14,20,20,0,1
08-03-2025,Personal Care & Cosmetics,MARGO,10,45,42,3,1
08-03-2025,"Dry Fruits, Nuts & Seeds",Groundnuts 1 kg,2,190,170,20,1
08-03-2025,"Grains, Flours & Dals",AISHWARYA SP 1KG,4,80,70,10,1
08-03-2025,Snacks & Ready-to-Eat,ZEEDI,14,70,70,0,1
08-03-2025,Beverages,RRED LABEL 10G,1,5,5,0,1
08-03-2025,Misc,VD0001,8,100,100,0,1
08-03-2025,Snacks & Ready-to-Eat,NGT CHATPATTA CHANA 90GM,14,50,50,0,2
08-03-2025,Snacks & Ready-to-Eat,VD VAMUPUSA 175GM,14,60,60,0,1
08-03-2025,Snacks & Ready-to-Eat,VD ARISELU,14,100,100,0,1
08-03-2025,Snacks & Ready-to-Eat,VD RIBBON PAKODI 175GM,14,60,60,0,1
08-03-2025,"Grains, Flours & Dals",VGR RICE 10 KGS,4,700,650,50,1
07-03-2025,Snacks & Ready-to-Eat,MB LITTLE MILLET NOODLES 180G,14,95,95,0,1
07-03-2025,"Health, Wellness & Ayurvedic Products",RB Max Protein Choco chips 55gm,5,50,50,0,1
07-03-2025,"Health, Wellness & Ayurvedic Products",RB Nuts& Seeds cashews 35g,5,45,45,0,1
07-03-2025,Snacks & Ready-to-Eat,MIGHTY PUFFS TOMATO,14,25,25,0,1
07-03-2025,Snacks & Ready-to-Eat,SD FINGER Millet with palm Jaggery 250gm,14,135,135,0,1
07-03-2025,"Health, Wellness & Ayurvedic Products",RB Max Protein NUTS &SEEDS 55gm,5,50,50,0,1
07-03-2025,Snacks & Ready-to-Eat,SD Ginger Candy 100g,14,60,60,0,1
07-03-2025,Personal Care & Cosmetics,SUNNUPINDI SOAP UVS,10,99,99,0,1
07-03-2025,Spices & Seasonings,Masala Karam 250 gms,15,130,120,10,1
07-03-2025,Personal Care & Cosmetics,MADDI ALOEVERA SHAMPOO 500ML,10,300,300,0,1
07-03-2025,"Dry Fruits, Nuts & Seeds",PUMPKIN SEEDS 250GM,2,200,160,40,1
07-03-2025,Snacks & Ready-to-Eat,BATANA NGT 70GMS,14,40,40,0,2
07-03-2025,Sweeteners,YB Brown Sugar 1KG,16,140,140,0,1
07-03-2025,Snacks & Ready-to-Eat,SD Thati thandra 200gm,14,150,150,0,1
07-03-2025,Oils & Ghee,Safflower oil 1 L,9,440,400,40,1
07-03-2025,Oils & Ghee,Sesame oil 1 L,9,1180,"1,120.00",60,2
07-03-2025,Spices & Seasonings,Telaga Pindi 250 GM,15,40,35,5,1
07-03-2025,"Dry Fruits, Nuts & Seeds",SUNFLOWER SEEDS 250GRM,2,150,130,20,1
07-03-2025,"Grains, Flours & Dals",HS JOWAR IDLY RAWA,4,130,130,0,2
07-03-2025,"Dry Fruits, Nuts & Seeds",SATHVI CHIA SEEDS 100GM,2,200,160,40,2
07-03-2025,"Grains, Flours & Dals",WHITE BATANI,4,40,30,10,1
07-03-2025,"Dry Fruits, Nuts & Seeds",BLACK KISMIS 250GM,2,175,140,35,1
07-03-2025,Personal Care & Cosmetics,NEEM SOAP 100GM,10,100,90,10,1
07-03-2025,Personal Care & Cosmetics,KHADI ALMOND SOAP 125GM,10,80,80,0,1
07-03-2025,"Dry Fruits, Nuts & Seeds",Groundnuts 1 kg,2,190,170,20,1
07-03-2025,Snacks & Ready-to-Eat,MB PEARL MILLET NOODLES 180GM,14,95,95,0,1
07-03-2025,General Household & Kitchenware,GOOD HOME,3,15,15,0,1
07-03-2025,"Grains, Flours & Dals",THIN POHA 500GM,4,40,35,5,1
07-03-2025,Spices & Seasonings,Dalchin Rolls 50GM,15,70,70,0,1
07-03-2025,"Grains, Flours & Dals",Red Chana 250GM,4,35,30,5,1
07-03-2025,Spices & Seasonings,AVALU 100GM,15,25,20,5,1
07-03-2025,Household & Cleaning,VIM SOAP,6,20,20,0,4
07-03-2025,"Dry Fruits, Nuts & Seeds",BLACK KISMIS 250GM,2,175,140,35,1
07-03-2025,Pooja & Spiritual Items,GOW DURBAR GEETHA CAMPHOR,12,60,60,0,1
07-03-2025,Spices & Seasonings,BIRYANI LEAF 10GM,15,30,20,10,1
07-03-2025,Snacks & Ready-to-Eat,BATANA NGT 70GMS,14,20,20,0,1
07-03-2025,Snacks & Ready-to-Eat,VD DRY FRUIT PUTHAREKULU,14,120,120,0,1
07-03-2025,Snacks & Ready-to-Eat,VD RED CHILLI RICEPAPAD 150GM,14,50,50,0,1
07-03-2025,Pooja & Spiritual Items,V GUGGILAM 50GM,12,45,45,0,1
07-03-2025,"Grains, Flours & Dals",turdal 1kg,4,220,195,25,1
07-03-2025,"Grains, Flours & Dals",split green gram 1 kg,4,150,140,10,1
07-03-2025,"Grains, Flours & Dals",Wheat Flour 1 kg,4,70,60,10,1
07-03-2025,"Grains, Flours & Dals",URAD DALL,4,95,85,10,1
07-03-2025,Snacks & Ready-to-Eat,JUNNU POWDER 100GM,14,70,70,0,1
07-03-2025,Snacks & Ready-to-Eat,CHOCO BROWINE,14,20,20,0,1
07-03-2025,"Health, Wellness & Ayurvedic Products",SAI DURGA MORINGA LEAVES 100GM,5,75,75,0,1
07-03-2025,"Dry Fruits, Nuts & Seeds",Putnalu 250GM,2,45,38,7,1
07-03-2025,"Grains, Flours & Dals",Multigrain 1 kg,4,100,85,15,1
07-03-2025,"Grains, Flours & Dals",ANDU KORRALU (Browntop.m) 1 kg,4,260,220,40,1
07-03-2025,"Grains, Flours & Dals",KORRALU (FOXTAIL M) 1KG,4,150,110,40,1
07-03-2025,"Dry Fruits, Nuts & Seeds",ALMONDS 250GM,2,280,260,20,1
07-03-2025,"Grains, Flours & Dals",Wheat Flour 1 kg,4,70,60,10,1
07-03-2025,"Grains, Flours & Dals",Wheat Rava S 1KG,4,65,55,10,1
07-03-2025,"Grains, Flours & Dals",BOMBAY RAVA,4,70,55,15,1
07-03-2025,Pooja & Spiritual Items,GD Aiswarya Deepam 700ML,12,390,390,0,2
07-03-2025,"Health, Wellness & Ayurvedic Products",RB Max Protein Choco Berry bar 50g,5,100,100,0,2
07-03-2025,Snacks & Ready-to-Eat,VD PALLI CHIKKI,14,80,80,0,1
07-03-2025,"Grains, Flours & Dals",CHANA DAL 500GM,4,70,60,10,1
07-03-2025,"Grains, Flours & Dals",VGR rice 1 kg,4,350,325,25,5
07-03-2025,"Grains, Flours & Dals",AISHWARYA SP 1KG,4,400,350,50,5
07-03-2025,Spices & Seasonings,SD Garlic Karam Powder 100GM,15,65,65,0,1
07-03-2025,"Grains, Flours & Dals",Multigrain 1 kg,4,100,85,15,1
07-03-2025,Oils & Ghee,Groundnut oil 5 L,9,1800,"1,600.00",200,1
07-03-2025,"Grains, Flours & Dals",SINGLE POLISH 1KG,4,260,260,0,4
07-03-2025,"Grains, Flours & Dals",SL Idly Rava 1KG,4,65,55,10,1
07-03-2025,Snacks & Ready-to-Eat,VD MULTI CHAKKA,14,110,110,0,1
07-03-2025,"Dry Fruits, Nuts & Seeds",Groundnuts 500 gms,2,95,85,10,1
07-03-2025,Snacks & Ready-to-Eat,Sprouted Ragi Biscuits 450GM,14,150,150,0,1
07-03-2025,Spices & Seasonings,YB Rock Salt 1KG,15,120,120,0,1
07-03-2025,"Grains, Flours & Dals",MAAGAANI LOW GI SP L 1KG,4,120,105,15,1
07-03-2025,Oils & Ghee,Black Sesame oil 500 ml,9,220,190,30,1
07-03-2025,"Grains, Flours & Dals",Sathya Javva Wheat Rava 500GM,4,95,95,0,1
07-03-2025,"Grains, Flours & Dals",PESARA PAPPU 500GMS,4,85,75,10,1
07-03-2025,"Grains, Flours & Dals",RED TURDAL 500GM,4,75,70,5,1
07-03-2025,Snacks & Ready-to-Eat,RSC ORANGE 100GMS,14,20,20,0,1
07-03-2025,"Grains, Flours & Dals",White jowar.F 1 kg,4,200,160,40,2
07-03-2025,Oils & Ghee,cow ghee 500 ml,9,430,390,40,1
07-03-2025,Sweeteners,YB JAGGERY POWDER 500GMS,16,75,75,0,1
07-03-2025,"Grains, Flours & Dals",Wheat Flour 1 kg,4,280,240,40,4
07-03-2025,Snacks & Ready-to-Eat,NGT CHATPATTA CHANA 90GM,14,25,25,0,1
07-03-2025,Oils & Ghee,Sesame oil 1 L,9,590,560,30,1
07-03-2025,Oils & Ghee,Groundnut oil 1 L,9,720,660,60,2
07-03-2025,Spices & Seasonings,Telaga Pindi 500GM,15,80,70,10,1
07-03-2025,Snacks & Ready-to-Eat,BATANA NGT 70GMS,14,20,20,0,1
07-03-2025,Snacks & Ready-to-Eat,VD PALLI LADDU,14,80,80,0,1
07-03-2025,"Grains, Flours & Dals",ANDU KORRALU (Browntop.m) 1 kg,4,260,220,40,1
07-03-2025,"Grains, Flours & Dals",White jowar.F 1 kg,4,100,80,20,1
07-03-2025,"Grains, Flours & Dals",Arikadu ( kodo),4,140,130,10,1
07-03-2025,Spices & Seasonings,SATHVI TURMERIC POWDER 500GM,15,360,260,100,2
07-03-2025,"Grains, Flours & Dals",Bajra Flour 1 kg,4,70,60,10,1
07-03-2025,"Grains, Flours & Dals",UDALU (Barnyard millet) 1 kg,4,140,115,25,1
07-03-2025,"Grains, Flours & Dals",SAMALU,4,170,130,40,1
07-03-2025,"Grains, Flours & Dals",YB Red RICE 1 KG,4,300,240,60,2
07-03-2025,Personal Care & Cosmetics,Khadi Red Onion Shampoo 200ML,10,199,199,0,1
07-03-2025,Personal Care & Cosmetics,ORGANIC SPONGE LOOFAH,10,70,70,0,1
07-03-2025,Personal Care & Cosmetics,OVAL BODY LOOFAH,10,55,55,0,1
07-03-2025,Personal Care & Cosmetics,SVE RED SANDAL SOAP 100GM,10,90,90,0,1
07-03-2025,Pooja & Spiritual Items,LOOSE VATHULU,12,30,25,5,1
07-03-2025,Snacks & Ready-to-Eat,NGT CHATPATTA CHANA 90GM,14,25,25,0,1
07-03-2025,Spices & Seasonings,GREEN SOUNF,15,120,80,40,2
07-03-2025,"Grains, Flours & Dals",Multigrain 1 kg,4,100,85,15,1
07-03-2025,"Grains, Flours & Dals",RAGULU 1 KG,4,210,180,30,3
07-03-2025,"Grains, Flours & Dals",POORI ATTA 1KG,4,70,60,10,1
07-03-2025,"Grains, Flours & Dals",JOWAR YELLOW 1 K,4,100,90,10,1
07-03-2025,"Grains, Flours & Dals",BARLEY SEEDS 250GMS,4,40,35,5,1
07-03-2025,Sweeteners,SD PALM JAGGERY 500GM,16,200,200,0,1
07-03-2025,Personal Care & Cosmetics,GA DANT MANJAN TP 50GM,10,60,60,0,1
07-03-2025,"Dry Fruits, Nuts & Seeds",SUNFLOWER SEEDS 250GRM,2,150,130,20,1
07-03-2025,Oils & Ghee,Sesame oil 1 L,9,590,560,30,1
07-03-2025,Spices & Seasonings,Elaichi 25GM,15,145,120,25,1
07-03-2025,Spices & Seasonings,Coriander seeds 200 gms,15,192,160,32,4
07-03-2025,Snacks & Ready-to-Eat,PEANUT CHIKKI,14,22,22,0,1
07-03-2025,"Grains, Flours & Dals",BARLEY SEEDS 1KG,4,80,70,10,0.5
07-03-2025,"Grains, Flours & Dals",SL Idly Rava 1KG,4,65,55,10,1
07-03-2025,Misc,VD0009,8,200,200,0,2
07-03-2025,Snacks & Ready-to-Eat,SD FINGER Millet with palm Jaggery 250gm,14,135,135,0,1
07-03-2025,"Grains, Flours & Dals",DH URAD GOTA 1KG,4,215,190,25,1
07-03-2025,Spices & Seasonings,DRY MIECHI 200GM,15,80,60,20,1
07-03-2025,"Dry Fruits, Nuts & Seeds",PULMAKHANA 100 GM,2,180,170,10,1
07-03-2025,Spices & Seasonings,ROYAL SAFFRON 400GRMS,15,65,65,0,1
07-03-2025,Spices & Seasonings,Coriander seeds 200 gms,15,48,40,8,1
07-03-2025,"Grains, Flours & Dals",AISHWARAYA IDLY RAVA 1KG,4,99,66,33,1
07-03-2025,"Dry Fruits, Nuts & Seeds",DRYDATES 250GM,2,150,120,30,1
07-03-2025,Snacks & Ready-to-Eat,BATANA NGT 70GMS,14,20,20,0,1
07-03-2025,Milk & Dairy,BROWN EGGS 1P,7,84,72,12,6
07-03-2025,"Grains, Flours & Dals",RAGI FLOUR 500GRMS,4,40,35,5,1
07-03-2025,"Grains, Flours & Dals",Sathya Javva Wheat Rava 500GM,4,95,95,0,1
07-03-2025,Misc,ROLL D C,8,70,45,25,1
07-03-2025,Spices & Seasonings,Elaichi 25GM,15,145,120,25,1
07-03-2025,Oils & Ghee,Sesame oil 1 L,9,590,560,30,1
07-03-2025,"Grains, Flours & Dals",Wheat Flour 1 kg,4,70,60,10,1
07-03-2025,"Dry Fruits, Nuts & Seeds",SH GROUNDNUT 500GM,2,163,130,33,1
07-03-2025,"Grains, Flours & Dals",CHANA DAL 500GM,4,70,60,10,1
07-03-2025,Oils & Ghee,Sesame oil 500ml,9,295,280,15,1
07-03-2025,"Dry Fruits, Nuts & Seeds",YELLOW KISHMISH 250GM,2,130,110,20,1
07-03-2025,Spices & Seasonings,Tamarind 500GM,15,160,130,30,1
07-03-2025,"Dry Fruits, Nuts & Seeds",ALMONDS 250GM,2,280,260,20,1
07-03-2025,Milk & Dairy,ID PANEER,7,135,135,0,1
07-03-2025,"Grains, Flours & Dals",RAGI FLOUR 1KG,4,80,70,10,1
07-03-2025,Spices & Seasonings,ROYAL SAFFRON,15,125,125,0,1
07-03-2025,Personal Care & Cosmetics,SVE SHIKAKAI SOAP 100GM,10,100,100,0,1
07-03-2025,Snacks & Ready-to-Eat,SD Moringa with plam jaggery 250gm,14,135,135,0,1
07-03-2025,"Grains, Flours & Dals",Wheat Flour 1 kg,4,280,240,40,4
07-03-2025,Personal Care & Cosmetics,SVE REETHA KUNKUDUKAYALU,10,398,398,0,2
07-03-2025,"Grains, Flours & Dals",White jowar.F 1 kg,4,100,80,20,1
07-03-2025,Personal Care & Cosmetics,SVE RED SANDAL SOAP 100GM,10,90,90,0,1
07-03-2025,"Grains, Flours & Dals",POORI ATTA 1KG,4,70,60,10,1
07-03-2025,Snacks & Ready-to-Eat,SD JOWAR WITH PALM JAGGERY 250GM,14,270,270,0,2
07-03-2025,Spices & Seasonings,Turmeric powder 250 gms,15,100,75,25,1
07-03-2025,Sweeteners,Mishri 500GM,16,70,60,10,1
07-03-2025,Spices & Seasonings,DRY MIECHI 200GM,15,80,60,20,1
07-03-2025,"Grains, Flours & Dals",RED TUDAL 1KG,4,150,140,10,1
07-03-2025,"Grains, Flours & Dals",BARLEY SEEDS 1KG,4,80,70,10,0.5
07-03-2025,Personal Care & Cosmetics,HERBAL BATH POWDER 200GM,10,80,80,0,1
07-03-2025,Oils & Ghee,Groundnut oil 1 L,9,360,330,30,1
07-03-2025,Spices & Seasonings,NUVVULU 250GM,15,80,65,15,1
07-03-2025,"Grains, Flours & Dals",Bajra Flour 500 gms,4,35,30,5,1
07-03-2025,Snacks & Ready-to-Eat,SATHVI REGIVADA 200GM,14,160,120,40,2
07-03-2025,"Grains, Flours & Dals",Brown RICE 1KG,4,210,195,15,3
07-03-2025,"Grains, Flours & Dals",Green gram 1 kg,4,150,130,20,1
07-03-2025,Snacks & Ready-to-Eat,VD PALLI LADDU,14,80,80,0,1
07-03-2025,"Grains, Flours & Dals",VYS.SP.RICE BAG 1,4,1800,"1,650.00",150,1
07-03-2025,Oils & Ghee,Coconut oil 500 ml,9,220,200,20,1
07-03-2025,"Grains, Flours & Dals",VYS.SP.RICE BAG 1,4,1800,"1,650.00",150,1
07-03-2025,"Dry Fruits, Nuts & Seeds",SALTED PISTA 250GM,2,400,350,50,1
07-03-2025,Oils & Ghee,Safflower oil 1 L,9,880,800,80,2
07-03-2025,Snacks & Ready-to-Eat,SF CHOCO CRUNCH,14,598,598,0,2
07-03-2025,"Grains, Flours & Dals",THICK POHA 1KG,4,80,70,10,1
07-03-2025,"Grains, Flours & Dals",Wheat Flour 1 kg,4,140,120,20,2
07-03-2025,Spices & Seasonings,YB Rock Salt 1KG,15,240,240,0,2
07-03-2025,"Dry Fruits, Nuts & Seeds",CASHEW 250GM,2,340,310,30,1
07-03-2025,Sweeteners,YB Brown Sugar 500GM,16,150,150,0,2
07-03-2025,"Dry Fruits, Nuts & Seeds",YELLOW KISHMISH 250GM,2,130,110,20,1
07-03-2025,Snacks & Ready-to-Eat,ANNAPURNA APPALAM,14,175,175,0,5
07-03-2025,Snacks & Ready-to-Eat,PEANUT CHILLI,14,25,25,0,5
07-03-2025,"Dry Fruits, Nuts & Seeds",Groundnuts 1 kg,2,190,170,20,1
07-03-2025,Snacks & Ready-to-Eat,VD RICE SAGO PAPAD 150GM,14,110,110,0,2
07-03-2025,"Dry Fruits, Nuts & Seeds",ALMONDS 250GM,2,280,260,20,1
07-03-2025,Snacks & Ready-to-Eat,SD Ginger Candy 100g,14,60,60,0,1
07-03-2025,Spices & Seasonings,SD Curry Leaves Karam Powder 100GM,15,65,65,0,1
07-03-2025,Snacks & Ready-to-Eat,VD MIXTURE 175 GM,14,60,60,0,1
07-03-2025,"Health, Wellness & Ayurvedic Products",AMLAMRUT AMLA MASALA CANDY,5,95,95,0,1
07-03-2025,"Grains, Flours & Dals",turdal 1kg,4,220,195,25,1
07-03-2025,"Dry Fruits, Nuts & Seeds",PUMPKIN SEEDS 250GM,2,200,160,40,1
07-03-2025,Snacks & Ready-to-Eat,VD ATUKULU MIXTURE 175GM,14,60,60,0,1
07-03-2025,"Health, Wellness & Ayurvedic Products",SAI DURGA MORINGA LEAVES 100GM,5,150,150,0,2
07-03-2025,Sweeteners,YB JAGGERY POWDER 500GMS,16,75,75,0,1
07-03-2025,Oils & Ghee,Coconut oil 500 ml,9,220,200,20,1
07-03-2025,Spices & Seasonings,NUVVULU 500GM,15,160,130,30,1
07-03-2025,Oils & Ghee,Flaxseed oil 500 ml,9,300,270,30,1
07-03-2025,"Grains, Flours & Dals",Chittimuthaylu rice 1 kg,4,160,140,20,1
07-03-2025,Snacks & Ready-to-Eat,VD MINAPA VADIYAM,14,65,65,0,1
07-03-2025,"Dry Fruits, Nuts & Seeds",CASHEW 250GM,2,680,620,60,2
07-03-2025,Snacks & Ready-to-Eat,VD Minapa papad 200gm,14,120,120,0,2
07-03-2025,"Dry Fruits, Nuts & Seeds",Groundnuts 1 kg,2,190,170,20,1
07-03-2025,Spices & Seasonings,Menthulu 250 gms,15,50,45,5,1
07-03-2025,Snacks & Ready-to-Eat,SD FLAX SEED APPADALU,14,90,90,0,1
07-03-2025,Snacks & Ready-to-Eat,VD GUMMADI VADIYAM,14,150,150,0,2
07-03-2025,Personal Care & Cosmetics,MYSORE SANDAL,10,69,69,0,1
07-03-2025,General Household & Kitchenware,SIRIDHANYALU BOOK,3,200,180,20,1
07-03-2025,Snacks & Ready-to-Eat,VD PALLI LADDU,14,80,80,0,1
07-03-2025,Snacks & Ready-to-Eat,SD GINGER CANDY 200GM,14,120,120,0,1
07-03-2025,Snacks & Ready-to-Eat,RAGI LADDU,14,120,120,0,1
07-03-2025,Personal Care & Cosmetics,SVE HIBISCUS SOAP,10,90,90,0,1
07-03-2025,Snacks & Ready-to-Eat,VD GUMMADI VADIYAM,14,75,75,0,1
07-03-2025,Spices & Seasonings,FLAXSEED KARAM,15,75,75,0,1
07-03-2025,"Health, Wellness & Ayurvedic Products",MH Womens Malt 500GM,5,250,240,10,1
07-03-2025,Spices & Seasonings,SD Curry Leaves Karam Powder 100GM,15,65,65,0,1
07-03-2025,Pooja & Spiritual Items,SIVA JOOTHI 365 DEEPAPU,12,50,50,0,2
07-03-2025,Personal Care & Cosmetics,ROUND LOOFAH,10,65,65,0,1
07-03-2025,Snacks & Ready-to-Eat,SD Ginger Candy 100g,14,60,60,0,1
07-03-2025,Personal Care & Cosmetics,BLACK NATURALS,10,90,84,6,2
07-03-2025,Misc,VD0009,8,100,100,0,1
07-03-2025,Spices & Seasonings,NUVVULU 250GM,15,100,85,15,1
07-03-2025,Snacks & Ready-to-Eat,JUNNU POWDER 100GM,14,70,70,0,1
07-03-2025,"Health, Wellness & Ayurvedic Products",SAI DURGA MORINGA LEAVES 100GM,5,75,75,0,1
07-03-2025,"Grains, Flours & Dals",Wheat Flour 1 kg,4,70,60,10,1
07-03-2025,Spices & Seasonings,NUVVULU 500GM,15,160,130,30,1
07-03-2025,Misc,ROLL D C,8,70,45,25,1
07-03-2025,Oils & Ghee,Safflower oil 1 L,9,440,400,40,1
07-03-2025,Oils & Ghee,Castor oil 200 ml,9,100,80,20,1
07-03-2025,Sweeteners,YB Brown Sugar 500GM,16,75,75,0,1
07-03-2025,"Grains, Flours & Dals",KORRALU (FOXTAIL M) 500GM,4,130,110,20,2
07-03-2025,"Grains, Flours & Dals",AISHWARYA SP 25KG,4,1999,"1,690.00",309,1
07-03-2025,Spices & Seasonings,AVALU 100GM,15,25,20,5,1
07-03-2025,"Grains, Flours & Dals",split green gram 500 gms,4,75,70,5,1
07-03-2025,"Grains, Flours & Dals",BARLEY FLOUR 500GM,4,90,80,10,1
07-03-2025,"Dry Fruits, Nuts & Seeds",FLAX SEEDS 250GM,2,75,65,10,1
07-03-2025,Oils & Ghee,Groundnut oil 1 L,9,720,660,60,2
07-03-2025,"Grains, Flours & Dals",turdal 500 gms,4,110,100,10,1
07-03-2025,"Grains, Flours & Dals",Red uluvalu 500 gms,4,90,75,15,1
07-03-2025,"Grains, Flours & Dals",PRO SABUDHANA 500GM,4,89,89,0,1
07-03-2025,Oils & Ghee,Coconut oil 1 L,9,440,400,40,1
07-03-2025,Oils & Ghee,Safflower oil 1 L,9,440,400,40,1
07-03-2025,Spices & Seasonings,Jeera 100GM,15,50,45,5,1
07-03-2025,Snacks & Ready-to-Eat,SATHVI REGIVADA 200GM,14,80,60,20,1
07-03-2025,General Household & Kitchenware,B4 BOWL,3,320,304,16,2
07-03-2025,General Household & Kitchenware,B1 bowl,3,399,379.05,19.95,1
07-03-2025,"Dry Fruits, Nuts & Seeds",sabja seeds,2,80,70,10,1
07-03-2025,Beverages,MUA COFFEE EXT STRONG 250GM,1,140,140,0,1
07-03-2025,"Grains, Flours & Dals",WHEAT 1 KG,4,120,100,20,2
07-03-2025,Oils & Ghee,Groundnut oil 1 L,9,720,660,60,2
07-03-2025,"Grains, Flours & Dals",SINGLE POLISH 1KG,4,195,195,0,3
07-03-2025,"Dry Fruits, Nuts & Seeds",SALTED PISTA 250GM,2,400,350,50,1
07-03-2025,Beverages,BISLERI WATER 1L,1,20,20,0,1
07-03-2025,"Grains, Flours & Dals",Sathya Javva Wheat Rava 500GM,4,95,95,0,1
07-03-2025,Spices & Seasonings,ROYAL SAFFRON,15,250,250,0,2
07-03-2025,Sweeteners,YB Brown Sugar 1KG,16,140,140,0,1
07-03-2025,"Grains, Flours & Dals",JOWAR YELLOW 1 K,4,100,90,10,1
07-03-2025,"Grains, Flours & Dals",EM Foxtail idli r 500 g,4,109,109,0,1
07-03-2025,"Grains, Flours & Dals",Yellow jowar .F1 kg,4,110,100,10,1
07-03-2025,"Grains, Flours & Dals",ANDU KORRALU (Browntop.m) 1 kg,4,260,220,40,1
07-03-2025,Snacks & Ready-to-Eat,NGT CHATPATTA CHANA 90GM,14,25,25,0,1
07-03-2025,"Grains, Flours & Dals",Quinova 1 kg,4,220,195,25,1
07-03-2025,"Grains, Flours & Dals",Bajra Flour 1 kg,4,70,60,10,1
07-03-2025,"Grains, Flours & Dals",KORRALU (FOXTAIL M) 1KG,4,150,110,40,1
07-03-2025,"Grains, Flours & Dals",KORRALU (FOXTAIL M) 1KG,4,150,110,40,1
07-03-2025,"Dry Fruits, Nuts & Seeds",FLAX SEEDS 250GM,2,60,50,10,1
07-03-2025,"Grains, Flours & Dals",POORI ATTA 1KG,4,70,60,10,1
07-03-2025,"Grains, Flours & Dals",THIN POHA 500GM,4,80,70,10,2
07-03-2025,Snacks & Ready-to-Eat,BB VERMICELLI 1KG,14,95,90,5,1
07-03-2025,"Grains, Flours & Dals",SL Suji Rava 500GM,4,64,64,0,2
07-03-2025,Spices & Seasonings,YB PINK ROCK SALT 1KG,15,120,120,0,1
07-03-2025,Oils & Ghee,Coconut oil 1 L,9,440,400,40,1
07-03-2025,"Grains, Flours & Dals",Wheat Flour 1 kg,4,210,180,30,3
07-03-2025,"Grains, Flours & Dals",Arikadu ( kodo),4,140,130,10,1
07-03-2025,"Grains, Flours & Dals",PESARA PAPPU 500GMS,4,85,75,10,1
07-03-2025,Oils & Ghee,Safflower oil 1 L,9,440,400,40,1
07-03-2025,"Grains, Flours & Dals",Wheat Flour 1 kg,4,140,120,20,2
07-03-2025,"Grains, Flours & Dals",Wheat Rava S 1KG,4,65,55,10,1
07-03-2025,"Grains, Flours & Dals",Multigrain 1 kg,4,100,85,15,1
07-03-2025,"Grains, Flours & Dals",RAGI FLOUR 1KG,4,80,70,10,1
07-03-2025,Oils & Ghee,Groundnut oil 1 L,9,1080,990,90,3
07-03-2025,"Grains, Flours & Dals",CHANA DAL 500GM,4,70,60,10,1
07-03-2025,"Grains, Flours & Dals",THIN POHA 500GM,4,80,70,10,2
07-03-2025,"Grains, Flours & Dals",Idly Rava L 1KG,4,60,50,10,1
07-03-2025,"Grains, Flours & Dals",Urad dall 1 Kg,4,185,170,15,1
07-03-2025,"Grains, Flours & Dals",White jowar.F 1 kg,4,100,80,20,1
07-03-2025,"Grains, Flours & Dals",white Bobarlu 500 gms,4,80,75,5,1
07-03-2025,Personal Care & Cosmetics,nivea men roll on,10,215,161.25,53.75,1
07-03-2025,Personal Care & Cosmetics,PATANJALI STRONG &HEALTHY 180ML,10,120,90,30,1
07-03-2025,Personal Care & Cosmetics,vaseline daily brightness,10,225,168.75,56.25,1
07-03-2025,Oils & Ghee,Safflower oil 5 L,9,2200,"1,950.00",250,1
07-03-2025,Personal Care & Cosmetics,WILD STONE CODE GOLD BODY BODY,10,275,206.25,68.75,1
07-03-2025,Personal Care & Cosmetics,HEAD& SHOULDERS ANTI DANDRUFF,10,399,299.25,99.75,1
07-03-2025,Snacks & Ready-to-Eat,WHITE SESAME CHIKKI,14,10,10,0,1
07-03-2025,Baking & Cooking Aids,GONDH 50GRMS,0,100,80,20,2
07-03-2025,Snacks & Ready-to-Eat,SD KODO MILLET WITH PALM JAGGERY,14,135,135,0,1
07-03-2025,"Grains, Flours & Dals",BARLEY SEEDS 250GMS,4,40,35,5,1
07-03-2025,"Dry Fruits, Nuts & Seeds",sabja seeds,2,80,70,10,1
07-03-2025,Personal Care & Cosmetics,ROUND LOOFAH,10,65,65,0,1
07-03-2025,"Grains, Flours & Dals",JOWAR UPMA RAVA,4,75,75,0,1
07-03-2025,Snacks & Ready-to-Eat,SATHVI REGIVADA 200GM,14,80,60,20,1
07-03-2025,"Grains, Flours & Dals",Sathya Javva Wheat Rava 500GM,4,95,95,0,1
07-03-2025,"Dry Fruits, Nuts & Seeds",ANJEER 250GM,2,400,360,40,1
07-03-2025,"Grains, Flours & Dals",Wheat Flour 1 kg,4,70,60,10,1
07-03-2025,"Grains, Flours & Dals",Quinova 500 gms,4,110,100,10,1
07-03-2025,Personal Care & Cosmetics,VETIVER BATH SCRUB,10,40,40,0,1
07-03-2025,"Health, Wellness & Ayurvedic Products",GD 27 HERBS OIL 120ML,5,150,150,0,1
07-03-2025,"Dry Fruits, Nuts & Seeds",YB GRANMA NUTS,2,90,90,0,1
07-03-2025,Personal Care & Cosmetics,COW DURBAR 7 HERBS SHAMPOO,10,125,125,0,1
07-03-2025,Spices & Seasonings,NUVVULU 250GM,15,100,85,15,1
07-03-2025,Oils & Ghee,Coconut oil 500 ml,9,220,200,20,1
07-03-2025,Snacks & Ready-to-Eat,VD CORNFLAKES MIXTURE 175GM,14,60,60,0,1
07-03-2025,Snacks & Ready-to-Eat,CHOCO BROWINE,14,20,20,0,1
07-03-2025,Milk & Dairy,HRITAGE TOTAL CURD 130GM,7,10,10,0,1
07-03-2025,"Grains, Flours & Dals",Wheat Rava M 500GM,4,33,30,3,1
07-03-2025,Oils & Ghee,Groundnut oil 1 L,9,720,660,60,2
07-03-2025,Spices & Seasonings,Tamarind 500GM,15,160,130,30,1
07-03-2025,"Grains, Flours & Dals",Chana Flour 500 gms,4,70,65,5,1
07-03-2025,Snacks & Ready-to-Eat,MIGHTY PUFFS KHATTA METTA,14,25,25,0,1
07-03-2025,"Health, Wellness & Ayurvedic Products",MAX PROTEIN ALMOND BAR,5,80,80,0,1
07-03-2025,Snacks & Ready-to-Eat,CHOCO BROWINE,14,20,20,0,1
07-03-2025,Snacks & Ready-to-Eat,ELITE MILK RUSK 200GM,14,35,35,0,1
07-03-2025,Snacks & Ready-to-Eat,MILK BREAD,14,30,30,0,1
07-03-2025,Pooja & Spiritual Items,GD Aiswarya Deepam 700ML,12,195,195,0,1
07-03-2025,Spices & Seasonings,pickle chili powder,15,360,330,30,2
07-03-2025,Pooja & Spiritual Items,GD Kailash 60 GM,12,60,60,0,1
07-03-2025,Personal Care & Cosmetics,ORAL B KIDS,10,25,25,0,1
07-03-2025,Milk & Dairy,SANGAM TONED MILK 500ML,7,30,30,0,1
07-03-2025,Pooja & Spiritual Items,GD Sambrani Cup Dhoop 10 PC,12,96,96,0,1
07-03-2025,Pooja & Spiritual Items,GD Dhoop Sticks 26GM,12,20,20,0,1
07-03-2025,Spices & Seasonings,Chilli powder 500 gms,15,290,210,80,1
07-03-2025,Pickles & Cooking Pastes,DB Three Mango 1KG,11,28,25,3,1
07-03-2025,Spices & Seasonings,LG 50GM,15,92,92,0,1
07-03-2025,Oils & Ghee,Groundnut oil 1 L,9,360,330,30,1
07-03-2025,Oils & Ghee,Sesame oil 500ml,9,295,280,15,1
07-03-2025,Household & Cleaning,VIM SOAP,6,35,35,0,7
07-03-2025,Spices & Seasonings,JEERA 250 gms,15,125,105,20,1
07-03-2025,"Grains, Flours & Dals",Green gram 1 kg,4,150,130,20,1
07-03-2025,Oils & Ghee,Sesame oil 1 L,9,1180,"1,120.00",60,2
07-03-2025,"Grains, Flours & Dals",UDALU (Barnyard millet) 500 gms,4,70,60,10,1
07-03-2025,"Grains, Flours & Dals",BOMBAY RAVA,4,70,55,15,1
07-03-2025,"Grains, Flours & Dals",Wheat Rava S 1KG,4,65,55,10,1
07-03-2025,"Grains, Flours & Dals",RAGULU 1 KG,4,70,60,10,1
07-03-2025,Snacks & Ready-to-Eat,Corn Chips 250GM,14,40,35,5,1
07-03-2025,"Grains, Flours & Dals",JOWAR WHITE 1 KG,4,160,140,20,2
07-03-2025,"Health, Wellness & Ayurvedic Products",MAX PROTEIN ALMOND BAR,5,80,80,0,1
07-03-2025,"Grains, Flours & Dals",KORRALU (FOXTAIL M) 1KG,4,150,110,40,1
07-03-2025,"Grains, Flours & Dals",RICE FLOUR 500 GM,4,35,28,7,1
07-03-2025,Oils & Ghee,Groundnut oil 1 L,9,1080,990,90,3
07-03-2025,"Grains, Flours & Dals",White Chana 500GM,4,120,100,20,1
07-03-2025,Oils & Ghee,Sesame oil 1 L,9,590,560,30,1
07-03-2025,"Grains, Flours & Dals",Green gram 500 gms,4,75,70,5,1
07-03-2025,"Grains, Flours & Dals",DH URAD GOTA 1KG,4,430,380,50,2
07-03-2025,Spices & Seasonings,Avalu small 250 gms,15,60,40,20,1
07-03-2025,"Grains, Flours & Dals",maida 500grms,4,35,30,5,1
07-03-2025,Spices & Seasonings,JEERA 250 gms,15,125,105,20,1
07-03-2025,Sweeteners,SUGAR 500 GM,16,30,25,5,1
07-03-2025,"Grains, Flours & Dals",Chana Flour 500 gms,4,70,65,5,1
07-03-2025,"Grains, Flours & Dals",RICE FLOUR 1KG,4,70,55,15,1
07-03-2025,General Household & Kitchenware,B4 BOWL,3,160,160,0,1
07-03-2025,"Grains, Flours & Dals",Wheat Flour 2 kgs,4,140,120,20,1
06-03-2025,"Grains, Flours & Dals",Wheat Flour 1 kg,4,70,60,10,1
06-03-2025,"Grains, Flours & Dals",RAGI FLOUR 500GRMS,4,80,70,10,2
06-03-2025,Milk & Dairy,BROWN EGGS TRAY 30P,7,360,330,30,1
06-03-2025,"Dry Fruits, Nuts & Seeds",PULMAKHANA 100 GM,2,180,170,10,1
06-03-2025,Snacks & Ready-to-Eat,TILLI CHIKKI,14,25,25,0,5
06-03-2025,Household & Cleaning,GOOD KNIGHT SMALL,6,85,85,0,1
06-03-2025,Milk & Dairy,BROWN EGGS TRAY 30P,7,360,330,30,1
06-03-2025,Personal Care & Cosmetics,DWI GULABA ARKA 60ML,10,30,30,0,1
06-03-2025,"Dry Fruits, Nuts & Seeds",PULMAKHANA 100 GM,2,180,170,10,1
06-03-2025,Household & Cleaning,PITAMBARI SHINING POWDER 200G,6,60,60,0,1
06-03-2025,Snacks & Ready-to-Eat,VD PALLI LADDU,14,80,80,0,1
06-03-2025,Snacks & Ready-to-Eat,DOSA BATTER 1KG,14,60,60,0,1
06-03-2025,Spices & Seasonings,JEERA 250 gms,15,125,105,20,1
06-03-2025,Sweeteners,GS Palm Jaggery Powder 400GM,16,180,180,0,1
06-03-2025,"Grains, Flours & Dals",CHANA DAL 1KG,4,35,30,5,0.25
06-03-2025,Oils & Ghee,Groundnut oil 5 L,9,1800,"1,600.00",200,1
06-03-2025,"Grains, Flours & Dals",HS JOWAR FLAKES 250GM 1+1,4,119,119,0,1
06-03-2025,"Dry Fruits, Nuts & Seeds",YB GRANMA NUTS,2,90,90,0,1
06-03-2025,Milk & Dairy,HERITAGE BUTTERMILK,7,10,10,0,1
06-03-2025,Milk & Dairy,HERITAGE TOTAL CURD 500GM,7,50,50,0,1
06-03-2025,Spices & Seasonings,Tamalapaku Karam Powder 100GM,15,80,80,0,1
06-03-2025,Snacks & Ready-to-Eat,BROWN BREAD,14,55,55,0,1
06-03-2025,Snacks & Ready-to-Eat,SD Thati thandra 200gm,14,150,150,0,1
06-03-2025,Pickles & Cooking Pastes,SD GINGER PICKLE 250GM,11,110,110,0,1
06-03-2025,"Dry Fruits, Nuts & Seeds",Groundnuts 500 gms,2,95,85,10,1
06-03-2025,Snacks & Ready-to-Eat,PN JAGGERY BITES,14,135,135,0,1
06-03-2025,"Grains, Flours & Dals",white Bobarlu 500 gms,4,80,75,5,1
06-03-2025,Snacks & Ready-to-Eat,SATHVI REGIVADA 200GM,14,80,60,20,1
06-03-2025,Spices & Seasonings,SREE MARUTHI IDLY KARAM 200GM,15,60,60,0,1
06-03-2025,Personal Care & Cosmetics,GA DANT MANJAN TP 50GM,10,60,60,0,1
06-03-2025,Household & Cleaning,HERBAL LIZARD REPELLENT 100ML,6,240,240,0,1
06-03-2025,"Grains, Flours & Dals",Wheat Flour 1 kg,4,70,60,10,1
06-03-2025,Household & Cleaning,GOOD KNIGHT,6,105,105,0,1
06-03-2025,Spices & Seasonings,Vamu 100GM,15,60,50,10,1
06-03-2025,"Health, Wellness & Ayurvedic Products",MD Aamlaki Choornam 100GM,5,80,80,0,1
06-03-2025,"Grains, Flours & Dals",SL Idly Rava 1KG,4,65,55,10,1
06-03-2025,Oils & Ghee,Castor oil 200 ml,9,100,80,20,1
06-03-2025,"Grains, Flours & Dals",Red Chana 500 GM,4,150,120,30,2
06-03-2025,"Dry Fruits, Nuts & Seeds",sabja seeds,2,80,70,10,1
06-03-2025,"Grains, Flours & Dals",KORRALU (FOXTAIL M) 500GM,4,65,55,10,1
06-03-2025,"Grains, Flours & Dals",RAGI FLOUR 500GRMS,4,80,70,10,2
06-03-2025,Snacks & Ready-to-Eat,Corn Chips 250GM,14,40,35,5,1
06-03-2025,Oils & Ghee,Groundnut oil 1 L,9,360,330,30,1
06-03-2025,"Grains, Flours & Dals",SINGLE POLISH 1KG,4,65,65,0,1
06-03-2025,"Grains, Flours & Dals",HS JOWAR FLAKES 250GM 1+1,4,119,59.5,59.5,1
06-03-2025,"Grains, Flours & Dals",RICE FLOUR 500 GM,4,35,28,7,1
06-03-2025,Snacks & Ready-to-Eat,VD MULTI CHAKKA,14,110,110,0,1
06-03-2025,"Grains, Flours & Dals",White jowar.F 1 kg,4,200,160,40,2
06-03-2025,Sweeteners,YB FOREST HONEY 250GM,16,180,180,0,1
06-03-2025,Oils & Ghee,GANTASALA A2 COW GHEE 250ML,9,299,299,0,1
06-03-2025,Misc,386627138,8,0,0,0,1
06-03-2025,Oils & Ghee,Coconut oil 500 ml,9,220,200,20,1
06-03-2025,Milk & Dairy,HRITAGE TOTAL CURD 130GM,7,10,10,0,1
06-03-2025,"Grains, Flours & Dals",Wheat Flour 1 kg,4,140,120,20,2
06-03-2025,"Grains, Flours & Dals",THICK POHA 1KG,4,160,140,20,2
06-03-2025,"Grains, Flours & Dals",Wheat Rava S 1KG,4,65,55,10,1
06-03-2025,"Grains, Flours & Dals",BOMBAY RAVA,4,70,55,15,1
06-03-2025,Spices & Seasonings,Tamarind 500GM,15,160,130,30,1
06-03-2025,Spices & Seasonings,Coriander seeds 200 gms,15,48,40,8,1
06-03-2025,Spices & Seasonings,SAJEERA,15,60,40,20,1
06-03-2025,"Grains, Flours & Dals",JOWAR UPMA RAVA,4,65,65,0,1
06-03-2025,Oils & Ghee,OLEEV POMACE OIL 1LTR,9,1100,550,550,1
06-03-2025,Oils & Ghee,Safflower oil 1 L,9,440,400,40,1
06-03-2025,Pooja & Spiritual Items,SWASTIK CAMPHOR 25GM,12,45,45,0,1
06-03-2025,Snacks & Ready-to-Eat,FOXTAIL BIS,14,135,135,0,1
06-03-2025,"Grains, Flours & Dals",Chana Flour 500 gms,4,70,65,5,1
06-03-2025,"Grains, Flours & Dals",KORRALU (FOXTAIL M) 500GM,4,65,55,10,1
06-03-2025,Milk & Dairy,BROWN EGGS 1P,7,84,72,12,6
06-03-2025,Snacks & Ready-to-Eat,urban murmura,14,60,55,5,1
06-03-2025,Pooja & Spiritual Items,PACHA KARPURAM 10GM,12,60,60,0,1
06-03-2025,Spices & Seasonings,BIRYANI LEAF 10GM,15,30,20,10,1
06-03-2025,Personal Care & Cosmetics,GOW DURBAR NAVA 100GM SOAP,10,40,40,0,1
06-03-2025,Oils & Ghee,BUFFALLO GHEE 500ML,9,410,370,40,1
06-03-2025,Household & Cleaning,VIM SOAP,6,50,50,0,10
06-03-2025,Spices & Seasonings,SAJEERA,15,60,40,20,1
06-03-2025,"Grains, Flours & Dals",SL Suji Rava 500GM,4,64,64,0,2
06-03-2025,"Grains, Flours & Dals",Wheat Flour 1 kg,4,70,60,10,1
06-03-2025,"Grains, Flours & Dals",Wheat Rava S 1KG,4,65,55,10,1
06-03-2025,Oils & Ghee,Coconut oil 500 ml,9,220,200,20,1
06-03-2025,Spices & Seasonings,NUVVULU 250GM,15,80,65,15,1
06-03-2025,"Dry Fruits, Nuts & Seeds",SATHVI CHIA SEEDS 100GM,2,100,80,20,1
06-03-2025,"Grains, Flours & Dals",HS JOWAR FLAKES 250GM 1+1,4,119,119,0,1
06-03-2025,"Grains, Flours & Dals",RAJMA 250GM,4,55,45,10,1
06-03-2025,Personal Care & Cosmetics,SEV TULASI SOAP 100GM,10,90,90,0,1
06-03-2025,Oils & Ghee,Sesame oil 500ml,9,295,280,15,1
06-03-2025,"Grains, Flours & Dals",Idly Rava L 1KG,4,60,50,10,1
06-03-2025,Spices & Seasonings,JEERA 250 gms,15,125,105,20,1
06-03-2025,Beverages,TAJ MAHAL 250GM,1,235,235,0,1
06-03-2025,Spices & Seasonings,Masala Karam 500 gms,15,260,240,20,1
06-03-2025,Spices & Seasonings,SATHVI TURMERIC POWDER 500GM,15,180,130,50,1
06-03-2025,Oils & Ghee,Coconut oil 500 ml,9,220,200,20,1
06-03-2025,"Grains, Flours & Dals",MAAGAANI SP RICE 20 KGS,4,2300,"1,960.00",340,1
06-03-2025,Snacks & Ready-to-Eat,VD PALLI LADDU,14,80,80,0,1
06-03-2025,Milk & Dairy,HERITAGE BUTTERMILK,7,10,10,0,1
06-03-2025,Sweeteners,YB Palm Jaggery 250GM,16,200,200,0,1
06-03-2025,"Grains, Flours & Dals",Urad dall 1 Kg,4,185,170,15,1
06-03-2025,"Grains, Flours & Dals",Brown RICE 1KG,4,140,130,10,2
06-03-2025,Milk & Dairy,BROWN EGGS TRAY 30P,7,360,330,30,1
06-03-2025,Oils & Ghee,Groundnut oil 1 L,9,360,330,30,1
06-03-2025,"Health, Wellness & Ayurvedic Products",j s pnature,5,136,136,0,1
06-03-2025,Pooja & Spiritual Items,NAGA SINDHURAM,12,40,40,0,1
06-03-2025,Oils & Ghee,Coconut oil 500 ml,9,440,400,40,2
06-03-2025,Snacks & Ready-to-Eat,ID IDLY DOSA BATTER,14,90,90,0,1
06-03-2025,General Household & Kitchenware,VERMI COMPOST MIX,3,30,30,0,1
06-03-2025,General Household & Kitchenware,BLADE,3,12,12,0,1
06-03-2025,"Grains, Flours & Dals",White jowar.F 1 kg,4,300,240,60,3
06-03-2025,"Grains, Flours & Dals",Chana Flour 500 gms,4,70,65,5,1
06-03-2025,"Grains, Flours & Dals",Wheat Flour 1 kg,4,70,60,10,1
06-03-2025,"Grains, Flours & Dals",Quinova 1 kg,4,220,195,25,1
06-03-2025,Spices & Seasonings,Turmeric powder 250 gms,15,100,75,25,1
06-03-2025,Personal Care & Cosmetics,SVE KHADI ALOEVERA GEL 200GM,10,270,270,0,1
06-03-2025,Snacks & Ready-to-Eat,MB LITTLE MILLET NOODLES 180G,14,95,95,0,1
06-03-2025,"Grains, Flours & Dals",Multigrain 1 kg,4,500,425,75,5
06-03-2025,Spices & Seasonings,Avalu small 250 gms,15,120,80,40,2
06-03-2025,Spices & Seasonings,DURGA SALT CRYSTAL 1KG,15,56,56,0,2
06-03-2025,Spices & Seasonings,Tamarind 500GM,15,320,260,60,2
06-03-2025,Spices & Seasonings,Menthulu 250 gms,15,50,45,5,1
06-03-2025,Snacks & Ready-to-Eat,SD FINGER Millet with palm Jaggery 250gm,14,135,135,0,1
06-03-2025,Oils & Ghee,Groundnut oil 5 L,9,1800,"1,600.00",200,1
06-03-2025,Personal Care & Cosmetics,UVIS MULTANI MITTI PW 100GM,10,49,49,0,1
06-03-2025,"Grains, Flours & Dals",Multigrain 1 kg,4,300,255,45,3
06-03-2025,"Grains, Flours & Dals",Chana Flour 500 gms,4,140,130,10,2
06-03-2025,"Grains, Flours & Dals",Idly Rava L 1KG,4,60,50,10,1
06-03-2025,"Grains, Flours & Dals",White jowar.F 1 kg,4,100,80,20,1
06-03-2025,Baking & Cooking Aids,GONDH 50GRMS,0,50,40,10,1
06-03-2025,Snacks & Ready-to-Eat,ID PAROTA,14,99,99,0,1
06-03-2025,Snacks & Ready-to-Eat,VD PALLI LADDU,14,80,80,0,1
06-03-2025,"Grains, Flours & Dals",turdal 500 gms,4,110,100,10,1
06-03-2025,Oils & Ghee,Groundnut oil 1 L,9,360,330,30,1
06-03-2025,Snacks & Ready-to-Eat,COPRA LADDU 200GM,14,100,80,20,1
06-03-2025,Snacks & Ready-to-Eat,BROWN BREAD,14,55,55,0,1
06-03-2025,Milk & Dairy,BROWN EGGS 1P,7,70,60,10,5
06-03-2025,"Grains, Flours & Dals",Wheat Flour 1 kg,4,70,60,10,1
06-03-2025,"Grains, Flours & Dals",RAGI FLOUR 1KG,4,80,70,10,1
06-03-2025,Snacks & Ready-to-Eat,VD MULTI CHAKKA,14,110,110,0,1
06-03-2025,"Health, Wellness & Ayurvedic Products",RB Nuts& Seeds cashews 35g,5,45,45,0,1
06-03-2025,Sweeteners,SUGAR 1KG,16,120,100,20,2
06-03-2025,"Dry Fruits, Nuts & Seeds",Groundnuts 1 kg,2,190,170,20,1
06-03-2025,"Grains, Flours & Dals",Urad dall 1 Kg,4,370,340,30,2
06-03-2025,Snacks & Ready-to-Eat,VD ARISELU 5 PIC,14,100,100,0,1
06-03-2025,Snacks & Ready-to-Eat,BATANA NGT 70GMS,14,80,80,0,4
06-03-2025,Pooja & Spiritual Items,BLACK DRAGON AGABATHI,12,240,228,12,1
06-03-2025,"Grains, Flours & Dals",VYS.SP.RICE BAG 1,4,1800,"1,650.00",150,1
06-03-2025,Pickles & Cooking Pastes,SD RED CHILLI PICKLE,11,330,330,0,3
06-03-2025,Milk & Dairy,HRITAGE TOTAL CURD 130GM,7,30,30,0,3
06-03-2025,Snacks & Ready-to-Eat,Corn Chips 250GM,14,40,35,5,1
06-03-2025,Snacks & Ready-to-Eat,VD Pappu Chekkalu 190gm,14,60,60,0,1
06-03-2025,Spices & Seasonings,ROYAL SAFFRON 400GRMS,15,65,65,0,1
06-03-2025,"Grains, Flours & Dals",CORN FLOUR,4,80,70,10,1
06-03-2025,"Grains, Flours & Dals",White jowar.F 1 kg,4,100,80,20,1
06-03-2025,"Grains, Flours & Dals",POORI ATTA 500GM,4,35,30,5,1
06-03-2025,Beverages,BRU GREEN LABEL 200G,1,140,140,0,1
06-03-2025,"Grains, Flours & Dals",DESI CHANA,4,25,25,0,1
06-03-2025,"Grains, Flours & Dals",THICK POHA 500GM,4,40,35,5,1
06-03-2025,Baking & Cooking Aids,Baking Soda 50GM,0,20,15,5,1
06-03-2025,"Grains, Flours & Dals",SABDANA 500GM,4,90,70,20,1
06-03-2025,"Grains, Flours & Dals",VGR rice 1 kg,4,350,325,25,5
06-03-2025,Sweeteners,MADHUR SUGAR 1KG,16,65,55,10,1
06-03-2025,"Grains, Flours & Dals",DISANO OATS 1KG,4,285,142.5,142.5,1
06-03-2025,"Dry Fruits, Nuts & Seeds",PUMPKIN SEEDS 250GM,2,200,160,40,1
06-03-2025,"Dry Fruits, Nuts & Seeds",SUNFLOWER SEEDS 250GRM,2,150,130,20,1
06-03-2025,"Dry Fruits, Nuts & Seeds",SATHVI CHIA SEEDS 100GM,2,100,80,20,1
06-03-2025,"Grains, Flours & Dals",HS RAGI FLAKES 250GM 1+1,4,119,59.5,59.5,1
06-03-2025,"Dry Fruits, Nuts & Seeds",ANJEER 250GM,2,400,360,40,1
06-03-2025,"Dry Fruits, Nuts & Seeds",KAJU HALF 250GM,2,310,290,20,1
06-03-2025,"Dry Fruits, Nuts & Seeds",PULMAKHANA 100 GM,2,180,170,10,1
06-03-2025,Snacks & Ready-to-Eat,TILLI CHIKKI,14,35,35,0,7
06-03-2025,"Dry Fruits, Nuts & Seeds",sabja seeds,2,80,70,10,1
06-03-2025,Spices & Seasonings,Menthulu 250 gms,15,50,45,5,1
06-03-2025,"Grains, Flours & Dals",JOWAR UPMA RAVA,4,65,65,0,1
06-03-2025,Oils & Ghee,Groundnut oil 500ml,9,180,165,15,1
06-03-2025,"Dry Fruits, Nuts & Seeds",DIANUTS 500GM,2,120,120,0,1
06-03-2025,Oils & Ghee,Safflower oil 1 L,9,440,400,40,1
06-03-2025,"Grains, Flours & Dals",THICK POHA 500GM,4,40,35,5,1
06-03-2025,Snacks & Ready-to-Eat,NGT CHATPATTA CHANA 90GM,14,25,25,0,1
06-03-2025,Snacks & Ready-to-Eat,VD MANGO JELLY 250GRMS,14,80,80,0,1
06-03-2025,Pickles & Cooking Pastes,SD MIXED VEG,11,110,110,0,1
06-03-2025,Spices & Seasonings,SREE MARUTHI IDLY KARAM 200GM,15,60,60,0,1
06-03-2025,Snacks & Ready-to-Eat,Pani Poori Chips 250GM,14,50,40,10,1
06-03-2025,"Grains, Flours & Dals",Chana Flour 500 gms,4,70,65,5,1
06-03-2025,"Grains, Flours & Dals",SL Suji Rava 500GM,4,32,32,0,1
06-03-2025,Spices & Seasonings,NUVVULU 250GM,15,100,85,15,1
06-03-2025,Personal Care & Cosmetics,GOW DURBAR NAVA 100GM SOAP,10,80,80,0,2
06-03-2025,Snacks & Ready-to-Eat,PEANUT CHIKKI,14,22,22,0,1
06-03-2025,Pooja & Spiritual Items,GOMATHA AGARBATHI,12,75,75,0,1
06-03-2025,Personal Care & Cosmetics,SANTOOR B SOAP,10,62,62,0,1
06-03-2025,Oils & Ghee,Coconut oil 500 ml,9,220,200,20,1
06-03-2025,Milk & Dairy,SANGAM TONED MILK 500ML,7,90,90,0,3
06-03-2025,Snacks & Ready-to-Eat,VD SAGOPAPAD 150GM,14,55,55,0,1
06-03-2025,Snacks & Ready-to-Eat,VD Minapa papad 200gm,14,60,60,0,1
06-03-2025,Snacks & Ready-to-Eat,SF COOKIES CHOCO RAGI,14,99,99,0,1
06-03-2025,Spices & Seasonings,SWEET SOUNF,15,20,20,0,1
06-03-2025,Snacks & Ready-to-Eat,VD DAHI MIRCHI(SALTED) 100GM,14,45,45,0,1
06-03-2025,Snacks & Ready-to-Eat,SD JOWAR WITH PALM JAGGERY 250GM,14,135,135,0,1
06-03-2025,Snacks & Ready-to-Eat,GREEN FRIED batana,14,20,20,0,1
06-03-2025,Oils & Ghee,Sesame oil 500ml,9,295,280,15,1
06-03-2025,Snacks & Ready-to-Eat,COPRA LADDU 200GM,14,100,80,20,1
06-03-2025,Snacks & Ready-to-Eat,SATHVI REGIVADA 200GM,14,80,60,20,1
06-03-2025,"Dry Fruits, Nuts & Seeds",SATHVI CHIA SEEDS 100GM,2,100,80,20,1
06-03-2025,Oils & Ghee,Coconut oil 500 ml,9,220,200,20,1
06-03-2025,"Grains, Flours & Dals",RAJMA 500GM,4,90,90,0,1
06-03-2025,Oils & Ghee,Sesame oil 1 L,9,590,560,30,1
06-03-2025,Personal Care & Cosmetics,VETIVER SOAP 100GM,10,100,100,0,1
06-03-2025,Spices & Seasonings,SAJEERA,15,60,40,20,1
06-03-2025,"Grains, Flours & Dals",Yellow jowar .F1 kg,4,110,100,10,1
06-03-2025,Personal Care & Cosmetics,SVE RED SANDAL SOAP 100GM,10,90,90,0,1
06-03-2025,Spices & Seasonings,DHANIYA POWDER 200GM,15,100,85,15,1
06-03-2025,Oils & Ghee,Groundnut oil 1 L,9,360,330,30,1
06-03-2025,Oils & Ghee,OLIVANA 100ML,9,179,169,10,1
06-03-2025,Oils & Ghee,Groundnut oil 1 L,9,720,660,60,2
06-03-2025,Baking & Cooking Aids,WEIKFIELD CUSTARD POWDER,0,43,43,0,1
06-03-2025,Sweeteners,MADHUR SUGAR 1KG,16,130,110,20,2
06-03-2025,Baking & Cooking Aids,Baking Soda 50GM,0,40,30,10,2
06-03-2025,"Grains, Flours & Dals",Wheat Rava S 1KG,4,65,55,10,1
06-03-2025,Spices & Seasonings,DURGA SALT CRYSTAL 1KG,15,25,25,0,1
06-03-2025,"Grains, Flours & Dals",White jowar.F 1 kg,4,100,80,20,1
06-03-2025,Spices & Seasonings,AVALU 100GM,15,25,20,5,1
06-03-2025,Spices & Seasonings,JEERA 250 gms,15,125,105,20,1
06-03-2025,Spices & Seasonings,DRY MIECHI 200GM,15,80,60,20,1
06-03-2025,"Grains, Flours & Dals",PESARA PAPPU 1 KG,4,170,145,25,1
06-03-2025,General Household & Kitchenware,GOOD HOME,3,70,70,0,7
06-03-2025,Beverages,GEMINI TEA 500GRMS,1,275,275,0,1
06-03-2025,"Dry Fruits, Nuts & Seeds",Groundnuts 1 kg,2,190,170,20,1
06-03-2025,"Grains, Flours & Dals",CHANA DAL 500GM,4,140,120,20,2
06-03-2025,Spices & Seasonings,Coriander seeds 200 gms,15,48,40,8,1
06-03-2025,Spices & Seasonings,Turmeric powder 250 gms,15,100,75,25,1
06-03-2025,Sweeteners,SUGAR 1KG,16,180,150,30,3
06-03-2025,Oils & Ghee,Groundnut oil 1 L,9,1080,990,90,3
06-03-2025,Household & Cleaning,SURF EXCEL QUICK WASH 500GM,6,99,99,0,1
06-03-2025,"Grains, Flours & Dals",turdal 1kg,4,440,390,50,2
06-03-2025,"Grains, Flours & Dals",URAD DALL,4,190,170,20,2
06-03-2025,Household & Cleaning,LIZOL JAQSMINE 500ML,6,232,232,0,2
06-03-2025,Household & Cleaning,vim dish liquid,6,110,110,0,2
06-03-2025,Spices & Seasonings,YB Rock Salt 1KG,15,240,240,0,2
06-03-2025,"Grains, Flours & Dals",Wheat Rava S 1KG,4,65,55,10,1
06-03-2025,Spices & Seasonings,Adithya Salt 1KG,15,25,25,0,1
06-03-2025,"Grains, Flours & Dals",UDALU (Barnyard millet) 500 gms,4,70,60,10,1
06-03-2025,"Grains, Flours & Dals",SAMALU (Little millet) 500 gms,4,170,130,40,2
06-03-2025,Beverages,ASSAM ELAICHI TEA,1,199,199,0,1
06-03-2025,"Health, Wellness & Ayurvedic Products",RAMA BALM 10ML,5,50,50,0,1
06-03-2025,"Dry Fruits, Nuts & Seeds",PUTNALU 500GMS,2,90,76,14,1
06-03-2025,Household & Cleaning,PITAMBARI SHINING POWDER 200G,6,60,60,0,1
06-03-2025,Spices & Seasonings,ROYAL SAFFRON 400GRMS,15,130,130,0,2
06-03-2025,Oils & Ghee,Coconut oil 500 ml,9,220,200,20,1
06-03-2025,Oils & Ghee,Groundnut oil 1 L,9,360,330,30,1
06-03-2025,Sweeteners,YB Brown Sugar 1KG,16,280,280,0,2
06-03-2025,Personal Care & Cosmetics,BIOTIQUE WALNUT VOLUME &BOUNCE,10,99,74.25,24.75,1
06-03-2025,Snacks & Ready-to-Eat,SD Groundnut with palm jaggery 250gm,14,135,135,0,1
06-03-2025,"Grains, Flours & Dals",BASMATHI RICE 1KG,4,150,135,15,1
06-03-2025,Snacks & Ready-to-Eat,BELLAM GHEE SUNIUNDALU 250,14,120,120,0,1
06-03-2025,Snacks & Ready-to-Eat,RB Choco Delite Almonds Raisins 40g,14,45,45,0,1
06-03-2025,"Dry Fruits, Nuts & Seeds",SALTED PISTA 250GM,2,400,350,50,1
06-03-2025,"Grains, Flours & Dals",Sathya Javva Wheat Rava 500GM,4,95,95,0,1
06-03-2025,Snacks & Ready-to-Eat,ELITE ELAICHI RUSK 200GM,14,35,35,0,1
06-03-2025,Snacks & Ready-to-Eat,ELITE MILK RUSK 200GM,14,35,35,0,1
06-03-2025,"Grains, Flours & Dals",UDALU (Barnyard millet) 500 gms,4,70,60,10,1
06-03-2025,Snacks & Ready-to-Eat,SF VERMICELLI,14,139,139,0,1
06-03-2025,General Household & Kitchenware,WOODEN SPOON BIG,3,40,40,0,1
06-03-2025,Snacks & Ready-to-Eat,SS IDLY BATTER 1KG,14,60,60,0,1
06-03-2025,"Grains, Flours & Dals",Idly Rava L 1KG,4,60,50,10,1
06-03-2025,"Grains, Flours & Dals",EM Foxtail idli r 500 g,4,109,109,0,1
06-03-2025,"Grains, Flours & Dals",Brown RICE 1KG,4,35,32.5,2.5,0.5
06-03-2025,"Grains, Flours & Dals",Arikalu (kodo),4,70,65,5,1
06-03-2025,Snacks & Ready-to-Eat,VD Minapa papad 200gm,14,60,60,0,1
06-03-2025,Snacks & Ready-to-Eat,RITEBITE MELTING CHOCOLATE,14,50,50,0,1
06-03-2025,Snacks & Ready-to-Eat,RSC ORANGE 100GMS,14,20,20,0,1
06-03-2025,Spices & Seasonings,Turmeric powder 250 gms,15,100,75,25,1
06-03-2025,"Grains, Flours & Dals",Wheat Flour 1 kg,4,210,180,30,3
06-03-2025,"Grains, Flours & Dals",RICE FLOUR 500 GM,4,35,28,7,1
06-03-2025,"Grains, Flours & Dals",turdal 500 gms,4,110,100,10,1
06-03-2025,Spices & Seasonings,ROYAL SAFFRON,15,125,125,0,1
06-03-2025,"Grains, Flours & Dals",DISANO OATS 1KG,4,285,285,0,1
06-03-2025,"Grains, Flours & Dals",Bombay Rava 500GM,4,35,30,5,1
06-03-2025,Oils & Ghee,Groundnut oil 1 L,9,360,330,30,1
06-03-2025,Sweeteners,YB Brown Sugar 500GM,16,75,75,0,1
06-03-2025,"Grains, Flours & Dals",Green gram 1 kg,4,150,130,20,1
06-03-2025,"Grains, Flours & Dals",White jowar.F 1 kg,4,100,80,20,1
06-03-2025,"Grains, Flours & Dals",Arikalu (kodo),4,70,65,5,1
06-03-2025,Snacks & Ready-to-Eat,BB VERMICELLY 500GM,14,53,53,0,1
06-03-2025,Spices & Seasonings,DRY MIECHI 200GM,15,80,60,20,1
06-03-2025,"Grains, Flours & Dals",SAMALU (Little millet) 500 gms,4,85,65,20,1
06-03-2025,Oils & Ghee,Safflower oil 1 L,9,440,400,40,1
06-03-2025,"Grains, Flours & Dals",Multigrain 1 kg,4,100,85,15,1
06-03-2025,Oils & Ghee,Coconut oil 1 L,9,440,400,40,1
06-03-2025,Spices & Seasonings,pickle chili powder,15,180,165,15,1
06-03-2025,Baking & Cooking Aids,GONDH 50GRMS,0,50,40,10,1
06-03-2025,"Grains, Flours & Dals",POORI ATTA 1KG,4,70,60,10,1
06-03-2025,Snacks & Ready-to-Eat,ANNAPURNA APPALAM,14,35,35,0,1
06-03-2025,Snacks & Ready-to-Eat,RINGS 200GM,14,30,30,0,1
06-03-2025,Spices & Seasonings,Black Till 250GM,15,90,75,15,1
06-03-2025,"Grains, Flours & Dals",Urad dall 1 Kg,4,185,170,15,1
06-03-2025,"Grains, Flours & Dals",white Bobarlu 500 gms,4,80,75,5,1
06-03-2025,"Grains, Flours & Dals",White jowar.F 1 kg,4,100,80,20,1
06-03-2025,Spices & Seasonings,Gasagasalu 50GM,15,130,110,20,1
06-03-2025,Spices & Seasonings,Coriander seeds 200 gms,15,96,80,16,2
06-03-2025,"Grains, Flours & Dals",SA WHITE JOWAR RAVA 500GM,4,69,69,0,1
06-03-2025,"Grains, Flours & Dals",Green gram 500 gms,4,75,70,5,1
06-03-2025,"Grains, Flours & Dals",Wheat Flour 1 kg,4,140,120,20,2
06-03-2025,Spices & Seasonings,GREEN SOUNF,15,120,80,40,2
06-03-2025,"Grains, Flours & Dals",Red Bobarlu 500 gms,4,95,85,10,1
06-03-2025,"Grains, Flours & Dals",Red uluvalu 250 gms,4,45,40,5,1
06-03-2025,"Grains, Flours & Dals",VGR RICE bag 1,4,1899,"1,650.00",249,1
06-03-2025,Spices & Seasonings,Coconut Powder 250GM,15,90,70,20,1
06-03-2025,Oils & Ghee,Groundnut oil 5 L,9,1800,"1,600.00",200,1
06-03-2025,Spices & Seasonings,Coriander seeds 200 gms,15,48,40,8,1
06-03-2025,"Grains, Flours & Dals",Wheat Flour 1 kg,4,210,180,30,3
06-03-2025,Snacks & Ready-to-Eat,NGT CHATPATTA CHANA 90GM,14,50,50,0,2
06-03-2025,Oils & Ghee,Sesame oil 1 L,9,590,560,30,1
06-03-2025,Snacks & Ready-to-Eat,VD NUVULU CHEGODI 175GM,14,60,60,0,1
06-03-2025,Oils & Ghee,Groundnut oil 1 L,9,360,330,30,1
06-03-2025,Pooja & Spiritual Items,bilwa patra,12,60,60,0,1
06-03-2025,Sweeteners,SUGAR 1KG,16,120,100,20,2
06-03-2025,Beverages,BRU GREEN LABEL 1.2G,1,24,24,0,12
06-03-2025,"Grains, Flours & Dals",BOMBAY RAVA,4,70,55,15,1
06-03-2025,"Grains, Flours & Dals",RAGI FLOUR 500GRMS,4,40,35,5,1
06-03-2025,"Dry Fruits, Nuts & Seeds",DRYDATES YELLOW 250GM,2,135,120,15,1
06-03-2025,Pooja & Spiritual Items,SWASTIK CAMPHOR 25GM,12,45,45,0,1
06-03-2025,"Grains, Flours & Dals",VYS.SP.RICE BAG 1,4,1800,"1,650.00",150,1
06-03-2025,Oils & Ghee,Safflower oil 1 L,9,880,800,80,2
06-03-2025,Oils & Ghee,BUFFALLO GHEE 500ML,9,410,370,40,1
06-03-2025,"Grains, Flours & Dals",split black gram 1 kg,4,180,170,10,1
06-03-2025,"Dry Fruits, Nuts & Seeds",Groundnuts 1 kg,2,190,170,20,1
06-03-2025,Oils & Ghee,Sesame oil 1 L,9,1770,"1,680.00",90,3
06-03-2025,Oils & Ghee,Groundnut oil 1 L,9,360,330,30,1
06-03-2025,Oils & Ghee,Groundnut oil 1 L,9,720,660,60,2
06-03-2025,"Grains, Flours & Dals",Wheat Rava M 500GM,4,33,30,3,1
06-03-2025,"Grains, Flours & Dals",SL Idly Rava 1KG,4,195,165,30,3
06-03-2025,"Grains, Flours & Dals",MAATEJA rice 1 kg,4,1080,"1,035.00",45,15
06-03-2025,"Grains, Flours & Dals",idly/Dosa rice 1 kg,4,70,60,10,1
06-03-2025,Sweeteners,YB Brown Sugar 500GM,16,150,150,0,2
06-03-2025,"Grains, Flours & Dals",PESARA PAPPU 500GMS,4,85,75,10,1
06-03-2025,"Grains, Flours & Dals",Wheat Flour 1 kg,4,210,180,30,3
06-03-2025,Milk & Dairy,BROWN EGGS 1P,7,280,240,40,20
05-03-2025,Milk & Dairy,BROWN EGGS TRAY 30P,7,360,330,30,1
05-03-2025,"Dry Fruits, Nuts & Seeds",SD Mango cubes 100gm,2,45,45,0,1
05-03-2025,Snacks & Ready-to-Eat,RAJGIRA PEANUT CHIKKI 450GM,14,125,125,0,1
05-03-2025,Snacks & Ready-to-Eat,VD PALLI CHIKKI,14,80,80,0,1
05-03-2025,Spices & Seasonings,DURGA SALT CRYSTAL 1KG,15,50,50,0,2
05-03-2025,"Grains, Flours & Dals",SABDANA,4,40,35,5,1
05-03-2025,Oils & Ghee,Groundnut oil 1 L,9,360,330,30,1
05-03-2025,"Grains, Flours & Dals",BARLEY SEEDS 1KG,4,80,70,10,0.5
05-03-2025,Spices & Seasonings,ROYAL SAFFRON,15,125,125,0,1
05-03-2025,Oils & Ghee,Groundnut oil 1 L,9,360,330,30,1
05-03-2025,Oils & Ghee,Sesame oil 1 L,9,590,560,30,1
05-03-2025,"Grains, Flours & Dals",Multigrain 1 kg,4,100,85,15,1
05-03-2025,Pooja & Spiritual Items,GD WOODS 150GM,12,110,110,0,1
05-03-2025,"Dry Fruits, Nuts & Seeds",sabja seeds,2,80,70,10,1
05-03-2025,"Dry Fruits, Nuts & Seeds",PULMAKHANA 100 GM,2,180,170,10,1
05-03-2025,"Dry Fruits, Nuts & Seeds",sabja seeds,2,80,70,10,1
05-03-2025,"Grains, Flours & Dals",RAGI FLOUR 500GRMS,4,40,35,5,1
05-03-2025,Oils & Ghee,Groundnut oil 1 L,9,720,660,60,2
05-03-2025,Snacks & Ready-to-Eat,BD LITTLE MILLET NOODLES 200G,14,75,75,0,1
05-03-2025,Snacks & Ready-to-Eat,MILK BREAD,14,55,55,0,1
05-03-2025,Oils & Ghee,Sesame oil 1 L,9,590,560,30,1
05-03-2025,Oils & Ghee,Safflower oil 1 L,9,440,400,40,1
05-03-2025,"Grains, Flours & Dals",DISANO ROLED OATS,4,395,395,0,1
05-03-2025,Spices & Seasonings,RED COPRA 250GMS,15,85,74,11,1
05-03-2025,"Dry Fruits, Nuts & Seeds",PULMAKHANA 100 GM,2,180,170,10,1
05-03-2025,"Dry Fruits, Nuts & Seeds",SUNFLOWER SEEDS 250GRM,2,150,130,20,1
05-03-2025,"Grains, Flours & Dals",RAGI FLOUR 1KG,4,80,70,10,1
05-03-2025,"Dry Fruits, Nuts & Seeds",PUMPKIN SEEDS 250GM,2,200,160,40,1
05-03-2025,"Dry Fruits, Nuts & Seeds",FLAX SEEDS 250GM,2,60,50,10,1
05-03-2025,Oils & Ghee,Groundnut oil 1 L,9,360,330,30,1
05-03-2025,Sweeteners,MADHUR SUGAR 1KG,16,65,55,10,1
05-03-2025,"Grains, Flours & Dals",Green gram 1 kg,4,150,130,20,1
05-03-2025,Spices & Seasonings,Tamarind 500GM,15,160,130,30,1
05-03-2025,"Grains, Flours & Dals",JOWAR WHITE 1 KG,4,160,140,20,2
05-03-2025,Snacks & Ready-to-Eat,SD Aswagandha with palm Jaggery250Gm,14,135,135,0,1
05-03-2025,Snacks & Ready-to-Eat,VD DRY FRUIT PUTHAREKULU,14,120,120,0,1
05-03-2025,"Grains, Flours & Dals",RAGI FLOUR 500GRMS,4,40,35,5,1
05-03-2025,Snacks & Ready-to-Eat,VD GUMMADI CHAKKA,14,130,130,0,1
05-03-2025,"Grains, Flours & Dals",RAGULU 1 KG,4,35,30,5,0.5
05-03-2025,"Grains, Flours & Dals",Multigrain 1 kg,4,200,170,30,2
05-03-2025,"Grains, Flours & Dals",Wheat Flour 1 kg,4,140,120,20,2
05-03-2025,Snacks & Ready-to-Eat,MB SORGHUM NOODLES 180GM,14,190,190,0,2
05-03-2025,Oils & Ghee,Groundnut oil 1 L,9,360,330,30,1
05-03-2025,Beverages,GANTASALA GREEN TEA 100GM,1,149,149,0,1
05-03-2025,"Dry Fruits, Nuts & Seeds",PUMPKIN SEEDS 250GM,2,200,160,40,1
05-03-2025,Snacks & Ready-to-Eat,SD Atreyapuram DRY Fruit ghee,14,150,150,0,1
05-03-2025,Sweeteners,NATURAL HONEY 1KG,16,560,480,80,1
05-03-2025,"Grains, Flours & Dals",PESARA PAPPU 500GMS,4,85,75,10,1
05-03-2025,"Dry Fruits, Nuts & Seeds",PLAIN PISTA 250GM,2,660,550,110,1
05-03-2025,"Dry Fruits, Nuts & Seeds",SUNFLOWER SEEDS 250GRM,2,150,130,20,1
05-03-2025,Personal Care & Cosmetics,aleova soap,10,90,90,0,1
05-03-2025,"Dry Fruits, Nuts & Seeds",ANJEER 250GM,2,400,360,40,1
05-03-2025,Snacks & Ready-to-Eat,JUNNU POWDER 100GM,14,70,70,0,1
05-03-2025,"Grains, Flours & Dals",Multigrain 1 kg,4,100,85,15,1
05-03-2025,"Dry Fruits, Nuts & Seeds",BLACK KISMIS 250GM,2,175,140,35,1
05-03-2025,"Grains, Flours & Dals",Brown RICE 1KG,4,70,65,5,1
05-03-2025,"Dry Fruits, Nuts & Seeds",WALLNUTS 250GM,2,290,290,0,1
05-03-2025,Snacks & Ready-to-Eat,VD Pappu Chekkalu 190gm,14,60,60,0,1
05-03-2025,Snacks & Ready-to-Eat,VD BOONDI 175GM,14,60,60,0,1
05-03-2025,Snacks & Ready-to-Eat,VD NUVULU CHEGODI 175GM,14,60,60,0,1
05-03-2025,Snacks & Ready-to-Eat,PEANUT CHIKKI,14,88,88,0,4
05-03-2025,Beverages,GANTASALA GREEN TEA 100GM,1,149,149,0,1
05-03-2025,"Grains, Flours & Dals",RAJMA 250GM,4,55,45,10,1
05-03-2025,"Health, Wellness & Ayurvedic Products",AMLAMRUT AMLA MASALA CANDY,5,95,95,0,1
05-03-2025,Snacks & Ready-to-Eat,VD VAMUPUSA 175GM,14,60,60,0,1
05-03-2025,Snacks & Ready-to-Eat,VD MURUKU 175GM,14,60,60,0,1
05-03-2025,Snacks & Ready-to-Eat,SD DrybFruit LADDU WITH DATES 175GM,14,170,170,0,1
05-03-2025,"Grains, Flours & Dals",PESARA PAPPU 500GMS,4,85,75,10,1
05-03-2025,Spices & Seasonings,YB Rock Salt 1KG,15,120,120,0,1
05-03-2025,Spices & Seasonings,DURGA SALT CRYSTAL 1KG,15,28,28,0,1
05-03-2025,Oils & Ghee,Groundnut oil 1 L,9,360,330,30,1
05-03-2025,Oils & Ghee,Groundnut oil 5 L,9,1800,"1,600.00",200,1
05-03-2025,"Grains, Flours & Dals",SINGLE POLISH 1KG,4,130,130,0,2
05-03-2025,"Grains, Flours & Dals",DOCTOR RICE DIABETIC SFR 1KG,4,120,120,0,1
05-03-2025,"Grains, Flours & Dals",ANDU KORRALU (Brown top .mlt) 500,4,130,110,20,1
05-03-2025,"Grains, Flours & Dals",SAMALU (Little millet) 500 gms,4,85,65,20,1
05-03-2025,Snacks & Ready-to-Eat,SD JOWAR WITH PALM JAGGERY 250GM,14,135,135,0,1
05-03-2025,"Grains, Flours & Dals",KORRALU (FOXTAIL M) 500GM,4,65,55,10,1
05-03-2025,"Grains, Flours & Dals",Quinova 500 gms,4,110,100,10,1
05-03-2025,Sweeteners,YB Brown Sugar 500GM,16,75,75,0,1
05-03-2025,"Grains, Flours & Dals",Arikalu (kodo),4,70,65,5,1
05-03-2025,"Grains, Flours & Dals",AISHWARYA SP 1KG,4,240,210,30,3
05-03-2025,Spices & Seasonings,DURGA SALT CRYSTAL 1KG,15,56,56,0,2
05-03-2025,Spices & Seasonings,DRY MIECHI 200GM,15,160,120,40,2
05-03-2025,Oils & Ghee,Castor oil 200 ml,9,100,80,20,1
05-03-2025,Oils & Ghee,Groundnut oil 5 L,9,1800,"1,600.00",200,1
05-03-2025,Oils & Ghee,Coconut oil 500 ml,9,220,200,20,1
05-03-2025,Milk & Dairy,BROWN EGGS 1P,7,84,72,12,6
05-03-2025,Spices & Seasonings,PRO ORG CORIANDER WHOLE 100G,15,70,70,0,1
05-03-2025,Oils & Ghee,Coconut oil 1 L,9,440,400,40,1
05-03-2025,Snacks & Ready-to-Eat,CHOCO BROWINE,14,20,20,0,1
05-03-2025,Spices & Seasonings,Miriyalu 50GM,15,100,80,20,1
05-03-2025,"Grains, Flours & Dals",VGR rice 1 kg,4,70,65,5,1
05-03-2025,Spices & Seasonings,SH MUSTARD 100GM,15,30,30,0,1
05-03-2025,"Grains, Flours & Dals",turdal 1kg,4,220,195,25,1
05-03-2025,Household & Cleaning,vim small,6,15,15,0,1
05-03-2025,Snacks & Ready-to-Eat,VD MURMURA LADDU,14,50,50,0,1
05-03-2025,Snacks & Ready-to-Eat,BATANA NGT 70GMS,14,20,20,0,1
05-03-2025,Milk & Dairy,SANGAM CURD 450GM,7,38,38,0,1
05-03-2025,"Grains, Flours & Dals",Wheat Flour 1 kg,4,70,60,10,1
05-03-2025,Snacks & Ready-to-Eat,TILLI CHIKKI,14,20,20,0,4
05-03-2025,"Grains, Flours & Dals",AISHWARYA SP 1KG,4,400,350,50,5
05-03-2025,Snacks & Ready-to-Eat,RSC ORANGE 100GMS,14,20,20,0,1
05-03-2025,Spices & Seasonings,DRY MANGO POWDER,15,45,45,0,1
05-03-2025,Spices & Seasonings,Menthulu 250 gms,15,50,45,5,1
05-03-2025,Sweeteners,PN ORGANIC JAGGERY POWDER 400GM,16,86,86,0,1
05-03-2025,Oils & Ghee,A2 BUFFALO GHEE 250ML,9,299,299,0,1
05-03-2025,Household & Cleaning,LIZOL JAQSMINE 500ML,6,116,116,0,1
05-03-2025,Sweeteners,YB JAGGERY POWDER 500GMS,16,75,75,0,1
05-03-2025,"Grains, Flours & Dals",Wheat Flour 1 kg,4,140,120,20,2
05-03-2025,"Grains, Flours & Dals",SABDANA 500GM,4,90,70,20,1
05-03-2025,Snacks & Ready-to-Eat,Corn Chips 250GM,14,80,70,10,2
05-03-2025,Sweeteners,YB JAGGERY POWDER 500GMS,16,150,150,0,2
05-03-2025,Spices & Seasonings,YB Rock Salt 1KG,15,120,120,0,1
05-03-2025,Oils & Ghee,GANTASALA A2 COW GHEE 500ML,9,550,550,0,1
05-03-2025,Oils & Ghee,Coconut oil 500 ml,9,220,200,20,1
05-03-2025,Spices & Seasonings,Chilli powder 500 gms,15,290,210,80,1
05-03-2025,Personal Care & Cosmetics,ORGANIC SPONGE LOOFAH,10,70,70,0,1
05-03-2025,Spices & Seasonings,DURGA SALT CRYSTAL 1KG,15,25,25,0,1
05-03-2025,Household & Cleaning,ROOPERI PITAMBARI SILVER 50ML,6,110,110,0,1
05-03-2025,"Grains, Flours & Dals",AISHWARYA RICE RAVA SP 500GRMS,4,60,42,18,1
05-03-2025,Baking & Cooking Aids,GONDH 50GRMS,0,100,80,20,2
05-03-2025,Oils & Ghee,Black Sesame oil 1 L,9,440,380,60,1
05-03-2025,Snacks & Ready-to-Eat,CHOCO BROWINE,14,20,20,0,1
05-03-2025,Snacks & Ready-to-Eat,RSC ORANGE 100GMS,14,20,20,0,1
05-03-2025,Snacks & Ready-to-Eat,RINGS 200GM,14,30,30,0,1
05-03-2025,Snacks & Ready-to-Eat,VD GUMMADI VADIYAM,14,75,75,0,1
05-03-2025,"Grains, Flours & Dals",SPLIT BLACK GRAM 500 GM,4,90,85,5,1
05-03-2025,"Dry Fruits, Nuts & Seeds",Groundnuts 500 gms,2,95,85,10,1
05-03-2025,Spices & Seasonings,AVALU 100GM,15,25,20,5,1
05-03-2025,Snacks & Ready-to-Eat,MARMURA LADDU,14,80,60,20,1
05-03-2025,"Dry Fruits, Nuts & Seeds",PUTNALU 500GMS,2,90,76,14,1
05-03-2025,Personal Care & Cosmetics,MYSORE SANDAL,10,69,69,0,1
05-03-2025,Personal Care & Cosmetics,KHADI ACTIVATED CHARCOAL SOAP,10,80,80,0,1
05-03-2025,Spices & Seasonings,DURGA SALT CRYSTAL 1KG,15,25,25,0,1
05-03-2025,Spices & Seasonings,DHANIYA POWDER 200GM,15,100,85,15,1
05-03-2025,"Grains, Flours & Dals",RAJMA 250GM,4,55,45,10,1
05-03-2025,"Grains, Flours & Dals",PRO ORG MEDIUM POHA 500G,4,78,78,0,1
05-03-2025,Household & Cleaning,SURF EXCEL MATIC FL 1L,6,250,250,0,1
05-03-2025,Beverages,TAJ MAHAL 100GM,1,95,95,0,1
05-03-2025,General Household & Kitchenware,MATCH BOX,3,20,20,0,1
05-03-2025,"Grains, Flours & Dals",Bombay Rava 500GM,4,35,30,5,1
05-03-2025,"Grains, Flours & Dals",SL Idly Rava 1KG,4,65,55,10,1
05-03-2025,Snacks & Ready-to-Eat,COPRA LADDU 200GM,14,100,80,20,1
05-03-2025,"Grains, Flours & Dals",Wheat Rava M 500GM,4,33,30,3,1
05-03-2025,Snacks & Ready-to-Eat,BB VERMICELLI 250GM,14,30,30,0,1
05-03-2025,"Grains, Flours & Dals",RAGI FLOUR 500GRMS,4,40,35,5,1
05-03-2025,"Grains, Flours & Dals",Multigrain 1 kg,4,100,85,15,1
05-03-2025,Spices & Seasonings,YB Rock Salt 1KG,15,120,120,0,1
05-03-2025,Spices & Seasonings,Jeera 100GM,15,50,45,5,1
05-03-2025,"Grains, Flours & Dals",DH URAD GOTA 1KG,4,215,190,25,1
05-03-2025,Oils & Ghee,Coconut oil 1 L,9,440,400,40,1
05-03-2025,"Dry Fruits, Nuts & Seeds",SATHVI CHIA SEEDS 100GM,2,100,80,20,1
05-03-2025,Spices & Seasonings,Elaichi 25GM,15,145,120,25,1
05-03-2025,Spices & Seasonings,YB Rock Salt 1KG,15,120,120,0,1
05-03-2025,Milk & Dairy,HERITAGE TONED MILK 500ML,7,31,31,0,1
05-03-2025,"Grains, Flours & Dals",split green gram 1 kg,4,300,280,20,2
05-03-2025,"Grains, Flours & Dals",Red uluvalu 250 gms,4,45,40,5,1
05-03-2025,Pooja & Spiritual Items,GD Aiswarya Deepam 700ML,12,195,195,0,1
05-03-2025,"Grains, Flours & Dals",HS JOWAR IDLY RAWA,4,325,325,0,5
05-03-2025,"Grains, Flours & Dals",SA YELLOW JOWAR RAVA 500GM,4,190,190,0,2
05-03-2025,"Grains, Flours & Dals",Brown RICE 1KG,4,140,130,10,2
05-03-2025,"Grains, Flours & Dals",RAGI FLOUR 1KG,4,160,140,20,2
05-03-2025,Oils & Ghee,GROUNDNUT OIL 1KG,9,1225,"1,225.00",0,3.5
05-03-2025,"Grains, Flours & Dals",RAGI FLOUR 500GRMS,4,40,35,5,1
05-03-2025,"Health, Wellness & Ayurvedic Products",MD Mandara Leaf Powder 50GM,5,100,100,0,1
05-03-2025,"Grains, Flours & Dals",Multigrain 1 kg,4,100,85,15,1
05-03-2025,"Health, Wellness & Ayurvedic Products",MD Fenugreek Choornam 100GM,5,80,80,0,1
05-03-2025,Oils & Ghee,Groundnut oil 500ml,9,180,165,15,1
05-03-2025,General Household & Kitchenware,SABEENA,3,15,15,0,1
05-03-2025,Sweeteners,YB Brown Sugar 1KG,16,280,280,0,2
05-03-2025,"Dry Fruits, Nuts & Seeds",PUMPKIN SEEDS 250GM,2,200,160,40,1
05-03-2025,"Grains, Flours & Dals",Red uluvalu 500 gms,4,90,75,15,1
05-03-2025,"Dry Fruits, Nuts & Seeds",FLAX SEEDS 250GM,2,60,50,10,1
05-03-2025,Spices & Seasonings,NUVVULU 250GM,15,100,85,15,1
05-03-2025,"Dry Fruits, Nuts & Seeds",WATERMELON SEEDS 250GRM,2,640,560,80,2
05-03-2025,"Grains, Flours & Dals",RAGI FLOUR 1KG,4,80,70,10,1
05-03-2025,Beverages,REFRESH SHARBATH NORMAL,1,199,190,9,1
05-03-2025,Oils & Ghee,Black Sesame oil 1 L,9,440,380,60,1
05-03-2025,Sweeteners,GS JAGGERY NUGGETS 500GM,16,120,120,0,1
05-03-2025,"Health, Wellness & Ayurvedic Products",VAMU WATER,5,99,99,0,1
05-03-2025,Milk & Dairy,SANGAM FULL CREAM MILK 500ML,7,76,76,0,2
05-03-2025,Spices & Seasonings,NUVVULU 250GM,15,160,130,30,2
05-03-2025,Spices & Seasonings,YB Rock Salt 1KG,15,120,120,0,1
05-03-2025,Personal Care & Cosmetics,NEEM COMB,10,99,99,0,1
05-03-2025,Sweeteners,GS Palm Jaggery Powder 400GM,16,68,68,0,1
05-03-2025,Snacks & Ready-to-Eat,JUNNU POWDER 100GM,14,140,140,0,2
05-03-2025,"Dry Fruits, Nuts & Seeds",SUNFLOWER SEEDS 250GRM,2,150,130,20,1
05-03-2025,"Health, Wellness & Ayurvedic Products",RB Max Protein Choco chips 55gm,5,50,50,0,1
05-03-2025,"Dry Fruits, Nuts & Seeds",PUTNALU 500GMS,2,90,76,14,1
05-03-2025,"Dry Fruits, Nuts & Seeds",PULMAKHANA 100 GM,2,360,340,20,2
05-03-2025,Milk & Dairy,SANGAM TONED MILK 500ML,7,60,60,0,2
05-03-2025,Snacks & Ready-to-Eat,VD SAGOPAPAD 150GM,14,110,110,0,2
05-03-2025,"Dry Fruits, Nuts & Seeds",Groundnuts 1 kg,2,190,170,20,1
05-03-2025,General Household & Kitchenware,CLAY JUG J1,3,265,251.75,13.25,1
05-03-2025,Snacks & Ready-to-Eat,Popcorn Seeds 250GM,14,45,40,5,1
05-03-2025,Sweeteners,SUGAR 500 GM,16,30,25,5,1
05-03-2025,Oils & Ghee,Freedom Rice Bran Oil 1L,9,194,180,14,1
05-03-2025,"Grains, Flours & Dals",UDALU (Barnyard millet) 1 kg,4,210,172.5,37.5,1.5
05-03-2025,"Grains, Flours & Dals",WHEAT 1 KG,4,60,50,10,1
05-03-2025,"Grains, Flours & Dals",Red uluvalu 250 gms,4,45,40,5,1
05-03-2025,"Grains, Flours & Dals",RAGULU 1 KG,4,140,120,20,2
05-03-2025,"Grains, Flours & Dals",URAD DALL,4,95,85,10,1
05-03-2025,Pickles & Cooking Pastes,SD RED CHILLI PICKLE,11,330,330,0,3
05-03-2025,Oils & Ghee,GANTASALA A2 COW GHEE 500ML,9,550,550,0,1
05-03-2025,Sweeteners,SD DrybFruit Honey 500GM,16,550,550,0,1
05-03-2025,Milk & Dairy,SANGAM TONED MILK 500ML,7,60,60,0,2
05-03-2025,Snacks & Ready-to-Eat,VD Pappu Chekkalu 190gm,14,60,60,0,1
05-03-2025,Snacks & Ready-to-Eat,VD MIXTURE 175 GM,14,60,60,0,1
05-03-2025,Spices & Seasonings,Tamarind 250GMS,15,80,65,15,1
05-03-2025,Personal Care & Cosmetics,DETTOL 50ML,10,154,154,0,1
05-03-2025,Sweeteners,SUGAR 1KG,16,60,50,10,1
05-03-2025,Spices & Seasonings,ROYAL SAFFRON 400GRMS,15,65,65,0,1
05-03-2025,"Grains, Flours & Dals",THICK POHA 1KG,4,80,70,10,1
05-03-2025,"Grains, Flours & Dals",RAGI FLOUR 500GRMS,4,40,35,5,1
05-03-2025,"Grains, Flours & Dals",White jowar.F 1 kg,4,100,80,20,1
05-03-2025,Oils & Ghee,OLEEV POMACE OIL 1LTR,9,1100,550,550,1
05-03-2025,"Grains, Flours & Dals",Yellow jowar.F 500 gms,4,55,50,5,1
05-03-2025,"Grains, Flours & Dals",SA WHITE JOWAR RAVA 500GM,4,69,69,0,1
05-03-2025,Spices & Seasonings,Turmeric powder 250 gms,15,100,75,25,1
05-03-2025,"Grains, Flours & Dals",RAGI FLOUR 500GRMS,4,40,35,5,1
05-03-2025,Snacks & Ready-to-Eat,Corn Chips 250GM,14,40,35,5,1
05-03-2025,"Grains, Flours & Dals",PESARA PAPPU 500GMS,4,85,75,10,1
05-03-2025,Spices & Seasonings,NUVVULU 250GM,15,80,65,15,1
05-03-2025,Snacks & Ready-to-Eat,SF NOODLES CLKASSIC MASALA,14,129,129,0,1
05-03-2025,"Grains, Flours & Dals",SABDANA,4,40,35,5,1
05-03-2025,"Grains, Flours & Dals",RAGI FLOUR 1KG,4,80,70,10,1
05-03-2025,Oils & Ghee,Groundnut oil 1 L,9,360,330,30,1
05-03-2025,"Dry Fruits, Nuts & Seeds",SALTED PISTA 250GM,2,400,350,50,1
05-03-2025,Oils & Ghee,Sesame oil 1 L,9,590,560,30,1
05-03-2025,Oils & Ghee,Safflower oil 1 L,9,440,400,40,1
05-03-2025,Sweeteners,GS Palm Jaggery Powder 400GM,16,180,180,0,1
05-03-2025,"Grains, Flours & Dals",RAGULU 1 KG,4,35,30,5,0.5
05-03-2025,"Grains, Flours & Dals",JOWAR YELLOW 1 K,4,50,45,5,0.5
05-03-2025,"Grains, Flours & Dals",BAJRA 1 KG,4,30,25,5,0.5
05-03-2025,Sweeteners,YB JAGGERY POWDER 1KG,16,140,140,0,1
05-03-2025,"Grains, Flours & Dals",White jowar.F 1 kg,4,200,160,40,2
05-03-2025,Oils & Ghee,Sesame oil 1 L,9,590,560,30,1
05-03-2025,Oils & Ghee,Safflower oil 1 L,9,440,400,40,1
05-03-2025,Oils & Ghee,Coconut oil 1 L,9,440,400,40,1
05-03-2025,Oils & Ghee,Groundnut oil 1 L,9,720,660,60,2
05-03-2025,General Household & Kitchenware,WOODEN SPOON BIG,3,40,40,0,1
05-03-2025,Oils & Ghee,Groundnut oil 1 L,9,360,330,30,1
05-03-2025,Household & Cleaning,vim small,6,15,15,0,1
05-03-2025,Sweeteners,MADHUR SUGAR 1KG,16,65,55,10,1
05-03-2025,Pooja & Spiritual Items,GD Bhagavatha Mallika 75GM,12,60,60,0,1
05-03-2025,Spices & Seasonings,BIRYANI LEAF 10GM,15,30,20,10,1
05-03-2025,Sweeteners,GS JAGGERY NUGGETS 500GM,16,120,120,0,1
05-03-2025,Household & Cleaning,VIM SOAP,6,30,30,0,6
05-03-2025,"Grains, Flours & Dals",CHANA DAL 500GM,4,70,60,10,1
05-03-2025,Spices & Seasonings,Coriander seeds 200 gms,15,96,80,16,2
05-03-2025,Spices & Seasonings,Menthulu 250 gms,15,50,45,5,1
05-03-2025,Spices & Seasonings,Gasagasalu 50GM,15,130,110,20,1
05-03-2025,"Grains, Flours & Dals",split urad dall 250 gms,4,45,40,5,1
05-03-2025,General Household & Kitchenware,SABEENA,3,30,30,0,1
05-03-2025,Spices & Seasonings,Jeera 100GM,15,50,45,5,1
05-03-2025,Spices & Seasonings,Avalu small 250 gms,15,60,40,20,1
05-03-2025,Spices & Seasonings,Elaichi 25GM,15,145,120,25,1
05-03-2025,"Grains, Flours & Dals",SRILATHA RICE RAVVA 500GM,4,35,35,0,1
05-03-2025,"Grains, Flours & Dals",MAATEJA rice 5 kg,4,360,345,15,1
05-03-2025,"Grains, Flours & Dals",SINGLE POLISH 1KG,4,130,130,0,2
05-03-2025,Snacks & Ready-to-Eat,VD BELLAM GAVVALU 200GM,14,60,60,0,1
05-03-2025,Snacks & Ready-to-Eat,NGT CHATPATTA CHANA 90GM,14,25,25,0,1
05-03-2025,"Dry Fruits, Nuts & Seeds",ANJEER 250GM,2,400,360,40,1
05-03-2025,"Dry Fruits, Nuts & Seeds",CASHEW 250GM,2,340,310,30,1
05-03-2025,"Dry Fruits, Nuts & Seeds",YELLOW KISHMISH 250GM,2,130,110,20,1
05-03-2025,"Grains, Flours & Dals",Urad dall 1 Kg,4,370,340,30,2
05-03-2025,"Dry Fruits, Nuts & Seeds",Groundnuts 1 kg,2,190,170,20,1
05-03-2025,Spices & Seasonings,Coriander seeds 200 gms,15,48,40,8,1
05-03-2025,Spices & Seasonings,ROYAL SAFFRON 400GRMS,15,65,65,0,1
05-03-2025,Oils & Ghee,Groundnut oil 5 L,9,1800,"1,600.00",200,1
05-03-2025,Household & Cleaning,ODOMOS,6,32,32,0,1
05-03-2025,"Grains, Flours & Dals",Wheat Flour 1 kg,4,70,60,10,1
05-03-2025,"Grains, Flours & Dals",Wheat Flour 1 kg,4,70,60,10,1
05-03-2025,Spices & Seasonings,JEERA 250 gms,15,125,105,20,1
05-03-2025,"Grains, Flours & Dals",FLOUR CHARGE,4,38.4,38.4,0,3.2
05-03-2025,Oils & Ghee,Groundnut oil 1 L,9,360,330,30,1
05-03-2025,Personal Care & Cosmetics,DWI NEEM TULSI SOAP 100GM,10,75,75,0,1
05-03-2025,Personal Care & Cosmetics,SANTOOR,10,120,100,20,1
05-03-2025,Personal Care & Cosmetics,COLGATE ACTIVE SALT,10,20,20,0,1
05-03-2025,Oils & Ghee,Freedom Rice Bran Oil 1L,9,388,360,28,2
05-03-2025,Spices & Seasonings,AV Iodized Salt 1KG,15,28,25,3,1
05-03-2025,"Grains, Flours & Dals",PESARA PAPPU 500GMS,4,85,75,10,1
05-03-2025,Personal Care & Cosmetics,MESWAK 100GM,10,70,70,0,1
05-03-2025,"Grains, Flours & Dals",Wheat Flour 1 kg,4,70,60,10,1
05-03-2025,Spices & Seasonings,Turmeric powder 250 gms,15,100,75,25,1
05-03-2025,Personal Care & Cosmetics,DETTOL 50ML,10,154,154,0,1
05-03-2025,Sweeteners,GS A2 Buffalo Ghee 500ML,16,550,550,0,1
05-03-2025,Spices & Seasonings,ROYAL SAFFRON 400GRMS,15,65,65,0,1
05-03-2025,"Dry Fruits, Nuts & Seeds",CASHEW 250GM,2,340,310,30,1
05-03-2025,"Grains, Flours & Dals",split green gram 500 gms,4,75,70,5,1
05-03-2025,Snacks & Ready-to-Eat,KURNOOL MARMURA,14,70,55,15,1
05-03-2025,"Dry Fruits, Nuts & Seeds",Groundnuts 1 kg,2,190,170,20,1
05-03-2025,Snacks & Ready-to-Eat,SF COOKIES CHOCO RAGI,14,99,99,0,1
05-03-2025,"Grains, Flours & Dals",Chana Flour 500 gms,4,70,65,5,1
05-03-2025,"Grains, Flours & Dals",Yellow jowar .F1 kg,4,330,300,30,3
05-03-2025,Spices & Seasonings,Turmeric powder 250 gms,15,100,75,25,1
05-03-2025,"Grains, Flours & Dals",RICE FLOUR 1KG,4,140,110,30,2
05-03-2025,"Grains, Flours & Dals",Bajra Flour 1 kg,4,70,60,10,1
05-03-2025,Spices & Seasonings,Masala Karam 250 gms,15,130,120,10,1
05-03-2025,Spices & Seasonings,Chilli powder 500 gms,15,290,210,80,1
05-03-2025,Spices & Seasonings,Jeera 100GM,15,50,45,5,1
05-03-2025,Spices & Seasonings,GS Pink Rock Salt 1KG,15,120,120,0,1
05-03-2025,"Dry Fruits, Nuts & Seeds",PUTNALU 500GMS,2,180,152,28,2
05-03-2025,"Grains, Flours & Dals",HS JOWAR FLAKES 250GM 1+1,4,119,119,0,1
05-03-2025,Service,WALNUT OIL GRINDING CHRGES,13,700,560,140,1
05-03-2025,Sweeteners,KAMAL JAGGERY 500GM,16,80,80,0,2
05-03-2025,"Dry Fruits, Nuts & Seeds",WALNUT ROUND 250GM,2,320,280,40,1
05-03-2025,"Grains, Flours & Dals",White jowar.F 1 kg,4,100,80,20,1
05-03-2025,"Grains, Flours & Dals",HS JOWAR IDLY RAWA,4,65,65,0,1
05-03-2025,Spices & Seasonings,SATHVI TURMERIC POWDER 500GM,15,180,130,50,1
05-03-2025,"Grains, Flours & Dals",RAGI FLOUR 500GRMS,4,40,35,5,1
05-03-2025,Spices & Seasonings,Chilli powder 1 kg,15,580,420,160,1
05-03-2025,Oils & Ghee,BUFFALLO GHEE 500ML,9,410,370,40,1
05-03-2025,Oils & Ghee,Castor oil 200 ml,9,100,80,20,1
05-03-2025,Spices & Seasonings,RED COPRA 500GM,15,170,148,22,1
05-03-2025,Spices & Seasonings,RED COPRA 250GMS,15,85,74,11,1
05-03-2025,"Grains, Flours & Dals",Wheat Flour 1 kg,4,350,300,50,5
05-03-2025,Spices & Seasonings,RED COPRA 500GM,15,170,148,22,1
05-03-2025,"Dry Fruits, Nuts & Seeds",SD Mango cubes 200gm,2,90,90,0,1
05-03-2025,Snacks & Ready-to-Eat,BELLAM MINAPA SUNADULLU,14,180,180,0,1
05-03-2025,Snacks & Ready-to-Eat,PALLI LADDU 200GMS,14,180,140,40,2
05-03-2025,Spices & Seasonings,Chilli powder 500 gms,15,290,210,80,1
05-03-2025,Snacks & Ready-to-Eat,VD CORNFLAKES MIXTURE 175GM,14,60,60,0,1
05-03-2025,Snacks & Ready-to-Eat,VD CORNFLAKES MIXTURE 175GM,14,60,60,0,1
05-03-2025,Snacks & Ready-to-Eat,VD MURUKU 175GM,14,60,60,0,1
05-03-2025,Sweeteners,YB JAGGERY POWDER 1KG,16,280,280,0,2
05-03-2025,Oils & Ghee,Groundnut oil 1 L,9,720,660,60,2
05-03-2025,"Grains, Flours & Dals",SINGLE POLISH 1KG,4,325,325,0,5
05-03-2025,Snacks & Ready-to-Eat,VD BELLAM GAVVALU 200GM,14,60,60,0,1
05-03-2025,Snacks & Ready-to-Eat,SF MIGHTY PUFFS,14,25,25,0,1
05-03-2025,"Grains, Flours & Dals",SABDANA,4,40,35,5,1
05-03-2025,Snacks & Ready-to-Eat,Pani Poori Chips 250GM,14,50,40,10,1
05-03-2025,Spices & Seasonings,AVALU 100GM,15,25,20,5,1
05-03-2025,"Grains, Flours & Dals",BARLEY SEEDS 250GMS,4,40,35,5,1
05-03-2025,Snacks & Ready-to-Eat,VD PALLI CHIKKI,14,80,80,0,1
05-03-2025,"Health, Wellness & Ayurvedic Products",VITAMIN C,5,125,125,0,1
05-03-2025,Snacks & Ready-to-Eat,VD SAGOPAPAD 150GM,14,55,55,0,1
05-03-2025,Personal Care & Cosmetics,Khadi Shikakai With Amla Shampoo 200,10,199,199,0,1
05-03-2025,"Grains, Flours & Dals",Wheat Flour 1 kg,4,210,180,30,3
05-03-2025,Spices & Seasonings,EVEREST PANI PURI MASALA 50GM,15,40,40,0,1
05-03-2025,Snacks & Ready-to-Eat,SATHVI REGIVADA 200GM,14,80,60,20,1
05-03-2025,Oils & Ghee,Groundnut oil 1 L,9,1440,"1,320.00",120,4
05-03-2025,Sweeteners,MADHUR SUGAR 1KG,16,65,55,10,1
05-03-2025,Spices & Seasonings,Jeera 100GM,15,50,45,5,1
05-03-2025,"Grains, Flours & Dals",PESARA PAPPU 500GMS,4,85,75,10,1
05-03-2025,Snacks & Ready-to-Eat,BB VERMICELLY 500GM,14,53,53,0,1
05-03-2025,Spices & Seasonings,Gasagasalu 50GM,15,130,110,20,1
05-03-2025,Spices & Seasonings,RED COPRA 250GMS,15,85,74,11,1
05-03-2025,"Grains, Flours & Dals",Idly Rava L 1KG,4,120,100,20,2
05-03-2025,"Grains, Flours & Dals",Urad dall 1 Kg,4,370,340,30,2
05-03-2025,Spices & Seasonings,SAJEERA,15,60,40,20,1
05-03-2025,Spices & Seasonings,ROYAL SAFFRON 400GRMS,15,65,65,0,1
05-03-2025,Sweeteners,SUGAR 1KG,16,60,50,10,1
05-03-2025,General Household & Kitchenware,GOOD HOME,3,15,15,0,1
05-03-2025,"Grains, Flours & Dals",Idly Rava L 1KG,4,60,50,10,1
05-03-2025,Personal Care & Cosmetics,BLACK NATURALS,10,42,42,0,1
05-03-2025,Oils & Ghee,Freedom Rice Bran Oil 1L,9,194,180,14,1
05-03-2025,Sweeteners,MISHRI D,16,40,30,10,1
05-03-2025,"Grains, Flours & Dals",Wheat Flour 1 kg,4,70,60,10,1
05-03-2025,Misc,ROLL D C,8,70,45,25,1
05-03-2025,Snacks & Ready-to-Eat,Corn Chips 250GM,14,40,35,5,1
05-03-2025,"Grains, Flours & Dals",UNPOLISHED TURDALL 1KG,4,240,210,30,1
05-03-2025,Spices & Seasonings,NUVVULU 500GM,15,320,260,60,2
05-03-2025,"Grains, Flours & Dals",Em jowar idly R 500G,4,600,600,0,8
05-03-2025,"Grains, Flours & Dals",Wheat Flour 1 kg,4,70,60,10,1
05-03-2025,Snacks & Ready-to-Eat,VD NUVULU PAPAD 200GM,14,200,200,0,2
05-03-2025,Snacks & Ready-to-Eat,VD SAGOPAPAD 150GM,14,110,110,0,2
05-03-2025,Snacks & Ready-to-Eat,VD MINAPA MIRCHI PAPAD 195GM,14,180,180,0,3
05-03-2025,"Dry Fruits, Nuts & Seeds",FLAX SEEDS 250GM,2,120,100,20,2
05-03-2025,"Dry Fruits, Nuts & Seeds",WATERMELON SEEDS 250GRM,2,320,280,40,1
05-03-2025,Snacks & Ready-to-Eat,BROWN BREAD,14,55,55,0,1
05-03-2025,Misc,VD0009,8,100,100,0,1
05-03-2025,Snacks & Ready-to-Eat,ZEEDI,14,140,140,0,2
05-03-2025,Milk & Dairy,ID PANEER,7,135,135,0,1
05-03-2025,"Grains, Flours & Dals",PRO ORG IDLY RAVA 1KG,4,145,145,0,1
05-03-2025,"Grains, Flours & Dals",DH URAD GOTA 1KG,4,215,190,25,1
05-03-2025,Snacks & Ready-to-Eat,Sprouted Ragi Biscuits 450GM,14,150,150,0,1
05-03-2025,"Grains, Flours & Dals",Idly Rava L 1KG,4,60,50,10,1
05-03-2025,"Grains, Flours & Dals",Urad dall 1 Kg,4,185,170,15,1
05-03-2025,Snacks & Ready-to-Eat,VD GUMMADI VADIYAM,14,75,75,0,1
05-03-2025,Personal Care & Cosmetics,papaya soap,10,0,0,0,1
05-03-2025,Sweeteners,MISHRI 250 GM,16,35,30,5,1
05-03-2025,"Grains, Flours & Dals",unpolished turdall500grms,4,120,110,10,1
05-03-2025,"Dry Fruits, Nuts & Seeds",sabja seeds,2,80,70,10,1
05-03-2025,Oils & Ghee,Groundnut oil 1 L,9,360,330,30,1
05-03-2025,Personal Care & Cosmetics,KHADI MIX FRUIT SOAP 125GM,10,80,80,0,1
05-03-2025,"Grains, Flours & Dals",Wheat Flour 2 kgs,4,140,120,20,1
05-03-2025,Oils & Ghee,Safflower oil 1 L,9,440,400,40,1
05-03-2025,"Grains, Flours & Dals",Em jowar idly R 500G,4,75,75,0,1
05-03-2025,Snacks & Ready-to-Eat,NGT CHATPATTA CHANA 90GM,14,50,50,0,2
05-03-2025,Snacks & Ready-to-Eat,JUNNU POWDER 100GM,14,70,70,0,1
05-03-2025,"Grains, Flours & Dals",SAMALU (Little millet) 500 gms,4,85,65,20,1
05-03-2025,Snacks & Ready-to-Eat,NGT CHATPATTA CHANA 90GM,14,50,50,0,2
05-03-2025,"Grains, Flours & Dals",Arikalu (kodo),4,70,65,5,1
05-03-2025,"Grains, Flours & Dals",KORRALU (FOXTAIL M) 500GM,4,65,55,10,1
05-03-2025,"Grains, Flours & Dals",DOCTOR RICE DIABETIC SFR 1KG,4,600,600,0,5
05-03-2025,Milk & Dairy,BROWN EGGS TRAY 30P,7,360,330,30,1
05-03-2025,Milk & Dairy,BROWN EGGS 1P,7,336,288,48,24
05-03-2025,Oils & Ghee,Sesame oil 1 L,9,590,560,30,1
05-03-2025,Oils & Ghee,Coconut oil 1 L,9,440,400,40,1
05-03-2025,"Grains, Flours & Dals",Wheat Flour 2 kgs,4,280,240,40,2
05-03-2025,Spices & Seasonings,Chilli powder 500 gms,15,290,210,80,1
05-03-2025,"Grains, Flours & Dals",Wheat Flour 1 kg,4,70,60,10,1
05-03-2025,"Grains, Flours & Dals",Quinova 1 kg,4,220,195,25,1
05-03-2025,Sweeteners,NATURAL HONEY 1KG,16,560,480,80,1
05-03-2025,"Grains, Flours & Dals",SINGLE POLISH 1KG,4,325,325,0,5
05-03-2025,"Grains, Flours & Dals",RED TUDAL 1KG,4,150,140,10,1
05-03-2025,"Grains, Flours & Dals",VGR rice 1 kg,4,70,65,5,1
05-03-2025,"Dry Fruits, Nuts & Seeds",Groundnuts 1 kg,2,380,340,40,2
05-03-2025,Snacks & Ready-to-Eat,VD PALLI LADDU,14,80,80,0,1
05-03-2025,"Grains, Flours & Dals",Wheat Flour 1 kg,4,70,60,10,1
05-03-2025,Snacks & Ready-to-Eat,VD MYSOREPAK 6PIC,14,100,100,0,1
05-03-2025,"Health, Wellness & Ayurvedic Products",MD Mandara Leaf Powder 50GM,5,100,100,0,1
05-03-2025,"Grains, Flours & Dals",Wheat Flour 2 kgs,4,140,120,20,1
05-03-2025,"Health, Wellness & Ayurvedic Products",MD Neem Leaf Choornam 100GM,5,80,80,0,1
05-03-2025,Spices & Seasonings,MG Dasa dinasalu 250gm,15,220,220,0,1
05-03-2025,Snacks & Ready-to-Eat,VD MULTI CHAKKA,14,110,110,0,1
05-03-2025,Snacks & Ready-to-Eat,SD FINGER Millet with palm Jaggery 250gm,14,135,135,0,1
05-03-2025,Oils & Ghee,Castor oil 200 ml,9,100,80,20,1
05-03-2025,Personal Care & Cosmetics,SVE KHADI ALOEVERA GEL 100GM,10,140,140,0,1
05-03-2025,"Grains, Flours & Dals",Wheat Flour 2 kgs,4,280,240,40,2
05-03-2025,"Grains, Flours & Dals",SAMALU (Little millet) 500 gms,4,85,65,20,1
05-03-2025,"Grains, Flours & Dals",KORRALU (FOXTAIL M) 500GM,4,65,55,10,1
05-03-2025,"Grains, Flours & Dals",RAGI FLOUR 1KG,4,80,70,10,1
05-03-2025,Oils & Ghee,Groundnut oil 1 L,9,720,660,60,2
05-03-2025,Milk & Dairy,BROWN EGGS 1P,7,280,240,40,20
05-03-2025,"Grains, Flours & Dals",Brown RICE 1KG,4,210,195,15,3
05-03-2025,Snacks & Ready-to-Eat,BB VERMICELLY 500GM,14,53,53,0,1
05-03-2025,"Dry Fruits, Nuts & Seeds",Groundnuts 1 kg,2,380,340,40,2
05-03-2025,"Dry Fruits, Nuts & Seeds",PULMAKHANA 100 GM,2,180,170,10,1
05-03-2025,"Grains, Flours & Dals",Yellow jowar .F1 kg,4,110,100,10,1
05-03-2025,Milk & Dairy,BROWN EGGS TRAY 30P,7,360,330,30,1
05-03-2025,Baking & Cooking Aids,GONDH 50GRMS,0,100,80,20,2
05-03-2025,"Grains, Flours & Dals",Multigrain 1 kg,4,100,85,15,1
05-03-2025,Spices & Seasonings,YB PINK ROCK SALT 1KG,15,120,120,0,1
05-03-2025,Spices & Seasonings,Jeera 100GM,15,50,45,5,1
05-03-2025,"Grains, Flours & Dals",UNPOLISHED TURDALL 1KG,4,240,210,30,1
05-03-2025,"Grains, Flours & Dals",RAGI FLOUR 500GRMS,4,40,35,5,1
04-03-2025,Spices & Seasonings,Jeera 100GM,15,50,45,5,1
04-03-2025,Spices & Seasonings,NUVVULU 500GM,15,160,130,30,1
04-03-2025,"Grains, Flours & Dals",RAGI FLOUR 500GRMS,4,40,35,5,1
04-03-2025,General Household & Kitchenware,B4 BOWL,3,160,152,8,1
04-03-2025,Snacks & Ready-to-Eat,millet noodles sf,14,70,70,0,2
04-03-2025,"Grains, Flours & Dals",BARLEY SEEDS 1KG,4,160,140,20,1
04-03-2025,"Grains, Flours & Dals",RAGI FLOUR 1KG,4,80,70,10,1
04-03-2025,Snacks & Ready-to-Eat,COPRA LADDU 200GM,14,100,80,20,1
04-03-2025,Personal Care & Cosmetics,YB Bath Powder 200GM,10,100,100,0,1
04-03-2025,Oils & Ghee,Groundnut oil 1 L,9,360,330,30,1
04-03-2025,"Grains, Flours & Dals",Urad dall 1 Kg,4,185,170,15,1
04-03-2025,"Grains, Flours & Dals",SABDANA,4,120,105,15,3
04-03-2025,Spices & Seasonings,PRO ORG FENUGREEK 200GM,15,86,86,0,1
04-03-2025,"Grains, Flours & Dals",Brown RICE 1KG,4,350,325,25,5
04-03-2025,"Grains, Flours & Dals",DH URAD GOTA 1KG,4,430,380,50,2
04-03-2025,Snacks & Ready-to-Eat,VD CORNFLAKES MIXTURE 175GM,14,60,60,0,1
04-03-2025,"Dry Fruits, Nuts & Seeds",SALTED PISTA 250GM,2,400,350,50,1
04-03-2025,Snacks & Ready-to-Eat,VD VAMUPUSA 175GM,14,60,60,0,1
04-03-2025,"Grains, Flours & Dals",JOWAR UPMA RAVA,4,75,75,0,1
04-03-2025,Snacks & Ready-to-Eat,SD Vamu with palm jaggery 250gm,14,135,135,0,1
04-03-2025,Oils & Ghee,Safflower oil 1 L,9,880,800,80,2
04-03-2025,Snacks & Ready-to-Eat,SATHVI REGIVADA 200GM,14,80,60,20,1
04-03-2025,Snacks & Ready-to-Eat,GREEN FRIED BATANA,14,20,20,0,1
04-03-2025,Snacks & Ready-to-Eat,Corn Chips 250GM,14,40,35,5,1
04-03-2025,Snacks & Ready-to-Eat,NGT CHATPATTA CHANA 90GM,14,25,25,0,1
04-03-2025,Snacks & Ready-to-Eat,PEANUT CHIKKI,14,44,44,0,2
04-03-2025,Snacks & Ready-to-Eat,SD MASALA GAVVALU 200GM,14,95,95,0,1
04-03-2025,Snacks & Ready-to-Eat,VD MULTI CHAKKA,14,110,110,0,1
04-03-2025,Spices & Seasonings,SD IDLY KARAM,15,65,65,0,1
04-03-2025,Snacks & Ready-to-Eat,VD SANNAPUSA 175GM,14,60,60,0,1
04-03-2025,"Grains, Flours & Dals",split black gram 1 kg,4,180,170,10,1
04-03-2025,Snacks & Ready-to-Eat,RSC ORANGE 100GMS,14,20,20,0,1
04-03-2025,"Grains, Flours & Dals",Multigrain 1 kg,4,100,85,15,1
04-03-2025,"Grains, Flours & Dals",RICE FLOUR 500 GM,4,35,28,7,1
04-03-2025,Spices & Seasonings,FLAXSEED KARAM,15,75,75,0,1
04-03-2025,Snacks & Ready-to-Eat,SS IDLY BATTER 1KG,14,60,60,0,1
04-03-2025,Snacks & Ready-to-Eat,VD PALLI CHIKKI,14,80,80,0,1
04-03-2025,Snacks & Ready-to-Eat,MARMURA LADDU,14,80,60,20,1
04-03-2025,Snacks & Ready-to-Eat,VD MURUKU 175GM,14,60,60,0,1
04-03-2025,Milk & Dairy,BROWN EGGS 1P,7,140,120,20,10
04-03-2025,Snacks & Ready-to-Eat,CHOCO BROWINE,14,40,40,0,2
04-03-2025,"Grains, Flours & Dals",Wheat Flour 1 kg,4,140,120,20,2
04-03-2025,"Grains, Flours & Dals",Quinova 1 kg,4,220,195,25,1
04-03-2025,"Grains, Flours & Dals",Arikadu ( kodo),4,280,260,20,2
04-03-2025,"Grains, Flours & Dals",Sathya Javva Wheat Rava 500GM,4,95,95,0,1
04-03-2025,"Grains, Flours & Dals",KORRALU (FOXTAIL M) 1KG,4,150,110,40,1
04-03-2025,Spices & Seasonings,AV Iodized Salt 1KG,15,28,25,3,1
04-03-2025,Oils & Ghee,Groundnut oil 1 L,9,360,330,30,1
04-03-2025,"Grains, Flours & Dals",SAMALU,4,170,130,40,1
04-03-2025,"Grains, Flours & Dals",ANDU KORRALU (Browntop.m) 1 kg,4,260,220,40,1
04-03-2025,Sweeteners,SUGAR 500 GM,16,30,25,5,1
04-03-2025,"Grains, Flours & Dals",CHANA DAL 1KG,4,35,30,5,0.25
04-03-2025,"Grains, Flours & Dals",WHEAT 1 KG,4,240,200,40,4
04-03-2025,"Grains, Flours & Dals",JOWAR WHITE 1 KG,4,160,140,20,2
04-03-2025,"Grains, Flours & Dals",FLOUR CHARGE,4,72,72,0,6
04-03-2025,Snacks & Ready-to-Eat,VD BOONDI 175GM,14,120,120,0,2
04-03-2025,Snacks & Ready-to-Eat,VD PALLI LADDU,14,80,80,0,1
04-03-2025,Snacks & Ready-to-Eat,BELLAM GHEE SUNIUNDALU 250,14,240,240,0,2
04-03-2025,Spices & Seasonings,BLACK JEERA 50 GM,15,45,30,15,1
04-03-2025,Snacks & Ready-to-Eat,VD Pappu Chekkalu 190gm,14,120,120,0,2
04-03-2025,Snacks & Ready-to-Eat,VD VAMUPUSA 175GM,14,120,120,0,2
04-03-2025,Snacks & Ready-to-Eat,VD BELLAM GAVVALU 200GM,14,60,60,0,1
04-03-2025,Snacks & Ready-to-Eat,VD MIXTURE 175 GM,14,120,120,0,2
04-03-2025,Oils & Ghee,Groundnut oil 5 L,9,1800,"1,600.00",200,1
04-03-2025,Snacks & Ready-to-Eat,VD NUVULU CHEGODI 175GM,14,60,60,0,1
04-03-2025,Spices & Seasonings,Masala Karam 250 gms,15,130,120,10,1
04-03-2025,Baking & Cooking Aids,GONDH 50GRMS,0,50,40,10,1
04-03-2025,"Grains, Flours & Dals",turdal 500 gms,4,110,100,10,1
04-03-2025,Snacks & Ready-to-Eat,ZEEDI,14,70,70,0,1
04-03-2025,General Household & Kitchenware,SABEENA,3,15,15,0,1
04-03-2025,Snacks & Ready-to-Eat,VD BOONDI 175GM,14,60,60,0,1
04-03-2025,Personal Care & Cosmetics,HERBAL BATH POWDER,10,160,160,0,1
04-03-2025,Spices & Seasonings,DRY MIECHI 200GM,15,80,60,20,1
04-03-2025,General Household & Kitchenware,GOOD HOME,3,210,210,0,14
04-03-2025,Spices & Seasonings,JEERA 250 gms,15,125,105,20,1
04-03-2025,"Grains, Flours & Dals",Red Chana 250GM,4,35,30,5,1
04-03-2025,Spices & Seasonings,AVALU 100GM,15,25,20,5,1
04-03-2025,"Dry Fruits, Nuts & Seeds",PULMAKHANA 100 GM,2,180,170,10,1
04-03-2025,"Grains, Flours & Dals",Urad dall 1 Kg,4,185,170,15,1
04-03-2025,Milk & Dairy,BROWN EGGS 1P,7,196,168,28,14
04-03-2025,"Grains, Flours & Dals",Green gram 500 gms,4,75,70,5,1
04-03-2025,Household & Cleaning,ODOMOS,6,32,32,0,1
04-03-2025,"Grains, Flours & Dals",Wheat Flour 1 kg,4,70,60,10,1
04-03-2025,"Grains, Flours & Dals",ANDU KORRALU (Brown top .mlt) 500,4,130,110,20,1
04-03-2025,"Grains, Flours & Dals",RAGULU 1 KG,4,70,60,10,1
04-03-2025,"Grains, Flours & Dals",KORRALU (FOXTAIL M) 1KG,4,150,110,40,1
04-03-2025,"Grains, Flours & Dals",RAJMA 250GM,4,55,45,10,1
04-03-2025,"Grains, Flours & Dals",UDALU (Barnyard millet) 1 kg,4,140,115,25,1
04-03-2025,Snacks & Ready-to-Eat,SD barnyard Millet with palm jaggery,14,135,135,0,1
04-03-2025,"Grains, Flours & Dals",SAMALU,4,170,130,40,1
04-03-2025,"Grains, Flours & Dals",white Bobarlu 500 gms,4,80,75,5,1
04-03-2025,"Grains, Flours & Dals",FLOUR CHARGE,4,18,18,0,1.5
04-03-2025,"Grains, Flours & Dals",DESI CHANA,4,25,25,0,1
04-03-2025,"Grains, Flours & Dals",JOWAR WHITE 1 KG,4,20,17.5,2.5,0.25
04-03-2025,"Grains, Flours & Dals",Arikalu (kodo),4,70,65,5,1
04-03-2025,"Grains, Flours & Dals",BAJRA 1 KG,4,15,12.5,2.5,0.25
04-03-2025,General Household & Kitchenware,B1 bowl,3,399,379.05,19.95,1
04-03-2025,Snacks & Ready-to-Eat,KURNOOL MARMURA,14,70,55,15,1
04-03-2025,Snacks & Ready-to-Eat,VD PALLI CHIKKI,14,160,160,0,2
04-03-2025,"Dry Fruits, Nuts & Seeds",PULMAKHANA 100 GM,2,180,170,10,1
04-03-2025,Snacks & Ready-to-Eat,VD MINAPA VADIYAM,14,65,65,0,1
04-03-2025,Snacks & Ready-to-Eat,MARMURA LADDU,14,160,120,40,2
04-03-2025,Snacks & Ready-to-Eat,NGT CHATPATTA CHANA 90GM,14,25,25,0,1
04-03-2025,Oils & Ghee,Groundnut oil 1 L,9,720,660,60,2
04-03-2025,Oils & Ghee,Groundnut oil 1 L,9,360,330,30,1
04-03-2025,Sweeteners,NATURAL HONEY 1KG,16,560,480,80,1
04-03-2025,Spices & Seasonings,Masala Karam 250 gms,15,130,120,10,1
04-03-2025,Snacks & Ready-to-Eat,COPRA LADDU 200GM,14,100,80,20,1
04-03-2025,Snacks & Ready-to-Eat,VD Minapa papad 200gm,14,60,60,0,1
04-03-2025,"Dry Fruits, Nuts & Seeds",PUTNALU 500GMS,2,90,76,14,1
04-03-2025,Snacks & Ready-to-Eat,VD SANNAPUSA 175GM,14,60,60,0,1
04-03-2025,Personal Care & Cosmetics,OVAL BODY LOOFAH,10,55,55,0,1
04-03-2025,Snacks & Ready-to-Eat,VD NUVULU PAPAD 200GM,14,100,100,0,1
04-03-2025,"Dry Fruits, Nuts & Seeds",Groundnuts 500 gms,2,95,85,10,1
04-03-2025,Snacks & Ready-to-Eat,VD BELLAM GAVVALU 200GM,14,60,60,0,1
04-03-2025,Spices & Seasonings,Telaga Pindi 250 GM,15,40,35,5,1
04-03-2025,"Grains, Flours & Dals",SINGLE POLISH 1KG,4,325,325,0,5
04-03-2025,Oils & Ghee,Groundnut oil 1 L,9,360,330,30,1
04-03-2025,Oils & Ghee,Groundnut oil 1 L,9,360,330,30,1
04-03-2025,Spices & Seasonings,Masala Karam 250 gms,15,130,120,10,1
04-03-2025,"Grains, Flours & Dals",RAGULU 1 KG,4,70,60,10,1
04-03-2025,"Grains, Flours & Dals",UNPOLISHED TURDALL 1KG,4,240,210,30,1
04-03-2025,Milk & Dairy,BROWN EGGS 1P,7,168,144,24,12
04-03-2025,Milk & Dairy,HRITAGE TOTAL CURD 130GM,7,10,10,0,1
04-03-2025,"Grains, Flours & Dals",JOWAR YELLOW 1 K,4,100,90,10,1
04-03-2025,General Household & Kitchenware,BB BOWL,3,420,399,21,1
04-03-2025,"Grains, Flours & Dals",RAGI FLOUR 1KG,4,320,280,40,4
04-03-2025,"Grains, Flours & Dals",RAGI FLOUR 500GRMS,4,40,35,5,1
04-03-2025,"Grains, Flours & Dals",Multigrain 1 kg,4,100,85,15,1
04-03-2025,"Grains, Flours & Dals",Em jowar idly R 500G,4,75,75,0,1
04-03-2025,"Grains, Flours & Dals",PESARA PAPPU 1 KG,4,170,145,25,1
04-03-2025,"Dry Fruits, Nuts & Seeds",Groundnuts 1 kg,2,190,170,20,1
04-03-2025,"Grains, Flours & Dals",Brown RICE 1KG,4,70,65,5,1
04-03-2025,Spices & Seasonings,DRY MIECHI 200GM,15,80,60,20,1
04-03-2025,"Grains, Flours & Dals",SA YELLOW JOWAR RAVA 500GM,4,95,95,0,1
04-03-2025,"Grains, Flours & Dals",DOCTOR RICE DIABETIC SFR 1KG,4,120,120,0,1
04-03-2025,Oils & Ghee,Groundnut oil 1 L,9,360,330,30,1
04-03-2025,"Grains, Flours & Dals",RAGI FLOUR 500GRMS,4,40,35,5,1
04-03-2025,Oils & Ghee,Coconut oil 500 ml,9,220,200,20,1
04-03-2025,"Grains, Flours & Dals",SA WHITE JOWAR RAVA 500GM,4,69,69,0,1
04-03-2025,"Dry Fruits, Nuts & Seeds",YELLOW KISHMISH 250GM,2,130,110,20,1
04-03-2025,"Dry Fruits, Nuts & Seeds",KAJU HALF 250GM,2,310,290,20,1
04-03-2025,Beverages,TAJ MAHAL 250GM,1,470,470,0,1
04-03-2025,"Dry Fruits, Nuts & Seeds",SALTED PISTA 250GM,2,400,350,50,1
04-03-2025,Snacks & Ready-to-Eat,VD Pappu Chekkalu 190gm,14,60,60,0,1
04-03-2025,Snacks & Ready-to-Eat,VD PALLI LADDU,14,80,80,0,1
04-03-2025,Spices & Seasonings,Gasagasalu 50GM,15,130,110,20,1
04-03-2025,"Grains, Flours & Dals",URAD DALL,4,190,170,20,2
04-03-2025,"Grains, Flours & Dals",KORRALU (FOXTAIL M) 1KG,4,300,220,80,2
04-03-2025,"Grains, Flours & Dals",RICE FLOUR 500 GM,4,35,28,7,1
04-03-2025,"Grains, Flours & Dals",FLOUR CHARGE,4,12,12,0,1
04-03-2025,"Dry Fruits, Nuts & Seeds",Groundnuts 1 kg,2,190,170,20,1
04-03-2025,Spices & Seasonings,Menthulu 250 gms,15,50,45,5,1
04-03-2025,"Grains, Flours & Dals",CHANA DAL 500GM,4,70,60,10,1
04-03-2025,"Grains, Flours & Dals",DH URAD GOTA 1KG,4,215,190,25,1
04-03-2025,"Grains, Flours & Dals",WHEAT 1 KG,4,180,150,30,3
04-03-2025,Personal Care & Cosmetics,COLGATE ACTIVE SALT,10,20,20,0,1
04-03-2025,Misc,VD0009,8,100,100,0,1
04-03-2025,"Grains, Flours & Dals",YB Red RICE 1 KG,4,150,120,30,1
04-03-2025,Oils & Ghee,Groundnut oil 1 L,9,360,330,30,1
04-03-2025,Snacks & Ready-to-Eat,VD DRY FRUIT PUTHAREKULU,14,120,120,0,1
04-03-2025,"Grains, Flours & Dals",RAGI FLOUR 500GRMS,4,40,35,5,1
04-03-2025,"Health, Wellness & Ayurvedic Products",JAMBU SEED CHOORNAM 100GM,5,80,80,0,1
04-03-2025,"Grains, Flours & Dals",JOWAR WHITE 1 KG,4,160,140,20,2
04-03-2025,"Dry Fruits, Nuts & Seeds",BLACK KISMIS 250GM,2,175,140,35,1
04-03-2025,Oils & Ghee,Safflower oil 1 L,9,880,800,80,2
04-03-2025,"Grains, Flours & Dals",SRILATHA RICE RAVVA 500GM,4,35,35,0,1
04-03-2025,"Grains, Flours & Dals",PESARA PAPPU 500GMS,4,85,75,10,1
04-03-2025,Snacks & Ready-to-Eat,VD RIBBON PAKODI 175GM,14,60,60,0,1
04-03-2025,"Grains, Flours & Dals",Multigrain 1 kg,4,200,170,30,2
04-03-2025,Snacks & Ready-to-Eat,VD MIXTURE 175 GM,14,60,60,0,1
04-03-2025,"Dry Fruits, Nuts & Seeds",SD Mango cubes 100gm,2,45,45,0,1
04-03-2025,"Grains, Flours & Dals",SL Suji Rava 500GM,4,32,32,0,1
04-03-2025,"Grains, Flours & Dals",RAGI FLOUR 500GRMS,4,40,35,5,1
04-03-2025,"Grains, Flours & Dals",Multigrain 1 kg,4,100,85,15,1
04-03-2025,"Grains, Flours & Dals",Wheat Flour 1 kg,4,280,240,40,4
04-03-2025,Oils & Ghee,Groundnut oil 5 L,9,1800,"1,600.00",200,1
04-03-2025,Pooja & Spiritual Items,V GUGGILAM 50GM,12,45,45,0,1
04-03-2025,Snacks & Ready-to-Eat,VD MULTI CHAKKA,14,220,220,0,2
04-03-2025,"Grains, Flours & Dals",RAGI FLOUR 1KG,4,160,140,20,2
04-03-2025,Spices & Seasonings,FLAXSEED KARAM,15,75,75,0,1
04-03-2025,"Grains, Flours & Dals",Em Little idli R 500g,4,516,516,0,4
04-03-2025,Spices & Seasonings,THOKA MIRYALU 50GM,15,630,540,90,3
04-03-2025,"Grains, Flours & Dals",EM Foxtail idli r 500 g,4,327,327,0,3
04-03-2025,Spices & Seasonings,KARAKAYA,15,50,30,20,1
04-03-2025,Spices & Seasonings,SAJEERA,15,120,80,40,2
04-03-2025,Spices & Seasonings,Gasagasalu 50GM,15,130,110,20,1
04-03-2025,Snacks & Ready-to-Eat,VD BOONDI 175GM,14,60,60,0,1
04-03-2025,Sweeteners,SUGAR 1KG,16,60,50,10,1
04-03-2025,Pooja & Spiritual Items,JAGI KAYA 25GM,12,80,60,20,1
04-03-2025,"Grains, Flours & Dals",KORRALU (FOXTAIL M) 500GM,4,65,55,10,1
04-03-2025,"Grains, Flours & Dals",Em Multimillet idli r 500g,4,258,258,0,2
04-03-2025,General Household & Kitchenware,B4 BOWL,3,160,160,0,1
04-03-2025,"Grains, Flours & Dals",UDALU (Barnyard millet) 500 gms,4,70,60,10,1
04-03-2025,Spices & Seasonings,Marati Magga 50GM,15,130,110,20,1
04-03-2025,Snacks & Ready-to-Eat,SATHVI REGIVADA 200GM,14,80,60,20,1
04-03-2025,"Dry Fruits, Nuts & Seeds",SATHVI CHIA SEEDS 100GM,2,100,80,20,1
04-03-2025,"Grains, Flours & Dals",Em kodo idli R 500G,4,387,387,0,3
04-03-2025,Spices & Seasonings,Tamarind 250GMS,15,80,65,15,1
04-03-2025,"Grains, Flours & Dals",SAMALU (Little millet) 500 gms,4,85,65,20,1
04-03-2025,Spices & Seasonings,Jeera 100GM,15,50,45,5,1
04-03-2025,"Grains, Flours & Dals",SRILATHA RICE RAVVA 500GM,4,70,70,0,2
04-03-2025,Sweeteners,MADHUR SUGAR 1KG,16,65,55,10,1
04-03-2025,"Grains, Flours & Dals",SH RED POHA 500GM,4,85,85,0,1
04-03-2025,"Grains, Flours & Dals",turdal 500 gms,4,110,100,10,1
04-03-2025,"Dry Fruits, Nuts & Seeds",Groundnuts 500 gms,2,95,85,10,1
04-03-2025,"Grains, Flours & Dals",Urad dall 1 Kg,4,185,170,15,1
04-03-2025,"Grains, Flours & Dals",Idly Rava L 1KG,4,60,50,10,1
04-03-2025,Pickles & Cooking Pastes,SD TOMATO PICKLE,11,110,110,0,1
04-03-2025,Snacks & Ready-to-Eat,SF CHOCO CRUNCH,14,299,299,0,1
04-03-2025,Personal Care & Cosmetics,Khadi Shikakai With Amla Shampoo 200,10,199,199,0,1
04-03-2025,Oils & Ghee,Coconut oil 500 ml,9,220,200,20,1
04-03-2025,Pickles & Cooking Pastes,SD GINGER PICKLE 250GM,11,110,110,0,1
04-03-2025,"Grains, Flours & Dals",turdal 500 gms,4,110,100,10,1
04-03-2025,Spices & Seasonings,DHANIYA POWDER 200GM,15,100,85,15,1
04-03-2025,Oils & Ghee,Sesame oil 500ml,9,295,280,15,1
04-03-2025,Milk & Dairy,SANGAM TONED MILK 500ML,7,30,30,0,1
04-03-2025,"Grains, Flours & Dals",White jowar.F 1 kg,4,100,80,20,1
04-03-2025,Spices & Seasonings,Chilli powder 500 gms,15,290,210,80,1
04-03-2025,Snacks & Ready-to-Eat,SD Flax seeds with dates 250gm,14,135,135,0,1
04-03-2025,Spices & Seasonings,SATHVI TURMERIC POWDER 500GM,15,180,130,50,1
04-03-2025,Oils & Ghee,Groundnut oil 1 L,9,360,330,30,1
04-03-2025,Snacks & Ready-to-Eat,MARMURA LADDU,14,80,60,20,1
04-03-2025,"Grains, Flours & Dals",BLACK GRAM 1KG,4,150,140,10,1
04-03-2025,"Grains, Flours & Dals",JOWAR WHITE 1 KG,4,80,70,10,1
04-03-2025,Oils & Ghee,Safflower oil 500 ml,9,220,200,20,1
04-03-2025,"Dry Fruits, Nuts & Seeds",PULMAKHANA 100 GM,2,360,340,20,2
04-03-2025,"Grains, Flours & Dals",White jowar.F 1 kg,4,100,80,20,1
04-03-2025,Spices & Seasonings,RED COPRA 250GMS,15,85,74,11,1
04-03-2025,Spices & Seasonings,LG 50GM,15,92,92,0,1
04-03-2025,"Grains, Flours & Dals",Wheat Flour 1 kg,4,140,120,20,2
04-03-2025,Snacks & Ready-to-Eat,urban murmura,14,60,55,5,1
04-03-2025,Snacks & Ready-to-Eat,VD RICE SAGO PAPAD 150GM,14,55,55,0,1
04-03-2025,"Grains, Flours & Dals",Bajra Flour 1 kg,4,70,60,10,1
04-03-2025,"Grains, Flours & Dals",RAGI FLOUR 1KG,4,80,70,10,1
04-03-2025,"Grains, Flours & Dals",RICE FLOUR 1KG,4,70,55,15,1
04-03-2025,Oils & Ghee,Groundnut oil 1 L,9,360,330,30,1
04-03-2025,Milk & Dairy,BROWN EGGS TRAY 30P,7,360,330,30,1
04-03-2025,"Grains, Flours & Dals",Bajra Flour 1 kg,4,70,60,10,1
04-03-2025,Spices & Seasonings,SAJEERA,15,60,40,20,1
04-03-2025,Snacks & Ready-to-Eat,GREEN FRIED batana,14,20,20,0,1
04-03-2025,"Grains, Flours & Dals",JOWAR UPMA RAVA,4,65,65,0,1
04-03-2025,"Grains, Flours & Dals",SA YELLOW JOWAR RAVA 500GM,4,95,95,0,1
04-03-2025,Snacks & Ready-to-Eat,VD PALLI LADDU,14,160,160,0,2
04-03-2025,"Dry Fruits, Nuts & Seeds",sabja seeds,2,80,70,10,1
04-03-2025,"Grains, Flours & Dals",Wheat Flour 1 kg,4,70,60,10,1
04-03-2025,Oils & Ghee,Safflower oil 1 L,9,880,800,80,2
04-03-2025,"Grains, Flours & Dals",Multigrain 1 kg,4,100,85,15,1
04-03-2025,Snacks & Ready-to-Eat,SATHVI REGIVADA 200GM,14,80,60,20,1
04-03-2025,"Grains, Flours & Dals",HS JOWAR IDLY RAWA,4,65,65,0,1
04-03-2025,Snacks & Ready-to-Eat,Corn Chips 250GM,14,40,35,5,1
04-03-2025,"Dry Fruits, Nuts & Seeds",Groundnuts 1 kg,2,380,340,40,2
04-03-2025,"Grains, Flours & Dals",PLAIN OATS 1KG,4,52.5,52.5,0,0.25
04-03-2025,Milk & Dairy,ID PANEER,7,135,135,0,1
04-03-2025,"Grains, Flours & Dals",SINGLE POLISH 1KG,4,65,65,0,1
04-03-2025,"Grains, Flours & Dals",Multigrain 1 kg,4,100,85,15,1
04-03-2025,Snacks & Ready-to-Eat,RAJGIRA PEANUT CHIKKI,14,30,30,0,6
04-03-2025,Snacks & Ready-to-Eat,SD Flax seeds with dates 250gm,14,135,135,0,1
04-03-2025,Snacks & Ready-to-Eat,MARMURA LADDU,14,80,60,20,1
04-03-2025,"Grains, Flours & Dals",FLOUR CHARGE,4,30,30,0,2.5
04-03-2025,Snacks & Ready-to-Eat,millet noodles sf,14,35,35,0,1
04-03-2025,Spices & Seasonings,Masala Karam 250 gms,15,130,120,10,1
04-03-2025,Personal Care & Cosmetics,HERBAL BATH POWDER 200GM,10,80,80,0,1
04-03-2025,Snacks & Ready-to-Eat,millet noodles sf,14,35,35,0,1
04-03-2025,Spices & Seasonings,Masala Karam 250 gms,15,130,120,10,1
04-03-2025,Snacks & Ready-to-Eat,MUTLGRAIN BREAD,14,70,70,0,1
04-03-2025,Snacks & Ready-to-Eat,VD CORNFLAKES MIXTURE 175GM,14,60,60,0,1
04-03-2025,"Grains, Flours & Dals",Wheat Flour 1 kg,4,70,60,10,1
04-03-2025,Milk & Dairy,BROWN EGGS 1P,7,168,144,24,12
04-03-2025,"Grains, Flours & Dals",Brown RICE 1KG,4,140,130,10,2
04-03-2025,Snacks & Ready-to-Eat,MARMURA LADDU,14,80,60,20,1
04-03-2025,"Grains, Flours & Dals",JOWAR YELLOW 1 K,4,100,90,10,1
04-03-2025,"Dry Fruits, Nuts & Seeds",Groundnuts 1 kg,2,190,170,20,1
04-03-2025,Spices & Seasonings,Turmeric powder 250 gms,15,100,75,25,1
04-03-2025,"Dry Fruits, Nuts & Seeds",PULMAKHANA 100 GM,2,180,170,10,1
04-03-2025,Pooja & Spiritual Items,GD Aiswarya Deepam 700ML,12,195,195,0,1
04-03-2025,Snacks & Ready-to-Eat,BD RAGI NOODLES,14,75,75,0,1
04-03-2025,"Grains, Flours & Dals",RAGULU 1 KG,4,70,60,10,1
04-03-2025,Spices & Seasonings,Jeera 100GM,15,100,90,10,2
04-03-2025,"Grains, Flours & Dals",Wheat Flour 1 kg,4,140,120,20,2
04-03-2025,"Grains, Flours & Dals",DH URAD GOTA 1KG,4,430,380,50,2
04-03-2025,"Dry Fruits, Nuts & Seeds",Putnalu 250GM,2,45,38,7,1
04-03-2025,Spices & Seasonings,Tamarind 250GMS,15,80,65,15,1
04-03-2025,Spices & Seasonings,Coriander seeds 200 gms,15,48,40,8,1
04-03-2025,"Grains, Flours & Dals",SA WHITE JOWAR RAVA 500GM,4,138,138,0,2
04-03-2025,"Dry Fruits, Nuts & Seeds",Groundnuts 500 gms,2,95,85,10,1
04-03-2025,"Dry Fruits, Nuts & Seeds",PUTNALU 500GMS,2,90,76,14,1
04-03-2025,"Grains, Flours & Dals",RICE FLOUR 500 GM,4,35,28,7,1
04-03-2025,"Grains, Flours & Dals",RAGI FLOUR 1KG,4,80,70,10,1
04-03-2025,"Grains, Flours & Dals",split green gram 1 kg,4,150,140,10,1
04-03-2025,Oils & Ghee,Black Sesame oil 500 ml,9,220,190,30,1
04-03-2025,"Grains, Flours & Dals",HS Multimillet idly R 500 gms,4,65,65,0,1
04-03-2025,"Grains, Flours & Dals",Em little upma R 500g,4,129,129,0,1
04-03-2025,Snacks & Ready-to-Eat,SD Thati thandra 200gm,14,150,150,0,1
04-03-2025,"Grains, Flours & Dals",Red uluvalu 250 gms,4,45,40,5,1
04-03-2025,"Grains, Flours & Dals",Em jowar idly R 500G,4,75,75,0,1
04-03-2025,Snacks & Ready-to-Eat,NGT CHATPATTA CHANA 90GM,14,50,50,0,2
04-03-2025,Milk & Dairy,BROWN EGGS 1P,7,140,120,20,10
04-03-2025,"Grains, Flours & Dals",Em Foxtail upma r 500 g,4,109,109,0,1
04-03-2025,"Grains, Flours & Dals",EM kodo upma R 500g,4,129,129,0,1
04-03-2025,"Grains, Flours & Dals",split green gram 500 gms,4,75,70,5,1
04-03-2025,Snacks & Ready-to-Eat,GANTASALA GINGER CANDY 200GM,14,105,105,0,1
04-03-2025,Snacks & Ready-to-Eat,Popcorn Seeds 250GM,14,45,40,5,1
04-03-2025,Spices & Seasonings,Coconut Powder 250GM,15,90,90,0,1
04-03-2025,Sweeteners,SH JAGGERY POWDER 500GM,16,80,68,12,1
04-03-2025,Snacks & Ready-to-Eat,CHOCO BROWINE,14,20,20,0,1
04-03-2025,"Grains, Flours & Dals",Wheat Flour 1 kg,4,70,60,10,1
04-03-2025,Snacks & Ready-to-Eat,VD CORNFLAKES MIXTURE 175GM,14,60,60,0,1
04-03-2025,Snacks & Ready-to-Eat,FOXTAIL BIS,14,135,135,0,1
04-03-2025,"Dry Fruits, Nuts & Seeds",sabja seeds,2,80,70,10,1
04-03-2025,"Grains, Flours & Dals",ANDU KORRALU (Browntop.m) 1 kg,4,260,220,40,1
04-03-2025,"Grains, Flours & Dals",Quinova 500 gms,4,110,100,10,1
04-03-2025,"Grains, Flours & Dals",SAMALU (Little millet) 500 gms,4,85,65,20,1
04-03-2025,"Grains, Flours & Dals",Arikadu ( kodo),4,140,130,10,1
04-03-2025,Oils & Ghee,Groundnut oil 500ml,9,180,165,15,1
04-03-2025,"Grains, Flours & Dals",UDALU (Barnyard millet) 1 kg,4,140,115,25,1
04-03-2025,"Grains, Flours & Dals",KORRALU (FOXTAIL M) 1KG,4,150,110,40,1
04-03-2025,"Health, Wellness & Ayurvedic Products",MADDI MUSCLE OIL PAIN 100ML,5,270,270,0,1
04-03-2025,"Grains, Flours & Dals",Em Multimillet idli r 500g,4,129,129,0,1
04-03-2025,"Grains, Flours & Dals",Yellow jowar .F1 kg,4,110,100,10,1
04-03-2025,"Grains, Flours & Dals",Multigrain 1 kg,4,100,85,15,1
04-03-2025,"Grains, Flours & Dals",Wheat Flour 1 kg,4,70,60,10,1
04-03-2025,"Grains, Flours & Dals",Multigrain 1 kg,4,400,340,60,4
04-03-2025,Household & Cleaning,scrubber steel,6,15,15,0,1
04-03-2025,Misc,VD0009,8,200,200,0,2
04-03-2025,Snacks & Ready-to-Eat,SD Atreyapuram DRY Fruit ghee,14,450,450,0,3
04-03-2025,"Grains, Flours & Dals",SL Idly Rava 1KG,4,65,55,10,1
04-03-2025,Pooja & Spiritual Items,GD Dhoop Sticks 26GM,12,20,20,0,1
04-03-2025,"Grains, Flours & Dals",MAAGAANI SP RICE 5KGS,4,649,560,89,1
04-03-2025,Snacks & Ready-to-Eat,MIGHTY PUFFS TOMATO,14,25,25,0,1
04-03-2025,Oils & Ghee,Sesame oil 1 L,9,1180,"1,120.00",60,2
04-03-2025,Milk & Dairy,BROWN EGGS TRAY 30P,7,360,330,30,1
04-03-2025,Oils & Ghee,Groundnut oil 1 L,9,360,330,30,1
04-03-2025,"Grains, Flours & Dals",RICE FLOUR 1KG,4,70,55,15,1
04-03-2025,Personal Care & Cosmetics,DWI NEEM TULSI SOAP 100GM,10,75,75,0,1
04-03-2025,"Dry Fruits, Nuts & Seeds",PUMPKIN SEEDS 250GM,2,200,160,40,1
04-03-2025,Beverages,TAJ MAHAL 250GM,1,235,235,0,1
04-03-2025,Pooja & Spiritual Items,BALAJI BEL PHOOL DHOOP STICKS 10STK,12,70,70,0,1
04-03-2025,Spices & Seasonings,sf black pepper,15,190,190,0,1
04-03-2025,Snacks & Ready-to-Eat,millet noodles sf,14,35,35,0,1
04-03-2025,"Grains, Flours & Dals",SL Idly Rava 1KG,4,130,110,20,2
04-03-2025,"Grains, Flours & Dals",turdal 1kg,4,660,585,75,3
04-03-2025,Sweeteners,MISHRI 250 GM,16,105,90,15,3
04-03-2025,"Grains, Flours & Dals",PESARA PAPPU 1 KG,4,170,145,25,1
04-03-2025,"Grains, Flours & Dals",SL Suji Rava 500GM,4,64,64,0,2
04-03-2025,Snacks & Ready-to-Eat,MIGHTY PUFFS CHEDDAR CHEESE,14,25,25,0,1
04-03-2025,Personal Care & Cosmetics,DWI SMARA SOAP 100GM,10,75,75,0,1
04-03-2025,Snacks & Ready-to-Eat,MIGHTY PUFF,14,25,25,0,1
04-03-2025,"Dry Fruits, Nuts & Seeds",Groundnuts 500 gms,2,95,85,10,1
04-03-2025,"Grains, Flours & Dals",Red Chana 250GM,4,35,30,5,1
04-03-2025,"Grains, Flours & Dals",Idly Rava L 1KG,4,60,50,10,1
04-03-2025,"Dry Fruits, Nuts & Seeds",KAJU HALF 250GM,2,310,290,20,1
04-03-2025,"Dry Fruits, Nuts & Seeds",YELLOW KISHMISH 250GM,2,130,110,20,1
04-03-2025,"Grains, Flours & Dals",Chana Flour 500 gms,4,70,65,5,1
04-03-2025,Snacks & Ready-to-Eat,SF MIGHTY PUFFS,14,25,25,0,1
04-03-2025,"Grains, Flours & Dals",Urad dall 1 Kg,4,370,340,30,2
04-03-2025,"Grains, Flours & Dals",CHANA DAL 500GM,4,70,60,10,1
04-03-2025,"Grains, Flours & Dals",Wheat Flour 1 kg,4,140,120,20,2
04-03-2025,Spices & Seasonings,Jeera 100GM,15,50,45,5,1
04-03-2025,"Grains, Flours & Dals",SRILATHA RICE RAVVA 500GM,4,140,140,0,4
04-03-2025,Snacks & Ready-to-Eat,SF VERMICELLI,14,139,139,0,1
04-03-2025,Spices & Seasonings,Vamu 100GM,15,60,50,10,1
04-03-2025,"Grains, Flours & Dals",DH URAD GOTA 1KG,4,215,190,25,1
04-03-2025,General Household & Kitchenware,PREMIER KITTCHEN TOWEL,3,160,160,0,1
04-03-2025,"Grains, Flours & Dals",Green gram 500 gms,4,75,70,5,1
04-03-2025,"Grains, Flours & Dals",THICK POHA 500GM,4,40,35,5,1
04-03-2025,"Dry Fruits, Nuts & Seeds",SUNFLOWER SEEDS 250GRM,2,150,130,20,1
04-03-2025,Household & Cleaning,vim dish liquid,6,110,110,0,2
04-03-2025,Spices & Seasonings,Avalu small 250 gms,15,60,40,20,1
04-03-2025,Spices & Seasonings,LG 50GM,15,92,92,0,1
04-03-2025,Oils & Ghee,Sesame oil 1 L,9,590,560,30,1
04-03-2025,"Grains, Flours & Dals",THICK POHA 500GM,4,40,35,5,1
04-03-2025,Household & Cleaning,ODOMOS,6,64,64,0,2
04-03-2025,"Grains, Flours & Dals",turdal 1kg,4,440,390,50,2
04-03-2025,"Grains, Flours & Dals",SINGLE POLISH 1KG,4,390,390,0,6
04-03-2025,Spices & Seasonings,ROYAL SAFFRON,15,125,125,0,1
04-03-2025,"Grains, Flours & Dals",RAGI FLOUR 1KG,4,80,70,10,1
04-03-2025,Oils & Ghee,Groundnut oil 1 L,9,720,660,60,2
04-03-2025,Spices & Seasonings,JEERA 250 gms,15,125,105,20,1
04-03-2025,"Grains, Flours & Dals",VGR rice 1 kg,4,420,390,30,6
04-03-2025,Spices & Seasonings,Menthulu 250 gms,15,50,45,5,1
04-03-2025,"Grains, Flours & Dals",CHANA DAL 500GM,4,70,60,10,1
04-03-2025,Sweeteners,SUGAR 1KG,16,60,50,10,1
04-03-2025,"Dry Fruits, Nuts & Seeds",Groundnuts 1 kg,2,380,340,40,2
04-03-2025,"Grains, Flours & Dals",Idly Rava L 1KG,4,60,50,10,1
04-03-2025,"Grains, Flours & Dals",Urad dall 1 Kg,4,370,340,30,2
04-03-2025,"Grains, Flours & Dals",RED TURDAL 500GM,4,75,70,5,1
04-03-2025,Snacks & Ready-to-Eat,FUN TIME CRUNCH,14,90,90,0,2
04-03-2025,"Grains, Flours & Dals",Em jowar idly R 500G,4,375,375,0,5
04-03-2025,Snacks & Ready-to-Eat,RSC ORANGE 100GMS,14,20,20,0,1
04-03-2025,"Dry Fruits, Nuts & Seeds",SD Mango cubes 200gm,2,90,90,0,1
04-03-2025,Snacks & Ready-to-Eat,HS JOWAR BISCUITS,14,50,50,0,1
04-03-2025,Oils & Ghee,Coconut oil 1 L,9,880,800,80,2
04-03-2025,"Grains, Flours & Dals",AISHWARYA SP 1KG,4,400,350,50,5
04-03-2025,Spices & Seasonings,Turmeric powder 250 gms,15,100,75,25,1
04-03-2025,"Grains, Flours & Dals",Red Chana 250GM,4,70,60,10,2
04-03-2025,Spices & Seasonings,SD IDLY KARAM,15,65,65,0,1
04-03-2025,"Grains, Flours & Dals",KORRALU (FOXTAIL M) 1KG,4,150,110,40,1
04-03-2025,"Grains, Flours & Dals",PESARA PAPPU 500GMS,4,85,75,10,1
04-03-2025,Spices & Seasonings,Jeera 100GM,15,50,45,5,1
04-03-2025,"Grains, Flours & Dals",Red Bobarlu 500 gms,4,95,85,10,1
04-03-2025,Spices & Seasonings,Chilli powder 500 gms,15,290,210,80,1
04-03-2025,Oils & Ghee,Sesame oil 1 L,9,1180,"1,120.00",60,2
04-03-2025,Spices & Seasonings,Marati Magga 50GM,15,130,110,20,1
04-03-2025,Snacks & Ready-to-Eat,JUNNU POWDER 100GM,14,140,140,0,2
04-03-2025,Spices & Seasonings,SD Garlic Karam Powder 100GM,15,65,65,0,1
04-03-2025,"Dry Fruits, Nuts & Seeds",SD Mango cubes 100gm,2,45,45,0,1
04-03-2025,Pooja & Spiritual Items,bilwa patra,12,60,60,0,1
04-03-2025,Pooja & Spiritual Items,GD Ramayana Sandal 75GM,12,60,60,0,1
04-03-2025,Milk & Dairy,SANGAM FULL CREAM MILK 500ML,7,38,38,0,1
04-03-2025,Sweeteners,SUGAR 500 GM,16,30,25,5,1
04-03-2025,"Grains, Flours & Dals",Chana Flour 500 gms,4,70,65,5,1
03-03-2025,Snacks & Ready-to-Eat,VD GUMMADI VADIYAM,14,75,75,0,1
03-03-2025,"Grains, Flours & Dals",KORRALU (FOXTAIL M) 500GM,4,65,55,10,1
03-03-2025,Spices & Seasonings,ROYAL SAFFRON 400GRMS,15,65,65,0,1
03-03-2025,Oils & Ghee,Groundnut oil 1 L,9,360,330,30,1
03-03-2025,Snacks & Ready-to-Eat,ZEEDI,14,70,70,0,1
03-03-2025,Milk & Dairy,BROWN EGGS TRAY 30P,7,360,330,30,1
03-03-2025,"Grains, Flours & Dals",Idly Rava L 1KG,4,120,100,20,2
03-03-2025,"Grains, Flours & Dals",Urad dall 1 Kg,4,185,170,15,1
03-03-2025,"Dry Fruits, Nuts & Seeds",PULMAKHANA 100 GM,2,180,170,10,1
03-03-2025,"Dry Fruits, Nuts & Seeds",Groundnuts 1 kg,2,380,340,40,2
03-03-2025,"Grains, Flours & Dals",UNPOLISHED TURDALL 1KG,4,240,210,30,1
03-03-2025,"Grains, Flours & Dals",Wheat Flour 1 kg,4,140,120,20,2
03-03-2025,"Grains, Flours & Dals",VYS.SP.RICE BAG 1,4,1800,"1,650.00",150,1
03-03-2025,Spices & Seasonings,GS Pink Rock Salt 1KG,15,120,120,0,1
03-03-2025,"Grains, Flours & Dals",PESARA PAPPU 500GMS,4,85,75,10,1
03-03-2025,Spices & Seasonings,Vamu 100GM,15,60,50,10,1
03-03-2025,Snacks & Ready-to-Eat,NGT CHATPATTA CHANA 90GM,14,25,25,0,1
03-03-2025,Spices & Seasonings,NUVVULU 500GM,15,160,130,30,1
03-03-2025,"Grains, Flours & Dals",Wheat Flour 1 kg,4,70,60,10,1
03-03-2025,Snacks & Ready-to-Eat,ANNAPURNA APPALAM,14,35,35,0,1
03-03-2025,Snacks & Ready-to-Eat,BD LITTLE MILLET NOODLES 200G,14,75,75,0,1
03-03-2025,Pooja & Spiritual Items,GD Aiswarya Deepam 700ML,12,195,195,0,1
03-03-2025,Pooja & Spiritual Items,GD Sree Chandan 50GM,12,50,50,0,1
03-03-2025,Snacks & Ready-to-Eat,BELLAM MINAPA SUNADULLU,14,100,100,0,1
03-03-2025,Snacks & Ready-to-Eat,millet noodles sf,14,35,35,0,1
03-03-2025,"Dry Fruits, Nuts & Seeds",YB GRANMA NUTS,2,90,90,0,1
03-03-2025,Snacks & Ready-to-Eat,COPRA LADDU 200GM,14,100,80,20,1
03-03-2025,Snacks & Ready-to-Eat,VD PALLI LADDU,14,80,80,0,1
03-03-2025,Snacks & Ready-to-Eat,MARMURA LADDU,14,80,60,20,1
03-03-2025,Snacks & Ready-to-Eat,MIGHTY PUFF,14,25,25,0,1
03-03-2025,Snacks & Ready-to-Eat,VD BELLAM GAVVALU 200GM,14,60,60,0,1
03-03-2025,Snacks & Ready-to-Eat,VD MURUKU 175GM,14,60,60,0,1
03-03-2025,Pooja & Spiritual Items,BALAJI BEL PHOOL STICKS 90GM,12,60,60,0,1
03-03-2025,Snacks & Ready-to-Eat,NGT CHATPATTA CHANA 90GM,14,25,25,0,1
03-03-2025,"Grains, Flours & Dals",RAGI FLOUR 500GRMS,4,40,35,5,1
03-03-2025,"Grains, Flours & Dals",Wheat Flour 1 kg,4,70,60,10,1
03-03-2025,Beverages,GANTASALA GREEN TEA 100GM,1,149,149,0,1
03-03-2025,"Grains, Flours & Dals",turdal 1kg,4,220,195,25,1
03-03-2025,Snacks & Ready-to-Eat,PEANUT CHIKKI,14,22,22,0,1
03-03-2025,Snacks & Ready-to-Eat,VD MULTI CHAKKA,14,110,110,0,1
03-03-2025,Pooja & Spiritual Items,GD Dhoop Cones 40GM,12,60,60,0,2
03-03-2025,"Dry Fruits, Nuts & Seeds",SALTED PISTA 250GM,2,400,350,50,1
03-03-2025,Spices & Seasonings,Jeera 100GM,15,50,45,5,1
03-03-2025,"Grains, Flours & Dals",PESARA PAPPU 500GMS,4,85,75,10,1
03-03-2025,"Grains, Flours & Dals",DH URAD GOTA 1KG,4,215,190,25,1
03-03-2025,"Grains, Flours & Dals",Red uluvalu 250 gms,4,45,40,5,1
03-03-2025,"Dry Fruits, Nuts & Seeds",Groundnuts 1 kg,2,190,170,20,1
03-03-2025,Spices & Seasonings,Turmeric powder 250 gms,15,100,75,25,1
03-03-2025,"Dry Fruits, Nuts & Seeds",Groundnuts 500 gms,2,95,85,10,1
03-03-2025,"Grains, Flours & Dals",AISHWARYA SP IDLY RAVA 1KG,4,120,66,54,1
03-03-2025,Spices & Seasonings,Coriander seeds 200 gms,15,48,40,8,1
03-03-2025,Spices & Seasonings,DRY MIECHI 200GM,15,80,60,20,1
03-03-2025,Household & Cleaning,PITAMBARI SHINING POWDER 200G,6,60,60,0,1
03-03-2025,Pooja & Spiritual Items,BALAJI SANDAL DHOOP STICKS 10STK,12,125,125,0,1
03-03-2025,Spices & Seasonings,ROYAL SAFFRON 400GRMS,15,65,65,0,1
03-03-2025,General Household & Kitchenware,B3 BOWL,3,265,251.75,13.25,1
03-03-2025,"Grains, Flours & Dals",Wheat Flour 3 kgs,4,210,180,30,1
03-03-2025,Oils & Ghee,Mustard oil 1 L,9,440,400,40,1
03-03-2025,Oils & Ghee,Groundnut oil 1 L,9,360,330,30,1
03-03-2025,Snacks & Ready-to-Eat,SD Atreyapuram DRY Fruit ghee,14,150,150,0,1
03-03-2025,Oils & Ghee,Safflower oil 1 L,9,440,400,40,1
03-03-2025,Sweeteners,YB JAGGERY POWDER 500GMS,16,150,150,0,2
03-03-2025,Pooja & Spiritual Items,GD Dhoop Cones 40GM,12,30,30,0,1
03-03-2025,"Grains, Flours & Dals",VGR RICE 5 KGS,4,350,325,25,1
03-03-2025,Pooja & Spiritual Items,GD SANDAL 150GM,12,110,110,0,1
03-03-2025,Snacks & Ready-to-Eat,BELLAM MINAPA SUNADULLU,14,180,180,0,1
03-03-2025,Snacks & Ready-to-Eat,SD FINGER Millet with palm Jaggery 250gm,14,135,135,0,1
03-03-2025,Snacks & Ready-to-Eat,VD NUVULU LADDU 9PIC,14,120,120,0,1
03-03-2025,Snacks & Ready-to-Eat,SD Moringa with plam jaggery 250gm,14,135,135,0,1
03-03-2025,Spices & Seasonings,Avalu small 250 gms,15,60,20,40,1
03-03-2025,"Grains, Flours & Dals",SINGLE POLISH 1KG,4,195,195,0,3
03-03-2025,Oils & Ghee,Groundnut oil 1 L,9,720,660,60,2
03-03-2025,"Dry Fruits, Nuts & Seeds",PUMPKIN SEEDS 250GM,2,200,160,40,1
03-03-2025,"Grains, Flours & Dals",Multigrain 1 kg,4,100,85,15,1
03-03-2025,"Grains, Flours & Dals",Wheat Flour 500 gms,4,35,30,5,1
03-03-2025,"Grains, Flours & Dals",UDALU (Barnyard millet) 500 gms,4,70,60,10,1
03-03-2025,Milk & Dairy,BROWN EGGS 1P,7,84,72,12,6
03-03-2025,Snacks & Ready-to-Eat,SS IDLY BATTER 1KG,14,60,60,0,1
03-03-2025,Pickles & Cooking Pastes,SD MANGO PICKLE,11,110,110,0,1
03-03-2025,"Grains, Flours & Dals",SINGLE POLISH 1KG,4,650,650,0,10
03-03-2025,"Grains, Flours & Dals",SL Idly Rava 1KG,4,65,55,10,1
03-03-2025,Pooja & Spiritual Items,GD Ramayana Sandal 75GM,12,60,60,0,1
03-03-2025,Pooja & Spiritual Items,SIVA JOOTHI 365 DEEPAPU,12,50,50,0,2
03-03-2025,Spices & Seasonings,SREE MARUTHI IDLY KARAM 200GM,15,60,60,0,1
03-03-2025,Milk & Dairy,BROWN EGGS 1P,7,168,144,24,12
03-03-2025,"Dry Fruits, Nuts & Seeds",SH GROUNDNUT 500GM,2,163,130,33,1
03-03-2025,"Grains, Flours & Dals",VL Sabdana 500GM,4,77,77,0,1
03-03-2025,Spices & Seasonings,Tamarind 250GMS,15,80,65,15,1
03-03-2025,"Dry Fruits, Nuts & Seeds",KAJU HALF 250GM,2,310,290,20,1
03-03-2025,Spices & Seasonings,SAJEERA,15,60,40,20,1
03-03-2025,Snacks & Ready-to-Eat,MIGHTY PUFFS KHATTA METTA,14,25,25,0,1
03-03-2025,Snacks & Ready-to-Eat,VD PALLI CHIKKI,14,80,80,0,1
03-03-2025,Sweeteners,NATURAL HONEY 1KG,16,560,480,80,1
03-03-2025,"Dry Fruits, Nuts & Seeds",WATERMELON SEEDS 250GRM,2,320,280,40,1
03-03-2025,"Dry Fruits, Nuts & Seeds",FLAX SEEDS 250GM,2,60,50,10,1
03-03-2025,Oils & Ghee,Groundnut oil 1 L,9,360,330,30,1
03-03-2025,"Dry Fruits, Nuts & Seeds",PUMPKIN SEEDS 250GM,2,200,160,40,1
03-03-2025,"Dry Fruits, Nuts & Seeds",SUNFLOWER SEEDS 250GRM,2,300,260,40,2
03-03-2025,Snacks & Ready-to-Eat,RAJGIRA PEANUT CHIKKI,14,10,10,0,2
03-03-2025,Spices & Seasonings,Gasagasalu 50GM,15,130,110,20,1
03-03-2025,"Grains, Flours & Dals",Wheat Flour 1 kg,4,140,120,20,2
03-03-2025,"Grains, Flours & Dals",RAGULU 1 KG,4,70,60,10,1
03-03-2025,"Dry Fruits, Nuts & Seeds",ANJEER 250GM,2,400,360,40,1
03-03-2025,Misc,ROLL D C,8,70,45,25,1
03-03-2025,Oils & Ghee,Sesame oil 1 L,9,1180,"1,120.00",60,2
03-03-2025,"Grains, Flours & Dals",AISHWARYA SP 25KG,4,1999,"1,690.00",309,1
03-03-2025,Oils & Ghee,Groundnut oil 1 L,9,720,660,60,2
03-03-2025,Oils & Ghee,Groundnut oil 1 L,9,360,330,30,1
03-03-2025,Spices & Seasonings,AV Iodized Salt 1KG,15,28,25,3,1
03-03-2025,"Grains, Flours & Dals",EM Ragi upma R 500g,4,75,75,0,1
03-03-2025,"Dry Fruits, Nuts & Seeds",Putnalu 250GM,2,45,38,7,1
03-03-2025,Oils & Ghee,Safflower oil 1 L,9,440,400,40,1
03-03-2025,"Dry Fruits, Nuts & Seeds",KAJU HALF 250GM,2,310,290,20,1
03-03-2025,"Dry Fruits, Nuts & Seeds",Groundnuts 1 kg,2,190,170,20,1
03-03-2025,"Grains, Flours & Dals",AISHWARYA SP 1KG,4,400,350,50,5
03-03-2025,Snacks & Ready-to-Eat,SD Groundnut with palm jaggery 250gm,14,135,135,0,1
03-03-2025,Snacks & Ready-to-Eat,VD DAHI MIRCHI(SALTED) 100GM,14,45,45,0,1
03-03-2025,"Grains, Flours & Dals",HS Multimillet idly R 500 gms,4,65,65,0,1
03-03-2025,Personal Care & Cosmetics,ROUND LOOFAH,10,65,65,0,1
03-03-2025,Sweeteners,ACHUBELLAM 500GM,16,50,40,10,1
03-03-2025,Oils & Ghee,Groundnut oil 1 L,9,360,330,30,1
03-03-2025,"Grains, Flours & Dals",DISANO OATS 1KG,4,285,142.5,142.5,1
03-03-2025,Snacks & Ready-to-Eat,VD GUMMADI VADIYAM,14,75,75,0,1
03-03-2025,Snacks & Ready-to-Eat,VD DAHI MIRCHI(SALTED) 100GM,14,45,45,0,1
03-03-2025,"Grains, Flours & Dals",FLOUR CHARGE,4,12,12,0,1
03-03-2025,"Grains, Flours & Dals",CHANA DAL 500GM,4,70,60,10,1
03-03-2025,Oils & Ghee,Groundnut oil 1 L,9,720,660,60,2
03-03-2025,Oils & Ghee,Black Sesame oil 500 ml,9,220,190,30,1
03-03-2025,Spices & Seasonings,GS Pink Rock Salt 1KG,15,120,120,0,1
03-03-2025,Pooja & Spiritual Items,AMRUTHA SURABHI,12,80,80,0,1
03-03-2025,Snacks & Ready-to-Eat,MB LITTLE MILLET NOODLES 180G,14,95,95,0,1
03-03-2025,Pooja & Spiritual Items,DASANGAM DHOOP POWDER 50GM,12,86,86,0,2
03-03-2025,Snacks & Ready-to-Eat,KURNOOL MARMURA,14,70,55,15,1
03-03-2025,"Dry Fruits, Nuts & Seeds",Groundnuts 500 gms,2,95,85,10,1
03-03-2025,"Grains, Flours & Dals",DESI CHANA,4,25,25,0,1
03-03-2025,Spices & Seasonings,TATA SALT 1KG,15,30,30,0,1
03-03-2025,"Grains, Flours & Dals",Chana Flour 500 gms,4,70,65,5,1
03-03-2025,Snacks & Ready-to-Eat,SALTED PHALLI,14,65,65,0,1
03-03-2025,Snacks & Ready-to-Eat,PEANUT CHIKKI 450GM,14,125,125,0,1
03-03-2025,Oils & Ghee,Sesame oil 1 L,9,590,560,30,1
03-03-2025,Snacks & Ready-to-Eat,NGT CHATPATTA CHANA 90GM,14,50,50,0,2
03-03-2025,Snacks & Ready-to-Eat,ELITE ELAICHI RUSK 200GM,14,35,35,0,1
03-03-2025,"Grains, Flours & Dals",Wheat Flour 1 kg,4,700,600,100,10
03-03-2025,Snacks & Ready-to-Eat,Corn Chips 250GM,14,40,35,5,1
03-03-2025,"Grains, Flours & Dals",THICK POHA 500GM,4,40,35,5,1
03-03-2025,Oils & Ghee,Groundnut oil 1 L,9,720,660,60,2
03-03-2025,Oils & Ghee,Freedom Rice Bran Oil 1L,9,388,360,28,2
03-03-2025,"Grains, Flours & Dals",RICE FLOUR 1KG,4,70,55,15,1
03-03-2025,General Household & Kitchenware,SABEENA,3,15,15,0,1
03-03-2025,Spices & Seasonings,THREE MANGO RAI 200G,15,126,126,0,3
03-03-2025,Snacks & Ready-to-Eat,MASALA CHANA,14,25,25,0,1
03-03-2025,Oils & Ghee,Castor oil 200 ml,9,100,85,15,1
03-03-2025,Snacks & Ready-to-Eat,urban murmura,14,60,55,5,1
03-03-2025,Personal Care & Cosmetics,OVAL BODY LOOFAH,10,55,55,0,1
03-03-2025,"Dry Fruits, Nuts & Seeds",ANJEER 250GM,2,400,360,40,1
03-03-2025,"Grains, Flours & Dals",RAGI FLOUR 500GRMS,4,40,35,5,1
03-03-2025,"Grains, Flours & Dals",SRILALITHA MAIDA FLOUR 500G,4,32,32,0,1
03-03-2025,"Grains, Flours & Dals",Idly Rava L 1KG,4,60,50,10,1
03-03-2025,"Grains, Flours & Dals",SL Suji Rava 500GM,4,32,32,0,1
03-03-2025,Sweeteners,NATURAL HONEY 1KG,16,560,480,80,1
03-03-2025,Oils & Ghee,Groundnut oil 1 L,9,720,660,60,2
03-03-2025,"Grains, Flours & Dals",turdal 1kg,4,220,195,25,1
03-03-2025,Household & Cleaning,vim dish liquid,6,55,55,0,1
03-03-2025,Misc,ROLL D C,8,70,45,25,1
03-03-2025,Spices & Seasonings,Black Till 250GM,15,90,75,15,1
03-03-2025,Spices & Seasonings,ROYAL SAFFRON 400GRMS,15,65,65,0,1
03-03-2025,Pooja & Spiritual Items,GD Ramayana Sandal 75GM,12,60,60,0,1
03-03-2025,Pooja & Spiritual Items,SST 365 PURE COTTON POOJA,12,30,30,0,1
03-03-2025,"Grains, Flours & Dals",RICE FLOUR 500 GM,4,35,28,7,1
03-03-2025,Sweeteners,MISHRI D,16,40,30,10,1
03-03-2025,"Grains, Flours & Dals",Multigrain 1 kg,4,200,170,30,2
03-03-2025,"Grains, Flours & Dals",SA Sprouted Ragi Flour 500GM,4,69,69,0,1
03-03-2025,"Grains, Flours & Dals",Sathya Javva Wheat Rava 500GM,4,95,95,0,1
03-03-2025,"Dry Fruits, Nuts & Seeds",ROASTED FLAXSEED,2,75,75,0,1
03-03-2025,"Grains, Flours & Dals",SABDANA,4,40,35,5,1
03-03-2025,Snacks & Ready-to-Eat,Popcorn Seeds 250GM,14,45,40,5,1
03-03-2025,Snacks & Ready-to-Eat,BB VERMICELLI 1KG,14,95,90,5,1
03-03-2025,Spices & Seasonings,JEERA 250 gms,15,125,105,20,1
03-03-2025,"Grains, Flours & Dals",PESARA PAPPU 1 KG,4,170,145,25,1
03-03-2025,"Grains, Flours & Dals",Urad dall 1 Kg,4,370,340,30,2
03-03-2025,"Dry Fruits, Nuts & Seeds",Groundnuts 1 kg,2,190,170,20,1
03-03-2025,Milk & Dairy,BROWN EGGS TRAY 30P,7,360,330,30,1
03-03-2025,Oils & Ghee,Groundnut oil 1 L,9,360,330,30,1
03-03-2025,Spices & Seasonings,Tamarind 250GMS,15,160,130,30,2
03-03-2025,Oils & Ghee,Sesame oil 1 L,9,590,560,30,1
03-03-2025,"Grains, Flours & Dals",THICK POHA 1KG,4,80,70,10,1
03-03-2025,Spices & Seasonings,Tamarind 250GMS,15,80,65,15,1
03-03-2025,"Dry Fruits, Nuts & Seeds",BLACK KISMIS 250GM,2,175,140,35,1
03-03-2025,"Dry Fruits, Nuts & Seeds",YELLOW KISHMISH 250GM,2,130,110,20,1
03-03-2025,"Dry Fruits, Nuts & Seeds",DRYDATES YELLOW 250GM,2,270,240,30,2
03-03-2025,Snacks & Ready-to-Eat,MILK BREAD,14,30,30,0,1
03-03-2025,Snacks & Ready-to-Eat,SATHVI REGIVADA 200GM,14,720,540,180,9
03-03-2025,"Grains, Flours & Dals",THICK POHA 1KG,4,80,70,10,1
03-03-2025,Oils & Ghee,Safflower oil 1 L,9,440,400,40,1
03-03-2025,"Grains, Flours & Dals",Idly Rava L 1KG,4,60,50,10,1
03-03-2025,Spices & Seasonings,AVALU 100GM,15,25,20,5,1
03-03-2025,"Grains, Flours & Dals",PESARA PAPPU 1 KG,4,170,145,25,1
03-03-2025,Spices & Seasonings,JEERA 250 gms,15,125,105,20,1
03-03-2025,"Dry Fruits, Nuts & Seeds",PULMAKHANA 100 GM,2,180,170,10,1
03-03-2025,Spices & Seasonings,Masala Karam 250 gms,15,130,120,10,1
03-03-2025,Spices & Seasonings,SATHVI TURMERIC POWDER 500GM,15,180,130,50,1
03-03-2025,"Dry Fruits, Nuts & Seeds",ANJEER 250GM,2,400,360,40,1
03-03-2025,"Grains, Flours & Dals",Multigrain 1 kg,4,100,85,15,1
03-03-2025,Snacks & Ready-to-Eat,VD PALLI CHIKKI,14,160,160,0,2
03-03-2025,Oils & Ghee,Groundnut oil 1 L,9,720,660,60,2
03-03-2025,Pickles & Cooking Pastes,SD MANGO PICKLE,11,110,110,0,1
03-03-2025,"Grains, Flours & Dals",Wheat Rava M 1KG,4,65,55,10,1
03-03-2025,Spices & Seasonings,GROUNDNUT KARAM POWDER,15,65,65,0,1
03-03-2025,"Health, Wellness & Ayurvedic Products",UVIS NEEM OIL 100ML,5,110,110,0,1
03-03-2025,Spices & Seasonings,Telaga Pindi 250 GM,15,40,35,5,1
03-03-2025,Spices & Seasonings,NUVVULU 250GM,15,80,65,15,1
03-03-2025,"Health, Wellness & Ayurvedic Products",SAI DURGA MORINGA LEAVES 100GM,5,75,75,0,1
03-03-2025,Spices & Seasonings,SD Redgram Karam Powder 100GM,15,65,65,0,1
03-03-2025,Oils & Ghee,Coconut oil 1 L,9,440,400,40,1
03-03-2025,"Health, Wellness & Ayurvedic Products",AMLAKI CHOORNAM,5,100,100,0,1
03-03-2025,Oils & Ghee,Castor oil,9,95,85,10,1
03-03-2025,Snacks & Ready-to-Eat,VD Minapa papad 200gm,14,60,60,0,1
03-03-2025,Oils & Ghee,Sesame oil 500ml,9,295,280,15,1
03-03-2025,Pooja & Spiritual Items,SWASTIK CAMPHORE,12,90,90,0,1
03-03-2025,Pooja & Spiritual Items,GD TULASI 75GM,12,60,60,0,1
03-03-2025,"Dry Fruits, Nuts & Seeds",WALLNUTS 250GM,2,380,360,20,1
03-03-2025,Spices & Seasonings,Turmeric powder 250 gms,15,100,75,25,1
03-03-2025,Sweeteners,SUGAR 500 GM,16,60,50,10,2
03-03-2025,Pooja & Spiritual Items,SWASTIK PURE CAMPHOR 50GM,12,180,180,0,2
03-03-2025,"Grains, Flours & Dals",Green gram 1 kg,4,150,130,20,1
03-03-2025,"Grains, Flours & Dals",Green Batani 250GM,4,55,45,10,1
03-03-2025,"Dry Fruits, Nuts & Seeds",Groundnuts 500 gms,2,190,170,20,2
03-03-2025,"Grains, Flours & Dals",BASMATHI RICE 1KG,4,150,135,15,1
03-03-2025,"Grains, Flours & Dals",RICE FLOUR 500 GM,4,35,28,7,1
03-03-2025,Snacks & Ready-to-Eat,COPRA LADDU 200GM,14,100,80,20,1
03-03-2025,Spices & Seasonings,AV Iodized Salt 1KG,15,28,25,3,1
03-03-2025,Pooja & Spiritual Items,BHAVANI GP VATHULU,12,40,40,0,1
03-03-2025,Pooja & Spiritual Items,GD Bhagavatha Mallika 75GM,12,60,60,0,1
03-03-2025,Oils & Ghee,Sesame oil 1 L,9,590,560,30,1
03-03-2025,"Grains, Flours & Dals",URAD DALL,4,95,85,10,1
03-03-2025,"Grains, Flours & Dals",PESARA PAPPU 500GMS,4,85,75,10,1
03-03-2025,"Grains, Flours & Dals",RED WHEAT 1 KG,4,260,240,20,2
03-03-2025,"Grains, Flours & Dals",JOWAR YELLOW 1 K,4,50,45,5,0.5
03-03-2025,"Grains, Flours & Dals",FLOUR CHARGE,4,30,30,0,2.5
03-03-2025,Oils & Ghee,BUFFALLO GHEE 500ML,9,410,370,40,1
03-03-2025,"Grains, Flours & Dals",Multigrain 2 kgs,4,200,170,30,1
03-03-2025,Milk & Dairy,SANGAM FULL CREAM MILK 500ML,7,38,38,0,1
03-03-2025,Sweeteners,Natural Honey 1 kg,16,560,480,80,1
03-03-2025,Oils & Ghee,Safflower oil 1 L,9,440,400,40,1
03-03-2025,Oils & Ghee,Groundnut oil 1 L,9,360,330,30,1
03-03-2025,"Grains, Flours & Dals",KORRALU (FOXTAIL M) 1KG,4,300,220,80,2
03-03-2025,"Grains, Flours & Dals",SL Idly Rava 1KG,4,65,55,10,1
03-03-2025,Oils & Ghee,Coconut oil 1 L,9,440,400,40,1
03-03-2025,"Grains, Flours & Dals",Arikadu ( kodo),4,280,260,20,2
03-03-2025,Snacks & Ready-to-Eat,MB LITTLE MILLET NOODLES 180G,14,95,95,0,1
03-03-2025,Snacks & Ready-to-Eat,MB PEARL MILLET NOODLES 180GM,14,95,95,0,1
03-03-2025,"Grains, Flours & Dals",FLOUR CHARGE,4,60,60,0,5
03-03-2025,Snacks & Ready-to-Eat,VD GUMMADI VADIYAM,14,75,75,0,1
03-03-2025,Sweeteners,SUGAR 500 GM,16,30,25,5,1
03-03-2025,"Dry Fruits, Nuts & Seeds",WALLNUTS 250GM,2,380,360,20,1
03-03-2025,Snacks & Ready-to-Eat,VD GUMMADI VADIYAM,14,75,75,0,1
03-03-2025,Oils & Ghee,GANTASALA A2 COW GHEE 500ML,9,550,550,0,1
03-03-2025,Snacks & Ready-to-Eat,SD Vamu with palm jaggery 250gm,14,135,135,0,1
03-03-2025,Household & Cleaning,vim dish liquid,6,55,55,0,1
03-03-2025,Snacks & Ready-to-Eat,VD GUMMADI CHAKKA,14,130,130,0,1
03-03-2025,Snacks & Ready-to-Eat,SD JOWAR WITH PALM JAGGERY 250GM,14,135,135,0,1
03-03-2025,Household & Cleaning,vim small,6,30,30,0,2
03-03-2025,Snacks & Ready-to-Eat,BELLAM MINAPA SUNADULLU,14,240,240,0,2
03-03-2025,Snacks & Ready-to-Eat,SD KODO MILLET WITH PALM JAGGERY,14,135,135,0,1
03-03-2025,Snacks & Ready-to-Eat,VD MULTI CHAKKA,14,110,110,0,1
03-03-2025,Household & Cleaning,comfort lily fresh,6,58,58,0,1
03-03-2025,Oils & Ghee,Safflower oil 1 L,9,440,400,40,1
03-03-2025,Snacks & Ready-to-Eat,NGT CHATPATTA CHANA 90GM,14,25,25,0,1
03-03-2025,Oils & Ghee,Coconut oil 500 ml,9,220,200,20,1
03-03-2025,"Grains, Flours & Dals",RAGI FLOUR 500GRMS,4,80,70,10,2
03-03-2025,"Grains, Flours & Dals",RICE FLOUR 500 GM,4,35,28,7,1
03-03-2025,Oils & Ghee,Sesame oil 500ml,9,295,280,15,1
03-03-2025,"Grains, Flours & Dals",White jowar.F 1 kg,4,100,80,20,1
03-03-2025,"Grains, Flours & Dals",JOWAR WHITE 1 KG,4,40,35,5,0.5
03-03-2025,Snacks & Ready-to-Eat,VD PALLI CHIKKI,14,80,80,0,1
03-03-2025,"Dry Fruits, Nuts & Seeds",sabja seeds,2,80,70,10,1
03-03-2025,"Grains, Flours & Dals",BOMBAY RAVA,4,70,55,15,1
03-03-2025,"Grains, Flours & Dals",SAMALU (Little millet) 500 gms,4,85,65,20,1
03-03-2025,"Grains, Flours & Dals",RAGI FLOUR 1KG,4,80,70,10,1
03-03-2025,Snacks & Ready-to-Eat,VD MULTI CHAKKA,14,110,110,0,1
03-03-2025,"Grains, Flours & Dals",RAGI FLOUR 1KG,4,80,70,10,1
03-03-2025,Spices & Seasonings,RED COPRA 500GM,15,170,148,22,1
03-03-2025,Spices & Seasonings,dalchin chekka,15,50,40,10,1
03-03-2025,"Grains, Flours & Dals",SAMALU,4,170,130,40,1
03-03-2025,"Grains, Flours & Dals",SINGLE POLISH 1KG,4,325,325,0,5
03-03-2025,Snacks & Ready-to-Eat,VD PANIPURI 100GM,14,30,30,0,1
03-03-2025,"Grains, Flours & Dals",UDALU (Barnyard millet) 1 kg,4,140,115,25,1
03-03-2025,"Grains, Flours & Dals",White jowar.F 1 kg,4,100,80,20,1
03-03-2025,Pooja & Spiritual Items,bilwa patra,12,60,60,0,1
03-03-2025,Misc,JOKER,8,4,4,0,2
03-03-2025,Spices & Seasonings,JEERA 250 gms,15,125,105,20,1
03-03-2025,Spices & Seasonings,DURGA SALT CRYSTAL 1KG,15,25,25,0,1
03-03-2025,Snacks & Ready-to-Eat,NGT CHATPATTA CHANA 90GM,14,25,25,0,1
03-03-2025,"Grains, Flours & Dals",Arikadu ( kodo),4,140,130,10,1
03-03-2025,Personal Care & Cosmetics,MESWAK 100GM,10,70,70,0,1
03-03-2025,"Grains, Flours & Dals",Wheat Flour 1 kg,4,70,60,10,1
03-03-2025,Spices & Seasonings,LG 50GM,15,92,92,0,1
03-03-2025,"Dry Fruits, Nuts & Seeds",SATHVI CHIA SEEDS 100GM,2,100,80,20,1
03-03-2025,"Grains, Flours & Dals",SINGLE POLISH 1KG,4,130,130,0,2
03-03-2025,Oils & Ghee,Groundnut oil 1 L,9,360,330,30,1
03-03-2025,Snacks & Ready-to-Eat,RAGI LADDU,14,120,120,0,1
03-03-2025,Snacks & Ready-to-Eat,MIGHTY PUFFS CHEDDAR CHEESE,14,25,25,0,1
03-03-2025,Beverages,BRU GREEN LABEL 1.2G,1,4,4,0,2
03-03-2025,"Grains, Flours & Dals",ANDU KORRALU (Browntop.m) 1 kg,4,260,220,40,1
03-03-2025,"Grains, Flours & Dals",Arikadu ( kodo),4,140,130,10,1
03-03-2025,"Dry Fruits, Nuts & Seeds",SUNFLOWER SEEDS 250GRM,2,150,130,20,1
03-03-2025,"Grains, Flours & Dals",SAMALU,4,170,130,40,1
03-03-2025,"Grains, Flours & Dals",KORRALU (FOXTAIL M) 1KG,4,150,110,40,1
03-03-2025,"Dry Fruits, Nuts & Seeds",PUMPKIN SEEDS 250GM,2,200,160,40,1
03-03-2025,"Grains, Flours & Dals",UDALU (Barnyard millet) 1 kg,4,140,115,25,1
03-03-2025,Snacks & Ready-to-Eat,SD Atreyapuram DRY Fruit ghee,14,150,150,0,1
03-03-2025,Snacks & Ready-to-Eat,KURNOOL MARMURA,14,70,55,15,1
03-03-2025,"Grains, Flours & Dals",White jowar.F 1 kg,4,100,80,20,1
03-03-2025,Snacks & Ready-to-Eat,KURNOOL MARMURA,14,70,55,15,1
03-03-2025,"Grains, Flours & Dals",White jowar.F 1 kg,4,100,80,20,1
03-03-2025,Snacks & Ready-to-Eat,SD Atreyapuram DRY Fruit ghee,14,150,150,0,1
03-03-2025,Snacks & Ready-to-Eat,SD Atreyapuram DRY Fruit ghee,14,150,150,0,1
03-03-2025,Snacks & Ready-to-Eat,KURNOOL MARMURA,14,70,55,15,1
03-03-2025,"Grains, Flours & Dals",White jowar.F 1 kg,4,100,80,20,1
03-03-2025,"Grains, Flours & Dals",Brown RICE 1KG,4,140,130,10,2
03-03-2025,"Grains, Flours & Dals",RAGI FLOUR 500GRMS,4,40,35,5,1
03-03-2025,"Grains, Flours & Dals",ragipindi 500gms,4,40,35,5,1
03-03-2025,"Health, Wellness & Ayurvedic Products",DWI BHRINGARAJA TAILAM 100ML,5,150,150,0,1
03-03-2025,"Dry Fruits, Nuts & Seeds",YELLOW KISHMISH 250GM,2,130,110,20,1
03-03-2025,"Grains, Flours & Dals",KORRALU (FOXTAIL M) 500GM,4,65,55,10,1
03-03-2025,"Grains, Flours & Dals",unpolished turdall500grms,4,120,110,10,1
03-03-2025,Snacks & Ready-to-Eat,papad 1,14,35,35,0,1
03-03-2025,Pooja & Spiritual Items,javadhu 60,12,120,100,20,2
03-03-2025,"Grains, Flours & Dals",SAMALU (Little millet) 500 gms,4,85,65,20,1
03-03-2025,"Dry Fruits, Nuts & Seeds",SATHVI CHIA SEEDS 100GM,2,100,80,20,1
03-03-2025,"Grains, Flours & Dals",AISHWARYA SP 1KG,4,160,140,20,2
03-03-2025,Oils & Ghee,BUFFALLO GHEE 500ML,9,410,370,40,1
03-03-2025,Snacks & Ready-to-Eat,SESAME CHIKKI,14,120,100,20,1
03-03-2025,Snacks & Ready-to-Eat,SD Thati thandra 200gm,14,150,150,0,1
03-03-2025,Oils & Ghee,Groundnut oil 1 L,9,360,330,30,1
03-03-2025,Snacks & Ready-to-Eat,MILLET NOODLES CURRY MASALA,14,129,129,0,1
03-03-2025,"Dry Fruits, Nuts & Seeds",SABJA SEEDS 100GM,2,80,70,10,1
03-03-2025,Oils & Ghee,Coconut oil 1 L,9,440,400,40,1
03-03-2025,General Household & Kitchenware,nippo gold,3,72,72,0,4
03-03-2025,"Grains, Flours & Dals",JOWAR UPMA RAVA,4,65,65,0,1
03-03-2025,"Dry Fruits, Nuts & Seeds",YELLOW KISHMISH 250GM,2,130,110,20,1
03-03-2025,Sweeteners,Mishri 500GM,16,70,60,10,1
03-03-2025,"Grains, Flours & Dals",Chana Flour 500 gms,4,140,130,10,2
03-03-2025,Sweeteners,MISHRI D,16,40,30,10,1
03-03-2025,"Grains, Flours & Dals",Wheat Flour 1 kg,4,140,120,20,2
03-03-2025,Spices & Seasonings,GREEN SOUNF,15,60,40,20,1
03-03-2025,"Dry Fruits, Nuts & Seeds",SALTED PISTA 250GM,2,400,350,50,1
03-03-2025,"Grains, Flours & Dals",Sathya Javva Wheat Rava 500GM,4,190,190,0,2
03-03-2025,Sweeteners,Mishri 500GM,16,70,60,10,1
03-03-2025,Oils & Ghee,Sesame oil 500ml,9,295,280,15,1
03-03-2025,Snacks & Ready-to-Eat,VD SAGOPAPAD 150GM,14,55,55,0,1
03-03-2025,Sweeteners,SUGAR 1KG,16,120,100,20,2
03-03-2025,Snacks & Ready-to-Eat,MIX MILLET NOODLES,14,150,150,0,2
03-03-2025,"Dry Fruits, Nuts & Seeds",WALLNUTS 250GM,2,380,360,20,1
03-03-2025,"Grains, Flours & Dals",Brown RICE 1KG,4,700,650,50,10
03-03-2025,"Grains, Flours & Dals",SRILATHA RICE RAVVA 500GM,4,70,70,0,2
03-03-2025,Personal Care & Cosmetics,MESWAK 100GM,10,70,70,0,1
03-03-2025,Spices & Seasonings,Chilli powder 500 gms,15,290,210,80,1
03-03-2025,"Grains, Flours & Dals",Multigrain 1 kg,4,100,85,15,1
03-03-2025,"Dry Fruits, Nuts & Seeds",SALTED PISTA 250GM,2,400,350,50,1
03-03-2025,"Health, Wellness & Ayurvedic Products",MH Millets Malt 1KG,5,400,380,20,1
03-03-2025,"Grains, Flours & Dals",VGR RICE 5 KGS,4,350,325,25,1
03-03-2025,Spices & Seasonings,ROYAL SAFFRON,15,125,125,0,1
03-03-2025,Pooja & Spiritual Items,GD Sree Chandan 50GM,12,100,100,0,2
03-03-2025,"Grains, Flours & Dals",KORRALU (FOXTAIL M) 1KG,4,150,110,40,1
03-03-2025,Sweeteners,SD PALM JAGGERY 500GM,16,200,200,0,1
03-03-2025,Sweeteners,YB JAGGERY POWDER 1KG,16,140,140,0,1
03-03-2025,"Grains, Flours & Dals",Arikadu ( kodo),4,140,130,10,1
03-03-2025,Snacks & Ready-to-Eat,VD MANGO JELLY 250GRMS,14,160,160,0,2
03-03-2025,Snacks & Ready-to-Eat,SD Thati thandra 200gm,14,150,150,0,1
03-03-2025,General Household & Kitchenware,CANDLE,3,60,60,0,2
03-03-2025,Sweeteners,YB Brown Sugar 500GM,16,75,75,0,1
03-03-2025,"Grains, Flours & Dals",Green gram 1 kg,4,150,130,20,1
03-03-2025,"Grains, Flours & Dals",Urad dall 1 Kg,4,370,340,30,2
03-03-2025,Spices & Seasonings,Coriander seeds 200 gms,15,48,40,8,1
03-03-2025,"Dry Fruits, Nuts & Seeds",PUTNALU 500GMS,2,90,76,14,1
03-03-2025,Spices & Seasonings,Jeera 100GM,15,50,45,5,1
03-03-2025,Oils & Ghee,Sesame oil 1 L,9,1180,"1,120.00",60,2
03-03-2025,"Grains, Flours & Dals",Multigrain 1 kg,4,100,85,15,1
03-03-2025,Spices & Seasonings,dalchin chekka,15,50,40,10,1
03-03-2025,"Dry Fruits, Nuts & Seeds",DRYDATES YELLOW 250GM,2,135,120,15,1
03-03-2025,Oils & Ghee,Groundnut oil 1 L,9,360,330,30,1
03-03-2025,"Dry Fruits, Nuts & Seeds",FLAX SEEDS 250GM,2,60,50,10,1
03-03-2025,Spices & Seasonings,BIRYANI LEAF 10GM,15,30,20,10,1
03-03-2025,"Grains, Flours & Dals",turdal 1kg,4,220,195,25,1
03-03-2025,Sweeteners,MADHUR SUGAR 1KG,16,130,110,20,2
03-03-2025,Oils & Ghee,Groundnut oil 1 L,9,720,660,60,2
03-03-2025,Milk & Dairy,SANGAM TONED MILK 500ML,7,60,60,0,2
03-03-2025,"Dry Fruits, Nuts & Seeds",Groundnuts 1 kg,2,190,170,20,1
03-03-2025,"Grains, Flours & Dals",SL Suji Rava 500GM,4,64,64,0,2
03-03-2025,Oils & Ghee,cow ghee 500 ml,9,430,390,40,1
03-03-2025,"Grains, Flours & Dals",Wheat Flour 1 kg,4,70,60,10,1
03-03-2025,Snacks & Ready-to-Eat,COPRA LADDU 200GM,14,100,80,20,1
03-03-2025,"Grains, Flours & Dals",EM Foxtail idli r 500 g,4,109,109,0,1
03-03-2025,Snacks & Ready-to-Eat,VD BOONDI 175GM,14,60,60,0,1
03-03-2025,Spices & Seasonings,JEERA 250 gms,15,125,105,20,1
03-03-2025,Snacks & Ready-to-Eat,DOSA BATTER 1KG,14,60,60,0,1
03-03-2025,Snacks & Ready-to-Eat,VD PALLI CHIKKI,14,80,80,0,1
03-03-2025,"Grains, Flours & Dals",KORRALU (FOXTAIL M) 500GM,4,65,55,10,1
03-03-2025,"Grains, Flours & Dals",ANDU KORRALU (Brown top .mlt) 500,4,130,110,20,1
03-03-2025,"Grains, Flours & Dals",UDALU (Barnyard millet) 500 gms,4,70,60,10,1
03-03-2025,Misc,ROLL D C,8,70,45,25,1
03-03-2025,Snacks & Ready-to-Eat,SESAME CHIKKI,14,120,100,20,1
03-03-2025,Oils & Ghee,Groundnut oil 1 L,9,720,660,60,2
03-03-2025,Spices & Seasonings,dalchin chekka,15,50,40,10,1
03-03-2025,Snacks & Ready-to-Eat,VD MURMURA LADDU,14,50,50,0,1
03-03-2025,Oils & Ghee,Groundnut oil 1 L,9,360,330,30,1
03-03-2025,"Dry Fruits, Nuts & Seeds",PUMPKIN SEEDS 250GM,2,200,160,40,1
03-03-2025,"Grains, Flours & Dals",SL Idly Rava 1KG,4,65,55,10,1
03-03-2025,"Grains, Flours & Dals",Wheat Rava M 500GM,4,33,30,3,1
03-03-2025,"Dry Fruits, Nuts & Seeds",Groundnuts 500 gms,2,95,85,10,1
03-03-2025,General Household & Kitchenware,SABEENA,3,30,30,0,1
03-03-2025,"Grains, Flours & Dals",SL Suji Rava 500GM,4,32,32,0,1
03-03-2025,"Dry Fruits, Nuts & Seeds",YELLOW KISHMISH 250GM,2,130,110,20,1
03-03-2025,Spices & Seasonings,DURGA SALT CRYSTAL 1KG,15,25,25,0,1
03-03-2025,"Grains, Flours & Dals",CHANA DAL 500GM,4,70,60,10,1
03-03-2025,Snacks & Ready-to-Eat,VD MINAPA MIRCHI PAPAD 195GM,14,60,60,0,1
03-03-2025,Spices & Seasonings,AVALU 100GM,15,25,20,5,1
03-03-2025,Snacks & Ready-to-Eat,BB VERMICELLY 500GM,14,53,53,0,1
03-03-2025,"Grains, Flours & Dals",DH URAD GOTA 1KG,4,430,380,50,2
03-03-2025,"Grains, Flours & Dals",SRILATHA RICE RAVVA 500GM,4,35,35,0,1
03-03-2025,Snacks & Ready-to-Eat,MUTLGRAIN BREAD,14,70,70,0,1
03-03-2025,Snacks & Ready-to-Eat,VD VAMUPUSA 175GM,14,60,60,0,1
03-03-2025,Household & Cleaning,vim,6,60,60,0,1
03-03-2025,Spices & Seasonings,Jeera 100GM,15,50,45,5,1
03-03-2025,"Dry Fruits, Nuts & Seeds",SUNFLOWER SEEDS 250GRM,2,150,130,20,1
03-03-2025,Household & Cleaning,surfexcel 500,6,0,0,0,1
03-03-2025,"Grains, Flours & Dals",HS MULTI UPMA RAVA,4,65,65,0,1
03-03-2025,"Grains, Flours & Dals",AISHWARYA SP 25KG,4,1999,"1,690.00",309,1
03-03-2025,"Grains, Flours & Dals",JOWAR YELLOW 1 K,4,50,45,5,0.5
03-03-2025,"Grains, Flours & Dals",VYS.SP RICE 1 KG,4,70,65,5,1
03-03-2025,"Grains, Flours & Dals",RAGULU 1 KG,4,35,30,5,0.5
03-03-2025,"Grains, Flours & Dals",Brown rice 5 kgs,4,350,325,25,1
03-03-2025,"Dry Fruits, Nuts & Seeds",PUMPKIN SEEDS 250GM,2,200,160,40,1
03-03-2025,"Dry Fruits, Nuts & Seeds",WATERMELON SEEDS 250GRM,2,320,280,40,1
03-03-2025,"Dry Fruits, Nuts & Seeds",FLAX SEEDS 250GM,2,120,100,20,2
03-03-2025,"Dry Fruits, Nuts & Seeds",YELLOW KISHMISH 250GM,2,130,110,20,1
03-03-2025,"Dry Fruits, Nuts & Seeds",SUNFLOWER SEEDS 250GRM,2,150,130,20,1
03-03-2025,Spices & Seasonings,YB PINK ROCK SALT 1KG,15,120,120,0,1
03-03-2025,Personal Care & Cosmetics,MESWAK 100GM,10,70,70,0,1
03-03-2025,"Grains, Flours & Dals",turdal 500 gms,4,110,100,10,1
03-03-2025,"Dry Fruits, Nuts & Seeds",Groundnuts 500 gms,2,95,85,10,1
03-03-2025,Beverages,ASSAM ELAICHI TEA,1,199,199,0,1
03-03-2025,Snacks & Ready-to-Eat,MARMURA LADDU,14,80,60,20,1
03-03-2025,"Dry Fruits, Nuts & Seeds",Groundnuts 1 kg,2,190,170,20,1
03-03-2025,Oils & Ghee,BUFFALLO GHEE 500ML,9,410,370,40,1
03-03-2025,Beverages,REFRESH SHARBATH NORMAL,1,199,190,9,1
03-03-2025,Sweeteners,NATURAL HONEY 1KG,16,560,480,80,1
03-03-2025,"Grains, Flours & Dals",SAMALU (Little millet) 500 gms,4,85,65,20,1
03-03-2025,"Grains, Flours & Dals",ANDU KORRALU (Brown top .mlt) 500,4,130,110,20,1
03-03-2025,"Grains, Flours & Dals",Quinova 500 gms,4,110,100,10,1
03-03-2025,"Grains, Flours & Dals",KORRALU (FOXTAIL M) 500GM,4,65,55,10,1
03-03-2025,"Grains, Flours & Dals",PLAIN OATS 1KG,4,52.5,52.5,0,0.25
03-03-2025,"Grains, Flours & Dals",JOWAR WHITE 1 KG,4,40,35,5,0.5
03-03-2025,"Grains, Flours & Dals",THIN POHA 500GM,4,80,70,10,2
03-03-2025,"Grains, Flours & Dals",White jowar.F 1 kg,4,200,160,40,2
03-03-2025,"Grains, Flours & Dals",KORRALU (FOXTAIL M) 1KG,4,150,110,40,1
03-03-2025,"Grains, Flours & Dals",RAGI FLOUR 1KG,4,80,70,10,1
03-03-2025,"Grains, Flours & Dals",Wheat Flour 1 kg,4,70,60,10,1
03-03-2025,"Dry Fruits, Nuts & Seeds",PULMAKHANA 100 GM,2,180,170,10,1
03-03-2025,"Grains, Flours & Dals",MELMEKER 250GMS,4,60,45,15,1
03-03-2025,"Grains, Flours & Dals",RICE FLOUR 1KG,4,140,110,30,2
03-03-2025,Oils & Ghee,Groundnut oil 1 L,9,720,660,60,2
02-03-2025,Oils & Ghee,Groundnut oil 1 L,9,720,660,60,2
02-03-2025,"Grains, Flours & Dals",Wheat Flour 1 kg,4,140,120,20,2
02-03-2025,"Dry Fruits, Nuts & Seeds",SALTED PISTA 250GM,2,400,350,50,1
02-03-2025,Snacks & Ready-to-Eat,JUNNU POWDER 100GM,14,140,140,0,2
02-03-2025,Spices & Seasonings,ROYAL SAFFRON 400GRMS,15,65,65,0,1
02-03-2025,Spices & Seasonings,ROYAL SAFFRON 400GRMS,15,65,65,0,1
02-03-2025,Sweeteners,MISHRI D,16,40,30,10,1
02-03-2025,"Grains, Flours & Dals",AISHWARYA RICE RAVA SP 500GRMS,4,60,42,18,1
02-03-2025,Sweeteners,NATURAL HONEY 1KG,16,560,480,80,1
02-03-2025,"Grains, Flours & Dals",Em Multimillet idli r 500g,4,129,129,0,1
02-03-2025,"Grains, Flours & Dals",Arikalu (kodo),4,70,65,5,1
02-03-2025,"Grains, Flours & Dals",KORRALU (FOXTAIL M) 500GM,4,65,55,10,1
02-03-2025,"Grains, Flours & Dals",Quinova 500 gms,4,110,100,10,1
02-03-2025,"Grains, Flours & Dals",UDALU (Barnyard millet) 500 gms,4,70,60,10,1
02-03-2025,"Grains, Flours & Dals",SAMALU (Little millet) 500 gms,4,85,65,20,1
02-03-2025,"Dry Fruits, Nuts & Seeds",SABJA SEEDS 100GM,2,80,70,10,1
02-03-2025,"Grains, Flours & Dals",JOWAR WHITE 1 KG,4,400,350,50,5
02-03-2025,Snacks & Ready-to-Eat,VD PALLI LADDU,14,80,80,0,1
02-03-2025,"Grains, Flours & Dals",Idly Rava L 1KG,4,120,100,20,2
02-03-2025,Oils & Ghee,Groundnut oil 1 L,9,360,330,30,1
02-03-2025,"Grains, Flours & Dals",Multigrain 1 kg,4,400,340,60,4
02-03-2025,Oils & Ghee,Sesame oil 1 L,9,590,560,30,1
02-03-2025,"Health, Wellness & Ayurvedic Products",AMLA PACHAK,5,100,100,0,1
02-03-2025,Personal Care & Cosmetics,YB Bath Powder 200GM,10,100,100,0,1
02-03-2025,Snacks & Ready-to-Eat,VD MURMURA LADDU,14,50,50,0,1
02-03-2025,Snacks & Ready-to-Eat,COPRA LADDU 200GM,14,200,160,40,2
02-03-2025,"Grains, Flours & Dals",RICE FLOUR 1KG,4,70,55,15,1
02-03-2025,Oils & Ghee,Groundnut oil 1 L,9,360,330,30,1
02-03-2025,Snacks & Ready-to-Eat,SD DrybFruit LADDU WITH DATES 175GM,14,170,170,0,1
02-03-2025,Oils & Ghee,Sesame oil 1 L,9,590,560,30,1
02-03-2025,"Grains, Flours & Dals",SPLIT BLACK GRAM 500 GM,4,180,170,10,2
02-03-2025,Snacks & Ready-to-Eat,VD MINAPA VADIYAM,14,65,65,0,1
02-03-2025,Snacks & Ready-to-Eat,FOXTAIL NOODLES,14,75,75,0,1
02-03-2025,Snacks & Ready-to-Eat,VD VAMUPUSA 175GM,14,60,60,0,1
02-03-2025,Oils & Ghee,Coconut oil 500 ml,9,220,200,20,1
02-03-2025,"Grains, Flours & Dals",PESARA PAPPU 500GMS,4,85,75,10,1
02-03-2025,Snacks & Ready-to-Eat,VD MURUKU 175GM,14,60,60,0,1
02-03-2025,"Grains, Flours & Dals",Em Multimillet upma 500g,4,129,129,0,1
02-03-2025,"Grains, Flours & Dals",Sathya Javva Wheat Rava 500GM,4,95,95,0,1
02-03-2025,Spices & Seasonings,GS Pink Rock Salt 1KG,15,120,120,0,1
02-03-2025,Snacks & Ready-to-Eat,VD PALLI CHIKKI,14,80,80,0,1
02-03-2025,Snacks & Ready-to-Eat,MIGHTY PUFFS TOMATO,14,25,25,0,1
02-03-2025,"Grains, Flours & Dals",EM Ragi upma R 500g,4,75,75,0,1
02-03-2025,Snacks & Ready-to-Eat,VD MIXTURE 175 GM,14,60,60,0,1
02-03-2025,Oils & Ghee,Groundnut oil 5 L,9,1800,"1,600.00",200,1
02-03-2025,Oils & Ghee,Sesame oil 500ml,9,295,280,15,1
02-03-2025,"Dry Fruits, Nuts & Seeds",CASHEW,2,680,590,90,1
02-03-2025,Snacks & Ready-to-Eat,VD SANNAPUSA 175GM,14,60,60,0,1
02-03-2025,"Dry Fruits, Nuts & Seeds",Groundnuts 500 gms,2,95,85,10,1
02-03-2025,"Grains, Flours & Dals",turdal 500 gms,4,110,100,10,1
02-03-2025,"Grains, Flours & Dals",Wheat Rava M 500GM,4,33,30,3,1
02-03-2025,Pickles & Cooking Pastes,SD RED CHILLI PICKLE,11,110,110,0,1
02-03-2025,"Grains, Flours & Dals",Wheat Flour 1 kg,4,87.5,75,12.5,1.25
02-03-2025,Spices & Seasonings,Black Till 250GM,15,450,375,75,5
02-03-2025,"Health, Wellness & Ayurvedic Products",RB Nuts& Seeds cashews 35g,5,90,90,0,2
02-03-2025,Snacks & Ready-to-Eat,RITEBITE BLUEBERRY BLAST,14,50,50,0,1
02-03-2025,Pooja & Spiritual Items,NAGA SINDHURAM,12,40,40,0,1
02-03-2025,Snacks & Ready-to-Eat,VD MURMURA LADDU,14,50,50,0,1
02-03-2025,Spices & Seasonings,FLAXSEED KARAM,15,75,75,0,1
02-03-2025,"Dry Fruits, Nuts & Seeds",SD Mango cubes 200gm,2,90,90,0,1
02-03-2025,"Health, Wellness & Ayurvedic Products",RB FRUITS &amp;seeds Cranberries,5,45,45,0,1
02-03-2025,"Dry Fruits, Nuts & Seeds",SABJA SEEDS 100GM,2,80,70,10,1
02-03-2025,Snacks & Ready-to-Eat,RI Yogurt Berry Oats 35g,14,45,45,0,1
02-03-2025,Oils & Ghee,cow ghee 500 ml,9,430,390,40,1
02-03-2025,"Grains, Flours & Dals",Wheat Flour 1 kg,4,350,300,50,5
02-03-2025,Snacks & Ready-to-Eat,RSC ORANGE 100GMS,14,20,20,0,1
02-03-2025,"Grains, Flours & Dals",VGR RICE 5 KGS,4,350,325,25,1
02-03-2025,Pooja & Spiritual Items,SOSR SWATHHI 365,12,60,60,0,2
02-03-2025,Sweeteners,NATURAL HONEY 1KG,16,560,480,80,1
02-03-2025,Pooja & Spiritual Items,GD Aiswarya Deepam 700ML,12,195,195,0,1
02-03-2025,Beverages,REFRESH SHARBATH NORMAL,1,199,190,9,1
02-03-2025,Oils & Ghee,Groundnut oil 5 L,9,1800,"1,600.00",200,1
02-03-2025,Snacks & Ready-to-Eat,BATANA NGT 70GMS,14,20,20,0,1
02-03-2025,Pooja & Spiritual Items,BALAJI LAVENDER DOOP STICK 10STK,12,250,250,0,2
02-03-2025,"Grains, Flours & Dals",RAGI FLOUR 500GRMS,4,40,35,5,1
02-03-2025,"Grains, Flours & Dals",Wheat Flour 1 kg,4,70,60,10,1
02-03-2025,"Grains, Flours & Dals",White jowar.F 1 kg,4,300,240,60,3
02-03-2025,Spices & Seasonings,Turmeric powder 250 gms,15,100,75,25,1
02-03-2025,Pooja & Spiritual Items,BALAJI SANDAL DHOOP STICKS 10STK,12,125,125,0,1
02-03-2025,"Health, Wellness & Ayurvedic Products",UVIS NEEM OIL 100ML,5,120,120,0,1
02-03-2025,"Grains, Flours & Dals",RAGI FLOUR 500GRMS,4,40,35,5,1
02-03-2025,Spices & Seasonings,Tamarind 250GMS,15,80,65,15,1
02-03-2025,Oils & Ghee,Safflower oil 1 L,9,440,400,40,1
02-03-2025,"Grains, Flours & Dals",ANDU KORRALU (Browntop.m) 1 kg,4,260,220,40,1
02-03-2025,Snacks & Ready-to-Eat,SD Ginger Candy 100g,14,60,60,0,1
02-03-2025,"Grains, Flours & Dals",SAMALU,4,170,130,40,1
02-03-2025,Snacks & Ready-to-Eat,urban murmura,14,60,55,5,1
02-03-2025,Oils & Ghee,Groundnut oil 1 L,9,360,330,30,1
02-03-2025,Spices & Seasonings,Tamarind 250GMS,15,80,65,15,1
02-03-2025,Oils & Ghee,Sesame oil 1 L,9,590,560,30,1
02-03-2025,"Grains, Flours & Dals",BOMBAY RAVA,4,70,55,15,1
02-03-2025,Milk & Dairy,SANGAM CURD 450GM,7,38,38,0,1
02-03-2025,Snacks & Ready-to-Eat,VD CORNFLAKES MIXTURE 175GM,14,60,60,0,1
02-03-2025,"Grains, Flours & Dals",RAGI FLOUR 500GRMS,4,40,35,5,1
02-03-2025,"Grains, Flours & Dals",Wheat Flour 1 kg,4,70,60,10,1
02-03-2025,Spices & Seasonings,Elaichi 25GM,15,145,120,25,1
02-03-2025,"Grains, Flours & Dals",Wheat Rava M 1KG,4,65,55,10,1
02-03-2025,Sweeteners,SH JAGGERY POWDER 500GM,16,80,68,12,1
02-03-2025,"Dry Fruits, Nuts & Seeds",Groundnuts 500 gms,2,95,85,10,1
02-03-2025,"Grains, Flours & Dals",KORRALU (FOXTAIL M) 500GM,4,65,55,10,1
02-03-2025,"Health, Wellness & Ayurvedic Products",ZINDA TILISMATH 5ML,5,70,70,0,1
02-03-2025,"Grains, Flours & Dals",JOWAR WHITE 1 KG,4,40,35,5,0.5
02-03-2025,Personal Care & Cosmetics,UVIS SANDALWOOD POWDR 100gm,10,0,0,0,1
02-03-2025,"Grains, Flours & Dals",RAGI FLOUR 500GRMS,4,40,35,5,1
02-03-2025,Personal Care & Cosmetics,UVIS MULTANI MITTI PW 100GM,10,49,49,0,1
02-03-2025,Spices & Seasonings,SH CASSIA STICKS 50GM,15,75,75,0,1
02-03-2025,"Grains, Flours & Dals",Multigrain 1 kg,4,100,85,15,1
02-03-2025,"Dry Fruits, Nuts & Seeds",SATHVI CHIA SEEDS 100GM,2,100,80,20,1
02-03-2025,Pooja & Spiritual Items,GD Bhagavatha Mallika 75GM,12,60,60,0,1
02-03-2025,Personal Care & Cosmetics,GOW DURBAR 75G,10,60,60,0,1
02-03-2025,Snacks & Ready-to-Eat,SD Atreyapuram DRY Fruit ghee,14,150,150,0,1
02-03-2025,Pooja & Spiritual Items,GD WOODS 150GM,12,110,110,0,1
02-03-2025,Pooja & Spiritual Items,GD Aiswarya Deepam 700ML,12,195,195,0,1
02-03-2025,"Grains, Flours & Dals",KORRALU (FOXTAIL M) 1KG,4,150,110,40,1
02-03-2025,"Dry Fruits, Nuts & Seeds",MAHA BEERA SEEDS 100GM,2,60,60,0,1
02-03-2025,"Grains, Flours & Dals",Green gram 1 kg,4,150,130,20,1
02-03-2025,Personal Care & Cosmetics,DWIBHASHI GULABA ARKA ROSA WATER,10,60,60,0,1
02-03-2025,"Grains, Flours & Dals",split green gram 500 gms,4,75,70,5,1
02-03-2025,"Grains, Flours & Dals",white Bobarlu 500 gms,4,80,75,5,1
02-03-2025,"Dry Fruits, Nuts & Seeds",Groundnuts 1 kg,2,190,170,20,1
02-03-2025,"Grains, Flours & Dals",ANDU KORRALU (Browntop.m) 1 kg,4,260,220,40,1
02-03-2025,Pooja & Spiritual Items,GD TULASI 75GM,12,60,60,0,1
02-03-2025,"Grains, Flours & Dals",UNPOLISHED TURDALL 1KG,4,240,210,30,1
02-03-2025,"Grains, Flours & Dals",PESARA PAPPU 500GMS,4,85,75,10,1
02-03-2025,Oils & Ghee,Safflower oil 1 L,9,440,400,40,1
02-03-2025,Oils & Ghee,cow ghee 500 ml,9,430,390,40,1
02-03-2025,Oils & Ghee,Groundnut oil 1 L,9,720,660,60,2
02-03-2025,Snacks & Ready-to-Eat,VD PALLI CHIKKI,14,80,80,0,1
02-03-2025,"Grains, Flours & Dals",JOWAR WHITE 1 KG,4,80,70,10,1
02-03-2025,"Grains, Flours & Dals",white Bobarlu 500 gms,4,80,75,5,1
02-03-2025,"Grains, Flours & Dals",WHITE BATANI,4,40,30,10,1
02-03-2025,Snacks & Ready-to-Eat,VD Minapa papad 200gm,14,60,60,0,1
02-03-2025,Snacks & Ready-to-Eat,RSC ORANGE 100GMS,14,20,20,0,1
02-03-2025,"Grains, Flours & Dals",RAGULU 1 KG,4,70,60,10,1
02-03-2025,"Grains, Flours & Dals",Multigrain 1 kg,4,100,85,15,1
02-03-2025,Sweeteners,ACHUBELLAM 500GM,16,50,40,10,1
02-03-2025,Sweeteners,GS JAGGERY NUGGETS 500GM,16,120,120,0,1
02-03-2025,Snacks & Ready-to-Eat,millet noodles sf,14,35,35,0,1
02-03-2025,Pooja & Spiritual Items,GOW DURBAR GEETHA CAMPHOR,12,60,60,0,1
02-03-2025,Snacks & Ready-to-Eat,SESAME CHIKKI,14,120,100,20,1
02-03-2025,Snacks & Ready-to-Eat,COPRA LADDU 200GM,14,100,80,20,1
02-03-2025,Oils & Ghee,Groundnut oil 5 L,9,1800,"1,600.00",200,1
02-03-2025,"Dry Fruits, Nuts & Seeds",SD Mango cubes 200gm,2,90,90,0,1
02-03-2025,Snacks & Ready-to-Eat,VD JAGGERY GHEE 250GM,14,120,120,0,1
02-03-2025,Snacks & Ready-to-Eat,SD Atreyapuram DRY Fruit ghee,14,150,150,0,1
02-03-2025,Oils & Ghee,Groundnut oil 5 L,9,1800,"1,600.00",200,1
02-03-2025,Spices & Seasonings,Coriander seeds 200 gms,15,48,40,8,1
02-03-2025,"Dry Fruits, Nuts & Seeds",CASHEW,2,680,590,90,1
02-03-2025,"Grains, Flours & Dals",PN ORGANIC KALA CHANA 500GM,4,119,119,0,1
02-03-2025,Spices & Seasonings,SH BAY LEAF / TEJ PATTA 30GM,15,35,35,0,1
02-03-2025,"Grains, Flours & Dals",Wheat Flour 2 kgs,4,140,120,20,1
02-03-2025,"Grains, Flours & Dals",RAGI FLOUR 500GRMS,4,40,35,5,1
02-03-2025,Snacks & Ready-to-Eat,VD PANIPURI 100GM,14,30,30,0,1
02-03-2025,Snacks & Ready-to-Eat,MARMURA LADDU,14,80,60,20,1
02-03-2025,"Grains, Flours & Dals",MELMEKER 250GMS,4,60,45,15,1
02-03-2025,Personal Care & Cosmetics,UVIS SANDALWOOD POWDR 100gm,10,0,0,0,1
02-03-2025,"Health, Wellness & Ayurvedic Products",ZINDA TILISMATH 5ML,5,70,70,0,1
02-03-2025,Spices & Seasonings,SH CASSIA STICKS 50GM,15,75,75,0,1
02-03-2025,"Dry Fruits, Nuts & Seeds",SATHVI CHIA SEEDS 100GM,2,100,80,20,1
02-03-2025,"Grains, Flours & Dals",Multigrain 1 kg,4,100,85,15,1
02-03-2025,"Grains, Flours & Dals",RAGI FLOUR 500GRMS,4,40,35,5,1
02-03-2025,Personal Care & Cosmetics,UVIS MULTANI MITTI PW 100GM,10,49,49,0,1
02-03-2025,Pooja & Spiritual Items,GD Bhagavatha Mallika 75GM,12,60,60,0,1
02-03-2025,"Grains, Flours & Dals",RAGI FLOUR 500GRMS,4,40,35,5,1
02-03-2025,"Grains, Flours & Dals",Multigrain 1 kg,4,100,85,15,1
02-03-2025,Oils & Ghee,Coconut oil 500 ml,9,220,200,20,1
02-03-2025,"Grains, Flours & Dals",SABDANA 500GM,4,90,70,20,1
02-03-2025,"Dry Fruits, Nuts & Seeds",Groundnuts 1 kg,2,190,170,20,1
02-03-2025,Spices & Seasonings,NUVVULU 500GM,15,200,170,30,1
02-03-2025,"Grains, Flours & Dals",MAIDA 1KG,4,70,60,10,1
02-03-2025,Oils & Ghee,Safflower oil 1 L,9,440,400,40,1
02-03-2025,Snacks & Ready-to-Eat,NGT CHATPATTA CHANA 90GM,14,25,25,0,1
02-03-2025,"Grains, Flours & Dals",FLOUR CHARGE,4,50.4,50.4,0,4.2
02-03-2025,Snacks & Ready-to-Eat,KURNOOL MARMURA,14,70,55,15,1
02-03-2025,Snacks & Ready-to-Eat,GB SALT COOKIES,14,60,55,5,1
02-03-2025,Snacks & Ready-to-Eat,VD BOONDI 175GM,14,60,60,0,1
02-03-2025,Snacks & Ready-to-Eat,ONION RINGS,14,50,50,0,1
02-03-2025,Snacks & Ready-to-Eat,SD JOWAR WITH PALM JAGGERY 250GM,14,135,135,0,1
02-03-2025,Snacks & Ready-to-Eat,VD MURMURA LADDU,14,50,50,0,1
02-03-2025,Oils & Ghee,Sesame oil 1 L,9,590,560,30,1
02-03-2025,Snacks & Ready-to-Eat,SATHVI REGIVADA 200GM,14,80,60,20,1
02-03-2025,Oils & Ghee,BUFFALLO GHEE 500ML,9,410,370,40,1
02-03-2025,Snacks & Ready-to-Eat,VD MULTI CHAKKA,14,110,110,0,1
02-03-2025,Snacks & Ready-to-Eat,SESAME CHIKKI,14,120,100,20,1
02-03-2025,"Grains, Flours & Dals",RAGI FLOUR 500GRMS,4,80,70,10,2
02-03-2025,Oils & Ghee,Coconut oil 500 ml,9,220,200,20,1
02-03-2025,"Grains, Flours & Dals",Red Bobarlu 500 gms,4,95,85,10,1
02-03-2025,Oils & Ghee,Coconut oil 1 L,9,440,400,40,1
02-03-2025,Personal Care & Cosmetics,ORAL B KIDS,10,50,50,0,2
02-03-2025,Snacks & Ready-to-Eat,PEANUT CHILLI,14,10,10,0,2
02-03-2025,"Grains, Flours & Dals",Brown RICE 1KG,4,70,65,5,1
02-03-2025,"Grains, Flours & Dals",Red Chana 500 GM,4,75,60,15,1
02-03-2025,"Health, Wellness & Ayurvedic Products",MH Millets Malt 500GM,5,200,190,10,1
02-03-2025,Snacks & Ready-to-Eat,PEANUT CHILLI,14,5,5,0,1
02-03-2025,General Household & Kitchenware,SIRIDHANYALU BOOK,3,200,180,20,1
02-03-2025,Personal Care & Cosmetics,MARGO,10,45,42,3,1
02-03-2025,Personal Care & Cosmetics,MYSORE SANDAL SOAP 75G,10,42,42,0,1
02-03-2025,"Grains, Flours & Dals",SA YELLOW JOWAR RAVA 500GM,4,190,190,0,2
02-03-2025,Pooja & Spiritual Items,BALAJI BEL PHOOL STICKS 90GM,12,60,60,0,1
02-03-2025,"Grains, Flours & Dals",Sathya Javva Wheat Rava 500GM,4,190,190,0,2
02-03-2025,Pooja & Spiritual Items,GD Kailash 60 GM,12,60,60,0,1
02-03-2025,"Grains, Flours & Dals",KORRALU (FOXTAIL M) 1KG,4,150,110,40,1
02-03-2025,Spices & Seasonings,Telaga Pindi 500GM,15,80,70,10,1
02-03-2025,"Grains, Flours & Dals",SAMALU,4,170,130,40,1
02-03-2025,Snacks & Ready-to-Eat,VD MIXTURE 175 GM,14,60,60,0,1
02-03-2025,"Grains, Flours & Dals",Wheat Rava S 500GM,4,33,30,3,1
02-03-2025,Sweeteners,NATURAL HONEY 1KG,16,560,480,80,1
02-03-2025,"Grains, Flours & Dals",BASMATHI RICE 1KG,4,300,270,30,2
02-03-2025,"Dry Fruits, Nuts & Seeds",Groundnuts 1 kg,2,190,170,20,1
02-03-2025,Snacks & Ready-to-Eat,MIGHTY PUFFS CHEDDAR CHEESE,14,50,50,0,2
02-03-2025,"Dry Fruits, Nuts & Seeds",PULMAKHANA 100 GM,2,180,170,10,1
02-03-2025,"Grains, Flours & Dals",Chittimuthaylu rice 1 kg,4,320,280,40,2
02-03-2025,Spices & Seasonings,DURGA SALT CRYSTAL 1KG,15,25,25,0,1
02-03-2025,Spices & Seasonings,Coriander seeds 200 gms,15,48,40,8,1
02-03-2025,Snacks & Ready-to-Eat,SATHVI REGIVADA 200GM,14,80,60,20,1
02-03-2025,Spices & Seasonings,GREEN SOUNF,15,60,40,20,1
02-03-2025,"Grains, Flours & Dals",THICK POHA 500GM,4,40,35,5,1
02-03-2025,Sweeteners,YB JAGGERY POWDER 500GMS,16,75,75,0,1
02-03-2025,"Grains, Flours & Dals",Wheat Flour 1 kg,4,70,60,10,1
02-03-2025,Household & Cleaning,VIM TROPICAL LEMON FRESHNESS 250ML,6,60,60,0,1
02-03-2025,Spices & Seasonings,Coconut Powder 250GM,15,90,90,0,1
02-03-2025,"Grains, Flours & Dals",maida 500grms,4,35,30,5,1
02-03-2025,"Grains, Flours & Dals",CHANA DAL 500GM,4,70,60,10,1
02-03-2025,"Grains, Flours & Dals",split black gram 1 kg,4,540,510,30,3
02-03-2025,"Dry Fruits, Nuts & Seeds",Groundnuts 1 kg,2,190,170,20,1
02-03-2025,"Grains, Flours & Dals",SL Idly Rava 1KG,4,195,165,30,3
02-03-2025,Beverages,GANTASALA TEJ DRY GINGER COFFEE,1,149,149,0,1
02-03-2025,Personal Care & Cosmetics,KAIPO SANDALWOOD SOAP 100GM,10,300,300,0,3
02-03-2025,"Grains, Flours & Dals",BOBBARA PAPPU 500GM,4,85,80,5,1
02-03-2025,Snacks & Ready-to-Eat,SD Ginger Candy 100g,14,60,60,0,1
02-03-2025,Spices & Seasonings,SD Garlic Karam Powder 100GM,15,65,65,0,1
02-03-2025,Snacks & Ready-to-Eat,WHOLE WHEAT BREAD,14,55,55,0,1
02-03-2025,"Grains, Flours & Dals",HS jowar idly rava 500 gms,4,65,65,0,1
02-03-2025,Personal Care & Cosmetics,UVIS RED SANDAL SOAP 100GM,10,90,90,0,1
02-03-2025,Pooja & Spiritual Items,BALAJI SANDAL DHOOP STICKS 10STK,12,125,125,0,1
02-03-2025,"Grains, Flours & Dals",AISHWARYA SP IDLY RAVA 1KG,4,120,66,54,1
02-03-2025,Snacks & Ready-to-Eat,SD JOWAR WITH PALM JAGGERY 250GM,14,135,135,0,1
02-03-2025,Oils & Ghee,Groundnut oil 1 L,9,360,330,30,1
02-03-2025,Personal Care & Cosmetics,DWI NEEM TULSI SOAP 100GM,10,300,300,0,3
02-03-2025,Oils & Ghee,Groundnut oil 500ml,9,180,165,15,1
02-03-2025,"Grains, Flours & Dals",EM Ragi idli R 500G,4,75,75,0,1
02-03-2025,Spices & Seasonings,Chilli powder 500 gms,15,290,210,80,1
02-03-2025,Snacks & Ready-to-Eat,SATHVI REGIVADA 200GM,14,80,60,20,1
02-03-2025,Personal Care & Cosmetics,NEEM SOAP 100GM,10,100,100,0,1
02-03-2025,Snacks & Ready-to-Eat,VD PALLI LADDU,14,80,80,0,1
02-03-2025,"Dry Fruits, Nuts & Seeds",Groundnuts 1 kg,2,190,170,20,1
02-03-2025,"Dry Fruits, Nuts & Seeds",YELLOW KISHMISH 250GM,2,130,110,20,1
02-03-2025,Snacks & Ready-to-Eat,NGT CHATPATTA CHANA 90GM,14,25,25,0,1
02-03-2025,"Dry Fruits, Nuts & Seeds",Putnalu 250GM,2,45,38,7,1
02-03-2025,"Grains, Flours & Dals",Multigrain 1 kg,4,100,85,15,1
02-03-2025,"Grains, Flours & Dals",SL Suji Rava 500GM,4,32,32,0,1
02-03-2025,Spices & Seasonings,Telaga Pindi 500GM,15,80,70,10,1
02-03-2025,"Grains, Flours & Dals",SINGLE POLISH 1KG,4,195,195,0,3
02-03-2025,Snacks & Ready-to-Eat,Popcorn Seeds 500GM,14,90,80,10,1
02-03-2025,"Grains, Flours & Dals",White jowar.F 1 kg,4,100,80,20,1
02-03-2025,"Grains, Flours & Dals",SL Suji Rava 500GM,4,32,32,0,1
02-03-2025,Spices & Seasonings,DURGA SALT CRYSTAL 1KG,15,25,25,0,1
02-03-2025,"Dry Fruits, Nuts & Seeds",Groundnuts 1 kg,2,190,170,20,1
02-03-2025,Spices & Seasonings,Vamu 100GM,15,60,50,10,1
02-03-2025,"Grains, Flours & Dals",HS Jowar upma rava 500 gms,4,65,65,0,1
02-03-2025,Misc,386627138,8,0,0,0,1
02-03-2025,Oils & Ghee,Safflower oil 1 L,9,440,400,40,1
02-03-2025,Oils & Ghee,Groundnut oil 1 L,9,720,660,60,2
02-03-2025,Spices & Seasonings,AV Iodized Salt 1KG,15,28,25,3,1
02-03-2025,"Grains, Flours & Dals",SL Idly Rava 1KG,4,65,55,10,1
02-03-2025,"Grains, Flours & Dals",Wheat Rava M 1KG,4,65,55,10,1
02-03-2025,Snacks & Ready-to-Eat,VD Pappu Chekkalu 190gm,14,60,60,0,1
02-03-2025,Personal Care & Cosmetics,MYSORE SANDAL SOAP 75G,10,84,84,0,2
02-03-2025,Spices & Seasonings,Avalu small 250 gms,15,60,40,20,1
02-03-2025,Snacks & Ready-to-Eat,VD MURUKU 175GM,14,60,60,0,1
02-03-2025,Oils & Ghee,Sesame oil 1 L,9,590,560,30,1
02-03-2025,"Grains, Flours & Dals",Wheat Flour 1 kg,4,70,60,10,1
02-03-2025,Spices & Seasonings,Jeera 100GM,15,100,90,10,2
02-03-2025,"Grains, Flours & Dals",Multigrain 1 kg,4,100,85,15,1
02-03-2025,Spices & Seasonings,SONTI 50GM,15,30,30,0,1
02-03-2025,"Grains, Flours & Dals",RAGI FLOUR 1KG,4,80,70,10,1
02-03-2025,Spices & Seasonings,Coriander seeds 200 gms,15,48,40,8,1
02-03-2025,"Health, Wellness & Ayurvedic Products",MH Millets Malt 500GM,5,200,190,10,1
02-03-2025,"Grains, Flours & Dals",KORRALU (FOXTAIL M) 500GM,4,65,55,10,1
02-03-2025,Snacks & Ready-to-Eat,Corn Chips 250GM,14,40,35,5,1
02-03-2025,Oils & Ghee,Groundnut oil 1 L,9,360,330,30,1
02-03-2025,Snacks & Ready-to-Eat,MAAGAANI M JOWAR PASTA 200GM,14,199,199,0,1
02-03-2025,Oils & Ghee,Groundnut oil 1 L,9,360,330,30,1
02-03-2025,"Dry Fruits, Nuts & Seeds",PUMPKIN SEEDS 250GM,2,200,160,40,1
02-03-2025,"Grains, Flours & Dals",CHANA DAL 500GM,4,70,60,10,1
02-03-2025,Snacks & Ready-to-Eat,SF NOODLES CLKASSIC MASALA,14,129,129,0,1
02-03-2025,Snacks & Ready-to-Eat,MILLET NOODLES CURRY MASALA,14,129,129,0,1
02-03-2025,"Grains, Flours & Dals",Green gram 500 gms,4,75,70,5,1
02-03-2025,Oils & Ghee,Sesame oil 1 L,9,590,560,30,1
02-03-2025,Snacks & Ready-to-Eat,VD MURUKU 175GM,14,60,60,0,1
02-03-2025,Personal Care & Cosmetics,DABUR ALMOND HAIR OIL 485ML,10,305,305,0,1
02-03-2025,Snacks & Ready-to-Eat,VD RIBBON PAKODI 175GM,14,60,60,0,1
02-03-2025,"Dry Fruits, Nuts & Seeds",SUNFLOWER SEEDS 250GRM,2,150,130,20,1
02-03-2025,Snacks & Ready-to-Eat,VD VAMUPUSA 175GM,14,60,60,0,1
02-03-2025,Snacks & Ready-to-Eat,VD MULTI CHAKKA,14,110,110,0,1
02-03-2025,Snacks & Ready-to-Eat,VD NUVULU CHEGODI 175GM,14,60,60,0,1
02-03-2025,"Dry Fruits, Nuts & Seeds",DRYDATES YELLOW 250GM,2,270,240,30,2
02-03-2025,Household & Cleaning,MR WHITE 1KG,6,95,95,0,1
02-03-2025,Snacks & Ready-to-Eat,SD JOWAR WITH PALM JAGGERY 250GM,14,135,135,0,1
02-03-2025,"Grains, Flours & Dals",HS JOWAR FLAKES 250GM 1+1,4,119,119,0,1
02-03-2025,"Grains, Flours & Dals",HS JOWAR FLAKES 250GM 1+1,4,119,119,0,1
02-03-2025,Snacks & Ready-to-Eat,SD KODO MILLET WITH PALM JAGGERY,14,135,135,0,1
02-03-2025,Snacks & Ready-to-Eat,SS IDLY BATTER 1KG,14,60,60,0,1
02-03-2025,Snacks & Ready-to-Eat,KURNOOL MARMURA,14,70,55,15,1
02-03-2025,Snacks & Ready-to-Eat,MIGHTY PUFF,14,25,25,0,1
02-03-2025,"Dry Fruits, Nuts & Seeds",ROASTED FLAXSEED,2,75,75,0,1
02-03-2025,"Grains, Flours & Dals",SAMALU (Little millet) 500 gms,4,85,65,20,1
02-03-2025,"Grains, Flours & Dals",PESARA PAPPU 500GMS,4,85,75,10,1
02-03-2025,Snacks & Ready-to-Eat,VD RIBBON PAKODI 175GM,14,60,60,0,1
02-03-2025,Spices & Seasonings,Tamarind 250GMS,15,80,65,15,1
02-03-2025,"Grains, Flours & Dals",BOMBAY RAVA,4,70,55,15,1
02-03-2025,Spices & Seasonings,Turmeric powder 250 gms,15,100,75,25,1
02-03-2025,"Grains, Flours & Dals",Urad dall 1 Kg,4,185,170,15,1
02-03-2025,"Dry Fruits, Nuts & Seeds",Groundnuts 500 gms,2,95,85,10,1
02-03-2025,Snacks & Ready-to-Eat,BB VERMICELLY 500GM,14,53,53,0,1
02-03-2025,"Dry Fruits, Nuts & Seeds",PUTNALU 500GMS,2,90,76,14,1
02-03-2025,"Grains, Flours & Dals",Chana Flour 500 gms,4,70,65,5,1
02-03-2025,Snacks & Ready-to-Eat,PEANUT CHILLI,14,10,10,0,2
02-03-2025,Snacks & Ready-to-Eat,RINGS 200GM,14,30,30,0,1
02-03-2025,"Grains, Flours & Dals",split black gram 1 kg,4,360,340,20,2
02-03-2025,Snacks & Ready-to-Eat,VD DRY FRUIT PUTHAREKULU,14,120,120,0,1
02-03-2025,Oils & Ghee,Groundnut oil 1 L,9,720,660,60,2
02-03-2025,"Grains, Flours & Dals",turdal 1kg,4,220,195,25,1
02-03-2025,"Grains, Flours & Dals",SL Idly Rava 1KG,4,65,55,10,1
02-03-2025,Snacks & Ready-to-Eat,VD MIXTURE 175 GM,14,60,60,0,1
02-03-2025,Snacks & Ready-to-Eat,COPRA LADDU 200GM,14,100,80,20,1
02-03-2025,"Grains, Flours & Dals",SL Idly Rava 1KG,4,65,55,10,1
02-03-2025,Snacks & Ready-to-Eat,SD Thati thandra 200gm,14,150,150,0,1
02-03-2025,"Grains, Flours & Dals",Bombay Rava 500GM,4,35,30,5,1
02-03-2025,Sweeteners,YB JAGGERY POWDER 500GMS,16,75,75,0,1
02-03-2025,Snacks & Ready-to-Eat,SATHVI REGIVADA 200GM,14,80,60,20,1
02-03-2025,"Dry Fruits, Nuts & Seeds",SUNFLOWER SEEDS 250GRM,2,150,130,20,1
02-03-2025,"Grains, Flours & Dals",FLOUR CHARGE,4,72,72,0,6
02-03-2025,Snacks & Ready-to-Eat,VD SAGOPAPAD 150GM,14,55,55,0,1
02-03-2025,Spices & Seasonings,SARVA CHAAT MASALA 100GM,15,85,85,0,1
02-03-2025,Snacks & Ready-to-Eat,VD SANNAPUSA 175GM,14,60,60,0,1
02-03-2025,Snacks & Ready-to-Eat,MARMURA LADDU,14,80,60,20,1
02-03-2025,Snacks & Ready-to-Eat,BATANA NGT 70GMS,14,20,20,0,1
02-03-2025,Snacks & Ready-to-Eat,VD MULTI CHAKKA,14,110,110,0,1
02-03-2025,Snacks & Ready-to-Eat,BELLAM MINAPA SUNADULLU,14,200,200,0,2
02-03-2025,Spices & Seasonings,Elaichi 25GM,15,145,120,25,1
02-03-2025,Snacks & Ready-to-Eat,VD MYSOREPAK 6PIC,14,100,100,0,1
02-03-2025,Snacks & Ready-to-Eat,Corn Chips 250GM,14,40,35,5,1
02-03-2025,Spices & Seasonings,SREE MARUTHI IDLY KARAM 200GM,15,60,60,0,1
02-03-2025,Snacks & Ready-to-Eat,VD CORNFLAKES MIXTURE 175GM,14,60,60,0,1
02-03-2025,Oils & Ghee,Coconut oil 1 L,9,440,400,40,1
02-03-2025,Snacks & Ready-to-Eat,SATHVI REGIVADA 200GM,14,80,60,20,1
02-03-2025,Oils & Ghee,Coconut oil 1 L,9,440,400,40,1
02-03-2025,Spices & Seasonings,Masala Karam 250 gms,15,130,120,10,1
02-03-2025,"Grains, Flours & Dals",Idly Rava L 1KG,4,60,50,10,1
02-03-2025,Oils & Ghee,Groundnut oil 1 L,9,360,330,30,1
02-03-2025,Personal Care & Cosmetics,stayfree,10,100,100,0,1
02-03-2025,"Grains, Flours & Dals",Wheat Rava M 500GM,4,33,30,3,1
02-03-2025,"Health, Wellness & Ayurvedic Products",MH Womens Malt 500GM,5,250,240,10,1
02-03-2025,Snacks & Ready-to-Eat,HS JOWAR BISCUITS,14,50,50,0,1
02-03-2025,Oils & Ghee,Freedom Rice Bran Oil 1L,9,582,540,42,3
02-03-2025,Snacks & Ready-to-Eat,SD Ginger Candy 100g,14,60,60,0,1
02-03-2025,Personal Care & Cosmetics,KHADI Neem Anti Dandruff Shampoo,10,199,199,0,1
02-03-2025,Personal Care & Cosmetics,EYETEX,10,10,10,0,2
02-03-2025,Spices & Seasonings,DRY MIECHI 200GM,15,80,60,20,1
02-03-2025,Milk & Dairy,SANGAM TONED MILK 500ML,7,30,30,0,1
02-03-2025,Personal Care & Cosmetics,OVAL BODY LOOFAH,10,110,110,0,2
02-03-2025,"Grains, Flours & Dals",Arikalu (kodo),4,70,65,5,1
02-03-2025,"Grains, Flours & Dals",KORRALU (FOXTAIL M) 500GM,4,65,55,10,1
02-03-2025,Snacks & Ready-to-Eat,RSC ORANGE 100GMS,14,20,20,0,1
02-03-2025,Snacks & Ready-to-Eat,MARMURA LADDU,14,80,60,20,1
02-03-2025,"Grains, Flours & Dals",split black gram 1 kg,4,180,170,10,1
02-03-2025,"Grains, Flours & Dals",UDALU (Barnyard millet) 500 gms,4,70,60,10,1
02-03-2025,"Grains, Flours & Dals",ANDU KORRALU (Brown top .mlt) 500,4,130,110,20,1
02-03-2025,"Grains, Flours & Dals",SAMALU (Little millet) 500 gms,4,85,65,20,1
02-03-2025,"Grains, Flours & Dals",Multigrain 1 kg,4,100,85,15,1
02-03-2025,"Grains, Flours & Dals",AISHWARYA SP 1KG,4,160,140,20,2
02-03-2025,"Dry Fruits, Nuts & Seeds",Groundnuts 500 gms,2,95,85,10,1
02-03-2025,Sweeteners,MISHRI 250 GM,16,35,30,5,1
02-03-2025,Spices & Seasonings,ROYAL SAFFRON 400GRMS,15,65,65,0,1
02-03-2025,"Dry Fruits, Nuts & Seeds",YB GRANMA NUTS,2,90,90,0,1
02-03-2025,Snacks & Ready-to-Eat,NGT CHATPATTA CHANA 90GM,14,50,50,0,2
02-03-2025,"Grains, Flours & Dals",Chana Flour 500 gms,4,70,65,5,1
02-03-2025,"Grains, Flours & Dals",POORI ATTA 1KG,4,140,120,20,2
02-03-2025,"Health, Wellness & Ayurvedic Products",MH Millets Malt 500GM,5,200,190,10,1
02-03-2025,Snacks & Ready-to-Eat,Pani Poori Chips 250GM,14,50,40,10,1
02-03-2025,Sweeteners,Mishri 500GM,16,70,60,10,1
02-03-2025,Snacks & Ready-to-Eat,GB SALT COOKIES,14,60,55,5,1
02-03-2025,"Dry Fruits, Nuts & Seeds",WALLNUTS 250GM,2,380,360,20,1
02-03-2025,Sweeteners,YB FOREST HONEY 250GM,16,180,180,0,1
02-03-2025,Spices & Seasonings,JEERA 250 gms,15,125,105,20,1
02-03-2025,Pooja & Spiritual Items,SWASTIK CAMPHORE,12,180,180,0,2
02-03-2025,Personal Care & Cosmetics,MYSORE SANDAL,10,69,69,0,1
02-03-2025,Sweeteners,SUGAR 1KG,16,120,100,20,2
02-03-2025,Household & Cleaning,SRI OS BLEACHING POWDER100GM,6,65,65,0,1
02-03-2025,"Grains, Flours & Dals",BAJRA 1 KG,4,60,50,10,1
02-03-2025,Spices & Seasonings,Coriander seeds 200 gms,15,48,40,8,1
02-03-2025,Milk & Dairy,SANGAM TONED MILK 500ML,7,30,30,0,1
02-03-2025,"Health, Wellness & Ayurvedic Products",ZINDA TILISMATH 5ML,5,70,70,0,1
02-03-2025,Sweeteners,MISHRI 250 GM,16,70,60,10,2
02-03-2025,"Grains, Flours & Dals",Green Batani 250GM,4,55,45,10,1
02-03-2025,Snacks & Ready-to-Eat,VD PALLI LADDU,14,160,160,0,2
02-03-2025,Spices & Seasonings,Menthulu 250 gms,15,50,45,5,1
02-03-2025,"Grains, Flours & Dals",Red Chana 500 GM,4,150,120,30,2
02-03-2025,"Grains, Flours & Dals",Em Multimillet idli r 500g,4,129,129,0,1
02-03-2025,"Health, Wellness & Ayurvedic Products",MH Millets Malt 500GM,5,200,190,10,1
02-03-2025,Snacks & Ready-to-Eat,GB SALT COOKIES,14,60,55,5,1
02-03-2025,Personal Care & Cosmetics,SANTOOR,10,120,100,20,1
02-03-2025,Personal Care & Cosmetics,BLACK NATURALS,10,84,84,0,2
02-03-2025,"Grains, Flours & Dals",SL Idly Rava 1KG,4,195,165,30,3
02-03-2025,Snacks & Ready-to-Eat,VAKKALU,14,160,120,40,2
02-03-2025,"Dry Fruits, Nuts & Seeds",Putnalu 250GM,2,45,38,7,1
02-03-2025,"Grains, Flours & Dals",THICK POHA 500GM,4,40,35,5,1
02-03-2025,Spices & Seasonings,SREE MARUTHI IDLY KARAM 200GM,15,60,60,0,1
02-03-2025,"Grains, Flours & Dals",PESARA PAPPU 500GMS,4,85,75,10,1
02-03-2025,Spices & Seasonings,Jeera 100GM,15,50,45,5,1
02-03-2025,"Grains, Flours & Dals",SABDANA 500GM,4,90,70,20,1
02-03-2025,"Dry Fruits, Nuts & Seeds",SABJA SEEDS 100GM,2,80,70,10,1
02-03-2025,Snacks & Ready-to-Eat,ELITE ELAICHI RUSK 200GM,14,35,35,0,1
02-03-2025,Oils & Ghee,Sesame oil 1 L,9,590,560,30,1
02-03-2025,Spices & Seasonings,NUVVULU 250GM,15,80,65,15,1
02-03-2025,Spices & Seasonings,Avalu small 250 gms,15,60,40,20,1
02-03-2025,Spices & Seasonings,Marati Magga 50GM,15,130,110,20,1
02-03-2025,"Grains, Flours & Dals",Wheat Flour 1 kg,4,70,60,10,1
02-03-2025,"Grains, Flours & Dals",split black gram 1 kg,4,180,170,10,1
02-03-2025,Sweeteners,Mishri 500GM,16,70,60,10,1
02-03-2025,"Grains, Flours & Dals",Idly Rava L 1KG,4,60,50,10,1
02-03-2025,Personal Care & Cosmetics,SUNNUPINDI SOAP UVS,10,297,297,0,3
02-03-2025,"Grains, Flours & Dals",RAGI FLOUR 1KG,4,80,70,10,1
02-03-2025,Spices & Seasonings,ROYAL SAFFRON,15,125,125,0,1
02-03-2025,Pooja & Spiritual Items,GD Aiswarya Deepam 700ML,12,195,195,0,1
02-03-2025,Personal Care & Cosmetics,ROUND LOOFAH,10,65,65,0,1
02-03-2025,Oils & Ghee,Groundnut oil 1 L,9,360,330,30,1
02-03-2025,Snacks & Ready-to-Eat,SD Ginger Candy 100g,14,240,240,0,4
02-03-2025,Oils & Ghee,Groundnut oil 1 L,9,360,330,30,1
02-03-2025,Oils & Ghee,Flaxseed oil 500 ml,9,300,270,30,1
02-03-2025,Snacks & Ready-to-Eat,NGT CHATPATTA CHANA 90GM,14,50,50,0,2
02-03-2025,Oils & Ghee,Safflower oil 1 L,9,440,400,40,1
02-03-2025,Snacks & Ready-to-Eat,VD RICE MURUKU 150GM,14,50,50,0,1
02-03-2025,"Grains, Flours & Dals",Multigrain 1 kg,4,200,170,30,2
02-03-2025,Oils & Ghee,Sesame oil 1 L,9,590,560,30,1
02-03-2025,General Household & Kitchenware,B1 bowl,3,399,399,0,1
02-03-2025,"Grains, Flours & Dals",idly/Dosa rice 1 kg,4,70,60,10,1
02-03-2025,Snacks & Ready-to-Eat,VD SAGOPAPAD 150GM,14,55,55,0,1
02-03-2025,"Grains, Flours & Dals",BASMATHI RICE 1KG,4,300,270,30,2
02-03-2025,Snacks & Ready-to-Eat,MIGHTY PUFFS TOMATO,14,25,25,0,1
02-03-2025,Snacks & Ready-to-Eat,MIGHTY PUFFS KHATTA METTA,14,25,25,0,1
02-03-2025,Oils & Ghee,Sesame oil 500ml,9,295,280,15,1
02-03-2025,Oils & Ghee,Groundnut oil 1 L,9,360,330,30,1
02-03-2025,Oils & Ghee,Safflower oil 1 L,9,440,400,40,1
02-03-2025,Spices & Seasonings,Tamarind 250GMS,15,80,65,15,1
02-03-2025,"Grains, Flours & Dals",Wheat Flour 500 gms,4,35,30,5,1
02-03-2025,"Grains, Flours & Dals",White jowar.F 1 kg,4,100,80,20,1
02-03-2025,"Grains, Flours & Dals",SINGLE POLISH 1KG,4,65,65,0,1
02-03-2025,Snacks & Ready-to-Eat,RAJGIRA PEANUT CHIKKI,14,30,30,0,6
02-03-2025,Snacks & Ready-to-Eat,TILLI CHIKKI,14,30,30,0,6
02-03-2025,"Grains, Flours & Dals",Em Multimillet idli r 500g,4,129,129,0,1
02-03-2025,"Grains, Flours & Dals",FLOUR CHARGE,4,24,24,0,2
02-03-2025,Oils & Ghee,BUFFALLO GHEE 500ML,9,820,740,80,2
02-03-2025,Snacks & Ready-to-Eat,NGT CHATPATTA CHANA 90GM,14,50,50,0,2
02-03-2025,Milk & Dairy,SANGAM CURD 450GM,7,38,38,0,1
02-03-2025,Milk & Dairy,SANGAM FULL CREAM MILK 500ML,7,38,38,0,1
02-03-2025,Snacks & Ready-to-Eat,SATHVI REGIVADA 200GM,14,80,60,20,1
02-03-2025,Snacks & Ready-to-Eat,VD ATUKULU MIXTURE 175GM,14,60,60,0,1
02-03-2025,Snacks & Ready-to-Eat,NGT CHATPATTA CHANA 90GM,14,40,40,0,2
02-03-2025,Milk & Dairy,ID PANEER,7,135,135,0,1
02-03-2025,Snacks & Ready-to-Eat,SD Thati thandra 200gm,14,150,150,0,1
02-03-2025,Snacks & Ready-to-Eat,ZEEDI,14,70,70,0,1
02-03-2025,Beverages,RED LABEL 10R,1,50,50,0,5
02-03-2025,Snacks & Ready-to-Eat,KURNOOL MARMURA,14,70,55,15,1
02-03-2025,Snacks & Ready-to-Eat,VD SANNAPUSA 175GM,14,60,60,0,1
02-03-2025,"Grains, Flours & Dals",Chana Flour 500 gms,4,70,65,5,1
02-03-2025,Oils & Ghee,BUFFALLO GHEE 500ML,9,410,370,40,1
02-03-2025,Spices & Seasonings,Coriander seeds 200 gms,15,48,40,8,1
02-03-2025,"Grains, Flours & Dals",Urad dall 1 Kg,4,185,170,15,1
02-03-2025,Spices & Seasonings,Tamarind 500GM,15,160,130,30,1
02-03-2025,Spices & Seasonings,AVALU 100GM,15,25,20,5,1
02-03-2025,"Dry Fruits, Nuts & Seeds",Groundnuts 500 gms,2,95,85,10,1
02-03-2025,"Grains, Flours & Dals",THIN POHA 500GM,4,40,35,5,1
02-03-2025,Pooja & Spiritual Items,BALAJI SANDAL DHOOP STICKS 10STK,12,125,125,0,1
02-03-2025,"Dry Fruits, Nuts & Seeds",PUTNALU 500GMS,2,90,76,14,1
02-03-2025,Snacks & Ready-to-Eat,PEANUT CHILLI,14,20,20,0,4
02-03-2025,Snacks & Ready-to-Eat,KURNOOL MARMURA,14,70,55,15,1
02-03-2025,Snacks & Ready-to-Eat,RAJGIRA PEANUT CHIKKI,14,20,20,0,4
02-03-2025,"Grains, Flours & Dals",Wheat Flour 1 kg,4,70,60,10,1
02-03-2025,Snacks & Ready-to-Eat,VD DASA DINUSULU,14,199,199,0,1
02-03-2025,"Grains, Flours & Dals",VGR RICE 5 KGS,4,350,325,25,1
02-03-2025,Household & Cleaning,LIZOL 1L,6,246,246,0,1
02-03-2025,Oils & Ghee,Groundnut oil 1 L,9,1080,990,90,3
02-03-2025,Pooja & Spiritual Items,BALAJI BEL PHOOL DHOOP STICKS 10STK,12,70,70,0,1
02-03-2025,Pooja & Spiritual Items,BALAJI ROSE DHOOP STIKS 10STK,12,125,125,0,1
02-03-2025,"Grains, Flours & Dals",turdal 1kg,4,440,390,50,2
02-03-2025,Spices & Seasonings,ROYAL SAFFRON,15,125,125,0,1
02-03-2025,"Grains, Flours & Dals",SAMALU,4,170,130,40,1
02-03-2025,Snacks & Ready-to-Eat,Popcorn Seeds 500GM,14,90,80,10,1
02-03-2025,Sweeteners,MISHRI D,16,40,30,10,1
02-03-2025,"Grains, Flours & Dals",PN ORGANIC URAD WHITE WHOLE 500GM,4,158,158,0,1
02-03-2025,"Grains, Flours & Dals",SABDANA 500GM,4,90,70,20,1
02-03-2025,"Grains, Flours & Dals",PESARA PAPPU 500GMS,4,85,75,10,1
02-03-2025,Beverages,REFRESH SHARBATH NORMAL,1,199,190,9,1
02-03-2025,Oils & Ghee,Groundnut oil 1 L,9,360,330,30,1
02-03-2025,Oils & Ghee,Safflower oil 1 L,9,440,400,40,1
02-03-2025,Misc,ROLL D C,8,70,45,25,1
02-03-2025,"Grains, Flours & Dals",VYS.SP RICE 1 KG,4,210,195,15,3
02-03-2025,Oils & Ghee,Sesame oil 500ml,9,295,280,15,1
02-03-2025,"Grains, Flours & Dals",BASMATHI RICE 1KG,4,750,675,75,5
02-03-2025,"Grains, Flours & Dals",Brown RICE 1KG,4,210,195,15,3
02-03-2025,Spices & Seasonings,Black Till 250GM,15,90,75,15,1
02-03-2025,"Grains, Flours & Dals",ANDU KORRALU (Browntop.m) 1 kg,4,260,220,40,1
02-03-2025,Oils & Ghee,Groundnut oil 1 L,9,720,660,60,2
02-03-2025,"Grains, Flours & Dals",RAGULU 1 KG,4,70,60,10,1
02-03-2025,Spices & Seasonings,Chilli powder 500 gms,15,290,210,80,1
02-03-2025,Spices & Seasonings,Vamu 100GM,15,60,50,10,1
02-03-2025,"Dry Fruits, Nuts & Seeds",PULMAKHANA 100 GM,2,180,170,10,1
02-03-2025,Snacks & Ready-to-Eat,RSC ORANGE 100GMS,14,20,20,0,1
02-03-2025,Snacks & Ready-to-Eat,VD Minapa papad 200gm,14,60,60,0,1
02-03-2025,Snacks & Ready-to-Eat,SD barnyard Millet with palm jaggery,14,270,270,0,2
02-03-2025,Oils & Ghee,Groundnut oil 1 L,9,360,330,30,1
02-03-2025,Oils & Ghee,Groundnut oil 500ml,9,180,165,15,1
02-03-2025,"Grains, Flours & Dals",turdal 1kg,4,440,390,50,2
02-03-2025,"Grains, Flours & Dals",Wheat Flour 1 kg,4,280,240,40,4
02-03-2025,Oils & Ghee,Sesame oil 500ml,9,295,280,15,1
02-03-2025,"Dry Fruits, Nuts & Seeds",Groundnuts 1 kg,2,190,170,20,1
02-03-2025,Snacks & Ready-to-Eat,VD PALLI CHIKKI,14,160,160,0,2
02-03-2025,Spices & Seasonings,DRY MANGO POWDER,15,45,45,0,1
02-03-2025,Snacks & Ready-to-Eat,VD JAGGERY GHEE 250GM,14,120,120,0,1
02-03-2025,Snacks & Ready-to-Eat,SATHVI REGIVADA 200GM,14,80,60,20,1
02-03-2025,Snacks & Ready-to-Eat,VD ATUKULU MIXTURE 175GM,14,120,120,0,2
02-03-2025,"Dry Fruits, Nuts & Seeds",SATHVI CHIA SEEDS 100GM,2,100,80,20,1
02-03-2025,Snacks & Ready-to-Eat,VD NUVULLU CHIKKI,14,80,80,0,1
02-03-2025,Oils & Ghee,Coconut oil 1 L,9,440,400,40,1
02-03-2025,"Grains, Flours & Dals",White jowar.F 1 kg,4,100,80,20,1
02-03-2025,Oils & Ghee,Groundnut oil 1 L,9,360,330,30,1
02-03-2025,Spices & Seasonings,Telaga Pindi 500GM,15,80,70,10,1
02-03-2025,"Grains, Flours & Dals",RICE FLOUR 500 GM,4,35,28,7,1
02-03-2025,Snacks & Ready-to-Eat,BELLAM MINAPA SUNADULLU,14,230,230,0,1
02-03-2025,Snacks & Ready-to-Eat,urban murmura,14,60,55,5,1
02-03-2025,"Health, Wellness & Ayurvedic Products",VAMU WATER,5,99,99,0,1
02-03-2025,Snacks & Ready-to-Eat,VD NUVULLU CHIKKI,14,80,80,0,1
02-03-2025,Oils & Ghee,GANTASALA A2 COW GHEE 500ML,9,550,550,0,1
02-03-2025,Snacks & Ready-to-Eat,VD ATUKULU MIXTURE 175GM,14,60,60,0,1
02-03-2025,"Dry Fruits, Nuts & Seeds",YELLOW KISHMISH 250GM,2,130,110,20,1
02-03-2025,Personal Care & Cosmetics,SVE RED SANDAL SOAP 100GM,10,90,90,0,1
02-03-2025,Snacks & Ready-to-Eat,SF MIGHTY PUFFS,14,25,25,0,1
02-03-2025,Misc,JOKER,8,20,20,0,10
02-03-2025,Personal Care & Cosmetics,ORGANIC SPONGE LOOFAH,10,70,70,0,1
02-03-2025,Spices & Seasonings,WHITE SESAME,15,75,75,0,1
02-03-2025,"Health, Wellness & Ayurvedic Products",RB Max Protein PERI PERI 60gm,5,45,45,0,1
02-03-2025,"Dry Fruits, Nuts & Seeds",BLACK KISMIS 250GM,2,175,140,35,1
02-03-2025,"Grains, Flours & Dals",CHANA DAL 500GM,4,17.5,15,2.5,0.25
02-03-2025,"Grains, Flours & Dals",SL Suji Rava 500GM,4,32,32,0,1
02-03-2025,"Grains, Flours & Dals",Idly Rava L 1KG,4,60,50,10,1
02-03-2025,Oils & Ghee,Groundnut oil 1 L,9,1080,990,90,3
02-03-2025,Pooja & Spiritual Items,GD Aiswarya Deepam 700ML,12,195,195,0,1
02-03-2025,"Grains, Flours & Dals",SRILATHA RICE RAVVA 500GM,4,105,105,0,3
02-03-2025,Oils & Ghee,cow ghee 500 ml,9,860,780,80,2
02-03-2025,Snacks & Ready-to-Eat,BD BARELY NOODLES 200G,14,70,70,0,1
02-03-2025,"Grains, Flours & Dals",VYS.SP.RICE BAG 1,4,1800,"1,650.00",150,1
02-03-2025,"Dry Fruits, Nuts & Seeds",SH GROUNDNUT 500GM,2,163,130,33,1
02-03-2025,Spices & Seasonings,YB Rock Salt 1KG,15,120,120,0,1
02-03-2025,Snacks & Ready-to-Eat,NGT CHATPATTA CHANA 90GM,14,50,50,0,2
02-03-2025,Beverages,REFRESH SHARBATH SUGAR FREE,1,299,285,14,1
02-03-2025,Oils & Ghee,Coconut oil 500 ml,9,220,200,20,1
02-03-2025,Milk & Dairy,SANGAM CURD 450GM,7,38,38,0,1
02-03-2025,Snacks & Ready-to-Eat,VD PALLI CHIKKI,14,80,80,0,1
02-03-2025,"Health, Wellness & Ayurvedic Products",RB Max Protein PERI PERI 60gm,5,45,45,0,1
02-03-2025,Oils & Ghee,Groundnut oil 1 L,9,720,660,60,2
02-03-2025,"Dry Fruits, Nuts & Seeds",SD Mango cubes 200gm,2,90,90,0,1
02-03-2025,Snacks & Ready-to-Eat,urban murmura,14,60,55,5,1
02-03-2025,"Grains, Flours & Dals",Wheat Rava M 1KG,4,65,55,10,1
02-03-2025,Spices & Seasonings,NUVVULU 250GM,15,100,85,15,1
02-03-2025,"Grains, Flours & Dals",RICE FLOUR 1KG,4,140,110,30,2
02-03-2025,"Grains, Flours & Dals",turdal 1kg,4,220,195,25,1
02-03-2025,"Grains, Flours & Dals",RICE FLOUR 500 GM,4,35,28,7,1
02-03-2025,"Grains, Flours & Dals",THICK POHA 500GM,4,80,70,10,2
02-03-2025,"Grains, Flours & Dals",BOMBAY RAVA,4,70,55,15,1
02-03-2025,"Grains, Flours & Dals",PESARA PAPPU 500GMS,4,85,75,10,1
02-03-2025,"Grains, Flours & Dals",URAD DALL,4,95,85,10,1
02-03-2025,Spices & Seasonings,Coriander seeds 200 gms,15,48,40,8,1
02-03-2025,"Grains, Flours & Dals",White jowar.F 1 kg,4,100,80,20,1
02-03-2025,"Grains, Flours & Dals",CHANA DAL 500GM,4,70,60,10,1
02-03-2025,"Grains, Flours & Dals",Chana Flour 500 gms,4,140,130,10,2
02-03-2025,Spices & Seasonings,Biryani Leaf 25GM,15,30,30,0,1
02-03-2025,"Dry Fruits, Nuts & Seeds",Groundnuts 1 kg,2,190,170,20,1
02-03-2025,"Grains, Flours & Dals",Idly Rava L 1KG,4,60,50,10,1
02-03-2025,Snacks & Ready-to-Eat,BB VERMICELLY 500GM,14,53,53,0,1
02-03-2025,"Dry Fruits, Nuts & Seeds",YELLOW KISHMISH 250GM,2,130,110,20,1
02-03-2025,"Grains, Flours & Dals",BASMATHI RICE 1KG,4,150,135,15,1
02-03-2025,"Grains, Flours & Dals",AISHWARYA SP 1KG,4,80,70,10,1
02-03-2025,Spices & Seasonings,SATHVI ANASAPUVUU 25GM,15,90,65,25,1
02-03-2025,Pooja & Spiritual Items,BANDA PUVVU 25GM 25GM,12,80,60,20,1
02-03-2025,Milk & Dairy,HRITAGE TOTAL CURD 130GM,7,10,10,0,1
02-03-2025,Oils & Ghee,Coconut oil 1 L,9,880,800,80,2
02-03-2025,Spices & Seasonings,Elaichi 25GM,15,145,120,25,1
02-03-2025,Personal Care & Cosmetics,SVE REETHA KUNKUDUKAYALU,10,199,199,0,1
02-03-2025,Sweeteners,YB JAGGERY POWDER 500GMS,16,75,75,0,1
02-03-2025,Snacks & Ready-to-Eat,BELLAM MINAPA SUNADULLU,14,440,440,0,2
02-03-2025,Milk & Dairy,BROWN EGGS TRAY 30P,7,360,330,30,1
02-03-2025,"Grains, Flours & Dals",Wheat Rava S 500GM,4,33,30,3,1
02-03-2025,"Grains, Flours & Dals",UDALU (Barnyard millet) 1 kg,4,280,230,50,2
02-03-2025,"Grains, Flours & Dals",SAMALU,4,170,130,40,1
02-03-2025,Sweeteners,YB JAGGERY POWDER 1KG,16,140,140,0,1
02-03-2025,Pickles & Cooking Pastes,SD TOMATO PICKLE,11,110,110,0,1
02-03-2025,"Grains, Flours & Dals",Chana Flour 500 gms,4,70,65,5,1
02-03-2025,"Grains, Flours & Dals",Wheat Flour 3 kgs,4,210,180,30,1
02-03-2025,"Grains, Flours & Dals",RAGI FLOUR 500GRMS,4,40,35,5,1
02-03-2025,"Grains, Flours & Dals",THICK POHA 500GM,4,40,35,5,1
02-03-2025,"Grains, Flours & Dals",VYS.SP.RICE BAG 1,4,1800,"1,650.00",150,1
02-03-2025,"Grains, Flours & Dals",HS JOWAR IDLY RAWA,4,130,130,0,2
02-03-2025,"Grains, Flours & Dals",RAGI FLOUR 500GRMS,4,40,35,5,1
02-03-2025,Snacks & Ready-to-Eat,VD MINAPA VADIYAM,14,65,65,0,1
02-03-2025,"Grains, Flours & Dals",SH RED POHA 500GM,4,85,85,0,1
02-03-2025,"Grains, Flours & Dals",SINGLE POLISH 1KG,4,325,325,0,5
02-03-2025,Milk & Dairy,HERITAGE TOTAL CURD 500GM,7,50,50,0,1
02-03-2025,Snacks & Ready-to-Eat,BELLAM MINAPA SUNADULLU,14,120,120,0,1
02-03-2025,"Grains, Flours & Dals",RICE FLOUR 1KG,4,140,110,30,2
02-03-2025,"Grains, Flours & Dals",SINGLE POLISH 1KG,4,660,660,0,11
02-03-2025,Snacks & Ready-to-Eat,PEANUT CHIKKI,14,44,44,0,2
02-03-2025,Snacks & Ready-to-Eat,millet noodles sf,14,35,35,0,1
02-03-2025,Snacks & Ready-to-Eat,VD MULTI CHAKKA,14,110,110,0,1
02-03-2025,"Health, Wellness & Ayurvedic Products",MD Triphala Chorrnam 100GM,5,80,80,0,1
02-03-2025,Personal Care & Cosmetics,GAYATHRI KUMKUDUKAYA,10,150,150,0,1
02-03-2025,Oils & Ghee,Flaxseed oil 500 ml,9,300,270,30,1
02-03-2025,"Health, Wellness & Ayurvedic Products",MD Aamlaki Choornam 100GM,5,80,80,0,1
02-03-2025,Spices & Seasonings,Karakaya,15,30,30,0,1
02-03-2025,"Grains, Flours & Dals",YB NAVARA RICE 500GM,4,100,100,0,1
02-03-2025,Snacks & Ready-to-Eat,MILLET PANCAKE CHOCOLATE,14,199,199,0,1
02-03-2025,"Grains, Flours & Dals",Quinova 500 gms,4,27.5,25,2.5,0.25
02-03-2025,"Grains, Flours & Dals",KORRALU (FOXTAIL M) 500GM,4,65,55,10,1
02-03-2025,"Grains, Flours & Dals",RAGI FLOUR 1KG,4,80,70,10,1
02-03-2025,Sweeteners,MADHUR SUGAR 1KG,16,65,55,10,1
02-03-2025,"Grains, Flours & Dals",HS MULTI UPMA RAVA,4,65,65,0,1
02-03-2025,"Grains, Flours & Dals",RICE FLOUR 500 GM,4,35,28,7,1
02-03-2025,"Grains, Flours & Dals",SL Suji Rava 500GM,4,32,32,0,1
02-03-2025,Spices & Seasonings,AVALU 100GM,15,25,20,5,1
02-03-2025,Personal Care & Cosmetics,MULTANI MITTI CHOORNAM,10,40,40,0,1
02-03-2025,"Grains, Flours & Dals",RAGI FLOUR 500GRMS,4,40,35,5,1
02-03-2025,"Grains, Flours & Dals",VGR RICE bag 1,4,1899,"1,650.00",249,1
02-03-2025,"Dry Fruits, Nuts & Seeds",YB GRANMA NUTS,2,180,180,0,2
02-03-2025,"Grains, Flours & Dals",RICE FLOUR 1KG,4,140,110,30,2
02-03-2025,"Grains, Flours & Dals",Wheat Flour 1 kg,4,280,240,40,4
02-03-2025,Snacks & Ready-to-Eat,NGT CHATPATTA CHANA 90GM,14,50,50,0,2
02-03-2025,Sweeteners,YB JAGGERY POWDER 1KG,16,280,280,0,2
02-03-2025,Spices & Seasonings,RED COPRA 250GMS,15,170,148,22,2
02-03-2025,Spices & Seasonings,Coriander seeds 200 gms,15,48,40,8,1
02-03-2025,General Household & Kitchenware,B1 bowl,3,399,399,0,1
02-03-2025,General Household & Kitchenware,B2 bowl,3,315,315,0,1
02-03-2025,Spices & Seasonings,Elaichi 25GM,15,145,120,25,1
02-03-2025,Spices & Seasonings,Jeera 100GM,15,50,45,5,1
02-03-2025,Spices & Seasonings,Tamarind 250GMS,15,80,65,15,1
02-03-2025,"Grains, Flours & Dals",Wheat Flour 1 kg,4,70,60,10,1
02-03-2025,"Grains, Flours & Dals",BOMBAY RAVA,4,70,55,15,1
02-03-2025,Oils & Ghee,Groundnut oil 1 L,9,1080,990,90,3
02-03-2025,"Grains, Flours & Dals",maida 500grms,4,35,30,5,1
02-03-2025,"Grains, Flours & Dals",RED TUDAL 1KG,4,150,140,10,1
02-03-2025,Spices & Seasonings,ROYAL SAFFRON 400GRMS,15,65,65,0,1
02-03-2025,Spices & Seasonings,Biryani Leaf 25GM,15,30,30,0,1
02-03-2025,Spices & Seasonings,AVALU 100GM,15,25,20,5,1
02-03-2025,"Dry Fruits, Nuts & Seeds",Groundnuts 1 kg,2,190,170,20,1
02-03-2025,"Grains, Flours & Dals",SPLIT URAD DAL,4,40,40,0,1
02-03-2025,Spices & Seasonings,Chilli powder 500 gms,15,290,210,80,1
02-03-2025,"Grains, Flours & Dals",Multigrain 1 kg,4,100,85,15,1
02-03-2025,Spices & Seasonings,Jeera 100GM,15,50,45,5,1
02-03-2025,Spices & Seasonings,AV Iodized Salt 1KG,15,28,25,3,1
02-03-2025,Spices & Seasonings,ROYAL SAFFRON,15,125,125,0,1
02-03-2025,Oils & Ghee,Groundnut oil 1 L,9,360,330,30,1
02-03-2025,Beverages,REFRESH SHARBATH NORMAL,1,199,190,9,1
02-03-2025,Oils & Ghee,Groundnut oil 1 L,9,360,330,30,1
02-03-2025,Snacks & Ready-to-Eat,DOSA BATTER 1KG,14,60,60,0,1
02-03-2025,"Dry Fruits, Nuts & Seeds",ALBUKARA 250GM,2,145,120,25,1
02-03-2025,Snacks & Ready-to-Eat,VD PALLI CHIKKI,14,80,80,0,1
02-03-2025,Oils & Ghee,Coconut oil 1 L,9,440,400,40,1
02-03-2025,Oils & Ghee,Safflower oil 1 L,9,880,800,80,2
02-03-2025,"Grains, Flours & Dals",White jowar .F 2 KGS,4,200,160,40,1
02-03-2025,"Grains, Flours & Dals",Wheat Flour 1 kg,4,210,180,30,3
02-03-2025,"Grains, Flours & Dals",RAGI FLOUR 500GRMS,4,40,35,5,1
02-03-2025,Sweeteners,PN ORGANIC BROWN SUGAR 1KG,16,154,154,0,1
02-03-2025,Oils & Ghee,Groundnut oil 1 L,9,2160,"1,980.00",180,6
02-03-2025,"Grains, Flours & Dals",MAAGAANI LOW GI SP L 1KG,4,360,315,45,3
02-03-2025,"Grains, Flours & Dals",Wheat Rava M 1KG,4,65,55,10,1
02-03-2025,Snacks & Ready-to-Eat,VD CORNFLAKES MIXTURE 175GM,14,60,60,0,1
02-03-2025,Snacks & Ready-to-Eat,KURNOOL MARMURA,14,70,55,15,1
02-03-2025,Snacks & Ready-to-Eat,MARMURA LADDU,14,160,120,40,2
02-03-2025,Milk & Dairy,HERITAGE TONED MILK 500ML,7,62,62,0,2
02-03-2025,Snacks & Ready-to-Eat,VD GUMMADI VADIYAM,14,75,75,0,1
02-03-2025,Snacks & Ready-to-Eat,VD PALLI CHIKKI,14,80,80,0,1
02-03-2025,Snacks & Ready-to-Eat,VD PALLI LADDU,14,160,160,0,2
02-03-2025,"Health, Wellness & Ayurvedic Products",j s pnature,5,136,136,0,1
02-03-2025,Sweeteners,NATURAL HONEY 1KG,16,560,480,80,1
02-03-2025,Oils & Ghee,Groundnut oil 1 L,9,360,330,30,1
02-03-2025,Oils & Ghee,Sesame oil 1 L,9,1770,"1,680.00",90,3
02-03-2025,"Grains, Flours & Dals",Wheat Flour 1 kg,4,140,120,20,2
02-03-2025,Oils & Ghee,Coconut oil 1 L,9,440,400,40,1
02-03-2025,"Grains, Flours & Dals",Multigrain 1 kg,4,100,85,15,1
02-03-2025,"Grains, Flours & Dals",Green gram 500 gms,4,75,70,5,1
02-03-2025,Spices & Seasonings,SREE MARUTHI IDLY KARAM 200GM,15,60,60,0,1
02-03-2025,"Dry Fruits, Nuts & Seeds",Groundnuts 1 kg,2,190,170,20,1
02-03-2025,Spices & Seasonings,Masala Karam 250 gms,15,130,120,10,1
02-03-2025,Snacks & Ready-to-Eat,MIX MILLET NOODLES,14,150,150,0,2
02-03-2025,Oils & Ghee,Sesame oil 500ml,9,295,280,15,1
02-03-2025,"Grains, Flours & Dals",Red uluvalu 250 gms,4,45,40,5,1
02-03-2025,Personal Care & Cosmetics,SANTOOR,10,120,100,20,1
02-03-2025,Snacks & Ready-to-Eat,VD JAGGERY GHEE 250GM,14,160,160,0,2
02-03-2025,General Household & Kitchenware,w brush,3,45,40,5,1
02-03-2025,Personal Care & Cosmetics,COLGATE STRONG TEETH,10,20,20,0,1
02-03-2025,"Grains, Flours & Dals",Chana Flour 1 kg,4,140,130,10,1
02-03-2025,"Grains, Flours & Dals",Wheat Rava M 500GM,4,33,30,3,1
02-03-2025,"Grains, Flours & Dals",SAMALU (Little millet) 500 gms,4,85,65,20,1
02-03-2025,"Grains, Flours & Dals",ANDU KORRALU (Brown top .mlt) 500,4,130,110,20,1
02-03-2025,"Grains, Flours & Dals",KORRALU (FOXTAIL M) 500GM,4,65,55,10,1
02-03-2025,"Grains, Flours & Dals",Arikalu (kodo),4,70,65,5,1
01-03-2025,Snacks & Ready-to-Eat,RSC ORANGE 100GMS,14,20,20,0,1
01-03-2025,"Dry Fruits, Nuts & Seeds",YELLOW KISHMISH 250GM,2,130,110,20,1
01-03-2025,Snacks & Ready-to-Eat,VD GUMMADI VADIYAM,14,75,75,0,1
01-03-2025,Household & Cleaning,VIM SOAP,6,50,50,0,10
01-03-2025,"Dry Fruits, Nuts & Seeds",PULMAKHANA 100 GM,2,180,170,10,1
01-03-2025,"Health, Wellness & Ayurvedic Products",MH Millets Malt 500GM,5,200,190,10,1
01-03-2025,"Dry Fruits, Nuts & Seeds",BLACK KISMIS 250GM,2,175,140,35,1
01-03-2025,Snacks & Ready-to-Eat,VD MINAPA VADIYAM,14,65,65,0,1
01-03-2025,Pooja & Spiritual Items,SWASTIK CAMPHORE,12,90,90,0,1
01-03-2025,"Grains, Flours & Dals",MELMEKER 250GMS,4,60,45,15,1
01-03-2025,Snacks & Ready-to-Eat,PEANUT CHIKKI,14,22,22,0,1
01-03-2025,"Health, Wellness & Ayurvedic Products",RB Max Protein Salt & Caramel Bar 50g,5,75,75,0,1
01-03-2025,Household & Cleaning,TIDE DOUBLE POWER LEMON &amp;MINT,6,146,146,0,1
01-03-2025,"Grains, Flours & Dals",YB Red RICE 1 KG,4,150,120,30,1
01-03-2025,General Household & Kitchenware,MATCH BOX,3,20,20,0,1
01-03-2025,Household & Cleaning,VIM TROPICAL LEMON FRESHNESS 250ML,6,55,55,0,1
01-03-2025,"Grains, Flours & Dals",HS Jowar upma rava 500 gms,4,65,65,0,1
01-03-2025,Snacks & Ready-to-Eat,VD DAHI MIRCHI(SALTED) 100GM,14,45,45,0,1
01-03-2025,Spices & Seasonings,Dalchin Rolls 50GM,15,45,45,0,1
01-03-2025,Spices & Seasonings,Japatri 25GM,15,100,80,20,1
01-03-2025,"Dry Fruits, Nuts & Seeds",WALLNUTS 250GM,2,380,360,20,1
01-03-2025,"Dry Fruits, Nuts & Seeds",SD Mango cubes 100gm,2,45,45,0,1
01-03-2025,Snacks & Ready-to-Eat,SD Ginger Candy 100g,14,60,60,0,1
01-03-2025,"Grains, Flours & Dals",Hs yellow jowar r 500g,4,99,99,0,1
01-03-2025,"Grains, Flours & Dals",HS Multimillet upma r 500g,4,65,65,0,1
01-03-2025,Snacks & Ready-to-Eat,BELLAM MINAPA SUNADULLU,14,100,100,0,1
01-03-2025,Milk & Dairy,SANGAM CURD 450GM,7,38,38,0,1
01-03-2025,Milk & Dairy,SANGAM TONED MILK 500ML,7,30,30,0,1
01-03-2025,"Grains, Flours & Dals",SINGLE POLISH 1KG,4,325,325,0,5
01-03-2025,"Grains, Flours & Dals",Arikalu (kodo),4,70,65,5,1
01-03-2025,"Grains, Flours & Dals",KORRALU (FOXTAIL M) 500GM,4,65,55,10,1
01-03-2025,"Grains, Flours & Dals",UDALU (Barnyard millet) 500 gms,4,70,60,10,1
01-03-2025,"Grains, Flours & Dals",ANDU KORRALU (Brown top .mlt) 500,4,130,110,20,1
01-03-2025,"Grains, Flours & Dals",Multigrain 1 kg,4,200,170,30,2
01-03-2025,Oils & Ghee,Safflower oil 1 L,9,1320,"1,200.00",120,3
01-03-2025,Snacks & Ready-to-Eat,VD NUVULU CHEGODI 175GM,14,60,60,0,1
01-03-2025,Snacks & Ready-to-Eat,VD PALLI LADDU,14,80,80,0,1
01-03-2025,Snacks & Ready-to-Eat,SF MIGHTY PUFFS,14,25,25,0,1
01-03-2025,Snacks & Ready-to-Eat,PEANUT CHILLI,14,15,15,0,3
01-03-2025,"Grains, Flours & Dals",Green Batani 250GM,4,55,45,10,1
01-03-2025,Snacks & Ready-to-Eat,VD MANGO JELLY 250GRMS,14,80,80,0,1
01-03-2025,"Grains, Flours & Dals",Multigrain 1 kg,4,100,85,15,1
01-03-2025,"Grains, Flours & Dals",RAGI FLOUR 500GRMS,4,40,35,5,1
01-03-2025,Spices & Seasonings,Masala Karam 500 gms,15,260,240,20,1
01-03-2025,Snacks & Ready-to-Eat,PEANUT CHILLI,14,10,10,0,2
01-03-2025,Snacks & Ready-to-Eat,VD BOONDI 175GM,14,60,60,0,1
01-03-2025,"Grains, Flours & Dals",MAAGAANI LOW GI SP L 1KG,4,360,315,45,3
01-03-2025,Personal Care & Cosmetics,COW DURBAR 7 HERBS SHAMPOO,10,125,93.75,31.25,1
01-03-2025,"Health, Wellness & Ayurvedic Products",RB Max Protein Salt & Caramel Bar 50g,5,75,75,0,1
01-03-2025,Personal Care & Cosmetics,UVIS HENNA 100GM,10,75,75,0,1
01-03-2025,Snacks & Ready-to-Eat,VD PALLI LADDU,14,160,160,0,2
01-03-2025,Spices & Seasonings,DALCHIN POWDER M,15,100,100,0,1
01-03-2025,Snacks & Ready-to-Eat,SD JOWAR WITH PALM JAGGERY 250GM,14,135,135,0,1
01-03-2025,Snacks & Ready-to-Eat,BELLAM MINAPA SUNADULLU,14,180,180,0,1
01-03-2025,Snacks & Ready-to-Eat,VD RIBBON PAKODI 175GM,14,60,60,0,1
01-03-2025,"Grains, Flours & Dals",RAGI FLOUR 500GRMS,4,40,35,5,1
01-03-2025,"Grains, Flours & Dals",Multigrain 1 kg,4,100,85,15,1
01-03-2025,"Grains, Flours & Dals",Yellow jowar .F1 kg,4,110,100,10,1
01-03-2025,"Grains, Flours & Dals",Chana Flour 500 gms,4,70,65,5,1
01-03-2025,"Health, Wellness & Ayurvedic Products",AMLA PACHAK,5,100,100,0,1
01-03-2025,Spices & Seasonings,Turmeric powder 250 gms,15,100,75,25,1
01-03-2025,Spices & Seasonings,Chilli powder 1 kg,15,580,420,160,1
01-03-2025,Spices & Seasonings,GARAM MASALA 200GM,15,120,95,25,1
01-03-2025,"Grains, Flours & Dals",BARLEY FLOUR 250GM,4,45,40,5,1
01-03-2025,"Grains, Flours & Dals",Wheat Flour 1 kg,4,70,60,10,1
01-03-2025,Beverages,BISLERI SODA 750ML,1,10,10,0,1
01-03-2025,Snacks & Ready-to-Eat,BATANA NGT 70GMS,14,20,20,0,1
01-03-2025,Snacks & Ready-to-Eat,DOSA BATTER 1KG,14,60,60,0,1
01-03-2025,"Health, Wellness & Ayurvedic Products",RB Max Protein Choco Almond bar 50g,5,80,80,0,1
01-03-2025,Snacks & Ready-to-Eat,SD FINGER Millet with palm Jaggery 250gm,14,135,135,0,1
01-03-2025,"Grains, Flours & Dals",FLOUR CHARGE,4,68.4,68.4,0,5.7
01-03-2025,Snacks & Ready-to-Eat,BD LITTLE MILLET NOODLES 200G,14,75,75,0,1
01-03-2025,Snacks & Ready-to-Eat,BD KODO MILLET NOODLES 200GM,14,75,75,0,1
01-03-2025,Snacks & Ready-to-Eat,BD PEARL MILLET NOODLES 200G,14,70,70,0,1
01-03-2025,Snacks & Ready-to-Eat,BD RED RICE NOODLES 200G,14,70,70,0,1
01-03-2025,Snacks & Ready-to-Eat,BD RAGI NOODLES,14,75,75,0,1
01-03-2025,Spices & Seasonings,Tamalapaku Karam Powder 100GM,15,80,80,0,1
01-03-2025,"Grains, Flours & Dals",Multigrain 1 kg,4,200,170,30,2
01-03-2025,Oils & Ghee,Coconut oil 1 L,9,1760,"1,600.00",160,4
01-03-2025,Snacks & Ready-to-Eat,BD BARELY NOODLES 200G,14,70,70,0,1
01-03-2025,Sweeteners,YB JAGGERY POWDER 500GMS,16,75,75,0,1
01-03-2025,"Dry Fruits, Nuts & Seeds",PULMAKHANA 100 GM,2,180,170,10,1
01-03-2025,"Grains, Flours & Dals",FLOUR CHARGE,4,48,48,0,4
01-03-2025,"Grains, Flours & Dals",WHEAT 1 KG,4,240,200,40,4
01-03-2025,"Grains, Flours & Dals",RAGI FLOUR 1KG,4,80,70,10,1
01-03-2025,Snacks & Ready-to-Eat,BATANA NGT 70GMS,14,40,40,0,2
01-03-2025,"Grains, Flours & Dals",RAGI FLOUR 500GRMS,4,40,35,5,1
01-03-2025,Snacks & Ready-to-Eat,SD Moringa with plam jaggery 250gm,14,135,135,0,1
01-03-2025,"Grains, Flours & Dals",DESI CHANA,4,50,50,0,2
01-03-2025,"Grains, Flours & Dals",MELMEKER 250GMS,4,60,45,15,1
01-03-2025,"Dry Fruits, Nuts & Seeds",FLAX SEEDS 1KG,2,48,40,8,0.2
01-03-2025,"Grains, Flours & Dals",AISHWARYA SP IDLY RAVA 1KG,4,120,66,54,1
01-03-2025,"Grains, Flours & Dals",FLOUR CHARGE,4,64.8,64.8,0,5.4
01-03-2025,"Grains, Flours & Dals",SOYA BEANS 1KG,4,40,36,4,0.2
01-03-2025,"Grains, Flours & Dals",WHEAT 1 KG,4,240,200,40,4
01-03-2025,"Grains, Flours & Dals",AISHWARYA RICE RAVA SP 500GRMS,4,120,84,36,2
01-03-2025,"Grains, Flours & Dals",Wheat Rava S 1KG,4,65,55,10,1
01-03-2025,"Grains, Flours & Dals",RAGULU 1 KG,4,70,60,10,1
01-03-2025,"Grains, Flours & Dals",Red Bobarlu 500 gms,4,95,85,10,1
01-03-2025,"Grains, Flours & Dals",PN ORGANIC KALA CHANA 500GM,4,119,119,0,1
01-03-2025,"Dry Fruits, Nuts & Seeds",PULMAKHANA 100 GM,2,180,170,10,1
01-03-2025,"Grains, Flours & Dals",Green Batani 250GM,4,55,45,10,1
01-03-2025,"Grains, Flours & Dals",white Bobarlu 500 gms,4,80,75,5,1
01-03-2025,Snacks & Ready-to-Eat,KURNOOL MARMURA,14,70,55,15,1
01-03-2025,Snacks & Ready-to-Eat,VD SAGOPAPAD 150GM,14,55,55,0,1
01-03-2025,"Grains, Flours & Dals",Chittimuthaylu rice 1 kg,4,160,140,20,1
01-03-2025,Sweeteners,SUGAR 1KG,16,120,100,20,2
01-03-2025,"Dry Fruits, Nuts & Seeds",PULMAKHANA 100 GM,2,180,170,10,1
01-03-2025,Pooja & Spiritual Items,AMRUTHA SURABHI,12,80,80,0,1
01-03-2025,Milk & Dairy,BROWN EGGS 1P,7,238,204,34,17
01-03-2025,Snacks & Ready-to-Eat,VD RIBBON PAKODI 175GM,14,60,60,0,1
01-03-2025,"Grains, Flours & Dals",RAGI FLOUR 1KG,4,160,140,20,2
01-03-2025,Snacks & Ready-to-Eat,VD DRY FRUIT PUTHAREKULU,14,240,240,0,2
01-03-2025,Personal Care & Cosmetics,SVE KHADI WILD TURMERIC FACH,10,230,230,0,1
01-03-2025,"Grains, Flours & Dals",RICE FLOUR 1KG,4,70,55,15,1
01-03-2025,"Grains, Flours & Dals",SL Idly Rava 1KG,4,65,55,10,1
01-03-2025,"Dry Fruits, Nuts & Seeds",Putnalu 250GM,2,45,38,7,1
01-03-2025,Snacks & Ready-to-Eat,SD Vamu with palm jaggery 250gm,14,135,135,0,1
01-03-2025,"Grains, Flours & Dals",Multigrain 1 kg,4,100,85,15,1
01-03-2025,"Grains, Flours & Dals",White jowar.F 1 kg,4,100,80,20,1
01-03-2025,"Grains, Flours & Dals",Chana Flour 500 gms,4,70,65,5,1
01-03-2025,Snacks & Ready-to-Eat,VD JAGGERY GHEE 250GM,14,120,120,0,1
01-03-2025,Oils & Ghee,Coconut oil 500 ml,9,220,200,20,1
01-03-2025,"Grains, Flours & Dals",MELMEKER 250GMS,4,60,45,15,1
01-03-2025,Snacks & Ready-to-Eat,KURNOOL MARMURA,14,70,55,15,1
01-03-2025,"Grains, Flours & Dals",BLACK GRAM 1KG,4,150,140,10,1
01-03-2025,"Grains, Flours & Dals",JOWAR WHITE 1 KG,4,40,35,5,0.5
01-03-2025,Snacks & Ready-to-Eat,ANNAPURNA APPALAM,14,35,35,0,1
01-03-2025,Spices & Seasonings,Turmeric powder 250 gms,15,100,75,25,1
01-03-2025,"Grains, Flours & Dals",Wheat Flour 1 kg,4,140,120,20,2
01-03-2025,Oils & Ghee,Sesame oil 1 L,9,590,560,30,1
01-03-2025,"Dry Fruits, Nuts & Seeds",SATHVI CHIA SEEDS 100GM,2,100,80,20,1
01-03-2025,Spices & Seasonings,NUVVULU 250GM,15,80,65,15,1
01-03-2025,Snacks & Ready-to-Eat,NGT CHATPATTA CHANA 90GM,14,25,25,0,1
01-03-2025,Spices & Seasonings,Elaichi 25GM,15,145,120,25,1
01-03-2025,Spices & Seasonings,Masala Karam 500 gms,15,260,240,20,1
01-03-2025,Pooja & Spiritual Items,NALLAS VAISHNAVI MAISHAKSHI 50GM,12,50,50,0,1
01-03-2025,"Grains, Flours & Dals",Chana Flour 1 kg,4,140,130,10,1
01-03-2025,Snacks & Ready-to-Eat,VD BOONDI 175GM,14,60,60,0,1
01-03-2025,Spices & Seasonings,Coriander seeds 200 gms,15,48,40,8,1
01-03-2025,Spices & Seasonings,Dalchin Rolls 50GM,15,45,45,0,1
01-03-2025,Snacks & Ready-to-Eat,MILLET PANCAKE CHOCOLATE,14,199,199,0,1
01-03-2025,Household & Cleaning,TIDE DOUBLE POWER JASMINE &amp;ROSE,6,66,66,0,1
01-03-2025,Snacks & Ready-to-Eat,VD Pappu Chekkalu 190gm,14,60,60,0,1
01-03-2025,Snacks & Ready-to-Eat,VD SANNAPUSA 175GM,14,60,60,0,1
01-03-2025,Snacks & Ready-to-Eat,Corn Chips 250GM,14,40,35,5,1
01-03-2025,"Grains, Flours & Dals",JOWAR UPMA RAVA,4,75,75,0,1
01-03-2025,"Grains, Flours & Dals",PRO ORG RED POHA 500GM,4,356,356,0,4
01-03-2025,Spices & Seasonings,GREEN SOUNF,15,60,40,20,1
01-03-2025,"Grains, Flours & Dals",white Bobarlu 1 KG,4,170,150,20,1
01-03-2025,"Health, Wellness & Ayurvedic Products",MXP CHOCO CLASSIC BAR,5,70,70,0,1
01-03-2025,"Grains, Flours & Dals",JOWAR WHITE 1 KG,4,80,70,10,1
01-03-2025,"Grains, Flours & Dals",HS jowar idly rava 500 gms,4,65,65,0,1
01-03-2025,Oils & Ghee,Sesame oil 1 L,9,590,560,30,1
01-03-2025,Spices & Seasonings,Jeera 100GM,15,50,45,5,1
01-03-2025,"Grains, Flours & Dals",RAGULU 1 KG,4,70,60,10,1
01-03-2025,"Dry Fruits, Nuts & Seeds",SATHVI CHIA SEEDS 100GM,2,100,80,20,1
01-03-2025,"Dry Fruits, Nuts & Seeds",FLAX SEEDS 250GM,2,60,50,10,1
01-03-2025,"Grains, Flours & Dals",SA Sprouted Ragi Flour 500GM,4,69,69,0,1
01-03-2025,"Grains, Flours & Dals",Multigrain 1 kg,4,100,85,15,1
01-03-2025,"Grains, Flours & Dals",Wheat Flour 1 kg,4,70,60,10,1
01-03-2025,Snacks & Ready-to-Eat,millet noodles sf,14,70,70,0,2
01-03-2025,Spices & Seasonings,Masala Karam 250 gms,15,130,120,10,1
01-03-2025,Snacks & Ready-to-Eat,VD DAHI MIRCHI(SALTED) 100GM,14,45,45,0,1
01-03-2025,Snacks & Ready-to-Eat,VD NUVULU PAPAD 200GM,14,100,100,0,1
01-03-2025,Sweeteners,SUGAR 500 GM,16,30,25,5,1
01-03-2025,"Dry Fruits, Nuts & Seeds",Groundnuts 1 kg,2,190,170,20,1
01-03-2025,Spices & Seasonings,SAJEERA,15,60,40,20,1
01-03-2025,"Grains, Flours & Dals",Idly Rava L 1KG,4,120,100,20,2
01-03-2025,Household & Cleaning,VIM SOAP,6,25,25,0,5
01-03-2025,"Dry Fruits, Nuts & Seeds",PUTNALU 500GMS,2,90,76,14,1
01-03-2025,Personal Care & Cosmetics,DETTOL 50ML,10,154,154,0,1
01-03-2025,"Grains, Flours & Dals",BASMATHI RICE 1KG,4,300,270,30,2
01-03-2025,"Grains, Flours & Dals",Urad dall 1 Kg,4,185,170,15,1
01-03-2025,Spices & Seasonings,Elaichi 25GM,15,145,120,25,1
01-03-2025,"Grains, Flours & Dals",Green gram 500 gms,4,75,70,5,1
01-03-2025,Oils & Ghee,Coconut oil 500 ml,9,220,200,20,1
01-03-2025,"Grains, Flours & Dals",PESARA PAPPU 500GMS,4,85,75,10,1
01-03-2025,"Grains, Flours & Dals",RAGI FLOUR 1KG,4,80,70,10,1
01-03-2025,Snacks & Ready-to-Eat,VD JAGGERY GHEE 250GM,14,120,120,0,1
01-03-2025,Spices & Seasonings,AV Iodized Salt 1KG,15,28,25,3,1
01-03-2025,Spices & Seasonings,dalchin chekka,15,50,40,10,1
01-03-2025,"Grains, Flours & Dals",turdal 1kg,4,220,195,25,1
01-03-2025,Snacks & Ready-to-Eat,VD MULTI CHAKKA,14,110,110,0,1
01-03-2025,Snacks & Ready-to-Eat,MARMURA LADDU,14,80,60,20,1
01-03-2025,Snacks & Ready-to-Eat,MB LITTLE MILLET NOODLES 180G,14,95,95,0,1
01-03-2025,"Grains, Flours & Dals",RAGI FLOUR 500GRMS,4,80,70,10,2
01-03-2025,"Grains, Flours & Dals",Multigrain 1 kg,4,200,170,30,2
01-03-2025,Snacks & Ready-to-Eat,TILLI CHIKKI,14,10,10,0,2
01-03-2025,Snacks & Ready-to-Eat,MARMURA LADDU,14,80,60,20,1
01-03-2025,"Grains, Flours & Dals",SPLIT BLACK GRAM 500 GM,4,90,85,5,1
01-03-2025,Snacks & Ready-to-Eat,MARMURA LADDU,14,80,60,20,1
01-03-2025,Snacks & Ready-to-Eat,millet noodles sf,14,0,0,0,1
01-03-2025,"Grains, Flours & Dals",URAD DALL,4,80,80,0,1
01-03-2025,Snacks & Ready-to-Eat,VD MANGO JELLY 250GRMS,14,80,80,0,1
01-03-2025,Spices & Seasonings,GREEN SOUNF,15,60,40,20,1
01-03-2025,Snacks & Ready-to-Eat,SATHVI REGIVADA 200GM,14,80,60,20,1
01-03-2025,Spices & Seasonings,Elaichi 25GM,15,145,120,25,1
01-03-2025,Spices & Seasonings,Marati Magga 50GM,15,130,110,20,1
01-03-2025,Spices & Seasonings,Dalchin Rolls 50GM,15,70,45,25,1
01-03-2025,"Grains, Flours & Dals",KORRALU (FOXTAIL M) 500GM,4,65,55,10,1
01-03-2025,"Grains, Flours & Dals",unpolished turdall500grms,4,120,110,10,1
01-03-2025,Spices & Seasonings,SATHVI ANASAPUVUU 25GM,15,90,65,25,1
01-03-2025,Spices & Seasonings,Japatri 25GM,15,100,80,20,1
01-03-2025,Baking & Cooking Aids,RAJ BIRDS GELATINE 50GM,0,90,90,0,1
01-03-2025,Pooja & Spiritual Items,JAGI KAYA 25GM,12,80,60,20,1
01-03-2025,Spices & Seasonings,Lavangam 50GM,15,60,50,10,1
01-03-2025,Snacks & Ready-to-Eat,ZEEDI,14,70,70,0,1
01-03-2025,Pooja & Spiritual Items,SST PURE COTTON GUBBA WICKS,12,30,30,0,1
01-03-2025,Spices & Seasonings,MM CHAT MASALA,15,44,44,0,1
01-03-2025,"Grains, Flours & Dals",RICE FLOUR 1KG,4,70,55,15,1
01-03-2025,"Grains, Flours & Dals",MAIDA 1KG,4,70,60,10,1
01-03-2025,"Grains, Flours & Dals",SINGLE POLISH 1KG,4,650,650,0,10
01-03-2025,Personal Care & Cosmetics,MD Bath Powder 100GM,10,40,40,0,1
01-03-2025,Spices & Seasonings,EVEREST PANI PURI MASALA 50GM,15,40,40,0,1
01-03-2025,Oils & Ghee,Sesame oil 1 L,9,590,560,30,1
01-03-2025,Spices & Seasonings,Vamu 100GM,15,60,50,10,1
01-03-2025,"Dry Fruits, Nuts & Seeds",Putnalu 250GM,2,45,38,7,1
01-03-2025,"Grains, Flours & Dals",UNPOLISHED TURDALL 1KG,4,240,210,30,1
01-03-2025,"Grains, Flours & Dals",Sathya Javva Wheat Rava 500GM,4,95,95,0,1
01-03-2025,Spices & Seasonings,Tamarind 250GMS,15,80,65,15,1
01-03-2025,Spices & Seasonings,NUVVULU 250GM,15,80,65,15,1
01-03-2025,Snacks & Ready-to-Eat,NGT CHATPATTA CHANA 90GM,14,25,25,0,1
01-03-2025,"Grains, Flours & Dals",THICK POHA 500GM,4,40,35,5,1
01-03-2025,Spices & Seasonings,Avalu small 250 gms,15,60,40,20,1
01-03-2025,"Grains, Flours & Dals",Chana Flour 500 gms,4,70,65,5,1
01-03-2025,"Grains, Flours & Dals",split black gram 1 kg,4,360,340,20,2
01-03-2025,Snacks & Ready-to-Eat,VD GUMMADI VADIYAM,14,75,75,0,1
01-03-2025,Snacks & Ready-to-Eat,BB VERMICELLY 500GM,14,53,53,0,1
01-03-2025,"Grains, Flours & Dals",CORN FLOUR,4,80,70,10,1
01-03-2025,Pooja & Spiritual Items,SWASTIK PURE CAMPHOR 50GM,12,90,90,0,1
01-03-2025,"Grains, Flours & Dals",Wheat Flour 5 kgs,4,350,300,50,1
01-03-2025,Spices & Seasonings,DURGA SALT CRYSTAL 1KG,15,25,25,0,1
01-03-2025,"Grains, Flours & Dals",White jowar.F 1 kg,4,100,80,20,1
01-03-2025,"Grains, Flours & Dals",Idly Rava L 1KG,4,60,50,10,1
01-03-2025,Spices & Seasonings,Coriander seeds 200 gms,15,48,40,8,1
01-03-2025,"Dry Fruits, Nuts & Seeds",Groundnuts 1 kg,2,190,170,20,1
01-03-2025,"Grains, Flours & Dals",Urad dall 1 Kg,4,185,170,15,1
01-03-2025,Spices & Seasonings,DRY MIECHI 200GM,15,80,60,20,1
01-03-2025,Spices & Seasonings,DRY MANGO POWDER,15,45,45,0,1
01-03-2025,Spices & Seasonings,JEERA 250 gms,15,125,105,20,1
01-03-2025,Snacks & Ready-to-Eat,MILK BREAD,14,55,55,0,1
01-03-2025,Milk & Dairy,HERITAGE TONED MILK 500ML,7,62,62,0,2
01-03-2025,Beverages,GANTASALA TEJ DRY GINGER COFFEE,1,149,149,0,1
01-03-2025,Spices & Seasonings,Black Till 250GM,15,270,225,45,3
01-03-2025,Snacks & Ready-to-Eat,MARMURA LADDU,14,80,60,20,1
01-03-2025,Snacks & Ready-to-Eat,MILK BREAD,14,55,55,0,1
01-03-2025,Milk & Dairy,SANGAM TONED MILK 500ML,7,30,30,0,1
01-03-2025,Milk & Dairy,SANGAM FULL CREAM MILK 500ML,7,38,38,0,1
01-03-2025,Spices & Seasonings,Tamarind 250GMS,15,80,65,15,1
01-03-2025,Oils & Ghee,Coconut oil 500 ml,9,220,200,20,1
01-03-2025,"Grains, Flours & Dals",HS jowar idly rava 500 gms,4,65,65,0,1
01-03-2025,Snacks & Ready-to-Eat,VD MURUKU 175GM,14,60,60,0,1
01-03-2025,Spices & Seasonings,Elaichi 25GM,15,580,480,100,4
01-03-2025,"Dry Fruits, Nuts & Seeds",SATHVI CHIA SEEDS 100GM,2,100,80,20,1
01-03-2025,"Grains, Flours & Dals",RAGI FLOUR 500GRMS,4,80,70,10,2
01-03-2025,"Dry Fruits, Nuts & Seeds",SUNFLOWER SEEDS 250GRM,2,150,130,20,1
01-03-2025,"Grains, Flours & Dals",Quinova 1 kg,4,220,195,25,1
01-03-2025,"Grains, Flours & Dals",Wheat Flour 1 kg,4,140,120,20,2
01-03-2025,"Health, Wellness & Ayurvedic Products",PULIPIRI WARTS REMOVER 9GM,5,125,125,0,1
01-03-2025,Spices & Seasonings,LG 50GM,15,92,92,0,1
01-03-2025,"Grains, Flours & Dals",UDALU (Barnyard millet) 1 kg,4,140,115,25,1
01-03-2025,"Grains, Flours & Dals",HS Multimillet idly R 500 gms,4,65,65,0,1
01-03-2025,"Grains, Flours & Dals",turdal 1kg,4,220,195,25,1
01-03-2025,"Dry Fruits, Nuts & Seeds",PUMPKIN SEEDS 250GM,2,200,160,40,1
01-03-2025,Personal Care & Cosmetics,Soapnut 500GM,10,120,90,30,1
01-03-2025,"Grains, Flours & Dals",RICE FLOUR 500 GM,4,70,56,14,2
01-03-2025,"Grains, Flours & Dals",Wheat Rava M 1KG,4,65,55,10,1
01-03-2025,"Dry Fruits, Nuts & Seeds",WATERMELON SEEDS 250GRM,2,320,280,40,1
01-03-2025,Snacks & Ready-to-Eat,BB VERMICELLI 1KG,14,95,90,5,1
01-03-2025,"Dry Fruits, Nuts & Seeds",Groundnuts 1 kg,2,190,170,20,1
01-03-2025,"Dry Fruits, Nuts & Seeds",CASHEW 250GM,2,340,310,30,1
01-03-2025,"Dry Fruits, Nuts & Seeds",chironji 50grms,2,200,160,40,1
01-03-2025,"Health, Wellness & Ayurvedic Products",DWI EUCALYPTUS 50ML,5,210,210,0,1
01-03-2025,"Dry Fruits, Nuts & Seeds",YELLOW KISHMISH 250GM,2,130,110,20,1
01-03-2025,"Grains, Flours & Dals",Urad dall 1 Kg,4,370,340,30,2
01-03-2025,Snacks & Ready-to-Eat,BD PEARL MILLET NOODLES 200G,14,140,140,0,2
01-03-2025,Sweeteners,GS A2 Buffalo Ghee 500ML,16,550,550,0,1
01-03-2025,Snacks & Ready-to-Eat,SD RAGI GAVVALU,14,95,95,0,1
01-03-2025,Spices & Seasonings,KALONJI SEEDS,15,90,80,10,1
01-03-2025,Oils & Ghee,Safflower oil 1 L,9,440,400,40,1
01-03-2025,Snacks & Ready-to-Eat,SATHVI REGIVADA 200GM,14,80,60,20,1
01-03-2025,Beverages,REFRESH SHARBATH SUGAR FREE,1,299,285,14,1
01-03-2025,Sweeteners,YB JAGGERY POWDER 500GMS,16,75,75,0,1
01-03-2025,"Health, Wellness & Ayurvedic Products",MADDI NEEM OIL 100ML,5,70,70,0,1
01-03-2025,Snacks & Ready-to-Eat,NGT CHATPATTA CHANA 90GM,14,25,25,0,1
01-03-2025,Oils & Ghee,Sesame oil 1 L,9,590,560,30,1
01-03-2025,Spices & Seasonings,MD Sonti Powder 50GM,15,100,100,0,1
01-03-2025,Oils & Ghee,Safflower oil 1 L,9,880,800,80,2
01-03-2025,Oils & Ghee,Sesame oil 1 L,9,1180,"1,120.00",60,2
01-03-2025,"Dry Fruits, Nuts & Seeds",SATHVI CHIA SEEDS 100GM,2,100,80,20,1
01-03-2025,Oils & Ghee,Safflower oil 500 ml,9,220,200,20,1
01-03-2025,"Dry Fruits, Nuts & Seeds",FLAX SEEDS 250GM,2,120,100,20,2
01-03-2025,Snacks & Ready-to-Eat,ZEEDI,14,70,70,0,1
01-03-2025,"Grains, Flours & Dals",RAGI FLOUR 1KG,4,80,70,10,1
01-03-2025,"Dry Fruits, Nuts & Seeds",DRYDATES YELLOW 250GM,2,135,120,15,1
01-03-2025,"Grains, Flours & Dals",Wheat Flour 2 kgs,4,140,120,20,1
01-03-2025,"Grains, Flours & Dals",Multigrain 2 kgs,4,200,170,30,1
01-03-2025,"Grains, Flours & Dals",White jowar.F 1 kg,4,800,640,160,8
01-03-2025,"Grains, Flours & Dals",Urad dall 1 Kg,4,185,170,15,1
01-03-2025,"Grains, Flours & Dals",PESARA PAPPU 1 KG,4,170,145,25,1
01-03-2025,"Dry Fruits, Nuts & Seeds",PUTNALU 500GMS,2,90,76,14,1
01-03-2025,"Dry Fruits, Nuts & Seeds",Groundnuts 1 kg,2,190,170,20,1
01-03-2025,"Grains, Flours & Dals",Green gram 1 kg,4,150,130,20,1
01-03-2025,"Grains, Flours & Dals",white Bobarlu 1 KG,4,170,150,20,1
01-03-2025,"Grains, Flours & Dals",THICK POHA 1KG,4,80,70,10,1
01-03-2025,Spices & Seasonings,GD Turmeric 50GM,15,50,50,0,2
01-03-2025,Pooja & Spiritual Items,GD WOODS 150GM,12,110,110,0,1
01-03-2025,"Grains, Flours & Dals",VGR rice 1 kg,4,175,162.5,12.5,2.5
01-03-2025,Sweeteners,YB FOREST HONEY 250GM,16,180,180,0,1
01-03-2025,Beverages,BRU GREEN LABEL 1.2G,1,6,6,0,3
01-03-2025,Milk & Dairy,HERITAGE TONED MILK 500ML,7,62,62,0,2
01-03-2025,Milk & Dairy,HERITAGE TOTAL CURD 500GM,7,50,50,0,1
01-03-2025,"Grains, Flours & Dals",WHEAT 1 KG,4,180,150,30,3
01-03-2025,"Grains, Flours & Dals",RAGULU 1 KG,4,70,60,10,1
01-03-2025,"Dry Fruits, Nuts & Seeds",SATHVI CHIA SEEDS 100GM,2,100,80,20,1
01-03-2025,"Grains, Flours & Dals",FLOUR CHARGE,4,48,48,0,4
01-03-2025,"Grains, Flours & Dals",Chana Flour 500 gms,4,70,65,5,1
01-03-2025,Oils & Ghee,Safflower oil 1 L,9,440,400,40,1
01-03-2025,Oils & Ghee,Coconut oil 500 ml,9,220,200,20,1
01-03-2025,"Grains, Flours & Dals",white Bobarlu 1 KG,4,170,150,20,1
01-03-2025,"Grains, Flours & Dals",Wheat Flour 1 kg,4,70,60,10,1
01-03-2025,"Grains, Flours & Dals",Yellow jowar.F 2 kgs,4,220,200,20,1
01-03-2025,Spices & Seasonings,Vamu 100GM,15,60,50,10,1
01-03-2025,"Grains, Flours & Dals",RAGI FLOUR 1KG,4,80,70,10,1
01-03-2025,General Household & Kitchenware,DOYO RO CELL,3,100,100,0,2
01-03-2025,"Grains, Flours & Dals",Wheat Rava M 1KG,4,65,55,10,1
01-03-2025,"Grains, Flours & Dals",WHEAT 1 KG,4,30,25,5,0.5
01-03-2025,"Grains, Flours & Dals",SH WHITE POHA 500GM,4,75,75,0,1
01-03-2025,"Grains, Flours & Dals",Green gram 1 kg,4,300,260,40,2
01-03-2025,"Grains, Flours & Dals",Red Chana 500 GM,4,75,60,15,1
01-03-2025,"Dry Fruits, Nuts & Seeds",FLAX SEEDS 1KG,2,120,100,20,0.5
01-03-2025,"Dry Fruits, Nuts & Seeds",Groundnuts 1 kg,2,190,170,20,1
01-03-2025,"Grains, Flours & Dals",BARLEY FLOUR 500GM,4,22.5,20,2.5,0.25
01-03-2025,"Grains, Flours & Dals",White jowar.F 1 kg,4,200,160,40,2
01-03-2025,"Grains, Flours & Dals",Em Multimillet idli r 500g,4,258,258,0,2
01-03-2025,Spices & Seasonings,SAMBAR POWDER 200GM,15,130,110,20,1
01-03-2025,"Grains, Flours & Dals",EM Ragi idli R 500G,4,150,150,0,2
01-03-2025,Oils & Ghee,cow ghee 500 ml,9,430,390,40,1
01-03-2025,"Grains, Flours & Dals",Arikadu ( kodo),4,140,130,10,1
01-03-2025,"Grains, Flours & Dals",Em jowar idly R 500G,4,150,150,0,2
01-03-2025,"Grains, Flours & Dals",AISHWARYA MOONGDAL RICE,4,280,168,112,2
01-03-2025,"Grains, Flours & Dals",HS RAGI FLAKES 250GM 1+1,4,238,238,0,2
01-03-2025,Spices & Seasonings,SATHVI TURMERIC POWDER 500GM,15,180,130,50,1
01-03-2025,"Grains, Flours & Dals",RAGI FLOUR 1KG,4,80,70,10,1
01-03-2025,"Grains, Flours & Dals",AISHWARYA RICE RAVA SP 500GRMS,4,180,126,54,3
01-03-2025,Spices & Seasonings,Telaga Pindi 500GM,15,80,70,10,1
01-03-2025,"Grains, Flours & Dals",UDALU (Barnyard millet) 1 kg,4,140,115,25,1
01-03-2025,"Dry Fruits, Nuts & Seeds",FLAX SEEDS 250GM,2,60,50,10,1
01-03-2025,Snacks & Ready-to-Eat,GANTASALA FLAX SEEDS SPICY,14,90,90,0,1
01-03-2025,Household & Cleaning,ROOPERI PITAMBARI SILVER 50ML,6,110,110,0,1
01-03-2025,Baking & Cooking Aids,GONDH 50GRMS,0,50,40,10,1
01-03-2025,"Health, Wellness & Ayurvedic Products",RB Max Protein Salt & Caramel Bar 50g,5,75,75,0,1
01-03-2025,"Grains, Flours & Dals",AISHWARYA SP 25KG,4,1999,"1,690.00",309,1
01-03-2025,"Grains, Flours & Dals",split black gram 1 kg,4,360,340,20,2
01-03-2025,"Grains, Flours & Dals",Wheat Flour 2 kgs,4,140,120,20,1
01-03-2025,"Grains, Flours & Dals",Arikadu ( kodo),4,140,130,10,1
01-03-2025,"Dry Fruits, Nuts & Seeds",YB GRANMA NUTS,2,90,90,0,1
01-03-2025,"Grains, Flours & Dals",SAMALU (Little millet) 1 kg,4,170,130,40,1
01-03-2025,"Grains, Flours & Dals",KORRALU (FOXTAIL M) 1KG,4,150,110,40,1
01-03-2025,"Grains, Flours & Dals",JOWAR YELLOW 1 K,4,200,180,20,2
01-03-2025,"Grains, Flours & Dals",Quinova 500 gms,4,110,100,10,1
01-03-2025,Snacks & Ready-to-Eat,GREEN FRIED batana,14,40,40,0,2
01-03-2025,"Grains, Flours & Dals",White jowar.F 1 kg,4,100,80,20,1
01-03-2025,Snacks & Ready-to-Eat,NGT CHATPATTA CHANA 90GM,14,50,50,0,2
01-03-2025,Spices & Seasonings,Telaga Pindi 500GM,15,80,70,10,1
01-03-2025,"Grains, Flours & Dals",RAGI FLOUR 1KG,4,160,140,20,2
01-03-2025,Spices & Seasonings,NUVVULU 250GM,15,100,85,15,1
01-03-2025,"Grains, Flours & Dals",Bombay Rava 500GM,4,35,30,5,1
01-03-2025,"Grains, Flours & Dals",COW B RICE BAG 1,4,2099,"1,750.00",349,1
01-03-2025,"Grains, Flours & Dals",Wheat Rava M 500GM,4,33,30,3,1
01-03-2025,"Dry Fruits, Nuts & Seeds",PUTNALU 500GMS,2,90,76,14,1
01-03-2025,"Grains, Flours & Dals",Green gram 1 kg,4,150,130,20,1
01-03-2025,"Grains, Flours & Dals",split black gram 1 kg,4,180,170,10,1
01-03-2025,"Grains, Flours & Dals",Idly Rava L 1KG,4,60,50,10,1
01-03-2025,"Dry Fruits, Nuts & Seeds",Groundnuts 500 gms,2,95,85,10,1
01-03-2025,Snacks & Ready-to-Eat,VD PALLI LADDU,14,80,80,0,1
01-03-2025,Spices & Seasonings,TATA SALT 1KG,15,30,30,0,1
01-03-2025,Spices & Seasonings,JEERA 250 gms,15,125,105,20,1
01-03-2025,"Dry Fruits, Nuts & Seeds",CASHEW 250GM,2,340,310,30,1
01-03-2025,"Grains, Flours & Dals",Wheat Flour 1 kg,4,70,60,10,1
01-03-2025,"Grains, Flours & Dals",SAMALU (Little millet) 1 kg,4,170,130,40,1
01-03-2025,Sweeteners,SUGAR 1KG,16,60,50,10,1
01-03-2025,"Dry Fruits, Nuts & Seeds",Groundnuts 1 kg,2,190,170,20,1
01-03-2025,Snacks & Ready-to-Eat,VD DAHI MIRCHI(SALTED) 100GM,14,45,45,0,1
01-03-2025,Personal Care & Cosmetics,MARGO,10,45,42,3,1
01-03-2025,Oils & Ghee,Sesame oil 500ml,9,295,280,15,1
01-03-2025,"Grains, Flours & Dals",FLOUR CHARGE,4,48,48,0,4
01-03-2025,Sweeteners,YB FOREST HONEY 250GM,16,180,180,0,1
01-03-2025,Personal Care & Cosmetics,ORGANIC SPONGE LOOFAH,10,70,70,0,1
01-03-2025,Pooja & Spiritual Items,SWASTIK PURE CAMPHOR 50GM,12,90,90,0,1
01-03-2025,"Grains, Flours & Dals",Wheat Flour 2 kgs,4,560,480,80,4
01-03-2025,Oils & Ghee,Groundnut oil 500ml,9,180,165,15,1
01-03-2025,"Health, Wellness & Ayurvedic Products",MD Hibiscus Flower Choornam 30GM,5,100,100,0,1
01-03-2025,Pooja & Spiritual Items,GOW DURBAR GEETHA CAMPHOR,12,60,60,0,1
01-03-2025,Misc,JOKER,8,20,20,0,10
01-03-2025,"Grains, Flours & Dals",MAAGAANI SP RICE 5KGS,4,1298,"1,120.00",178,2
01-03-2025,"Dry Fruits, Nuts & Seeds",YELLOW KISHMISH 250GM,2,130,110,20,1
01-03-2025,"Dry Fruits, Nuts & Seeds",PRO ORG RAW PEANUTS 500GM,2,174,174,0,1
01-03-2025,Snacks & Ready-to-Eat,VD MIXTURE 175 GM,14,60,60,0,1
01-03-2025,Oils & Ghee,Sesame oil 1 L,9,590,560,30,1
01-03-2025,Snacks & Ready-to-Eat,Sprouted Ragi Biscuits 450GM,14,150,150,0,1
01-03-2025,Snacks & Ready-to-Eat,SD Moringa with plam jaggery 250gm,14,135,135,0,1
01-03-2025,"Grains, Flours & Dals",Wheat Flour 5 kgs,4,700,600,100,2
01-03-2025,Snacks & Ready-to-Eat,urban murmura,14,120,110,10,2
01-03-2025,Personal Care & Cosmetics,HEAD& SHOULDERS ANTI DANDRUFF,10,399,299.25,99.75,1
01-03-2025,"Grains, Flours & Dals",RAGULU 1 KG,4,70,60,10,1
01-03-2025,"Grains, Flours & Dals",JOWAR WHITE 1 KG,4,80,70,10,1
01-03-2025,"Grains, Flours & Dals",Urad dall 1 Kg,4,370,340,30,2
01-03-2025,Personal Care & Cosmetics,PARACHUTE 45ML,10,20,20,0,1
01-03-2025,"Grains, Flours & Dals",COW B rice 5 kgs,4,360,345,15,1
01-03-2025,Snacks & Ready-to-Eat,NGT CHATPATTA CHANA 90GM,14,25,25,0,1
01-03-2025,"Grains, Flours & Dals",Multigrain 1 kg,4,100,85,15,1
01-03-2025,Spices & Seasonings,SD IDLY KARAM,15,65,65,0,1
01-03-2025,Snacks & Ready-to-Eat,BELLAM MINAPA SUNADULLU,14,180,180,0,1
01-03-2025,Snacks & Ready-to-Eat,PEANUT CHILLI,14,35,35,0,7
01-03-2025,Misc,JOKER,8,4,4,0,2
01-03-2025,Oils & Ghee,cow ghee 500 ml,9,430,390,40,1
01-03-2025,Oils & Ghee,Groundnut oil 1 L,9,360,330,30,1
01-03-2025,Oils & Ghee,Groundnut oil 1 L,9,720,660,60,2
01-03-2025,"Dry Fruits, Nuts & Seeds",PULMAKHANA 100 GM,2,360,340,20,2
01-03-2025,Oils & Ghee,Sesame oil 500ml,9,295,280,15,1
01-03-2025,"Dry Fruits, Nuts & Seeds",KAJU HALF 250GM,2,310,290,20,1
01-03-2025,"Dry Fruits, Nuts & Seeds",CASHEW 250GM,2,340,310,30,1
01-03-2025,Baking & Cooking Aids,Baking Soda 50GM,0,15,15,0,1
01-03-2025,"Dry Fruits, Nuts & Seeds",FLAX SEEDS 250GM,2,60,50,10,1
01-03-2025,Oils & Ghee,Coconut oil 500 ml,9,220,200,20,1
01-03-2025,"Dry Fruits, Nuts & Seeds",SUNFLOWER SEEDS 250GRM,2,150,130,20,1
01-03-2025,"Grains, Flours & Dals",MAAGAANI LOW GI SP 1KG,4,149,125,24,1
01-03-2025,"Grains, Flours & Dals",YB Red RICE 1 KG,4,150,120,30,1
01-03-2025,"Dry Fruits, Nuts & Seeds",PUMPKIN SEEDS 250GM,2,200,160,40,1
01-03-2025,"Dry Fruits, Nuts & Seeds",WATERMELON SEEDS 250GRM,2,320,280,40,1
28-02-2025,"Grains, Flours & Dals",MAATEJA rice 10 kgs,4,720,690,30,1
28-02-2025,Snacks & Ready-to-Eat,RAJGIRA PEANUT CHIKKI 450GM,14,125,125,0,1
28-02-2025,"Grains, Flours & Dals",SA Sprouted Ragi Flour 500GM,4,69,69,0,1
28-02-2025,Sweeteners,YB JAGGERY POWDER 500GMS,16,75,75,0,1
28-02-2025,"Health, Wellness & Ayurvedic Products",PULIPIRI WARTS REMOVER 9GM,5,125,125,0,1
28-02-2025,Household & Cleaning,PITAMBARI,6,28,28,0,1
28-02-2025,"Dry Fruits, Nuts & Seeds",YB GRANMA NUTS,2,90,90,0,1
28-02-2025,"Grains, Flours & Dals",RAGI FLOUR 1KG,4,80,70,10,1
28-02-2025,Snacks & Ready-to-Eat,PEANUT CHILLI,14,60,60,0,12
28-02-2025,Sweeteners,MISHRI 250 GM,16,35,30,5,1
28-02-2025,"Grains, Flours & Dals",SABDANA,4,40,35,5,1
28-02-2025,"Grains, Flours & Dals",Idly Rava L 1KG,4,60,50,10,1
28-02-2025,"Grains, Flours & Dals",RAGULU 1 KG,4,70,60,10,1
28-02-2025,Beverages,RED LABEL 100GM,1,10,10,0,1
28-02-2025,"Dry Fruits, Nuts & Seeds",SABJA SEEDS 100GM,2,80,70,10,1
28-02-2025,"Grains, Flours & Dals",SABDANA,4,40,35,5,1
28-02-2025,Snacks & Ready-to-Eat,RSC ORANGE 100GMS,14,20,20,0,1
28-02-2025,Snacks & Ready-to-Eat,GB SALT COOKIES,14,60,55,5,1
28-02-2025,Snacks & Ready-to-Eat,DOSA BATTER 1KG,14,60,60,0,1
28-02-2025,Snacks & Ready-to-Eat,SALTED PHALLI,14,65,65,0,1
28-02-2025,Snacks & Ready-to-Eat,NGT CHATPATTA CHANA 90GM,14,25,25,0,1
28-02-2025,Snacks & Ready-to-Eat,MASALA CHANA,14,25,25,0,1
28-02-2025,Snacks & Ready-to-Eat,BATANA NGT 70GMS,14,20,20,0,1
28-02-2025,Oils & Ghee,Groundnut oil 1 L,9,360,330,30,1
28-02-2025,Baking & Cooking Aids,GONDH 50GRMS,0,50,40,10,1
28-02-2025,Spices & Seasonings,Coconut Powder 250GM,15,70,70,0,1
28-02-2025,Snacks & Ready-to-Eat,ZEEDI,14,70,70,0,1
28-02-2025,Snacks & Ready-to-Eat,SD FINGER Millet with palm Jaggery 250gm,14,135,135,0,1
28-02-2025,"Dry Fruits, Nuts & Seeds",SD Mango cubes 100gm,2,45,45,0,1
28-02-2025,"Dry Fruits, Nuts & Seeds",Groundnuts 1 kg,2,380,340,40,2
28-02-2025,"Grains, Flours & Dals",Red Wheat Flour 1 kg,4,140,130,10,1
28-02-2025,Spices & Seasonings,DURGA SALT CRYSTAL 1KG,15,25,25,0,1
28-02-2025,Snacks & Ready-to-Eat,BD RED RICE NOODLES 200G,14,70,70,0,1
28-02-2025,Snacks & Ready-to-Eat,KURNOOL MARMURA,14,70,55,15,1
28-02-2025,"Grains, Flours & Dals",THICK POHA 500GM,4,40,35,5,1
28-02-2025,"Dry Fruits, Nuts & Seeds",ANJEER 250GM,2,400,360,40,1
28-02-2025,Spices & Seasonings,Tamarind 250GMS,15,80,65,15,1
28-02-2025,"Grains, Flours & Dals",PESARA PAPPU 500GMS,4,85,75,10,1
28-02-2025,Personal Care & Cosmetics,PATANJALI DAILY NATURAL CARE,10,100,75,25,1
28-02-2025,"Grains, Flours & Dals",Brown RICE 1KG,4,70,65,5,1
28-02-2025,"Grains, Flours & Dals",VGR rice 1 kg,4,70,65,5,1
28-02-2025,Snacks & Ready-to-Eat,GB SALT COOKIES,14,60,55,5,1
28-02-2025,"Health, Wellness & Ayurvedic Products",MORINGA LEAF POWDER M,5,80,75,5,1
28-02-2025,Oils & Ghee,Groundnut oil 1 L,9,360,330,30,1
28-02-2025,Oils & Ghee,Sesame oil 1 L,9,590,560,30,1
28-02-2025,Oils & Ghee,Safflower oil 1 L,9,440,400,40,1
28-02-2025,Snacks & Ready-to-Eat,RAJGIRA PEANUT CHIKKI 450GM,14,250,250,0,2
28-02-2025,Snacks & Ready-to-Eat,GB SALT COOKIES,14,60,55,5,1
28-02-2025,"Dry Fruits, Nuts & Seeds",FLAX SEEDS 250GM,2,60,50,10,1
28-02-2025,"Grains, Flours & Dals",SAMALU (Little millet) 1 kg,4,340,260,80,2
28-02-2025,Snacks & Ready-to-Eat,ZEEDI,14,70,70,0,1
28-02-2025,"Grains, Flours & Dals",SINGLE POLISH 1KG,4,130,130,0,2
28-02-2025,"Dry Fruits, Nuts & Seeds",Putnalu 250GM,2,45,38,7,1
28-02-2025,"Dry Fruits, Nuts & Seeds",Groundnuts 1 kg,2,190,170,20,1
28-02-2025,Snacks & Ready-to-Eat,VD PALLI LADDU,14,80,80,0,1
28-02-2025,Sweeteners,YB JAGGERY POWDER 1KG,16,140,140,0,1
28-02-2025,"Dry Fruits, Nuts & Seeds",CASHEW 250GM,2,340,310,30,1
28-02-2025,Sweeteners,SUGAR 500 GM,16,30,25,5,1
28-02-2025,Spices & Seasonings,Coriander seeds 200 gms,15,48,40,8,1
28-02-2025,"Grains, Flours & Dals",Chana Flour 500 gms,4,70,65,5,1
28-02-2025,Snacks & Ready-to-Eat,VD RICE SAGO PAPAD 150GM,14,55,55,0,1
28-02-2025,"Grains, Flours & Dals",Wheat Rava M 1KG,4,65,55,10,1
28-02-2025,"Grains, Flours & Dals",RICE FLOUR 500 GM,4,35,28,7,1
28-02-2025,"Grains, Flours & Dals",Hs yellow jowar r 500g,4,99,99,0,1
28-02-2025,Oils & Ghee,Groundnut oil 1 L,9,360,330,30,1
28-02-2025,"Grains, Flours & Dals",RAGI FLOUR 1KG,4,80,70,10,1
28-02-2025,"Grains, Flours & Dals",Wheat Flour 2 kgs,4,140,120,20,1
28-02-2025,"Grains, Flours & Dals",RAGULU 1 KG,4,70,60,10,1
28-02-2025,Spices & Seasonings,Jeera 100GM,15,50,45,5,1
28-02-2025,"Grains, Flours & Dals",RAJMA 500GM,4,180,180,0,2
28-02-2025,Spices & Seasonings,Tamarind 250GMS,15,80,65,15,1
28-02-2025,"Dry Fruits, Nuts & Seeds",PULMAKHANA 100 GM,2,180,170,10,1
28-02-2025,Oils & Ghee,Sesame oil 500ml,9,295,280,15,1
28-02-2025,Oils & Ghee,Groundnut oil 1 L,9,360,330,30,1
28-02-2025,Pooja & Spiritual Items,GD Aiswarya Deepam 700ML,12,195,195,0,1
28-02-2025,Oils & Ghee,Safflower oil 1 L,9,440,400,40,1
28-02-2025,"Grains, Flours & Dals",FLOUR CHARGE,4,512,512,0,1
28-02-2025,"Grains, Flours & Dals",MELMEKER 250GMS,4,60,45,15,1
28-02-2025,Spices & Seasonings,SATHVI ANASAPUVUU 25GM,15,90,65,25,1
28-02-2025,"Grains, Flours & Dals",RED TUDAL 1KG,4,150,140,10,1
28-02-2025,"Dry Fruits, Nuts & Seeds",YELLOW KISHMISH 250GM,2,130,110,20,1
28-02-2025,Snacks & Ready-to-Eat,KURNOOL MARMURA,14,70,55,15,1
28-02-2025,"Dry Fruits, Nuts & Seeds",DRYDATES YELLOW 250GM,2,135,120,15,1
28-02-2025,Sweeteners,MADHUR SUGAR 1KG,16,65,55,10,1
28-02-2025,"Grains, Flours & Dals",THICK POHA 500GM,4,40,35,5,1
28-02-2025,"Dry Fruits, Nuts & Seeds",ANJEER 250GM,2,400,360,40,1
28-02-2025,"Grains, Flours & Dals",RAGI FLOUR 500GRMS,4,40,35,5,1
28-02-2025,Sweeteners,YB JAGGERY POWDER 500GMS,16,150,150,0,2
28-02-2025,Snacks & Ready-to-Eat,VD SAGOPAPAD 150GM,14,55,55,0,1
28-02-2025,Spices & Seasonings,DRY MIECHI 200GM,15,80,60,20,1
28-02-2025,Spices & Seasonings,Coriander seeds 200 gms,15,48,40,8,1
28-02-2025,Personal Care & Cosmetics,papaya soap,10,90,90,0,1
28-02-2025,"Dry Fruits, Nuts & Seeds",Groundnuts 1 kg,2,190,170,20,1
28-02-2025,Snacks & Ready-to-Eat,VD Minapa papad 200gm,14,60,60,0,1
28-02-2025,Spices & Seasonings,JEERA 250 gms,15,125,105,20,1
28-02-2025,Snacks & Ready-to-Eat,ZEEDI,14,70,70,0,1
28-02-2025,Sweeteners,MISHRI D,16,40,30,10,1
28-02-2025,Sweeteners,GS JAGGERY NUGGETS 500GM,16,120,120,0,1
28-02-2025,Sweeteners,YB JAGGERY POWDER 500GMS,16,75,75,0,1
28-02-2025,Snacks & Ready-to-Eat,PEANUT CHILLI,14,30,30,0,6
28-02-2025,Spices & Seasonings,BLACK JEERA 50 GM,15,45,30,15,1
28-02-2025,Oils & Ghee,MUSTARD OIL 100ML,9,100,100,0,1
28-02-2025,"Health, Wellness & Ayurvedic Products",MD Aamlaki Choornam 100GM,5,80,80,0,1
28-02-2025,"Grains, Flours & Dals",SINGLE POLISH 1KG,4,130,130,0,2
28-02-2025,"Grains, Flours & Dals",idly/Dosa rice 1 kg,4,70,60,10,1
28-02-2025,"Grains, Flours & Dals",FLOUR CHARGE,4,52.8,52.8,0,4.4
28-02-2025,"Grains, Flours & Dals",HS JOWAR FLAKES 250GM 1+1,4,119,119,0,1
28-02-2025,Spices & Seasonings,ROYAL SAFFRON,15,125,125,0,1
28-02-2025,Snacks & Ready-to-Eat,ZEEDI,14,70,70,0,1
28-02-2025,"Grains, Flours & Dals",RAGI FLOUR 1KG,4,80,70,10,1
28-02-2025,Snacks & Ready-to-Eat,RSC ORANGE 100GMS,14,20,20,0,1
28-02-2025,"Grains, Flours & Dals",MELMEKER 250GMS,4,60,45,15,1
28-02-2025,Spices & Seasonings,TATA SALT 1KG,15,30,30,0,1
28-02-2025,Snacks & Ready-to-Eat,VD SANNAPUSA 175GM,14,60,60,0,1
28-02-2025,Snacks & Ready-to-Eat,NGT CHATPATTA CHANA 90GM,14,25,25,0,1
28-02-2025,Snacks & Ready-to-Eat,VD NUVULLU CHIKKI,14,80,80,0,1
28-02-2025,Oils & Ghee,cow ghee 500 ml,9,430,390,40,1
28-02-2025,"Grains, Flours & Dals",JOWAR UPMA RAVA,4,75,75,0,1
28-02-2025,Snacks & Ready-to-Eat,VD MULTI CHAKKA,14,110,110,0,1
28-02-2025,"Health, Wellness & Ayurvedic Products",MXP CHOCO CLASSIC BAR,5,80,80,0,1
28-02-2025,Oils & Ghee,Groundnut oil 1 L,9,1080,990,90,3
28-02-2025,Snacks & Ready-to-Eat,RITEBITE BLUEBERRY BLAST,14,50,50,0,1
28-02-2025,Milk & Dairy,HERITAGE TOTAL CURD 500GM,7,50,50,0,1
28-02-2025,Milk & Dairy,SANGAM TONED MILK 500ML,7,30,30,0,1
28-02-2025,"Grains, Flours & Dals",Wheat Flour 1 kg,4,70,60,10,1
28-02-2025,"Grains, Flours & Dals",PRO SABUDHANA 500GM,4,89,89,0,1
28-02-2025,Spices & Seasonings,Chilli powder 500 gms,15,290,210,80,1
28-02-2025,"Grains, Flours & Dals",SRILATHA RICE RAVVA 500GM,4,35,35,0,1
28-02-2025,"Grains, Flours & Dals",PRO ORG RED POHA 500GM,4,89,89,0,1
28-02-2025,Spices & Seasonings,PRO ORG TURMERIC POWDER 100G,15,70,70,0,1
28-02-2025,Spices & Seasonings,Chilli powder 500 gms,15,290,210,80,1
28-02-2025,Spices & Seasonings,Elaichi 25GM,15,145,120,25,1
28-02-2025,General Household & Kitchenware,WOODEN SPOON BIG,3,50,50,0,1
28-02-2025,"Health, Wellness & Ayurvedic Products",RB Max Protein Soft &Chewy 55gm,5,60,60,0,1
28-02-2025,"Grains, Flours & Dals",RED TURDAL 500GM,4,75,70,5,1
28-02-2025,Spices & Seasonings,DWIBHASHI SAFFRON,15,360,360,0,1
28-02-2025,"Grains, Flours & Dals",White jowar.F 1 kg,4,100,80,20,1
28-02-2025,Snacks & Ready-to-Eat,SD JOWAR WITH PALM JAGGERY 250GM,14,135,135,0,1
28-02-2025,"Grains, Flours & Dals",KORRALU (FOXTAIL M) 500GM,4,65,55,10,1
28-02-2025,Snacks & Ready-to-Eat,VD Pappu Chekkalu 190gm,14,60,60,0,1
28-02-2025,Household & Cleaning,VIM TROPICAL LEMON FRESHNESS 250ML,6,55,55,0,1
28-02-2025,Sweeteners,YB JAGGERY POWDER 500GMS,16,75,75,0,1
28-02-2025,Snacks & Ready-to-Eat,JUNNU POWDER 100GM,14,70,70,0,1
28-02-2025,Snacks & Ready-to-Eat,VD MIXTURE 175 GM,14,60,60,0,1
28-02-2025,"Health, Wellness & Ayurvedic Products",RB Max Protein Jaggery Crunchy,5,175,175,0,1
28-02-2025,"Grains, Flours & Dals",HS JOWAR FLAKES 250GM 1+1,4,59,59,0,1
28-02-2025,Pooja & Spiritual Items,GD Aiswarya Deepam 700ML,12,195,195,0,1
28-02-2025,"Grains, Flours & Dals",White Chana 500GM,4,120,100,20,1
28-02-2025,"Grains, Flours & Dals",RAGI FLOUR 1KG,4,80,70,10,1
28-02-2025,"Grains, Flours & Dals",BARLEY SEEDS 250GMS,4,80,70,10,2
28-02-2025,"Grains, Flours & Dals",VL Sabdana 500GM,4,77,77,0,1
28-02-2025,Spices & Seasonings,PURO Healthy Salt Crystal 1KG,15,135,135,0,1
28-02-2025,"Grains, Flours & Dals",RAGI FLOUR 1KG,4,80,70,10,1
28-02-2025,"Grains, Flours & Dals",SL Idly Rava 1KG,4,65,55,10,1
28-02-2025,Oils & Ghee,Black Sesame oil 1 L,9,440,380,60,1
28-02-2025,"Grains, Flours & Dals",RICE FLOUR 1KG,4,70,55,15,1
28-02-2025,"Grains, Flours & Dals",THIN POHA 500GM,4,40,35,5,1
28-02-2025,Snacks & Ready-to-Eat,VD NUVULU LADDU 9PIC,14,100,100,0,1
28-02-2025,Snacks & Ready-to-Eat,VD PALLI CHIKKI,14,80,80,0,1
28-02-2025,Snacks & Ready-to-Eat,MILK BREAD,14,55,55,0,1
28-02-2025,Snacks & Ready-to-Eat,ELITE ELAICHI RUSK 200GM,14,35,35,0,1
28-02-2025,"Health, Wellness & Ayurvedic Products",RB Max Protein Chinese Manchurian,5,90,90,0,2
28-02-2025,Oils & Ghee,Safflower oil 500 ml,9,220,200,20,1
28-02-2025,Snacks & Ready-to-Eat,VD PALLI LADDU,14,160,160,0,2
28-02-2025,Spices & Seasonings,ROYAL SAFFRON 400GRMS,15,130,130,0,2
28-02-2025,Snacks & Ready-to-Eat,SD Atreyapuram DRY Fruit ghee,14,150,150,0,1
28-02-2025,Oils & Ghee,Groundnut oil 500ml,9,180,165,15,1
28-02-2025,Snacks & Ready-to-Eat,HS Ragi biscuits,14,50,50,0,1
28-02-2025,Snacks & Ready-to-Eat,Sprouted Ragi Biscuits 450GM,14,150,150,0,1
28-02-2025,"Grains, Flours & Dals",URAD DALL,4,95,85,10,1
28-02-2025,"Dry Fruits, Nuts & Seeds",Putnalu 250GM,2,45,38,7,1
28-02-2025,Snacks & Ready-to-Eat,RAJGIRA PEANUT CHIKKI,14,10,10,0,2
28-02-2025,Snacks & Ready-to-Eat,Corn Chips 250GM,14,40,35,5,1
28-02-2025,Snacks & Ready-to-Eat,MIX MILLET NOODLES,14,75,75,0,1
28-02-2025,Spices & Seasonings,AVALU 100GM,15,50,40,10,2
28-02-2025,Snacks & Ready-to-Eat,BD RED RICE NOODLES 200G,14,70,70,0,1
28-02-2025,Spices & Seasonings,Menthulu 250 gms,15,50,45,5,1
28-02-2025,Snacks & Ready-to-Eat,BD KODO MILLET NOODLES 200GM,14,75,75,0,1
28-02-2025,Snacks & Ready-to-Eat,BD PEARL MILLET NOODLES 200G,14,70,70,0,1
28-02-2025,"Grains, Flours & Dals",Idly Rava L 1KG,4,240,200,40,4
28-02-2025,"Grains, Flours & Dals",Chana Flour 500 gms,4,70,65,5,1
28-02-2025,"Dry Fruits, Nuts & Seeds",Groundnuts 1 kg,2,190,170,20,1
28-02-2025,Beverages,BRU GREEN LABEL 1.2G,1,240,240,0,1
28-02-2025,Spices & Seasonings,JEERA 250 gms,15,125,105,20,1
28-02-2025,Snacks & Ready-to-Eat,VD MIXTURE 175 GM,14,120,120,0,2
28-02-2025,Spices & Seasonings,AV Iodized Salt 1KG,15,56,50,6,2
28-02-2025,Snacks & Ready-to-Eat,FOXTAIL NOODLES,14,75,75,0,1
28-02-2025,Beverages,REFRESH SHARBATH NORMAL,1,199,190,9,1
28-02-2025,Personal Care & Cosmetics,SVE KHADI ALOEVERA GEL 200GM,10,270,270,0,1
28-02-2025,"Grains, Flours & Dals",BOMBAY RAVA,4,140,110,30,2
28-02-2025,Snacks & Ready-to-Eat,JUNNU POWDER 100GM,14,140,140,0,2
28-02-2025,Spices & Seasonings,LG 50GM,15,92,92,0,1
28-02-2025,Beverages,REFRESH SHARBATH SUGAR FREE,1,598,570,28,2
28-02-2025,"Grains, Flours & Dals",THICK POHA 1KG,4,80,70,10,1
28-02-2025,Spices & Seasonings,Elaichi 25GM,15,290,240,50,2
28-02-2025,Spices & Seasonings,Tamarind 250GMS,15,80,65,15,1
28-02-2025,"Dry Fruits, Nuts & Seeds",SUNFLOWER SEEDS 250GRM,2,150,130,20,1
28-02-2025,Spices & Seasonings,SAJEERA,15,60,40,20,1
28-02-2025,"Dry Fruits, Nuts & Seeds",PUMPKIN SEEDS 250GM,2,200,160,40,1
28-02-2025,"Dry Fruits, Nuts & Seeds",WATERMELON SEEDS 250GRM,2,320,280,40,1
28-02-2025,"Dry Fruits, Nuts & Seeds",FLAX SEEDS 250GM,2,60,50,10,1
28-02-2025,"Grains, Flours & Dals",SA Sprouted Ragi Flour 500GM,4,69,69,0,1
28-02-2025,Personal Care & Cosmetics,PAPAYA GEL,10,140,140,0,1
28-02-2025,Spices & Seasonings,DRY MIECHI 200GM,15,80,60,20,1
28-02-2025,Milk & Dairy,SANGAM TONED MILK 500ML,7,30,30,0,1
28-02-2025,Household & Cleaning,VIM EXTRA 110GM,6,20,20,0,2
28-02-2025,Personal Care & Cosmetics,SANTOOR,10,20,0,20,1
28-02-2025,Oils & Ghee,Groundnut oil 1 L,9,360,330,30,1
28-02-2025,"Grains, Flours & Dals",Multigrain 1 kg,4,100,85,15,1
28-02-2025,Oils & Ghee,Sesame oil 1 L,9,590,560,30,1
28-02-2025,Snacks & Ready-to-Eat,PEANUT CHILLI,14,50,50,0,10
28-02-2025,Snacks & Ready-to-Eat,TILLI CHIKKI,14,25,25,0,5
28-02-2025,Sweeteners,Natural Honey 500 gms,16,280,240,40,1
28-02-2025,Oils & Ghee,Groundnut oil 1 L,9,360,330,30,1
28-02-2025,"Grains, Flours & Dals",RAGI FLOUR 1KG,4,160,140,20,2
28-02-2025,Spices & Seasonings,Jeera 100GM,15,50,45,5,1
28-02-2025,"Grains, Flours & Dals",Multigrain 1 kg,4,100,85,15,1
28-02-2025,Oils & Ghee,Safflower oil 1 L,9,440,400,40,1
28-02-2025,Snacks & Ready-to-Eat,Corn Chips 250GM,14,40,35,5,1
28-02-2025,Sweeteners,Mishri 500GM,16,70,60,10,1
28-02-2025,"Grains, Flours & Dals",Yellow jowar .F1 kg,4,110,100,10,1
28-02-2025,Spices & Seasonings,DRY MIECHI 200GM,15,80,60,20,1
28-02-2025,"Grains, Flours & Dals",White jowar.F 1 kg,4,100,80,20,1
28-02-2025,"Grains, Flours & Dals",white Bobarlu 500 gms,4,80,75,5,1
28-02-2025,Snacks & Ready-to-Eat,VD PALLI LADDU,14,80,80,0,1
28-02-2025,Snacks & Ready-to-Eat,VD SAGOPAPAD 150GM,14,55,55,0,1
28-02-2025,"Grains, Flours & Dals",Wheat Flour 1 kg,4,140,120,20,2
28-02-2025,Oils & Ghee,Sesame oil 1 L,9,590,560,30,1
28-02-2025,Oils & Ghee,Groundnut oil 1 L,9,360,330,30,1
28-02-2025,Spices & Seasonings,Turmeric powder 250 gms,15,100,75,25,1
28-02-2025,Spices & Seasonings,Masala Karam 250 gms,15,130,120,10,1
28-02-2025,"Grains, Flours & Dals",MELMEKER 250GMS,4,60,45,15,1
28-02-2025,Snacks & Ready-to-Eat,VD Minapa papad 200gm,14,60,60,0,1
28-02-2025,"Grains, Flours & Dals",FLOUR CHARGE,4,24,24,0,2
28-02-2025,"Grains, Flours & Dals",Red Wheat Flour 1 kg,4,280,260,20,2
28-02-2025,"Dry Fruits, Nuts & Seeds",SATHVI CHIA SEEDS 100GM,2,200,160,40,2
28-02-2025,Oils & Ghee,Safflower oil 1 L,9,440,400,40,1
28-02-2025,"Grains, Flours & Dals",Red Bobarlu 500 gms,4,95,85,10,1
28-02-2025,Oils & Ghee,Groundnut oil 1 L,9,360,330,30,1
28-02-2025,"Grains, Flours & Dals",KORRALU (FOXTAIL M) 1KG,4,300,220,80,2
28-02-2025,Milk & Dairy,HERITAGE TOTAL CURD 500GM,7,50,50,0,1
28-02-2025,Oils & Ghee,Safflower oil 500 ml,9,220,200,20,1
28-02-2025,"Grains, Flours & Dals",Em kodo idli R 500G,4,129,129,0,1
28-02-2025,"Health, Wellness & Ayurvedic Products",MD Guduchi Choornam 100GM,5,110,110,0,1
28-02-2025,Oils & Ghee,Groundnut oil 1 L,9,720,660,60,2
28-02-2025,"Grains, Flours & Dals",BARLEY SEEDS 1KG,4,480,420,60,3
28-02-2025,"Grains, Flours & Dals",FLOUR CHARGE,4,36,36,0,3
28-02-2025,Sweeteners,YB Brown Sugar 500GM,16,300,300,0,4
28-02-2025,Snacks & Ready-to-Eat,RSC ORANGE 100GMS,14,20,20,0,1
28-02-2025,"Grains, Flours & Dals",Idly Rava L 1KG,4,60,50,10,1
28-02-2025,Oils & Ghee,Coconut oil 500 ml,9,220,200,20,1
28-02-2025,"Grains, Flours & Dals",Multigrain 1 kg,4,200,170,30,2
28-02-2025,"Health, Wellness & Ayurvedic Products",KONDAPINDI CHOORNAM,5,100,100,0,1
28-02-2025,Oils & Ghee,Groundnut oil 1 L,9,720,660,60,2
28-02-2025,Oils & Ghee,Groundnut oil 500ml,9,180,165,15,1
28-02-2025,Oils & Ghee,Sesame oil 500ml,9,295,280,15,1
28-02-2025,"Grains, Flours & Dals",unpolished turdall500grms,4,120,110,10,1
28-02-2025,"Grains, Flours & Dals",Idly Rava L 1KG,4,60,50,10,1
28-02-2025,General Household & Kitchenware,B3 BOWL,3,265,251.75,13.25,1
28-02-2025,"Dry Fruits, Nuts & Seeds",YELLOW KISHMISH 250GM,2,130,110,20,1
28-02-2025,"Grains, Flours & Dals",JOWAR WHITE 1 KG,4,40,35,5,0.5
28-02-2025,"Grains, Flours & Dals",BASMATHI RICE 1KG,4,150,135,15,1
28-02-2025,Oils & Ghee,Groundnut oil 1 L,9,720,660,60,2
28-02-2025,"Dry Fruits, Nuts & Seeds",FLAX SEEDS 250GM,2,60,50,10,1
28-02-2025,Household & Cleaning,VIM EXTRA 110GM,6,30,30,0,3
28-02-2025,"Grains, Flours & Dals",Wheat Flour 1 kg,4,140,120,20,2
28-02-2025,Snacks & Ready-to-Eat,BLACK SESAME CHIKKI,14,10,10,0,1
28-02-2025,Snacks & Ready-to-Eat,RAJGIRA PEANUT CHIKKI,14,25,25,0,5
28-02-2025,General Household & Kitchenware,B4 BOWL,3,160,152,8,1
28-02-2025,Milk & Dairy,BROWN EGGS 1P,7,168,144,24,12
28-02-2025,"Grains, Flours & Dals",Bajra Flour 500 gms,4,35,30,5,1
28-02-2025,Milk & Dairy,BROWN EGGS 1P,7,84,72,12,6
28-02-2025,"Grains, Flours & Dals",RAGI FLOUR 500GRMS,4,40,35,5,1
28-02-2025,"Grains, Flours & Dals",Yellow jowar.F 500 gms,4,55,50,5,1
28-02-2025,"Grains, Flours & Dals",Wheat Rava M 500GM,4,33,30,3,1
28-02-2025,Snacks & Ready-to-Eat,GREEN FRIED BATANA,14,20,20,0,1
28-02-2025,"Grains, Flours & Dals",FLOUR CHARGE,4,14.4,14.4,0,1.2
28-02-2025,"Grains, Flours & Dals",DESI CHANA,4,25,25,0,1
28-02-2025,"Grains, Flours & Dals",KORRALU (FOXTAIL M) 500GM,4,65,55,10,1
28-02-2025,"Grains, Flours & Dals",FLOUR CHARGE,4,18,18,0,1.5
28-02-2025,"Grains, Flours & Dals",Arikalu (kodo),4,70,65,5,1
28-02-2025,"Grains, Flours & Dals",RAGULU 1 KG,4,35,30,5,0.5
28-02-2025,Oils & Ghee,Coconut oil 500 ml,9,220,200,20,1
28-02-2025,Sweeteners,MISHRI D,16,40,30,10,1
28-02-2025,Spices & Seasonings,Dalchin Chekka 50GM,15,50,40,10,1
28-02-2025,"Grains, Flours & Dals",PESARA PAPPU 1 KG,4,170,145,25,1
28-02-2025,"Grains, Flours & Dals",JOWAR YELLOW 1 K,4,100,90,10,1
28-02-2025,Sweeteners,MISHRI 250 GM,16,35,30,5,1
28-02-2025,Sweeteners,SUGAR 1KG,16,60,50,10,1
28-02-2025,"Grains, Flours & Dals",Idly Rava L 1KG,4,60,50,10,1
28-02-2025,"Grains, Flours & Dals",FLOUR CHARGE,4,24,24,0,2
28-02-2025,"Grains, Flours & Dals",KORRALU (FOXTAIL M) 1KG,4,150,110,40,1
28-02-2025,Oils & Ghee,GROUNDNUT OIL 1KG,9,1400,"1,400.00",0,4
28-02-2025,"Grains, Flours & Dals",WHEAT 1 KG,4,120,100,20,2
28-02-2025,Oils & Ghee,Groundnut oil 1 L,9,720,660,60,2
28-02-2025,Sweeteners,MISHRI D,16,40,30,10,1
28-02-2025,"Grains, Flours & Dals",Red Bobarlu 500 gms,4,95,85,10,1
28-02-2025,Spices & Seasonings,Jeera 100GM,15,50,45,5,1
28-02-2025,Oils & Ghee,Coconut oil 500 ml,9,220,200,20,1
28-02-2025,"Grains, Flours & Dals",Red Chana 500 GM,4,75,60,15,1
28-02-2025,"Grains, Flours & Dals",RED TURDAL 500GM,4,75,70,5,1
28-02-2025,"Grains, Flours & Dals",ANDU KORRALU (Browntop.m) 1 kg,4,260,220,40,1
28-02-2025,"Grains, Flours & Dals",UDALU (Barnyard millet) 1 kg,4,140,115,25,1
28-02-2025,"Grains, Flours & Dals",SAMALU (Little millet) 1 kg,4,170,130,40,1
28-02-2025,"Grains, Flours & Dals",Arikadu ( kodo),4,140,130,10,1
28-02-2025,Spices & Seasonings,Menthulu 250 gms,15,50,45,5,1
28-02-2025,"Grains, Flours & Dals",POORI ATTA 500GM,4,70,60,10,2
28-02-2025,Spices & Seasonings,Lavangam 50GM,15,60,50,10,1
28-02-2025,Milk & Dairy,BROWN EGGS TRAY 30P,7,360,330,30,1
28-02-2025,Oils & Ghee,Coconut oil 500 ml,9,220,200,20,1
28-02-2025,"Grains, Flours & Dals",POORI ATTA 1KG,4,70,60,10,1
28-02-2025,Milk & Dairy,SANGAM TONED MILK 500ML,7,30,30,0,1
28-02-2025,Milk & Dairy,SANGAM TONED MILK 500ML,7,30,30,0,1
28-02-2025,Snacks & Ready-to-Eat,VD MIXTURE 175 GM,14,60,60,0,1
28-02-2025,Oils & Ghee,Groundnut oil 1 L,9,360,330,30,1
28-02-2025,Oils & Ghee,Mustard oil 500 ml,9,220,195,25,1
28-02-2025,Oils & Ghee,Sesame oil 1 L,9,590,560,30,1
28-02-2025,Sweeteners,GS Organic Jaggery Powder 600GM,16,99,99,0,1
28-02-2025,"Grains, Flours & Dals",ANDU KORRALU (Brown top .mlt) 500,4,130,110,20,1
28-02-2025,"Grains, Flours & Dals",Wheat Flour 1 kg,4,70,60,10,1
28-02-2025,"Grains, Flours & Dals",COW B rice 5 kgs,4,360,345,15,1
28-02-2025,"Grains, Flours & Dals",Brown RICE 1KG,4,700,650,50,10
28-02-2025,Snacks & Ready-to-Eat,VD NUVULLU CHIKKI,14,80,80,0,1
28-02-2025,Pickles & Cooking Pastes,SD MANGO TOKKU,11,110,110,0,1
28-02-2025,Oils & Ghee,Groundnut oil 1 L,9,360,330,30,1
28-02-2025,Spices & Seasonings,NUVVULU 250GM,15,100,85,15,1
28-02-2025,Snacks & Ready-to-Eat,SD FINGER Millet with palm Jaggery 250gm,14,135,135,0,1
28-02-2025,Oils & Ghee,Groundnut oil 1 L,9,360,330,30,1
28-02-2025,Snacks & Ready-to-Eat,VD PALLI LADDU,14,80,80,0,1
28-02-2025,Snacks & Ready-to-Eat,SESAME LADDU 200GM,14,100,80,20,1
28-02-2025,Snacks & Ready-to-Eat,SD black sesme laddu with dates 175gm,14,135,135,0,1
28-02-2025,Spices & Seasonings,YB PINK ROCK SALT 1KG,15,120,120,0,1
28-02-2025,Oils & Ghee,Groundnut oil 1 L,9,360,330,30,1
28-02-2025,"Grains, Flours & Dals",KORRALU (FOXTAIL M) 1KG,4,1500,"1,100.00",400,10
28-02-2025,Spices & Seasonings,DURGA SALT CRYSTAL 1KG,15,25,25,0,1
28-02-2025,Snacks & Ready-to-Eat,KURNOOL MARMURA,14,70,55,15,1
28-02-2025,Milk & Dairy,SANGAM TONED MILK 500ML,7,30,30,0,1
28-02-2025,Milk & Dairy,SANGAM FULL CREAM MILK 500ML,7,38,38,0,1
28-02-2025,Snacks & Ready-to-Eat,MB FOXTAIL MILLET NOODLES 180GM,14,95,95,0,1
28-02-2025,"Grains, Flours & Dals",Red Wheat Flour 1 kg,4,140,130,10,1
28-02-2025,"Grains, Flours & Dals",Urad dall 1 Kg,4,185,170,15,1
28-02-2025,"Grains, Flours & Dals",Yellow jowar .F1 kg,4,110,100,10,1
28-02-2025,"Grains, Flours & Dals",KORRALU (FOXTAIL M) 500GM,4,65,55,10,1
28-02-2025,"Grains, Flours & Dals",Idly Rava L 1KG,4,120,100,20,2
28-02-2025,Oils & Ghee,Sesame oil 1 L,9,1180,"1,120.00",60,2
28-02-2025,"Grains, Flours & Dals",Wheat Flour 1 kg,4,70,60,10,1
28-02-2025,Oils & Ghee,Coconut oil 500 ml,9,220,200,20,1
28-02-2025,Oils & Ghee,Groundnut oil 500ml,9,180,165,15,1
27-02-2025,Snacks & Ready-to-Eat,ZEEDI,14,70,70,0,1
27-02-2025,Personal Care & Cosmetics,ORGANIC SPONGE LOOFAH,10,70,70,0,1
27-02-2025,"Health, Wellness & Ayurvedic Products",GS Wheat Grass Powder 100GMS,5,349,349,0,1
27-02-2025,"Grains, Flours & Dals",DESI CHANA,4,25,25,0,1
27-02-2025,Oils & Ghee,Sesame oil 500ml,9,295,280,15,1
27-02-2025,"Grains, Flours & Dals",Yellow jowar .F1 kg,4,110,100,10,1
27-02-2025,Personal Care & Cosmetics,PAPAYA GEL,10,140,140,0,1
27-02-2025,"Dry Fruits, Nuts & Seeds",SD Mango cubes 100gm,2,45,45,0,1
27-02-2025,Snacks & Ready-to-Eat,VD NUVULU LADDU 9PIC,14,100,100,0,1
27-02-2025,Snacks & Ready-to-Eat,VD MANGO JELLY 250GRMS,14,80,80,0,1
27-02-2025,"Dry Fruits, Nuts & Seeds",SALTED PISTA 250GM,2,400,350,50,1
27-02-2025,Oils & Ghee,Groundnut oil 1 L,9,360,330,30,1
27-02-2025,"Grains, Flours & Dals",VGR RICE 5 KGS,4,350,325,25,1
27-02-2025,Snacks & Ready-to-Eat,SD Aswagandha with palm Jaggery250Gm,14,135,135,0,1
27-02-2025,Sweeteners,YB Brown Sugar 500GM,16,75,75,0,1
27-02-2025,"Grains, Flours & Dals",Wheat Flour 1 kg,4,210,180,30,3
27-02-2025,Sweeteners,GS Organic Jaggery Powder 600GM,16,99,99,0,1
27-02-2025,Snacks & Ready-to-Eat,SD KODO MILLET WITH PALM JAGGERY,14,135,135,0,1
27-02-2025,"Grains, Flours & Dals",KORRALU (FOXTAIL M) 500GM,4,65,55,10,1
27-02-2025,Snacks & Ready-to-Eat,SD Aswagandha with palm Jaggery250Gm,14,135,135,0,1
27-02-2025,"Dry Fruits, Nuts & Seeds",Groundnuts 500 gms,2,95,85,10,1
27-02-2025,Oils & Ghee,Sesame oil 1 L,9,590,560,30,1
27-02-2025,"Grains, Flours & Dals",RAGI FLOUR 500GRMS,4,40,35,5,1
27-02-2025,Oils & Ghee,Groundnut oil 1 L,9,360,330,30,1
27-02-2025,"Grains, Flours & Dals",SL Idly Rava 1KG,4,130,110,20,2
27-02-2025,Milk & Dairy,SANGAM TONED MILK 500ML,7,30,30,0,1
27-02-2025,"Grains, Flours & Dals",ANDU KORRALU (Browntop.m) 1 kg,4,260,220,40,1
27-02-2025,"Grains, Flours & Dals",KORRALU (FOXTAIL M) 1KG,4,150,110,40,1
27-02-2025,"Grains, Flours & Dals",Red uluvalu 250 gms,4,45,40,5,1
27-02-2025,Milk & Dairy,SANGAM CURD 450GM,7,38,38,0,1
27-02-2025,Oils & Ghee,Sesame oil 1 L,9,590,560,30,1
27-02-2025,Oils & Ghee,Safflower oil 1 L,9,440,400,40,1
27-02-2025,"Grains, Flours & Dals",Wheat Rava M 1KG,4,130,110,20,2
27-02-2025,"Grains, Flours & Dals",BARLEY SEEDS 1KG,4,80,70,10,0.5
27-02-2025,"Health, Wellness & Ayurvedic Products",RB Max Protein Choco Creamy Spread,5,80,80,0,1
27-02-2025,"Grains, Flours & Dals",SINGLE POLISH 1KG,4,292.5,292.5,0,4.5
27-02-2025,Oils & Ghee,Groundnut oil 500ml,9,180,165,15,1
27-02-2025,"Dry Fruits, Nuts & Seeds",SD Mango cubes 100gm,2,45,45,0,1
27-02-2025,Oils & Ghee,Sesame oil 500ml,9,295,280,15,1
27-02-2025,"Grains, Flours & Dals",Multigrain 1 kg,4,100,85,15,1
27-02-2025,Oils & Ghee,Groundnut oil 1 L,9,720,660,60,2
27-02-2025,Spices & Seasonings,TATA SALT 1KG,15,30,30,0,1
27-02-2025,"Grains, Flours & Dals",Multigrain 1 kg,4,100,85,15,1
27-02-2025,Milk & Dairy,HERITAGE BUTTERMILK,7,20,20,0,2
27-02-2025,"Grains, Flours & Dals",CHANA DAL 1KG,4,35,30,5,0.25
27-02-2025,Oils & Ghee,Groundnut oil 1 L,9,360,330,30,1
27-02-2025,Snacks & Ready-to-Eat,KURNOOL MARMURA,14,70,55,15,1
27-02-2025,"Grains, Flours & Dals",VGR rice 1 kg,4,140,130,10,2
27-02-2025,Spices & Seasonings,Elaichi 25GM,15,145,120,25,1
27-02-2025,"Grains, Flours & Dals",Multigrain 1 kg,4,100,85,15,1
27-02-2025,"Grains, Flours & Dals",CORN FLOUR,4,80,70,10,1
27-02-2025,"Grains, Flours & Dals",Chana Flour 500 gms,4,70,65,5,1
27-02-2025,Snacks & Ready-to-Eat,RB Choco Delite Almonds Raisins 40g,14,45,45,0,1
27-02-2025,"Grains, Flours & Dals",Chana Flour 500 gms,4,70,65,5,1
27-02-2025,Snacks & Ready-to-Eat,PEANUT CHILLI,14,25,25,0,5
27-02-2025,"Grains, Flours & Dals",Wheat Rava M 500GM,4,33,30,3,1
27-02-2025,"Grains, Flours & Dals",Multigrain 1 kg,4,200,170,30,2
27-02-2025,Snacks & Ready-to-Eat,VD RIBBON PAKODI 175GM,14,60,60,0,1
27-02-2025,Snacks & Ready-to-Eat,VD BELLAM GAVVALU 200GM,14,60,60,0,1
27-02-2025,Oils & Ghee,Black Sesame oil 1 L,9,880,760,120,2
27-02-2025,Snacks & Ready-to-Eat,GREEN FRIED BATANA,14,20,20,0,1
27-02-2025,"Grains, Flours & Dals",Quinova 500 gms,4,110,100,10,1
27-02-2025,"Grains, Flours & Dals",KORRALU (FOXTAIL M) 500GM,4,65,55,10,1
27-02-2025,"Grains, Flours & Dals",FLOUR CHARGE,4,48,48,0,4
27-02-2025,"Grains, Flours & Dals",Arikalu (kodo),4,70,65,5,1
27-02-2025,"Grains, Flours & Dals",JOWAR YELLOW 1 K,4,400,360,40,4
27-02-2025,"Grains, Flours & Dals",AISHWARYA LOW GI RICE 5KG,4,700,525,175,1
27-02-2025,"Grains, Flours & Dals",AISHWARYA SP 5KG,4,400,375,25,1
27-02-2025,"Grains, Flours & Dals",DESI CHANA,4,50,50,0,2
27-02-2025,"Dry Fruits, Nuts & Seeds",PULMAKHANA 100 GM,2,180,170,10,1
27-02-2025,"Dry Fruits, Nuts & Seeds",PUMPKIN SEEDS 250GM,2,200,160,40,1
27-02-2025,"Dry Fruits, Nuts & Seeds",DRYDATES 250GM,2,150,120,30,1
27-02-2025,"Dry Fruits, Nuts & Seeds",WATERMELON SEEDS 250GRM,2,320,280,40,1
27-02-2025,"Dry Fruits, Nuts & Seeds",DRYDATES YELLOW 250GM,2,135,120,15,1
27-02-2025,"Dry Fruits, Nuts & Seeds",SUNFLOWER SEEDS 250GRM,2,150,130,20,1
27-02-2025,"Dry Fruits, Nuts & Seeds",PLAIN PISTA 250GM,2,660,550,110,1
27-02-2025,Oils & Ghee,Coconut oil 1 L,9,440,400,40,1
27-02-2025,"Grains, Flours & Dals",Wheat Flour 1 kg,4,70,60,10,1
27-02-2025,"Dry Fruits, Nuts & Seeds",SABJA SEEDS 100GM,2,80,70,10,1
27-02-2025,"Grains, Flours & Dals",Multigrain 1 kg,4,200,170,30,2
27-02-2025,"Dry Fruits, Nuts & Seeds",PUTNALU 500GMS,2,90,76,14,1
27-02-2025,Snacks & Ready-to-Eat,VD DAHI MIRCHI(SALTED) 100GM,14,45,45,0,1
27-02-2025,"Dry Fruits, Nuts & Seeds",PRO ORG RAW PEANUTS 500GM,2,174,174,0,1
27-02-2025,Spices & Seasonings,SD Curry Leaves Karam Powder 100GM,15,65,65,0,1
27-02-2025,"Grains, Flours & Dals",RAGI FLOUR 1KG,4,160,140,20,2
27-02-2025,Spices & Seasonings,RED COPRA 500GM,15,170,148,22,1
27-02-2025,"Health, Wellness & Ayurvedic Products",HARITHAKI CHOORNAM,5,60,60,0,1
27-02-2025,"Health, Wellness & Ayurvedic Products",MD Neem Leaf Choornam 100GM,5,80,80,0,1
27-02-2025,Snacks & Ready-to-Eat,RI Yogurt Berry Oats 35g,14,45,45,0,1
27-02-2025,"Health, Wellness & Ayurvedic Products",MD Lodhra Choornam 50GM,5,100,100,0,1
27-02-2025,"Grains, Flours & Dals",SAMALU (Little millet) 500 gms,4,85,65,20,1
27-02-2025,Snacks & Ready-to-Eat,Sprouted Ragi Biscuits 450GM,14,150,150,0,1
27-02-2025,Personal Care & Cosmetics,HERBAL BATH POWDER 200GM,10,80,80,0,1
27-02-2025,Oils & Ghee,Groundnut oil 1 L,9,360,330,30,1
27-02-2025,"Dry Fruits, Nuts & Seeds",YB GRANMA NUTS,2,90,90,0,1
27-02-2025,Snacks & Ready-to-Eat,SD Ginger Candy 100g,14,60,60,0,1
27-02-2025,"Grains, Flours & Dals",Quinova 500 gms,4,110,100,10,1
27-02-2025,"Grains, Flours & Dals",SRILATHA RICE RAVVA 500GM,4,35,35,0,1
27-02-2025,"Grains, Flours & Dals",MAATEJA rice 5 kg,4,360,345,15,1
27-02-2025,"Grains, Flours & Dals",SL Idly Rava 1KG,4,65,55,10,1
27-02-2025,Snacks & Ready-to-Eat,VD RICE SAGO PAPAD 150GM,14,55,55,0,1
27-02-2025,Snacks & Ready-to-Eat,GB SALT COOKIES,14,60,55,5,1
27-02-2025,Household & Cleaning,VIM SOAP,6,5,5,0,1
27-02-2025,Milk & Dairy,HERITAGE TONED MILK 500ML,7,31,31,0,1
27-02-2025,"Grains, Flours & Dals",split urad dall 250 gms,4,45,40,5,1
27-02-2025,"Grains, Flours & Dals",Idly Rava L 1KG,4,60,50,10,1
27-02-2025,"Grains, Flours & Dals",SA WHITE JOWAR RAVA 500GM,4,69,69,0,1
27-02-2025,General Household & Kitchenware,WOODEN SPOON BIG,3,50,50,0,1
27-02-2025,Snacks & Ready-to-Eat,SD FINGER Millet with palm Jaggery 250gm,14,135,135,0,1
27-02-2025,"Grains, Flours & Dals",RAGI FLOUR 500GRMS,4,80,70,10,2
27-02-2025,Oils & Ghee,Coconut oil 500 ml,9,220,200,20,1
27-02-2025,Spices & Seasonings,SWEET SOUNF,15,20,20,0,1
27-02-2025,"Grains, Flours & Dals",THIN POHA 500GM,4,40,35,5,1
27-02-2025,"Dry Fruits, Nuts & Seeds",PN ORGANIC MAKHANA 50GM,2,125,125,0,1
27-02-2025,Spices & Seasonings,ROYAL SAFFRON,15,125,125,0,1
27-02-2025,Pooja & Spiritual Items,SST PURE COTTON GUBBA WICKS,12,115,115,0,1
27-02-2025,"Grains, Flours & Dals",UDALU (Barnyard millet) 1 kg,4,140,115,25,1
27-02-2025,"Grains, Flours & Dals",AISHWARYA RICE RAVA SP 500GRMS,4,60,42,18,1
27-02-2025,"Grains, Flours & Dals",SB Javva Wheat Ravva 500GM,4,95,95,0,1
27-02-2025,"Grains, Flours & Dals",ANDU KORRALU (Brown top .mlt) 500,4,130,110,20,1
27-02-2025,"Grains, Flours & Dals",KORRALU (FOXTAIL M) 500GM,4,65,55,10,1
27-02-2025,Snacks & Ready-to-Eat,SD Aswagandha with palm Jaggery250Gm,14,135,135,0,1
27-02-2025,Pooja & Spiritual Items,JAVADHU POWDER 2G,12,120,120,0,2
27-02-2025,"Health, Wellness & Ayurvedic Products",MH Millets Malt 500GM,5,200,190,10,1
27-02-2025,"Grains, Flours & Dals",Wheat Flour 1 kg,4,70,60,10,1
27-02-2025,"Grains, Flours & Dals",THICK POHA 1KG,4,80,70,10,1
27-02-2025,"Grains, Flours & Dals",SRILATHA RICE RAVVA 500GM,4,70,70,0,2
27-02-2025,"Grains, Flours & Dals",DH URAD GOTA 1KG,4,430,380,50,2
27-02-2025,Spices & Seasonings,PRO ORG MUSTARD SMALL -RAI 200G,15,168,168,0,2
27-02-2025,"Grains, Flours & Dals",split black gram 500 gms,4,90,85,5,1
27-02-2025,"Grains, Flours & Dals",AISHWARYA MOONGDAL RICE,4,140,84,56,1
27-02-2025,Spices & Seasonings,PRO ORG CUMIN 100G,15,352,352,0,2
27-02-2025,"Grains, Flours & Dals",Wheat Flour 1 kg,4,140,120,20,2
27-02-2025,Beverages,MARWADI CHAI 100GM,1,750,750,0,10
27-02-2025,Oils & Ghee,Black Sesame oil 1 L,9,440,380,60,1
27-02-2025,"Grains, Flours & Dals",SL Idly Rava 1KG,4,130,110,20,2
27-02-2025,Oils & Ghee,Groundnut oil 1 L,9,1080,990,90,3
27-02-2025,"Grains, Flours & Dals",PRO ORG KABULI CHANNA 500GM,4,196,196,0,1
27-02-2025,"Grains, Flours & Dals",SB Javva Wheat Ravva 500GM,4,285,285,0,3
27-02-2025,"Grains, Flours & Dals",RICE FLOUR 1KG,4,70,55,15,1
27-02-2025,"Grains, Flours & Dals",Red Wheat Flour 1 kg,4,280,260,20,2
27-02-2025,"Dry Fruits, Nuts & Seeds",Groundnuts 1 kg,2,380,340,40,2
27-02-2025,"Grains, Flours & Dals",SRILALITHA MAIDA FLOUR 500G,4,32,32,0,1
27-02-2025,"Grains, Flours & Dals",Chana Flour 500 gms,4,70,65,5,1
27-02-2025,Personal Care & Cosmetics,UVIS BLACK HENNA 100GM,10,350,350,0,2
27-02-2025,Oils & Ghee,Sesame oil 500ml,9,295,280,15,1
27-02-2025,Spices & Seasonings,DHANIYA POWDER 200GM,15,100,85,15,1
27-02-2025,"Dry Fruits, Nuts & Seeds",PUTNALU 500GMS,2,90,76,14,1
27-02-2025,Spices & Seasonings,Menthulu 250 gms,15,50,45,5,1
27-02-2025,"Grains, Flours & Dals",PESARA PAPPU 1 KG,4,170,145,25,1
27-02-2025,Snacks & Ready-to-Eat,SH PUFFED RICE 500GM,14,112,112,0,1
27-02-2025,"Grains, Flours & Dals",FLOUR CHARGE,4,80,80,0,1
27-02-2025,Snacks & Ready-to-Eat,GREEN FRIED BATANA,14,60,60,0,3
27-02-2025,Spices & Seasonings,Jeera 100GM,15,50,45,5,1
27-02-2025,Oils & Ghee,Safflower oil 1 L,9,880,800,80,2
27-02-2025,Oils & Ghee,Coconut oil 500 ml,9,220,200,20,1
27-02-2025,"Grains, Flours & Dals",DH URAD GOTA 1KG,4,430,380,50,2
27-02-2025,"Grains, Flours & Dals",SL Idly Rava 1KG,4,130,110,20,2
27-02-2025,Oils & Ghee,Groundnut oil 1 L,9,360,330,30,1
27-02-2025,"Grains, Flours & Dals",turdal 1kg,4,440,390,50,2
27-02-2025,Sweeteners,MADHUR SUGAR 1KG,16,130,110,20,2
27-02-2025,"Health, Wellness & Ayurvedic Products",MD Bringaraj Choornam 100GM,5,80,80,0,1
27-02-2025,Oils & Ghee,Groundnut oil 1 L,9,720,660,60,2
27-02-2025,Snacks & Ready-to-Eat,VD MULTI CHAKKA,14,110,110,0,1
27-02-2025,"Health, Wellness & Ayurvedic Products",AMLA PACHAK,5,100,100,0,1
27-02-2025,Oils & Ghee,Sesame oil 1 L,9,590,560,30,1
27-02-2025,Snacks & Ready-to-Eat,VD DASA DINUSULU,14,199,199,0,1
27-02-2025,Oils & Ghee,Coconut oil 500 ml,9,220,200,20,1
27-02-2025,Oils & Ghee,Safflower oil 1 L,9,880,800,80,2
27-02-2025,Pooja & Spiritual Items,AMRUTHA SURABHI,12,80,80,0,1
27-02-2025,Oils & Ghee,cow ghee 500 ml,9,430,390,40,1
27-02-2025,Oils & Ghee,Safflower oil 5 L,9,2200,"1,950.00",250,1
27-02-2025,"Grains, Flours & Dals",Urad dall 1 Kg,4,185,170,15,1
27-02-2025,Oils & Ghee,Groundnut oil 1 L,9,360,330,30,1
27-02-2025,"Grains, Flours & Dals",HS BARLEY FLAKES 250GM 1+1,4,119,119,0,1
27-02-2025,Snacks & Ready-to-Eat,BROWN BREAD,14,110,110,0,2
27-02-2025,Snacks & Ready-to-Eat,MB FOXTAIL MILLET NOODLES 180GM,14,190,190,0,2
27-02-2025,"Grains, Flours & Dals",Wheat Rava M 500GM,4,33,30,3,1
27-02-2025,"Health, Wellness & Ayurvedic Products",MAX PROTEIN PEANUT,5,175,175,0,1
27-02-2025,"Grains, Flours & Dals",SL Idly Rava 1KG,4,65,55,10,1
27-02-2025,"Grains, Flours & Dals",RICE FLOUR 1KG,4,70,55,15,1
27-02-2025,"Grains, Flours & Dals",SB Javva Wheat Ravva 500GM,4,190,190,0,2
27-02-2025,"Grains, Flours & Dals",RAGI FLOUR 1KG,4,80,70,10,1
27-02-2025,Spices & Seasonings,Chilli powder 500 gms,15,290,210,80,1
27-02-2025,Snacks & Ready-to-Eat,WHOLE WHEAT BREAD,14,55,55,0,1
27-02-2025,Oils & Ghee,Sesame oil 1 L,9,1770,"1,680.00",90,3
27-02-2025,"Grains, Flours & Dals",DH URAD GOTA 1KG,4,215,190,25,1
27-02-2025,Beverages,REFRESH SHARBATH SUGAR FREE,1,299,285,14,1
27-02-2025,"Dry Fruits, Nuts & Seeds",SATHVI CHIA SEEDS 100GM,2,200,160,40,2
27-02-2025,"Grains, Flours & Dals",VL Sabdana 500GM,4,77,77,0,1
27-02-2025,"Grains, Flours & Dals",BOMBAY RAVA,4,70,55,15,1
27-02-2025,Snacks & Ready-to-Eat,VD PALLI CHIKKI,14,160,160,0,2
27-02-2025,"Grains, Flours & Dals",MELMEKER 250GMS,4,60,45,15,1
27-02-2025,Snacks & Ready-to-Eat,TILLI CHIKKI,14,125,125,0,1
27-02-2025,"Grains, Flours & Dals",AISHWARAYA IDLY RAVA 1KG,4,99,66,33,1
27-02-2025,"Grains, Flours & Dals",idly/Dosa rice 1 kg,4,70,60,10,1
27-02-2025,"Grains, Flours & Dals",SL Idly Rava 1KG,4,65,55,10,1
27-02-2025,"Grains, Flours & Dals",SRILATHA RICE RAVVA 500GM,4,35,35,0,1
27-02-2025,"Grains, Flours & Dals",Wheat Flour 1 kg,4,70,60,10,1
27-02-2025,Snacks & Ready-to-Eat,VD MURUKU 175GM,14,60,60,0,1
27-02-2025,Milk & Dairy,SANGAM TONED MILK 500ML,7,30,30,0,1
27-02-2025,"Grains, Flours & Dals",split urad dall 500 gms,4,90,80,10,1
27-02-2025,Snacks & Ready-to-Eat,BB VERMICELLY 500GM,14,53,53,0,1
27-02-2025,Household & Cleaning,VIM EXTRA 110GM,6,15,15,0,1
27-02-2025,"Grains, Flours & Dals",Bombay Rava 500GM,4,35,30,5,1
27-02-2025,Snacks & Ready-to-Eat,BROWN BREAD,14,60,60,0,1
27-02-2025,Snacks & Ready-to-Eat,BATANA NGT 70GMS,14,40,40,0,2
27-02-2025,Snacks & Ready-to-Eat,VD MANGO JELLY 250GRMS,14,80,80,0,1
27-02-2025,Snacks & Ready-to-Eat,VD PALLI LADDU,14,80,80,0,1
27-02-2025,"Dry Fruits, Nuts & Seeds",Groundnuts 500 gms,2,95,85,10,1
27-02-2025,General Household & Kitchenware,B4 BOWL,3,160,152,8,1
27-02-2025,"Grains, Flours & Dals",ANDU KORRALU (Brown top .mlt) 500,4,260,220,40,2
27-02-2025,"Grains, Flours & Dals",SAMALU (Little millet) 1 kg,4,170,130,40,1
27-02-2025,"Grains, Flours & Dals",UDALU (Barnyard millet) 1 kg,4,140,115,25,1
27-02-2025,"Grains, Flours & Dals",Arikalu (kodo),4,140,130,10,2
27-02-2025,"Grains, Flours & Dals",KORRALU (FOXTAIL M) 500GM,4,130,110,20,2
27-02-2025,Beverages,BRU GREEN LABEL 1.2G,1,96,96,0,48
27-02-2025,Snacks & Ready-to-Eat,VD PALLI LADDU,14,80,80,0,1
27-02-2025,Household & Cleaning,PITAMBARI SHINING POWDER 200G,6,60,60,0,1
27-02-2025,Snacks & Ready-to-Eat,DOSA BATTER 1KG,14,120,120,0,2
27-02-2025,Snacks & Ready-to-Eat,VD RICE SAGO PAPAD 150GM,14,55,55,0,1
27-02-2025,Snacks & Ready-to-Eat,VD NUVVULU LADDU,14,80,80,0,1
27-02-2025,"Health, Wellness & Ayurvedic Products",MXP CHOCO CLASSIC BAR,5,80,80,0,1
27-02-2025,Snacks & Ready-to-Eat,VD MIXTURE 175 GM,14,60,60,0,1
27-02-2025,"Grains, Flours & Dals",Wheat Rava M 500GM,4,33,30,3,1
27-02-2025,Spices & Seasonings,pickle chili powder,15,180,165,15,1
27-02-2025,Oils & Ghee,Groundnut oil 1 L,9,360,330,30,1
27-02-2025,Spices & Seasonings,Tamarind 250GMS,15,160,130,30,2
27-02-2025,Oils & Ghee,Coconut oil 500 ml,9,220,200,20,1
27-02-2025,"Grains, Flours & Dals",Wheat Rava S 1KG,4,65,55,10,1
27-02-2025,"Grains, Flours & Dals",VYS.SP.RICE 5 KGS,4,350,325,25,1
27-02-2025,Oils & Ghee,Freedom Rice Bran Oil 1L,9,194,180,14,1
27-02-2025,"Grains, Flours & Dals",AISHWARYA RICE RAVA SP 500GRMS,4,60,42,18,1
27-02-2025,Spices & Seasonings,DRY MIECHI 200GM,15,80,60,20,1
27-02-2025,"Grains, Flours & Dals",Green gram 1 kg,4,150,130,20,1
27-02-2025,"Grains, Flours & Dals",VGR rice 1 kg,4,70,65,5,1
27-02-2025,"Grains, Flours & Dals",Yellow jowar.F 500 gms,4,55,50,5,1
27-02-2025,"Grains, Flours & Dals",VGR rice 1 kg,4,70,65,5,1
27-02-2025,"Grains, Flours & Dals",Wheat Flour 1 kg,4,70,60,10,1
27-02-2025,"Grains, Flours & Dals",turdal 1kg,4,220,195,25,1
27-02-2025,"Grains, Flours & Dals",SINGLE POLISH 1KG,4,130,130,0,2
27-02-2025,Oils & Ghee,Groundnut oil 1 L,9,360,330,30,1
27-02-2025,"Health, Wellness & Ayurvedic Products",MD Bringaraj Choornam 100GM,5,80,80,0,1
27-02-2025,"Grains, Flours & Dals",Yellow jowar .F1 kg,4,110,100,10,1
27-02-2025,"Grains, Flours & Dals",Bajra Flour 500 gms,4,35,30,5,1
27-02-2025,Oils & Ghee,Coconut oil 500 ml,9,220,200,20,1
27-02-2025,"Grains, Flours & Dals",RAGI FLOUR 500GRMS,4,40,35,5,1
27-02-2025,"Dry Fruits, Nuts & Seeds",Groundnuts 500 gms,2,95,85,10,1
27-02-2025,Snacks & Ready-to-Eat,VD MINAPA SUNNUNDALU 12P,14,180,180,0,1
27-02-2025,"Grains, Flours & Dals",Green gram 1 kg,4,150,130,20,1
27-02-2025,Spices & Seasonings,Dalchin Rolls 50GM,15,45,45,0,1
27-02-2025,Spices & Seasonings,DRY MIECHI 200GM,15,80,60,20,1
27-02-2025,Pooja & Spiritual Items,GD Camphor 50GM,12,115,115,0,1
27-02-2025,"Dry Fruits, Nuts & Seeds",DRYDATES YELLOW 250GM,2,135,120,15,1
27-02-2025,Snacks & Ready-to-Eat,Corn Chips 250GM,14,40,35,5,1
27-02-2025,"Grains, Flours & Dals",Wheat Flour 1 kg,4,70,60,10,1
27-02-2025,Oils & Ghee,Sesame oil 1 L,9,590,560,30,1
27-02-2025,Snacks & Ready-to-Eat,Corn Chips 250GM,14,40,35,5,1
27-02-2025,"Grains, Flours & Dals",DESI CHANA,4,25,25,0,1
27-02-2025,Personal Care & Cosmetics,Soapnut 250GM,10,60,45,15,1
27-02-2025,Spices & Seasonings,Dalchin Rolls 50GM,15,45,45,0,1
27-02-2025,General Household & Kitchenware,CANDLE,3,30,30,0,1
27-02-2025,Spices & Seasonings,SATHVI BIRYANI LEAF 25GM,15,30,20,10,1
27-02-2025,"Grains, Flours & Dals",Bombay Rava 500GM,4,35,30,5,1
27-02-2025,Milk & Dairy,HERITAGE TOTAL CURD 500GM,7,50,50,0,1
27-02-2025,Sweeteners,ACHUBELLAM 500GM,16,50,40,10,1
27-02-2025,"Grains, Flours & Dals",Wheat Flour 1 kg,4,70,60,10,1
27-02-2025,Personal Care & Cosmetics,UVIS CHARCOAL SOAP 100GM,10,85,85,0,1
27-02-2025,Snacks & Ready-to-Eat,RSC ORANGE 100GMS,14,20,20,0,1
27-02-2025,Spices & Seasonings,Masala Karam 250 gms,15,130,120,10,1
27-02-2025,General Household & Kitchenware,BB BOWL,3,420,420,0,1
27-02-2025,"Grains, Flours & Dals",Brown RICE 1KG,4,140,130,10,2
27-02-2025,"Grains, Flours & Dals",Wheat Rava M 500GM,4,33,30,3,1
27-02-2025,"Grains, Flours & Dals",SABDANA 500GM,4,90,70,20,1
27-02-2025,"Grains, Flours & Dals",Arikadu ( kodo),4,140,130,10,1
27-02-2025,"Grains, Flours & Dals",SAMALU (Little millet) 1 kg,4,170,130,40,1
27-02-2025,"Grains, Flours & Dals",KORRALU (FOXTAIL M) 1KG,4,150,110,40,1
27-02-2025,Oils & Ghee,Freedom Rice Bran Oil 1L,9,194,180,14,1
27-02-2025,"Dry Fruits, Nuts & Seeds",MAHA BEERA SEEDS 100GM,2,120,120,0,2
27-02-2025,"Dry Fruits, Nuts & Seeds",SD Mango cubes 100gm,2,45,45,0,1
27-02-2025,Snacks & Ready-to-Eat,VD MIXTURE 175 GM,14,60,60,0,1
27-02-2025,"Grains, Flours & Dals",Wheat Rava M 1KG,4,65,55,10,1
27-02-2025,Snacks & Ready-to-Eat,VD GUMMADI CHAKKA,14,130,130,0,1
27-02-2025,General Household & Kitchenware,B4 BOWL,3,160,152,8,1
27-02-2025,"Grains, Flours & Dals",white Bobarlu 1 KG,4,170,150,20,1
27-02-2025,"Grains, Flours & Dals",Em kodo idli R 500G,4,129,129,0,1
27-02-2025,"Grains, Flours & Dals",JOWAR YELLOW 1 K,4,100,90,10,1
27-02-2025,"Grains, Flours & Dals",Red Chana 500 GM,4,75,60,15,1
27-02-2025,Spices & Seasonings,Dalchin Rolls 50GM,15,45,45,0,1
27-02-2025,"Grains, Flours & Dals",RAJMA 250GM,4,55,45,10,1
27-02-2025,Snacks & Ready-to-Eat,VD MURMURA LADDU,14,45,45,0,1
27-02-2025,Sweeteners,ACHUBELLAM 500GM,16,50,40,10,1
27-02-2025,Sweeteners,ACHU BELLAM 1KG,16,100,80,20,1
27-02-2025,"Grains, Flours & Dals",Wheat Flour 1 kg,4,140,120,20,2
27-02-2025,Snacks & Ready-to-Eat,VD RIBBON PAKODI 175GM,14,60,60,0,1
27-02-2025,Sweeteners,YB JAGGERY POWDER 500GMS,16,75,75,0,1
27-02-2025,Snacks & Ready-to-Eat,SD Ginger Candy 100g,14,60,60,0,1
27-02-2025,Spices & Seasonings,SD Curry Leaves Karam Powder 100GM,15,65,65,0,1
27-02-2025,Snacks & Ready-to-Eat,VD CORNFLAKES MIXTURE 175GM,14,60,60,0,1
27-02-2025,"Grains, Flours & Dals",Wheat Flour 1 kg,4,70,60,10,1
27-02-2025,Spices & Seasonings,Chilli powder 500 gms,15,290,210,80,1
27-02-2025,Snacks & Ready-to-Eat,VD MANGO JELLY 250GRMS,14,80,80,0,1
27-02-2025,"Grains, Flours & Dals",Red Chana 500 GM,4,75,60,15,1
27-02-2025,"Grains, Flours & Dals",white Bobarlu 500 gms,4,80,75,5,1
27-02-2025,Spices & Seasonings,SAMBAR POWDER 200GM,15,130,110,20,1
27-02-2025,"Grains, Flours & Dals",KORRALU (FOXTAIL M) 500GM,4,65,55,10,1
27-02-2025,Oils & Ghee,Sesame oil 500ml,9,295,280,15,1
27-02-2025,"Grains, Flours & Dals",Arikalu (kodo),4,70,65,5,1
27-02-2025,"Grains, Flours & Dals",Yellow jowar.F 500 gms,4,55,50,5,1
27-02-2025,Sweeteners,YB Brown Sugar 500GM,16,75,75,0,1
27-02-2025,"Health, Wellness & Ayurvedic Products",MD Sugandhi Pala Churnam 30GM,5,90,90,0,1
27-02-2025,"Health, Wellness & Ayurvedic Products",MD Bringaraj Choornam 100GM,5,80,80,0,1
27-02-2025,"Grains, Flours & Dals",PRO SOYA CHUNKS 200G,4,79,79,0,1
27-02-2025,Oils & Ghee,Groundnut oil 1 L,9,360,330,30,1
27-02-2025,"Grains, Flours & Dals",UDALU (Barnyard millet) 500 gms,4,70,60,10,1
27-02-2025,"Grains, Flours & Dals",SAMALU (Little millet) 500 gms,4,85,65,20,1
27-02-2025,"Grains, Flours & Dals",Wheat Flour 1 kg,4,70,60,10,1
27-02-2025,"Grains, Flours & Dals",RAGI FLOUR 500GRMS,4,40,35,5,1
27-02-2025,"Grains, Flours & Dals",ANDU KORRALU (Brown top .mlt) 500,4,130,110,20,1
27-02-2025,"Health, Wellness & Ayurvedic Products",MD Aamlaki Choornam 100GM,5,100,100,0,1
27-02-2025,Beverages,REFRESH SHARBATH SUGAR FREE,1,299,285,14,1
27-02-2025,Spices & Seasonings,Gasagasalu 50GM,15,130,110,20,1
27-02-2025,Pooja & Spiritual Items,BANDA PUVVU 25GM 25GM,12,80,60,20,1
27-02-2025,Spices & Seasonings,YB Rock Salt 1KG,15,120,120,0,1
27-02-2025,"Dry Fruits, Nuts & Seeds",SABJA SEEDS 100GM,2,80,70,10,1
27-02-2025,Oils & Ghee,Sesame oil 1 L,9,590,560,30,1
27-02-2025,Snacks & Ready-to-Eat,ELITE MILK RUSK 200GM,14,35,35,0,1
27-02-2025,"Grains, Flours & Dals",POORI ATTA 1KG,4,70,60,10,1
27-02-2025,Snacks & Ready-to-Eat,RSC ORANGE 100GMS,14,20,20,0,1
27-02-2025,Pooja & Spiritual Items,JAVADHU POWDER 2G,12,34,34,0,1
27-02-2025,"Grains, Flours & Dals",RED TURDAL 500GM,4,75,70,5,1
27-02-2025,Snacks & Ready-to-Eat,SD GINGER CANDY 200GM,14,120,120,0,1
27-02-2025,Snacks & Ready-to-Eat,RITEBITE BLUEBERRY BLAST,14,100,100,0,2
27-02-2025,Baking & Cooking Aids,GONDH 50GRMS,0,50,40,10,1
27-02-2025,Spices & Seasonings,SONTI 50GM,15,30,30,0,1
27-02-2025,Pooja & Spiritual Items,JAGI KAYA 25GM,12,80,60,20,1
27-02-2025,"Dry Fruits, Nuts & Seeds",PUMPKIN SEEDS 250GM,2,200,160,40,1
27-02-2025,Snacks & Ready-to-Eat,VD MURMURA LADDU,14,50,50,0,1
27-02-2025,"Dry Fruits, Nuts & Seeds",FLAX SEEDS 250GM,2,60,50,10,1
27-02-2025,Sweeteners,Natural Honey 500 gms,16,280,240,40,1
27-02-2025,"Dry Fruits, Nuts & Seeds",Putnalu 250GM,2,45,38,7,1
27-02-2025,"Grains, Flours & Dals",RAGULU 1 KG,4,70,60,10,1
27-02-2025,"Dry Fruits, Nuts & Seeds",SUNFLOWER SEEDS 250GRM,2,150,130,20,1
27-02-2025,"Dry Fruits, Nuts & Seeds",MAHA BEERA SEEDS 100GM,2,60,60,0,1
27-02-2025,"Dry Fruits, Nuts & Seeds",PULMAKHANA 100 GM,2,180,170,10,1
27-02-2025,Misc,JOKER,8,16,16,0,8
27-02-2025,"Dry Fruits, Nuts & Seeds",Groundnuts 500 gms,2,95,85,10,1
27-02-2025,Snacks & Ready-to-Eat,GB SALT COOKIES,14,60,55,5,1
27-02-2025,"Health, Wellness & Ayurvedic Products",MXP CREAM ONION,5,45,45,0,1
27-02-2025,Snacks & Ready-to-Eat,FOXTAIL BIS,14,135,135,0,1
27-02-2025,"Grains, Flours & Dals",HS Multimillet idly R 500 gms,4,65,65,0,1
27-02-2025,Oils & Ghee,Groundnut oil 1 L,9,720,660,60,2
27-02-2025,Snacks & Ready-to-Eat,PEANUT CHIKKI,14,44,44,0,2
27-02-2025,"Health, Wellness & Ayurvedic Products",RB Peanut butter Peanuts Dark 40g,5,90,90,0,2
27-02-2025,Snacks & Ready-to-Eat,GS WHEAT GRASS BISCUITS 250GM,14,130,130,0,1
27-02-2025,"Grains, Flours & Dals",PESARA PAPPU 500GMS,4,85,75,10,1
27-02-2025,"Dry Fruits, Nuts & Seeds",SATHVI CHIA SEEDS 100GM,2,200,160,40,2
27-02-2025,"Dry Fruits, Nuts & Seeds",SABJA SEEDS 100GM,2,160,140,20,2
27-02-2025,"Grains, Flours & Dals",UNPOLISHED TURDALL 1KG,4,240,210,30,1
27-02-2025,Snacks & Ready-to-Eat,SD FINGER Millet with palm Jaggery 250gm,14,135,135,0,1
27-02-2025,Spices & Seasonings,FLAXSEED KARAM,15,75,75,0,1
27-02-2025,Spices & Seasonings,GROUNDNUT KARAM POWDER,15,65,65,0,1
27-02-2025,Snacks & Ready-to-Eat,SD Aswagandha with palm Jaggery250Gm,14,135,135,0,1
27-02-2025,Snacks & Ready-to-Eat,SD Vamu with palm jaggery 250gm,14,135,135,0,1
27-02-2025,"Health, Wellness & Ayurvedic Products",RB Peanut butter Peanuts Dark 40g,5,45,45,0,1
27-02-2025,Oils & Ghee,Safflower oil 1 L,9,440,400,40,1
27-02-2025,Oils & Ghee,Sesame oil 1 L,9,590,560,30,1
27-02-2025,"Grains, Flours & Dals",Wheat Flour 1 kg,4,700,600,100,10
27-02-2025,Spices & Seasonings,Tamarind 250GMS,15,160,130,30,2
27-02-2025,"Grains, Flours & Dals",Wheat Rava S 1KG,4,65,55,10,1
27-02-2025,Spices & Seasonings,Jeera 100GM,15,50,45,5,1
27-02-2025,Spices & Seasonings,ROYAL SAFFRON,15,125,125,0,1
27-02-2025,"Grains, Flours & Dals",VGR RICE bag 1,4,1899,"1,650.00",249,1
27-02-2025,"Grains, Flours & Dals",CHANA DAL 1KG,4,35,30,5,0.25
27-02-2025,"Grains, Flours & Dals",turdal 1kg,4,220,195,25,1
27-02-2025,"Grains, Flours & Dals",Idly Rava L 1KG,4,60,50,10,1
27-02-2025,"Grains, Flours & Dals",Urad dall 1 Kg,4,185,170,15,1
27-02-2025,Sweeteners,SUGAR 1KG,16,120,100,20,2
27-02-2025,"Grains, Flours & Dals",PESARA PAPPU 1 KG,4,170,145,25,1
27-02-2025,Spices & Seasonings,Tamarind 500GM,15,160,130,30,1
27-02-2025,Spices & Seasonings,AVALU 100GM,15,25,20,5,1
27-02-2025,Oils & Ghee,Coconut oil 500 ml,9,220,200,20,1
27-02-2025,"Grains, Flours & Dals",VYS.SP.RICE BAG 1,4,3600,"3,300.00",300,2
27-02-2025,Oils & Ghee,Groundnut oil 1 L,9,720,660,60,2
27-02-2025,General Household & Kitchenware,NIPPO,3,36,36,0,2
27-02-2025,Oils & Ghee,Groundnut oil 5 L,9,1800,"1,600.00",200,1
27-02-2025,"Dry Fruits, Nuts & Seeds",SD Mango cubes 200gm,2,90,90,0,1
27-02-2025,Sweeteners,ACHUBELLAM 500GM,16,50,40,10,1
27-02-2025,Spices & Seasonings,NUVVULU 250GM,15,200,170,30,2
27-02-2025,Oils & Ghee,Coconut oil 1 L,9,440,400,40,1
27-02-2025,Oils & Ghee,Coconut oil 500 ml,9,220,200,20,1
27-02-2025,"Grains, Flours & Dals",Wheat Flour 1 kg,4,70,60,10,1
27-02-2025,"Grains, Flours & Dals",maida 500grms,4,30,30,0,1
27-02-2025,"Grains, Flours & Dals",CORN FOUR 250GM,4,40,35,5,1
27-02-2025,Oils & Ghee,BUFFALLO GHEE 500ML,9,410,370,40,1
27-02-2025,"Grains, Flours & Dals",Multigrain 1 kg,4,200,170,30,2
27-02-2025,"Grains, Flours & Dals",Multigrain 1 kg,4,100,85,15,1
27-02-2025,Personal Care & Cosmetics,MD HERBAL HAIR SHAMPOO,10,300,300,0,1
27-02-2025,"Grains, Flours & Dals",Wheat Flour 1 kg,4,140,120,20,2
27-02-2025,Oils & Ghee,Safflower oil 1 L,9,440,400,40,1
27-02-2025,"Grains, Flours & Dals",Chana Flour 500 gms,4,70,65,5,1
27-02-2025,Sweeteners,YB Brown Sugar 1KG,16,280,280,0,2
27-02-2025,Pooja & Spiritual Items,JAGI KAYA 25GM,12,80,60,20,1
27-02-2025,"Dry Fruits, Nuts & Seeds",YB GRANMA NUTS,2,180,180,0,2
27-02-2025,Snacks & Ready-to-Eat,SD FINGER Millet with palm Jaggery 250gm,14,135,135,0,1
27-02-2025,Sweeteners,Natural Honey 500 gms,16,280,240,40,1
27-02-2025,Snacks & Ready-to-Eat,COPRA LADDU 200GM,14,100,80,20,1
27-02-2025,Oils & Ghee,GANTASALA A2 COW GHEE 250ML,9,299,299,0,1
27-02-2025,Snacks & Ready-to-Eat,VD RICE MURUKU 150GM,14,50,50,0,1
27-02-2025,Snacks & Ready-to-Eat,VD SAGOPAPAD 150GM,14,55,55,0,1
27-02-2025,"Dry Fruits, Nuts & Seeds",PN ORGANIC MAKHANA 50GM,2,125,125,0,1
27-02-2025,Oils & Ghee,BUFFALLO GHEE 500ML,9,410,370,40,1
27-02-2025,Oils & Ghee,Sesame oil 5 L,9,2950,"2,750.00",200,1
27-02-2025,Spices & Seasonings,YB Rock Salt 1KG,15,120,120,0,1
27-02-2025,Snacks & Ready-to-Eat,NGT CHATPATTA CHANA 90GM,14,25,25,0,1
27-02-2025,"Grains, Flours & Dals",RAGULU 1 KG,4,70,60,10,1
27-02-2025,"Grains, Flours & Dals",Em jowar idly R 500G,4,75,75,0,1
27-02-2025,"Grains, Flours & Dals",JOWAR YELLOW 1 K,4,50,45,5,0.5
27-02-2025,"Grains, Flours & Dals",Em Multimillet idli r 500g,4,258,258,0,2
27-02-2025,"Grains, Flours & Dals",Wheat Flour 2 kgs,4,140,120,20,1
27-02-2025,Snacks & Ready-to-Eat,SESAME LADDU 200GM,14,100,80,20,1
27-02-2025,"Grains, Flours & Dals",Wheat Flour 1 kg,4,70,60,10,1
27-02-2025,"Grains, Flours & Dals",RAGI FLOUR 500GRMS,4,40,35,5,1
27-02-2025,"Grains, Flours & Dals",RAJMA 500GM,4,90,90,0,1
27-02-2025,"Grains, Flours & Dals",RAGI FLOUR 1KG,4,80,70,10,1
27-02-2025,"Grains, Flours & Dals",SAMALU (Little millet) 1 kg,4,510,390,120,3
27-02-2025,"Grains, Flours & Dals",ANDU KORRALU (Browntop.m) 1 kg,4,260,220,40,1
27-02-2025,Oils & Ghee,Safflower oil 1 L,9,440,400,40,1
27-02-2025,Oils & Ghee,Mustard oil 1 L,9,440,400,40,1
27-02-2025,Oils & Ghee,Groundnut oil 1 L,9,360,330,30,1
27-02-2025,"Grains, Flours & Dals",Wheat Flour 2 kgs,4,140,120,20,1
27-02-2025,Oils & Ghee,Coconut oil 500 ml,9,220,200,20,1
27-02-2025,"Grains, Flours & Dals",SL Suji Rava 500GM,4,32,32,0,1
27-02-2025,"Grains, Flours & Dals",VGR RICE 5 KGS,4,350,325,25,1
27-02-2025,Oils & Ghee,Coconut oil 500 ml,9,220,200,20,1
27-02-2025,Oils & Ghee,Sesame oil 1 L,9,1180,"1,120.00",60,2
27-02-2025,Sweeteners,GS Organic Jaggery Powder 600GM,16,198,198,0,2
27-02-2025,"Grains, Flours & Dals",POORI ATTA 1KG,4,70,60,10,1
27-02-2025,"Grains, Flours & Dals",Urad dall 1 Kg,4,46.25,42.5,3.75,0.25
27-02-2025,"Grains, Flours & Dals",FLOUR CHARGE,4,43.2,43.2,0,3.6
27-02-2025,"Grains, Flours & Dals",BAJRA 1 KG,4,60,50,10,1
27-02-2025,"Grains, Flours & Dals",Chana Flour 500 gms,4,70,65,5,1
27-02-2025,Spices & Seasonings,Turmeric powder 250 gms,15,100,75,25,1
27-02-2025,Personal Care & Cosmetics,KAIPO ACT CHARCOAL TP 100G,10,90,90,0,1
27-02-2025,"Grains, Flours & Dals",POORI ATTA 1KG,4,70,60,10,1
27-02-2025,Spices & Seasonings,AVALU 100GM,15,25,20,5,1
27-02-2025,Spices & Seasonings,Black Till 250GM,15,90,75,15,1
27-02-2025,Spices & Seasonings,JEERA 250 gms,15,125,105,20,1
27-02-2025,"Grains, Flours & Dals",Chittimuthaylu rice 1 kg,4,320,280,40,2
27-02-2025,Personal Care & Cosmetics,UVIS COW GHEE SOAP 100GM,10,85,85,0,1
27-02-2025,"Grains, Flours & Dals",Wheat Rava M 500GM,4,33,30,3,1
27-02-2025,Pooja & Spiritual Items,JAGI KAYA 25GM,12,80,60,20,1
27-02-2025,Oils & Ghee,Black Sesame oil 1 L,9,440,380,60,1
27-02-2025,Personal Care & Cosmetics,KAIPO SANDALWOOD SOAP 100GM,10,60,60,0,1
27-02-2025,Milk & Dairy,ID PANEER,7,270,270,0,2
27-02-2025,Personal Care & Cosmetics,KAIPO BRIGHT TP 100GM,10,90,90,0,1
27-02-2025,Spices & Seasonings,NUVVULU 500GM,15,160,130,30,1
27-02-2025,Oils & Ghee,Sesame oil 1 L,9,590,560,30,1
27-02-2025,"Grains, Flours & Dals",Multigrain 1 kg,4,100,85,15,1
27-02-2025,"Dry Fruits, Nuts & Seeds",Putnalu 250GM,2,45,38,7,1
27-02-2025,"Grains, Flours & Dals",Wheat Flour 1 kg,4,70,60,10,1
27-02-2025,Spices & Seasonings,Vamu 100GM,15,60,50,10,1
27-02-2025,Sweeteners,SUGAR 1KG,16,60,50,10,1
27-02-2025,Milk & Dairy,BROWN EGGS TRAY 30P,7,360,330,30,1
27-02-2025,Milk & Dairy,HERITAGE TOTAL CURD 500GM,7,50,50,0,1
27-02-2025,"Grains, Flours & Dals",WHEAT 1 KG,4,180,150,30,3
27-02-2025,Snacks & Ready-to-Eat,KURNOOL MARMURA,14,70,55,15,1
27-02-2025,"Grains, Flours & Dals",Yellow jowar .F1 kg,4,110,100,10,1
27-02-2025,"Grains, Flours & Dals",SH WHITE POHA 500GM,4,75,75,0,1
27-02-2025,"Grains, Flours & Dals",Red Wheat Flour 1 kg,4,140,130,10,1
27-02-2025,"Grains, Flours & Dals",Sathya Javva Wheat Rava 500GM,4,95,95,0,1
27-02-2025,"Grains, Flours & Dals",RAGI FLOUR 500GRMS,4,40,35,5,1
27-02-2025,"Grains, Flours & Dals",Wheat Flour 1 kg,4,70,60,10,1
27-02-2025,"Dry Fruits, Nuts & Seeds",PULMAKHANA 100 GM,2,180,170,10,1
27-02-2025,Household & Cleaning,VIM EXTRA 110GM,6,15,15,0,1
27-02-2025,Oils & Ghee,Groundnut oil 1 L,9,720,660,60,2
27-02-2025,Household & Cleaning,VIM MAHA BAR,6,60,60,0,1
27-02-2025,"Dry Fruits, Nuts & Seeds",FLAX SEEDS 250GM,2,60,50,10,1
27-02-2025,"Grains, Flours & Dals",SPLIT BLACK GRAM 500 GM,4,90,85,5,1
27-02-2025,Snacks & Ready-to-Eat,RINGS 200GM,14,30,30,0,1
27-02-2025,"Grains, Flours & Dals",WHITE BATANI,4,40,30,10,1
27-02-2025,"Grains, Flours & Dals",Urad dall 1 Kg,4,185,170,15,1
27-02-2025,"Grains, Flours & Dals",POORI ATTA 1KG,4,70,60,10,1
27-02-2025,Spices & Seasonings,Menthulu 250 gms,15,50,45,5,1
27-02-2025,"Grains, Flours & Dals",Chana Flour 500 gms,4,70,65,5,1
27-02-2025,Oils & Ghee,Sesame oil 1 L,9,590,560,30,1
27-02-2025,Snacks & Ready-to-Eat,NGT CHATPATTA CHANA 90GM,14,20,20,0,1
27-02-2025,"Dry Fruits, Nuts & Seeds",SUNFLOWER SEEDS 250GRM,2,150,130,20,1
27-02-2025,"Dry Fruits, Nuts & Seeds",WATERMELON SEEDS 250GRM,2,320,280,40,1
27-02-2025,"Dry Fruits, Nuts & Seeds",PUMPKIN SEEDS 250GM,2,200,160,40,1
27-02-2025,Oils & Ghee,Castor oil 200 ml,9,100,80,20,1
27-02-2025,Personal Care & Cosmetics,DWI ROSE WATER 120ML,10,90,90,0,1
27-02-2025,Milk & Dairy,HERITAGE TOTAL CURD 500GM,7,50,50,0,1
27-02-2025,Milk & Dairy,BROWN EGGS TRAY 30P,7,360,330,30,1
27-02-2025,Personal Care & Cosmetics,UVIS MULTANI MITTI PW 100GM,10,49,49,0,1
27-02-2025,Spices & Seasonings,Turmeric powder 250 gms,15,100,75,25,1
27-02-2025,Oils & Ghee,Sesame oil 500ml,9,295,280,15,1
27-02-2025,"Grains, Flours & Dals",Quinova 500 gms,4,110,100,10,1
27-02-2025,"Grains, Flours & Dals",Brown RICE 1KG,4,35,32.5,2.5,0.5
27-02-2025,"Grains, Flours & Dals",JOWAR YELLOW 1 K,4,50,45,5,0.5
27-02-2025,Spices & Seasonings,Jeera 100GM,15,50,45,5,1
27-02-2025,"Grains, Flours & Dals",RAGULU 1 KG,4,35,30,5,0.5
27-02-2025,"Grains, Flours & Dals",turdal 1kg,4,220,195,25,1
27-02-2025,Snacks & Ready-to-Eat,VD MULTI CHAKKA,14,110,110,0,1
27-02-2025,Oils & Ghee,Groundnut oil 1 L,9,360,330,30,1
27-02-2025,Snacks & Ready-to-Eat,VD MIXTURE 175 GM,14,60,60,0,1
27-02-2025,Snacks & Ready-to-Eat,SALTED PHALLI,14,65,65,0,1
27-02-2025,Snacks & Ready-to-Eat,VD PALLI CHIKKI,14,80,80,0,1
27-02-2025,Oils & Ghee,cow ghee 500 ml,9,430,390,40,1
27-02-2025,Snacks & Ready-to-Eat,VD RIBBON PAKODI 175GM,14,60,60,0,1
27-02-2025,"Grains, Flours & Dals",VYS.SP.RICE 10 KGS,4,700,650,50,1
27-02-2025,Milk & Dairy,BROWN EGGS 1P,7,168,144,24,12
27-02-2025,"Dry Fruits, Nuts & Seeds",SUNFLOWER SEEDS 250GRM,2,150,130,20,1
27-02-2025,Snacks & Ready-to-Eat,VD CORNFLAKES MIXTURE 175GM,14,60,60,0,1
27-02-2025,Snacks & Ready-to-Eat,VD NUVULLU CHIKKI,14,160,160,0,2
27-02-2025,Sweeteners,Natural Honey 500 gms,16,280,240,40,1
27-02-2025,"Dry Fruits, Nuts & Seeds",PUMPKIN SEEDS 250GM,2,200,160,40,1
27-02-2025,"Dry Fruits, Nuts & Seeds",WATERMELON SEEDS 250GRM,2,320,280,40,1
27-02-2025,Snacks & Ready-to-Eat,VD NUVVULU LADDU,14,160,160,0,2
27-02-2025,Snacks & Ready-to-Eat,VD PALLI CHIKKI,14,160,160,0,2
27-02-2025,"Grains, Flours & Dals",CHANA DAL 500GM,4,70,60,10,1
27-02-2025,"Grains, Flours & Dals",Urad dall 1 Kg,4,185,170,15,1
27-02-2025,Spices & Seasonings,Jeera 100GM,15,50,45,5,1
27-02-2025,Milk & Dairy,BROWN EGGS 1P,7,140,120,20,10
27-02-2025,Sweeteners,MISHRI 250 GM,16,35,30,5,1
27-02-2025,"Grains, Flours & Dals",AISHWARYA SP 1KG,4,240,210,30,3
27-02-2025,"Grains, Flours & Dals",Arikalu (kodo),4,70,65,5,1
27-02-2025,Beverages,BRU GREEN LABEL 1.2G,1,96,96,0,48
27-02-2025,"Grains, Flours & Dals",Quinova 500 gms,4,110,100,10,1
27-02-2025,"Grains, Flours & Dals",ANDU KORRALU (Brown top .mlt) 500,4,130,110,20,1
27-02-2025,Oils & Ghee,Sesame oil 1 L,9,590,560,30,1
27-02-2025,Pooja & Spiritual Items,BALAJI BEL PHOOL DHOOP STICKS 10STK,12,70,70,0,1
27-02-2025,"Grains, Flours & Dals",SA WHITE JOWAR RAVA 500GM,4,138,138,0,2
27-02-2025,"Grains, Flours & Dals",PESARA PAPPU 500GMS,4,85,75,10,1
27-02-2025,Spices & Seasonings,AV Iodized Salt 1KG,15,28,25,3,1
27-02-2025,"Dry Fruits, Nuts & Seeds",MAHA BEERA SEEDS 100GM,2,60,60,0,1
27-02-2025,Snacks & Ready-to-Eat,FOXTAIL BIS,14,135,135,0,1
27-02-2025,"Grains, Flours & Dals",AISHWARYA SP 1KG,4,80,70,10,1
27-02-2025,Snacks & Ready-to-Eat,RINGS 200GM,14,30,30,0,1
27-02-2025,"Grains, Flours & Dals",VYS.SP RICE 1 KG,4,70,65,5,1
27-02-2025,"Grains, Flours & Dals",Arikadu ( kodo),4,140,130,10,1
27-02-2025,"Grains, Flours & Dals",ANDU KORRALU (Browntop.m) 1 kg,4,260,220,40,1
27-02-2025,"Grains, Flours & Dals",SAMALU (Little millet) 1 kg,4,170,130,40,1
27-02-2025,"Grains, Flours & Dals",UDALU (Barnyard millet) 1 kg,4,140,115,25,1
27-02-2025,"Grains, Flours & Dals",KORRALU (FOXTAIL M) 1KG,4,150,110,40,1
26-02-2025,"Health, Wellness & Ayurvedic Products",MD Punarnava Choornam 50GM,5,100,100,0,1
26-02-2025,Milk & Dairy,BROWN EGGS 1P,7,84,72,12,6
26-02-2025,"Grains, Flours & Dals",AISHWARYA SP 1KG,4,80,70,10,1
26-02-2025,Sweeteners,MISHRI 250 GM,16,35,30,5,1
26-02-2025,"Health, Wellness & Ayurvedic Products",VAMU WATER,5,140,140,0,2
26-02-2025,Snacks & Ready-to-Eat,SD Ginger Candy 100g,14,120,120,0,1
26-02-2025,"Dry Fruits, Nuts & Seeds",PUMPKIN SEEDS 250GM,2,200,160,40,1
26-02-2025,"Dry Fruits, Nuts & Seeds",SUNFLOWER SEEDS 250GRM,2,150,130,20,1
26-02-2025,"Grains, Flours & Dals",UNPOLISHED TURDALL 1KG,4,240,220,20,1
26-02-2025,"Grains, Flours & Dals",SL Idly Rava 1KG,4,65,55,10,1
26-02-2025,"Dry Fruits, Nuts & Seeds",WALLNUTS 250GM,2,380,360,20,1
26-02-2025,"Dry Fruits, Nuts & Seeds",PULMAKHANA 100 GM,2,360,340,20,2
26-02-2025,"Grains, Flours & Dals",Em jowar idly R 500G,4,75,75,0,1
26-02-2025,"Dry Fruits, Nuts & Seeds",SATHVI CHIA SEEDS 100GM,2,200,160,40,2
26-02-2025,Oils & Ghee,Coconut oil 500 ml,9,220,200,20,1
26-02-2025,Beverages,REFRESH SHARBATH NORMAL,1,199,190,9,1
26-02-2025,"Dry Fruits, Nuts & Seeds",DRYDATES YELLOW 250GM,2,135,120,15,1
26-02-2025,"Dry Fruits, Nuts & Seeds",YELLOW KISHMISH 250GM,2,130,110,20,1
26-02-2025,Snacks & Ready-to-Eat,MB MULTIMILLET NOODLES 180GM,14,95,95,0,1
26-02-2025,Snacks & Ready-to-Eat,MB FOXTAIL MILLET NOODLES 180GM,14,95,95,0,1
26-02-2025,Pooja & Spiritual Items,GD Aiswarya Deepam 700ML,12,195,195,0,1
26-02-2025,"Dry Fruits, Nuts & Seeds",Groundnuts 1 kg,2,190,170,20,1
26-02-2025,"Grains, Flours & Dals",Brown RICE 1KG,4,70,65,5,1
26-02-2025,Milk & Dairy,SANGAM CURD 450GM,7,38,38,0,1
26-02-2025,Spices & Seasonings,NUVVULU 250GM,15,80,65,15,1
26-02-2025,Snacks & Ready-to-Eat,ZEEDI,14,70,70,0,1
26-02-2025,Snacks & Ready-to-Eat,SD FINGER Millet with palm Jaggery 250gm,14,135,135,0,1
26-02-2025,"Grains, Flours & Dals",SINGLE POLISH 1KG,4,520,520,0,8
26-02-2025,Snacks & Ready-to-Eat,SD Thati thandra 200gm,14,150,150,0,1
26-02-2025,Sweeteners,YB Brown Sugar 1KG,16,140,140,0,1
26-02-2025,Snacks & Ready-to-Eat,VD NUVULU LADDU 9PIC,14,100,100,0,1
26-02-2025,"Dry Fruits, Nuts & Seeds",Groundnuts 1 kg,2,190,170,20,1
26-02-2025,"Health, Wellness & Ayurvedic Products",RB Nuts& Seeds cashews 35g,5,90,90,0,2
26-02-2025,"Grains, Flours & Dals",Wheat Flour 1 kg,4,70,60,10,1
26-02-2025,Spices & Seasonings,NUVVULU 250GM,15,100,85,15,1
26-02-2025,Spices & Seasonings,AVALU 100GM,15,25,20,5,1
26-02-2025,"Grains, Flours & Dals",UNPOLISHED TURDALL 1KG,4,240,220,20,1
26-02-2025,Spices & Seasonings,Jeera 100GM,15,50,45,5,1
26-02-2025,Snacks & Ready-to-Eat,VD GUMMADI CHAKKA,14,130,130,0,1
26-02-2025,Snacks & Ready-to-Eat,VD MULTI CHAKKA,14,110,110,0,1
26-02-2025,Snacks & Ready-to-Eat,ANNAPURNA APPALAM,14,35,35,0,1
26-02-2025,Snacks & Ready-to-Eat,VD PALLI LADDU,14,80,80,0,1
26-02-2025,Snacks & Ready-to-Eat,VD PALLI CHIKKI,14,80,80,0,1
26-02-2025,Spices & Seasonings,Elaichi 25GM,15,145,120,25,1
26-02-2025,"Grains, Flours & Dals",RAGI FLOUR 1KG,4,80,70,10,1
26-02-2025,"Dry Fruits, Nuts & Seeds",ROASTED FLAXSEED,2,75,75,0,1
26-02-2025,"Dry Fruits, Nuts & Seeds",Groundnuts 1 kg,2,190,170,20,1
26-02-2025,"Grains, Flours & Dals",MELMEKER 250GMS,4,60,45,15,1
26-02-2025,"Grains, Flours & Dals",split black gram 1 kg,4,180,170,10,1
26-02-2025,"Grains, Flours & Dals",DESI CHANA,4,50,50,0,2
26-02-2025,Spices & Seasonings,ROYAL SAFFRON 400GRMS,15,65,65,0,1
26-02-2025,Oils & Ghee,Groundnut oil 1 L,9,360,330,30,1
26-02-2025,"Grains, Flours & Dals",Hs yellow jowar r 500g,4,99,99,0,1
26-02-2025,Spices & Seasonings,Menthulu 500 gms,15,100,90,10,1
26-02-2025,"Grains, Flours & Dals",Red uluvalu 250 gms,4,45,40,5,1
26-02-2025,"Grains, Flours & Dals",SINGLE POLISH 1KG,4,650,650,0,10
26-02-2025,"Dry Fruits, Nuts & Seeds",YB GRANMA NUTS,2,90,90,0,1
26-02-2025,"Grains, Flours & Dals",THICK POHA 500GM,4,80,70,10,2
26-02-2025,"Grains, Flours & Dals",Red Bobarlu 1 kg,4,190,170,20,1
26-02-2025,"Grains, Flours & Dals",Green gram 500 gms,4,75,70,5,1
26-02-2025,"Grains, Flours & Dals",RAGI FLOUR 500GRMS,4,40,35,5,1
26-02-2025,Spices & Seasonings,NUVVULU 250GM,15,80,65,15,1
26-02-2025,"Grains, Flours & Dals",EM Ragi idli R 500G,4,75,75,0,1
26-02-2025,Oils & Ghee,Sesame oil 1 L,9,590,560,30,1
26-02-2025,"Dry Fruits, Nuts & Seeds",YELLOW KISHMISH 250GM,2,130,110,20,1
26-02-2025,Snacks & Ready-to-Eat,SALTED PHALLI,14,25,25,0,1
26-02-2025,Snacks & Ready-to-Eat,ELITE ELAICHI RUSK 200GM,14,35,35,0,1
26-02-2025,Snacks & Ready-to-Eat,VD GUMMADI CHAKKA,14,130,130,0,1
26-02-2025,Beverages,REFRESH SHARBATH NORMAL,1,199,190,9,1
26-02-2025,"Dry Fruits, Nuts & Seeds",PUMPKIN SEEDS 250GM,2,200,160,40,1
26-02-2025,"Dry Fruits, Nuts & Seeds",FLAX SEEDS 250GM,2,60,50,10,1
26-02-2025,"Dry Fruits, Nuts & Seeds",ANJEER 250GM,2,400,360,40,1
26-02-2025,"Dry Fruits, Nuts & Seeds",SUNFLOWER SEEDS 250GRM,2,300,260,40,2
26-02-2025,"Dry Fruits, Nuts & Seeds",PULMAKHANA 100 GM,2,180,170,10,1
26-02-2025,Personal Care & Cosmetics,OVAL BODY LOOFAH,10,110,110,0,2
26-02-2025,Spices & Seasonings,DHANIYA POWDER 200GM,15,100,85,15,1
26-02-2025,"Grains, Flours & Dals",PRO SOYA CHUNKS 200G,4,79,79,0,1
26-02-2025,Spices & Seasonings,GARAM MASALA 200GM,15,120,95,25,1
26-02-2025,Snacks & Ready-to-Eat,MB LITTLE MILLET NOODLES 180G,14,95,95,0,1
26-02-2025,Spices & Seasonings,Masala Karam 500 gms,15,260,240,20,1
26-02-2025,Beverages,ASSAM TEA GINGER TEA POWDER 250GM,1,190,190,0,1
26-02-2025,"Grains, Flours & Dals",Sathya Javva Wheat Rava 500GM,4,95,95,0,1
26-02-2025,Oils & Ghee,cow ghee 500 ml,9,430,390,40,1
26-02-2025,Milk & Dairy,SANGAM CURD 450GM,7,38,38,0,1
26-02-2025,"Grains, Flours & Dals",SABDANA,4,40,35,5,1
26-02-2025,Sweeteners,MADHUR SUGAR 1KG,16,130,110,20,2
26-02-2025,"Grains, Flours & Dals",Chana Flour 1 kg,4,140,130,10,1
26-02-2025,Oils & Ghee,Groundnut oil 1 L,9,360,330,30,1
26-02-2025,Spices & Seasonings,GS Moringa Leaves Spicy Powder 100GM,15,90,90,0,1
26-02-2025,Sweeteners,GS Organic Jaggery Powder 600GM,16,99,99,0,1
26-02-2025,Oils & Ghee,GANTASALA A2 COW GHEE 250ML,9,299,299,0,1
26-02-2025,"Grains, Flours & Dals",RAGI FLOUR 500GRMS,4,40,35,5,1
26-02-2025,Snacks & Ready-to-Eat,SD FINGER Millet with palm Jaggery 250gm,14,135,135,0,1
26-02-2025,"Grains, Flours & Dals",Brown rice 5 kgs,4,350,325,25,1
26-02-2025,"Dry Fruits, Nuts & Seeds",KAJU HALF 250GM,2,310,290,20,1
26-02-2025,"Grains, Flours & Dals",Chana Flour 500 gms,4,70,65,5,1
26-02-2025,"Grains, Flours & Dals",SL Suji Rava 500GM,4,32,32,0,1
26-02-2025,"Grains, Flours & Dals",POORI ATTA 500GM,4,70,60,10,2
26-02-2025,Sweeteners,SUGAR 1KG,16,60,50,10,1
26-02-2025,Sweeteners,SUGAR 1KG,16,120,100,20,2
26-02-2025,Spices & Seasonings,Turmeric powder 250 gms,15,100,75,25,1
26-02-2025,"Grains, Flours & Dals",Urad dall 1 Kg,4,555,510,45,3
26-02-2025,"Grains, Flours & Dals",FLOUR CHARGE,4,24,24,0,2
26-02-2025,Spices & Seasonings,Coriander seeds 200 gms,15,48,40,8,1
26-02-2025,Sweeteners,MISHRI 250 GM,16,35,30,5,1
26-02-2025,"Grains, Flours & Dals",Idly Rava L 1KG,4,240,200,40,4
26-02-2025,"Dry Fruits, Nuts & Seeds",PUTNALU 500GMS,2,180,152,28,2
26-02-2025,"Grains, Flours & Dals",Wheat Flour 1 kg,4,210,180,30,3
26-02-2025,"Grains, Flours & Dals",RAGI FLOUR 500GRMS,4,40,35,5,1
26-02-2025,"Grains, Flours & Dals",UNPOLISHED TURDALL 1KG,4,240,220,20,1
26-02-2025,"Dry Fruits, Nuts & Seeds",SABJA SEEDS 100GM,2,160,140,20,2
26-02-2025,Oils & Ghee,Sesame oil 1 L,9,590,560,30,1
26-02-2025,"Dry Fruits, Nuts & Seeds",Putnalu 250GM,2,45,38,7,1
26-02-2025,Oils & Ghee,Groundnut oil 1 L,9,720,660,60,2
26-02-2025,Spices & Seasonings,Lavangam 50GM,15,60,50,10,1
26-02-2025,Snacks & Ready-to-Eat,GB SALT COOKIES,14,60,55,5,1
26-02-2025,"Grains, Flours & Dals",split black gram 1 kg,4,180,170,10,1
26-02-2025,"Dry Fruits, Nuts & Seeds",SABJA SEEDS 100GM,2,80,70,10,1
26-02-2025,"Grains, Flours & Dals",Wheat Flour 1 kg,4,70,60,10,1
26-02-2025,Snacks & Ready-to-Eat,ELITE MILK RUSK 200GM,14,35,35,0,1
26-02-2025,"Grains, Flours & Dals",UNPOLISHED TURDALL 1KG,4,240,220,20,1
26-02-2025,Sweeteners,YB Brown Sugar 1KG,16,140,140,0,1
26-02-2025,"Grains, Flours & Dals",VGR rice 1 kg,4,140,130,10,2
26-02-2025,Snacks & Ready-to-Eat,SD JOWAR WITH PALM JAGGERY 250GM,14,135,135,0,1
26-02-2025,"Dry Fruits, Nuts & Seeds",SABJA SEEDS 100GM,2,80,70,10,1
26-02-2025,General Household & Kitchenware,B2 bowl,3,315,299.25,15.75,1
26-02-2025,"Grains, Flours & Dals",SRILATHA RICE RAVVA 500GM,4,35,35,0,1
26-02-2025,Sweeteners,GS JAGGERY NUGGETS 500GM,16,120,120,0,1
26-02-2025,Snacks & Ready-to-Eat,VD NUVVULU LADDU,14,80,80,0,1
26-02-2025,General Household & Kitchenware,WOODEN SPOON BIG,3,50,50,0,1
26-02-2025,Spices & Seasonings,Dalchin Chekka 50GM,15,50,40,10,1
26-02-2025,Spices & Seasonings,SATHVI ANASAPUVUU 25GM,15,90,65,25,1
26-02-2025,Spices & Seasonings,Menthulu 250 gms,15,50,45,5,1
26-02-2025,Spices & Seasonings,Elaichi 25GM,15,145,120,25,1
26-02-2025,Beverages,REFRESH SHARBATH SUGAR FREE,1,299,285,14,1
26-02-2025,"Health, Wellness & Ayurvedic Products",HARITHAKI CHOORNAM,5,60,60,0,1
26-02-2025,Beverages,REFRESH SHARBATH NORMAL,1,199,190,9,1
26-02-2025,Sweeteners,ACHU BELLAM 1KG,16,100,80,20,1
26-02-2025,"Health, Wellness & Ayurvedic Products",MD Neem Leaf Choornam 100GM,5,80,80,0,1
26-02-2025,Personal Care & Cosmetics,GOW DURBAR NAVA 100GM SOAP,10,80,80,0,2
26-02-2025,"Grains, Flours & Dals",AISHWARYA SP 1KG,4,240,210,30,3
26-02-2025,Personal Care & Cosmetics,DWIBHASHI GULABA ARKA ROSA WATER,10,60,60,0,1
26-02-2025,Snacks & Ready-to-Eat,KURNOOL MARMURA,14,70,55,15,1
26-02-2025,Spices & Seasonings,Black Till 250GM,15,90,75,15,1
26-02-2025,Snacks & Ready-to-Eat,GREEN FRIED batana,14,80,80,0,4
26-02-2025,Personal Care & Cosmetics,JOHNOSONS BABY OIL 50ML,10,62,62,0,1
26-02-2025,Snacks & Ready-to-Eat,RSC ORANGE 100GMS,14,20,20,0,1
26-02-2025,"Dry Fruits, Nuts & Seeds",SABJA SEEDS 100GM,2,80,70,10,1
26-02-2025,"Grains, Flours & Dals",UNPOLISHED TURDALL 1KG,4,240,220,20,1
26-02-2025,Spices & Seasonings,PRO ORG CORIANDER WHOLE 100G,15,70,70,0,1
26-02-2025,Personal Care & Cosmetics,KAIPO SANDALWOOD SOAP 100GM,10,120,120,0,2
26-02-2025,"Grains, Flours & Dals",turdal 1kg,4,220,195,25,1
26-02-2025,Milk & Dairy,BROWN EGGS TRAY 30P,7,360,330,30,1
26-02-2025,Snacks & Ready-to-Eat,NGT CHATPATTA CHANA 90GM,14,25,25,0,1
26-02-2025,"Grains, Flours & Dals",Wheat Flour 1 kg,4,70,60,10,1
26-02-2025,Snacks & Ready-to-Eat,VD PAPPU CHEGODI 200GM,14,60,60,0,1
26-02-2025,Snacks & Ready-to-Eat,Corn Chips 250GM,14,40,35,5,1
26-02-2025,"Grains, Flours & Dals",Wheat Flour 1 kg,4,140,120,20,2
26-02-2025,Snacks & Ready-to-Eat,VD GUMMADI VADIYAM,14,75,75,0,1
26-02-2025,Snacks & Ready-to-Eat,SALTED PHALLI,14,25,25,0,1
26-02-2025,Spices & Seasonings,Dalchin Chekka 50GM,15,50,40,10,1
26-02-2025,Snacks & Ready-to-Eat,GS Moongdal Dosa Mix 400GM,14,140,140,0,1
26-02-2025,Oils & Ghee,Groundnut oil 1 L,9,720,660,60,2
26-02-2025,Snacks & Ready-to-Eat,SATHVI REGIVADA 200GM,14,240,180,60,3
26-02-2025,Oils & Ghee,Sesame oil 1 L,9,1180,"1,120.00",60,2
26-02-2025,Sweeteners,YB JAGGERY POWDER 500GMS,16,75,75,0,1
26-02-2025,Sweeteners,GS Organic Jaggery Powder 600GM,16,99,99,0,1
26-02-2025,"Dry Fruits, Nuts & Seeds",PUTNALU 500GMS,2,90,76,14,1
26-02-2025,"Grains, Flours & Dals",Multigrain 1 kg,4,100,85,15,1
26-02-2025,Pooja & Spiritual Items,SWASTIK CAMPHOR 25GM,12,45,45,0,1
26-02-2025,Oils & Ghee,Black Sesame oil 500 ml,9,220,190,30,1
26-02-2025,Spices & Seasonings,NUVVULU 250GM,15,100,85,15,1
26-02-2025,"Grains, Flours & Dals",RAGI FLOUR 500GRMS,4,40,35,5,1
26-02-2025,"Grains, Flours & Dals",Multigrain 1 kg,4,100,85,15,1
26-02-2025,"Grains, Flours & Dals",BAJRA 1 KG,4,15,12.5,2.5,0.25
26-02-2025,"Grains, Flours & Dals",Chana Flour 500 gms,4,70,65,5,1
26-02-2025,Sweeteners,MISHRI 250 GM,16,35,30,5,1
26-02-2025,"Grains, Flours & Dals",MELMEKER 250GMS,4,60,45,15,1
26-02-2025,Beverages,BRU GREEN LABEL 1.2G,1,8,8,0,4
26-02-2025,"Grains, Flours & Dals",White jowar.F 1 kg,4,100,80,20,1
26-02-2025,"Grains, Flours & Dals",BARLEY SEEDS 250GMS,4,40,35,5,1
26-02-2025,"Grains, Flours & Dals",Wheat Rava S 500GM,4,33,30,3,1
26-02-2025,Spices & Seasonings,Jeera 100GM,15,50,45,5,1
26-02-2025,"Grains, Flours & Dals",Red Bobarlu 500 gms,4,95,85,10,1
26-02-2025,Spices & Seasonings,Tamarind 250GMS,15,80,65,15,1
26-02-2025,"Grains, Flours & Dals",Green gram 500 gms,4,75,70,5,1
26-02-2025,"Grains, Flours & Dals",Wheat Rava S 1KG,4,65,55,10,1
26-02-2025,Sweeteners,SUGAR 1KG,16,60,50,10,1
26-02-2025,Oils & Ghee,Groundnut oil 1 L,9,360,330,30,1
26-02-2025,"Grains, Flours & Dals",Bombay Rava 500GM,4,35,30,5,1
26-02-2025,Oils & Ghee,Castor oil 200 ml,9,100,80,20,1
26-02-2025,"Grains, Flours & Dals",SINGLE POLISH 1KG,4,130,130,0,2
26-02-2025,Snacks & Ready-to-Eat,RITEBITE BLUEBERRY BLAST,14,50,50,0,1
26-02-2025,General Household & Kitchenware,MATCH BOX,3,2,2,0,1
26-02-2025,Spices & Seasonings,NUVVULU 250GM,15,100,85,15,1
26-02-2025,General Household & Kitchenware,GOOD HOME,3,15,15,0,1
26-02-2025,Household & Cleaning,VIM SOAP,6,10,10,0,2
26-02-2025,"Dry Fruits, Nuts & Seeds",Groundnuts 1 kg,2,190,170,20,1
26-02-2025,Snacks & Ready-to-Eat,Popcorn Seeds 250GM,14,45,40,5,1
26-02-2025,Pooja & Spiritual Items,SWASTIK CAMPHORE,12,90,90,0,1
26-02-2025,Personal Care & Cosmetics,DWIBHASHI GULABA ARKA ROSA WATER,10,75,75,0,1
26-02-2025,Sweeteners,SUGAR 1KG,16,60,50,10,1
26-02-2025,Milk & Dairy,HERITAGE TONED MILK 500ML,7,31,31,0,1
26-02-2025,"Grains, Flours & Dals",BOMBAY RAVA,4,70,55,15,1
26-02-2025,"Grains, Flours & Dals",RAGI FLOUR 500GRMS,4,40,35,5,1
26-02-2025,Pooja & Spiritual Items,BALAJI BEL PHOOL STICKS 90GM,12,60,60,0,1
26-02-2025,Sweeteners,NATURAL HONEY 250GM,16,150,130,20,1
26-02-2025,"Grains, Flours & Dals",Wheat Flour 1 kg,4,140,120,20,2
26-02-2025,Snacks & Ready-to-Eat,ELITE ELAICHI RUSK 200GM,14,35,35,0,1
26-02-2025,Oils & Ghee,cow ghee 500 ml,9,430,390,40,1
26-02-2025,Pooja & Spiritual Items,vibudhi,12,10,10,0,1
26-02-2025,General Household & Kitchenware,MATCH BOX,3,20,20,0,1
26-02-2025,Milk & Dairy,BROWN EGGS TRAY 30P,7,360,330,30,1
26-02-2025,Personal Care & Cosmetics,Khadi Milk Cream Shampoo 200ML,10,880,880,0,4
26-02-2025,"Dry Fruits, Nuts & Seeds",DRYDATES YELLOW 250GM,2,135,120,15,1
26-02-2025,Snacks & Ready-to-Eat,VD NUVULLU CHIKKI,14,80,80,0,1
26-02-2025,Personal Care & Cosmetics,SVE REETHA KUNKUDUKAYALU,10,398,398,0,2
26-02-2025,Snacks & Ready-to-Eat,KURNOOL MARMURA,14,70,55,15,1
26-02-2025,"Dry Fruits, Nuts & Seeds",Groundnuts 500 gms,2,95,85,10,1
26-02-2025,Personal Care & Cosmetics,MYSORE SANDAL SOAP 75G,10,168,168,0,4
26-02-2025,"Dry Fruits, Nuts & Seeds",PUTNALU 500GMS,2,180,152,28,2
26-02-2025,Household & Cleaning,PITAMBARI SHINING POWDER 200G,6,60,60,0,1
26-02-2025,Snacks & Ready-to-Eat,BB VERMICELLI 250GM,14,30,30,0,1
26-02-2025,"Grains, Flours & Dals",split green gram 1 kg,4,300,280,20,2
26-02-2025,Spices & Seasonings,Lavangam 50GM,15,60,50,10,1
26-02-2025,Snacks & Ready-to-Eat,NGT CHATPATTA CHANA 90GM,14,50,50,0,2
26-02-2025,"Grains, Flours & Dals",Red Bobarlu 1 kg,4,190,170,20,1
26-02-2025,"Grains, Flours & Dals",UNPOLISHED TURDALL 1KG,4,110,100,10,0.5
26-02-2025,Sweeteners,GS Organic Jaggery Powder 600GM,16,99,99,0,1
26-02-2025,"Grains, Flours & Dals",Wheat Flour 1 kg,4,70,60,10,1
26-02-2025,"Grains, Flours & Dals",Wheat Flour 2 kgs,4,140,120,20,1
26-02-2025,Pooja & Spiritual Items,GD Aiswarya Deepam 700ML,12,195,195,0,1
26-02-2025,Oils & Ghee,Castor oil 200 ml,9,100,80,20,1
26-02-2025,Spices & Seasonings,ROYAL SAFFRON 400GRMS,15,65,65,0,1
26-02-2025,"Grains, Flours & Dals",BARLEY SEEDS 250GMS,4,40,35,5,1
26-02-2025,"Grains, Flours & Dals",Sathya Javva Wheat Rava 500GM,4,190,190,0,2
26-02-2025,"Grains, Flours & Dals",SRILATHA RICE RAVVA 500GM,4,70,70,0,2
26-02-2025,Spices & Seasonings,Chilli powder 500 gms,15,290,210,80,1
26-02-2025,Snacks & Ready-to-Eat,ELITE ELAICHI RUSK 200GM,14,35,35,0,1
26-02-2025,Personal Care & Cosmetics,BLACK NATURALS,10,84,84,0,2
26-02-2025,"Dry Fruits, Nuts & Seeds",PUMPKIN SEEDS 250GM,2,200,160,40,1
26-02-2025,"Grains, Flours & Dals",Bombay Rava 500GM,4,35,30,5,1
26-02-2025,"Grains, Flours & Dals",Chana Flour 500 gms,4,70,65,5,1
26-02-2025,"Dry Fruits, Nuts & Seeds",BLACK KISMIS 250GM,2,175,140,35,1
26-02-2025,"Grains, Flours & Dals",White jowar.F 1 kg,4,100,80,20,1
26-02-2025,"Grains, Flours & Dals",Green Batani 500GM,4,110,90,20,1
26-02-2025,"Grains, Flours & Dals",KORRALU (FOXTAIL M) 500GM,4,65,55,10,1
26-02-2025,Snacks & Ready-to-Eat,Popcorn Seeds 250GM,14,45,40,5,1
26-02-2025,Snacks & Ready-to-Eat,VD Minapa papad 200gm,14,60,60,0,1
26-02-2025,Snacks & Ready-to-Eat,KURNOOL MARMURA,14,70,55,15,1
26-02-2025,"Grains, Flours & Dals",DESI CHANA,4,25,25,0,1
26-02-2025,Snacks & Ready-to-Eat,GB SALT COOKIES,14,60,55,5,1
26-02-2025,"Grains, Flours & Dals",idly/Dosa rice 1 kg,4,70,60,10,1
26-02-2025,Beverages,REFRESH SHARBATH SUGAR FREE,1,299,285,14,1
26-02-2025,"Dry Fruits, Nuts & Seeds",Putnalu 250GM,2,45,38,7,1
26-02-2025,Snacks & Ready-to-Eat,BATANA NGT 70GMS,14,20,20,0,1
26-02-2025,"Health, Wellness & Ayurvedic Products",VEMANA PULIPIRI 10GM,5,240,240,0,2
26-02-2025,"Health, Wellness & Ayurvedic Products",HARITHAKI CHOORNAM,5,80,80,0,1
26-02-2025,"Grains, Flours & Dals",Red uluvalu 500 gms,4,90,75,15,1
26-02-2025,Spices & Seasonings,BIRYANI MASALA,15,15,15,0,1
26-02-2025,"Grains, Flours & Dals",Black uluvalu 500 gms,4,90,70,20,1
26-02-2025,"Dry Fruits, Nuts & Seeds",PN ORGANIC MAKHANA 50GM,2,125,125,0,1
26-02-2025,Spices & Seasonings,AVALU 100GM,15,25,20,5,1
26-02-2025,"Dry Fruits, Nuts & Seeds",SUNFLOWER SEEDS 250GRM,2,150,130,20,1
26-02-2025,Spices & Seasonings,Jeera 100GM,15,50,45,5,1
26-02-2025,"Grains, Flours & Dals",RAGI FLOUR 500GRMS,4,40,35,5,1
26-02-2025,"Grains, Flours & Dals",Wheat Flour 1 kg,4,70,60,10,1
26-02-2025,"Grains, Flours & Dals",RAGI FLOUR 1KG,4,80,70,10,1
26-02-2025,"Grains, Flours & Dals",Wheat Rava S 1KG,4,65,55,10,1
26-02-2025,"Dry Fruits, Nuts & Seeds",PULMAKHANA 100 GM,2,180,170,10,1
26-02-2025,"Grains, Flours & Dals",PESARA PAPPU 1 KG,4,170,145,25,1
26-02-2025,"Grains, Flours & Dals",White jowar.F 1 kg,4,100,80,20,1
26-02-2025,Pooja & Spiritual Items,OM SAINATH ISOBORNEOL 10GM,12,60,60,0,1
26-02-2025,Pooja & Spiritual Items,HAND MADE VOTHULU,12,50,50,0,1
26-02-2025,"Dry Fruits, Nuts & Seeds",Groundnuts 1 kg,2,190,170,20,1
26-02-2025,Pooja & Spiritual Items,GOMATHA AGARBATHI,12,75,75,0,1
26-02-2025,"Grains, Flours & Dals",Multigrain 1 kg,4,100,85,15,1
26-02-2025,Oils & Ghee,Groundnut oil 5 L,9,1800,"1,600.00",200,1
26-02-2025,"Grains, Flours & Dals",WHEAT 1 KG,4,180,150,30,3
26-02-2025,Snacks & Ready-to-Eat,VD MURMURA LADDU,14,45,45,0,1
26-02-2025,"Grains, Flours & Dals",Wheat Rava M 1KG,4,65,55,10,1
26-02-2025,"Grains, Flours & Dals",FLOUR CHARGE,4,36,36,0,3
26-02-2025,Milk & Dairy,HERITAGE TONED MILK 500ML,7,31,31,0,1
26-02-2025,"Grains, Flours & Dals",Urad dall 1 Kg,4,740,680,60,4
26-02-2025,Spices & Seasonings,Miriyalu 50GM,15,200,160,40,2
26-02-2025,Spices & Seasonings,JEERA 250 gms,15,125,105,20,1
26-02-2025,Sweeteners,SUGAR 1KG,16,60,50,10,1
26-02-2025,"Dry Fruits, Nuts & Seeds",PUTNALU 500GMS,2,180,152,28,2
26-02-2025,Spices & Seasonings,Turmeric powder 250 gms,15,100,75,25,1
26-02-2025,Spices & Seasonings,Coriander seeds 200 gms,15,48,40,8,1
26-02-2025,"Dry Fruits, Nuts & Seeds",Groundnuts 1 kg,2,380,340,40,2
26-02-2025,Oils & Ghee,Sesame oil 5 L,9,2950,"2,750.00",200,1
26-02-2025,"Grains, Flours & Dals",Idly Rava L 1KG,4,120,100,20,2
26-02-2025,"Grains, Flours & Dals",CHANA DAL 500GM,4,140,120,20,2
26-02-2025,Spices & Seasonings,ROYAL SAFFRON 400GRMS,15,65,65,0,1
26-02-2025,Snacks & Ready-to-Eat,BB VERMICELLI 1KG,14,95,90,5,1
26-02-2025,Spices & Seasonings,DRY MIECHI 200GM,15,160,120,40,2
26-02-2025,Spices & Seasonings,DHANIYA POWDER 200GM,15,100,85,15,1
26-02-2025,Spices & Seasonings,Tamarind 500GM,15,160,130,30,1
26-02-2025,Spices & Seasonings,AVALU 100GM,15,50,40,10,2
26-02-2025,"Grains, Flours & Dals",RAGULU 1 KG,4,7,6,1,0.1
26-02-2025,"Grains, Flours & Dals",SABDANA 500GM,4,90,70,20,1
26-02-2025,"Grains, Flours & Dals",Wheat Flour 1 kg,4,210,180,30,3
26-02-2025,"Grains, Flours & Dals",PESARA PAPPU 500GMS,4,85,75,10,1
26-02-2025,"Grains, Flours & Dals",Green gram 500 gms,4,75,70,5,1
26-02-2025,"Grains, Flours & Dals",Wheat Flour 2 kgs,4,140,120,20,1
26-02-2025,Spices & Seasonings,Vamu 100GM,15,60,50,10,1
26-02-2025,Spices & Seasonings,Chilli powder 1 kg,15,580,420,160,1
26-02-2025,"Grains, Flours & Dals",Wheat Rava S 1KG,4,65,55,10,1
26-02-2025,"Grains, Flours & Dals",turdal 1kg,4,440,390,50,2
26-02-2025,"Grains, Flours & Dals",Bombay Rava 500GM,4,35,30,5,1
26-02-2025,Pooja & Spiritual Items,SWASTIK CAMPHORE,12,180,180,0,2
26-02-2025,Pooja & Spiritual Items,HAND MADE VOTHULU,12,50,50,0,1
26-02-2025,Oils & Ghee,Safflower oil 1 L,9,440,400,40,1
26-02-2025,Personal Care & Cosmetics,GAYATHRI KUMKUDUKAYA,10,150,150,0,1
26-02-2025,"Grains, Flours & Dals",Wheat Flour 1 kg,4,70,60,10,1
26-02-2025,"Grains, Flours & Dals",Red Wheat Flour 1 kg,4,140,130,10,1
26-02-2025,Spices & Seasonings,Japatri 25GM,15,100,80,20,1
26-02-2025,Spices & Seasonings,AVALU 100GM,15,25,20,5,1
26-02-2025,Spices & Seasonings,SATHVI BIRYANI LEAF 25GM,15,30,20,10,1
26-02-2025,Spices & Seasonings,GS Pink Rock Salt 1KG,15,120,120,0,1
26-02-2025,"Grains, Flours & Dals",RAGULU 1 KG,4,35,30,5,0.5
26-02-2025,Spices & Seasonings,Chilli powder 500 gms,15,290,210,80,1
26-02-2025,"Grains, Flours & Dals",VYS.SP.RICE 5 KGS,4,350,325,25,1
26-02-2025,Sweeteners,SUGAR 1KG,16,60,50,10,1
26-02-2025,"Grains, Flours & Dals",MAATEJA rice 1 kg,4,144,138,6,2
26-02-2025,Snacks & Ready-to-Eat,COPRA LADDU 200GM,14,200,160,40,2
26-02-2025,"Grains, Flours & Dals",PRO ORG MEDIUM POHA 500G,4,78,78,0,1
26-02-2025,Sweeteners,GS Palm Jaggery Powder 400GM,16,180,180,0,1
26-02-2025,"Grains, Flours & Dals",RAGULU 1 KG,4,35,30,5,0.5
26-02-2025,"Grains, Flours & Dals",Wheat Flour 2 kgs,4,140,120,20,1
26-02-2025,Oils & Ghee,Sesame oil 1 L,9,1180,"1,120.00",60,2
26-02-2025,Snacks & Ready-to-Eat,VD ATUKULU MIXTURE 175GM,14,60,60,0,1
26-02-2025,"Grains, Flours & Dals",Wheat Flour 1 kg,4,70,60,10,1
26-02-2025,"Grains, Flours & Dals",Red Wheat Flour 1 kg,4,140,130,10,1
26-02-2025,"Grains, Flours & Dals",Em Multimillet idli r 500g,4,129,129,0,1
26-02-2025,"Grains, Flours & Dals",Chana Flour 500 gms,4,140,130,10,2
26-02-2025,"Grains, Flours & Dals",KORRALU (FOXTAIL M) 500GM,4,65,55,10,1
26-02-2025,Snacks & Ready-to-Eat,VD SANNAPUSA 175GM,14,60,60,0,1
26-02-2025,"Grains, Flours & Dals",JOWAR WHITE 1 KG,4,40,35,5,0.5
26-02-2025,Milk & Dairy,BROWN EGGS TRAY 30P,7,360,330,30,1
26-02-2025,Snacks & Ready-to-Eat,VD PALLI LADDU,14,80,80,0,1
26-02-2025,Spices & Seasonings,Chilli powder 500 gms,15,290,210,80,1
26-02-2025,Snacks & Ready-to-Eat,COPRA LADDU 200GM,14,100,80,20,1
26-02-2025,Snacks & Ready-to-Eat,ZEEDI,14,70,70,0,1
26-02-2025,Snacks & Ready-to-Eat,RINGS 200GM,14,30,30,0,1
26-02-2025,Snacks & Ready-to-Eat,RSC ORANGE 100GMS,14,60,60,0,3
26-02-2025,Pooja & Spiritual Items,GD KUMKUM 50GM,12,30,30,0,1
26-02-2025,"Dry Fruits, Nuts & Seeds",Groundnuts 1 kg,2,190,170,20,1
26-02-2025,Beverages,BRU GREEN LABEL 1.2G,1,10,10,0,5
26-02-2025,Spices & Seasonings,Turmeric powder 250 gms,15,100,75,25,1
26-02-2025,"Grains, Flours & Dals",FLOUR CHARGE,4,24,24,0,2
26-02-2025,Snacks & Ready-to-Eat,GANTASALA GINGER CANDY 200GM,14,210,210,0,2
26-02-2025,Snacks & Ready-to-Eat,ANNAPURNA APPALAM,14,70,70,0,2
26-02-2025,"Grains, Flours & Dals",split green gram 500 gms,4,75,70,5,1
26-02-2025,Pooja & Spiritual Items,OM SAINATH ISOBORNEOL 10GM,12,60,60,0,1
26-02-2025,"Health, Wellness & Ayurvedic Products",AMLA PACHAK,5,100,100,0,1
26-02-2025,Snacks & Ready-to-Eat,VD PALLI LADDU,14,160,160,0,2
26-02-2025,Beverages,BRU GREEN LABEL 100G,1,65,65,0,1
26-02-2025,Snacks & Ready-to-Eat,VD DAHI MIRCHI(SALTED) 100GM,14,45,45,0,1
26-02-2025,"Grains, Flours & Dals",White jowar.F 1 kg,4,300,240,60,3
26-02-2025,Snacks & Ready-to-Eat,GREEN FRIED BATANA,14,100,100,0,5
26-02-2025,Snacks & Ready-to-Eat,NGT CHATPATTA CHANA 90GM,14,25,25,0,1
26-02-2025,Snacks & Ready-to-Eat,MASALA CHANA,14,100,100,0,4
26-02-2025,Snacks & Ready-to-Eat,ZEEDI,14,140,140,0,2
26-02-2025,"Grains, Flours & Dals",turdal 1kg,4,440,390,50,2
26-02-2025,"Health, Wellness & Ayurvedic Products",MD Bringaraj Choornam 100GM,5,80,80,0,1
26-02-2025,Personal Care & Cosmetics,REVIVE ANTI BACTERIA 50GM,10,20,20,0,1
26-02-2025,Personal Care & Cosmetics,KAIPO SANDALWOOD SOAP 100GM,10,60,60,0,1
26-02-2025,Spices & Seasonings,FLAXSEED KARAM,15,75,75,0,1
26-02-2025,Spices & Seasonings,PUTNALA KARAM POWDER 100GM,15,65,65,0,1
26-02-2025,"Grains, Flours & Dals",SAMALU (Little millet) 1 kg,4,170,130,40,1
26-02-2025,Snacks & Ready-to-Eat,COPRA LADDU 200GM,14,100,80,20,1
26-02-2025,"Grains, Flours & Dals",KORRALU (FOXTAIL M) 1KG,4,150,110,40,1
26-02-2025,"Grains, Flours & Dals",HS RAGI Idly rava 500 gms,4,70,70,0,1
26-02-2025,Spices & Seasonings,Menthulu 250 gms,15,50,45,5,1
26-02-2025,"Grains, Flours & Dals",UDALU (Barnyard millet) 500 gms,4,70,60,10,1
26-02-2025,"Grains, Flours & Dals",Arikadu ( kodo),4,140,130,10,1
26-02-2025,Oils & Ghee,Groundnut oil 1 L,9,360,330,30,1
26-02-2025,Household & Cleaning,VIM EXTRA 110GM,6,40,40,0,4
26-02-2025,Snacks & Ready-to-Eat,MAAGAANI JOWAR M COOKIES 120GM,14,149,149,0,1
26-02-2025,Oils & Ghee,Groundnut oil 1 L,9,360,330,30,1
26-02-2025,"Grains, Flours & Dals",Multigrain 1 kg,4,100,85,15,1
26-02-2025,"Grains, Flours & Dals",Wheat Flour 2 kgs,4,140,120,20,1
26-02-2025,Spices & Seasonings,AV Iodized Salt 1KG,15,28,25,3,1
26-02-2025,Spices & Seasonings,pickle chili powder,15,180,165,15,1
26-02-2025,Spices & Seasonings,DURGA SALT CRYSTAL 1KG,15,25,25,0,1
26-02-2025,Personal Care & Cosmetics,papaya soap,10,0,0,0,1
26-02-2025,Oils & Ghee,Sesame oil 500ml,9,295,280,15,1
26-02-2025,Spices & Seasonings,Menthulu 250 gms,15,50,45,5,1
26-02-2025,"Grains, Flours & Dals",JOWAR WHITE 1 KG,4,80,70,10,1
26-02-2025,Spices & Seasonings,Coriander seeds 200 gms,15,48,40,8,1
26-02-2025,"Grains, Flours & Dals",white Bobarlu 500 gms,4,80,75,5,1
26-02-2025,Snacks & Ready-to-Eat,KURNOOL MARMURA,14,45,45,0,1
26-02-2025,"Grains, Flours & Dals",RAGI FLOUR 500GRMS,4,40,35,5,1
26-02-2025,Snacks & Ready-to-Eat,VD MULTI CHAKKA,14,110,110,0,1
26-02-2025,"Grains, Flours & Dals",CHANA DAL 1KG,4,140,120,20,1
26-02-2025,Snacks & Ready-to-Eat,SD Atreyapuram DRY Fruit ghee,14,150,150,0,1
26-02-2025,"Grains, Flours & Dals",Bombay Rava 500GM,4,35,30,5,1
26-02-2025,Snacks & Ready-to-Eat,KURNOOL MARMURA,14,70,55,15,1
26-02-2025,Snacks & Ready-to-Eat,Corn Chips 250GM,14,80,70,10,2
26-02-2025,"Grains, Flours & Dals",Sathya Javva Wheat Rava 500GM,4,95,95,0,1
26-02-2025,"Grains, Flours & Dals",HS jowar idly rava 500 gms,4,65,65,0,1
26-02-2025,Sweeteners,GS Organic Jaggery Powder 600GM,16,99,99,0,1
26-02-2025,Snacks & Ready-to-Eat,NGT CHATPATTA CHANA 90GM,14,25,25,0,1
26-02-2025,"Dry Fruits, Nuts & Seeds",Putnalu 250GM,2,45,38,7,1
26-02-2025,Snacks & Ready-to-Eat,PEANUT CHIKKI,14,44,44,0,2
26-02-2025,Oils & Ghee,Groundnut oil 1 L,9,360,330,30,1
26-02-2025,Snacks & Ready-to-Eat,PEANUT CHILLI,14,10,10,0,2
26-02-2025,"Grains, Flours & Dals",idly/Dosa rice 1 kg,4,140,120,20,2
26-02-2025,Sweeteners,SUGAR 1KG,16,60,50,10,1
26-02-2025,Snacks & Ready-to-Eat,BB VERMICELLY 500GM,14,53,53,0,1
26-02-2025,"Grains, Flours & Dals",CHANA DAL 500GM,4,70,60,10,1
26-02-2025,Spices & Seasonings,JEERA 250 gms,15,125,105,20,1
26-02-2025,Spices & Seasonings,Coriander seeds 200 gms,15,48,40,8,1
26-02-2025,"Dry Fruits, Nuts & Seeds",Groundnuts 1 kg,2,190,170,20,1
26-02-2025,Spices & Seasonings,Miriyalu 50GM,15,100,80,20,1
26-02-2025,"Grains, Flours & Dals",THICK POHA 500GM,4,40,35,5,1
26-02-2025,Spices & Seasonings,GS Pink Rock Salt 1KG,15,120,120,0,1
26-02-2025,Spices & Seasonings,YB PINK ROCK SALT 1KG,15,120,120,0,1
26-02-2025,"Dry Fruits, Nuts & Seeds",Putnalu 250GM,2,45,38,7,1
26-02-2025,Spices & Seasonings,LG 50GM,15,184,184,0,2
26-02-2025,"Grains, Flours & Dals",BOMBAY RAVA,4,70,55,15,1
26-02-2025,"Dry Fruits, Nuts & Seeds",DRYDATES YELLOW 250GM,2,135,120,15,1
26-02-2025,"Grains, Flours & Dals",Wheat Rava M 1KG,4,65,55,10,1
26-02-2025,"Grains, Flours & Dals",RAGI FLOUR 1KG,4,160,140,20,2
26-02-2025,"Grains, Flours & Dals",RICE FLOUR 1KG,4,140,110,30,2
26-02-2025,Spices & Seasonings,Menthulu 500 gms,15,100,90,10,1
26-02-2025,"Grains, Flours & Dals",COW B rice 1 kg,4,144,138,6,2
26-02-2025,Oils & Ghee,Groundnut oil 1 L,9,360,330,30,1
26-02-2025,"Grains, Flours & Dals",Multigrain 1 kg,4,100,85,15,1
26-02-2025,Milk & Dairy,SANGAM CURD 450GM,7,38,38,0,1
26-02-2025,Milk & Dairy,SANGAM TONED MILK 500ML,7,60,60,0,2
26-02-2025,Oils & Ghee,A2 BUFFALO GHEE 250ML,9,299,299,0,1
26-02-2025,Spices & Seasonings,Masala Karam 500 gms,15,260,240,20,1
26-02-2025,Spices & Seasonings,Turmeric powder 250 gms,15,100,75,25,1
26-02-2025,Spices & Seasonings,Dalchin Rolls 50GM,15,70,70,0,1
26-02-2025,"Grains, Flours & Dals",Chittimuthaylu rice 1 kg,4,320,280,40,2
26-02-2025,Oils & Ghee,Groundnut oil 1 L,9,720,660,60,2
26-02-2025,Oils & Ghee,GANTASALA A2 COW GHEE 500ML,9,550,550,0,1
26-02-2025,Snacks & Ready-to-Eat,VD BELLAM GAVVALU 200GM,14,120,120,0,2
26-02-2025,Snacks & Ready-to-Eat,VD BOONDI 175GM,14,60,60,0,1
26-02-2025,Snacks & Ready-to-Eat,VD PALLI LADDU,14,80,80,0,1
26-02-2025,Snacks & Ready-to-Eat,VD PALLI CHIKKI,14,80,80,0,1
26-02-2025,Snacks & Ready-to-Eat,BELAM MENIPA SUNADULLU,14,180,180,0,1
26-02-2025,Milk & Dairy,SANGAM FULL CREAM MILK 500ML,7,76,76,0,2
26-02-2025,"Grains, Flours & Dals",KORRALU (FOXTAIL M) 500GM,4,65,55,10,1
26-02-2025,Oils & Ghee,Groundnut oil 1 L,9,360,330,30,1
26-02-2025,Oils & Ghee,Safflower oil 5 L,9,2200,"1,950.00",250,1
26-02-2025,Snacks & Ready-to-Eat,BD BARELY NOODLES 200G,14,150,150,0,2
26-02-2025,"Grains, Flours & Dals",Multigrain 1 kg,4,200,170,30,2
26-02-2025,"Grains, Flours & Dals",SAMALU (Little millet) 500 gms,4,85,65,20,1
26-02-2025,Snacks & Ready-to-Eat,NGT CHATPATTA CHANA 90GM,14,20,20,0,1
26-02-2025,"Grains, Flours & Dals",Yellow jowar .F1 kg,4,110,100,10,1
26-02-2025,"Grains, Flours & Dals",KORRALU (FOXTAIL M) 500GM,4,65,55,10,1
26-02-2025,"Grains, Flours & Dals",yellow jowar 500 gms,4,50,50,0,1
26-02-2025,"Grains, Flours & Dals",Quinova 500 gms,4,110,100,10,1
26-02-2025,Oils & Ghee,Groundnut oil 1 L,9,360,330,30,1
26-02-2025,"Grains, Flours & Dals",Wheat Rava S 500GM,4,33,30,3,1
25-02-2025,Oils & Ghee,Groundnut oil 5 L,9,1800,"1,600.00",200,1
25-02-2025,"Grains, Flours & Dals",Multigrain 1 kg,4,100,85,15,1
25-02-2025,Spices & Seasonings,ROYAL SAFFRON,15,125,125,0,1
25-02-2025,"Grains, Flours & Dals",AS Maize Rava 500GM,4,42,38,4,1
25-02-2025,Baking & Cooking Aids,Baking Soda 50GM,0,40,30,10,2
25-02-2025,Spices & Seasonings,PUTNALA KARAM POWDER 100GM,15,65,65,0,1
25-02-2025,Spices & Seasonings,SD Curry Leaves Karam Powder 100GM,15,65,65,0,1
25-02-2025,"Grains, Flours & Dals",Wheat Flour 1 kg,4,420,360,60,6
25-02-2025,"Dry Fruits, Nuts & Seeds",PULMAKHANA 100 GM,2,360,340,20,2
25-02-2025,"Dry Fruits, Nuts & Seeds",PULMAKHANA 100 GM,2,180,170,10,1
25-02-2025,Spices & Seasonings,Turmeric powder 250 gms,15,100,75,25,1
25-02-2025,"Grains, Flours & Dals",Wheat Rava M 1KG,4,65,55,10,1
25-02-2025,"Grains, Flours & Dals",THICK POHA 500GM,4,40,35,5,1
25-02-2025,Oils & Ghee,Sesame oil 1 L,9,590,560,30,1
25-02-2025,"Grains, Flours & Dals",Green gram 500 gms,4,75,70,5,1
25-02-2025,Pooja & Spiritual Items,bilwa patra,12,60,60,0,1
25-02-2025,Spices & Seasonings,Gasagasalu 50GM,15,130,110,20,1
25-02-2025,"Grains, Flours & Dals",RAGULU 1 KG,4,70,60,10,1
25-02-2025,"Grains, Flours & Dals",Red Bobarlu 500 gms,4,95,85,10,1
25-02-2025,"Dry Fruits, Nuts & Seeds",PULMAKHANA 100 GM,2,180,170,10,1
25-02-2025,"Grains, Flours & Dals",RAJMA 250GM,4,55,45,10,1
25-02-2025,Pooja & Spiritual Items,GD Sree Chandan 50GM,12,50,50,0,1
25-02-2025,Milk & Dairy,HRITAGE TOTAL CURD 130GM,7,10,10,0,1
25-02-2025,"Grains, Flours & Dals",Bobbara Pappu 1KG,4,360,320,40,2
25-02-2025,"Dry Fruits, Nuts & Seeds",SD Mango cubes 100gm,2,45,45,0,1
25-02-2025,Personal Care & Cosmetics,BIOTIQUE SHINE &GLOSS 120ML,10,99,99,0,1
25-02-2025,Spices & Seasonings,Black Till 250GM,15,90,75,15,1
25-02-2025,"Grains, Flours & Dals",Chana Flour 500 gms,4,70,65,5,1
25-02-2025,Spices & Seasonings,ROYAL SAFFRON,15,250,250,0,2
25-02-2025,Pooja & Spiritual Items,GD Sree Chandan 50GM,12,50,50,0,1
25-02-2025,Pooja & Spiritual Items,GD Camphor 50GM,12,115,115,0,1
25-02-2025,Sweeteners,GS JAGGERY NUGGETS 500GM,16,120,120,0,1
25-02-2025,Oils & Ghee,Black Sesame oil 1 L,9,440,380,60,1
25-02-2025,"Grains, Flours & Dals",PRO ORG RED POHA 500GM,4,89,89,0,1
25-02-2025,Oils & Ghee,Sesame oil 1 L,9,590,560,30,1
25-02-2025,"Grains, Flours & Dals",Multigrain 1 kg,4,100,85,15,1
25-02-2025,"Grains, Flours & Dals",Wheat Flour 1 kg,4,70,60,10,1
25-02-2025,Pooja & Spiritual Items,SOSR SWATHHI 365,12,30,30,0,1
25-02-2025,Snacks & Ready-to-Eat,SD Ginger Candy 100g,14,60,60,0,1
25-02-2025,Pooja & Spiritual Items,MS RANGOLI 100G,12,120,120,0,12
25-02-2025,"Grains, Flours & Dals",RAGI FLOUR 1KG,4,80,70,10,1
25-02-2025,Spices & Seasonings,DRY MIECHI 200GM,15,80,60,20,1
25-02-2025,"Grains, Flours & Dals",Red Chana 250GM,4,35,30,5,1
25-02-2025,"Grains, Flours & Dals",RICE FLOUR 1KG,4,140,110,30,2
25-02-2025,"Grains, Flours & Dals",Wheat Rava M 1KG,4,65,55,10,1
25-02-2025,"Grains, Flours & Dals",Wheat Rava M 500GM,4,33,30,3,1
25-02-2025,"Grains, Flours & Dals",Wheat Flour 1 kg,4,70,60,10,1
25-02-2025,"Grains, Flours & Dals",UDALU (Barnyard millet) 500 gms,4,70,60,10,1
25-02-2025,"Grains, Flours & Dals",SAMALU (Little millet) 500 gms,4,85,65,20,1
25-02-2025,"Grains, Flours & Dals",ANDU KORRALU (Brown top .mlt) 500,4,130,110,20,1
25-02-2025,"Health, Wellness & Ayurvedic Products",MH Millets Malt 500GM,5,200,190,10,1
25-02-2025,"Grains, Flours & Dals",Arikalu (kodo),4,70,65,5,1
25-02-2025,"Grains, Flours & Dals",KORRALU (FOXTAIL M) 500GM,4,65,55,10,1
25-02-2025,"Grains, Flours & Dals",Wheat Flour 1 kg,4,140,120,20,2
25-02-2025,Milk & Dairy,BROWN EGGS 1P,7,280,240,40,20
25-02-2025,"Grains, Flours & Dals",BOMBAY RAVA,4,70,55,15,1
25-02-2025,Snacks & Ready-to-Eat,VD PAPPU CHEGODI 200GM,14,60,60,0,1
25-02-2025,Oils & Ghee,Groundnut oil 1 L,9,360,330,30,1
25-02-2025,Snacks & Ready-to-Eat,RITEBITE BLUEBERRY BLAST,14,50,50,0,1
25-02-2025,"Grains, Flours & Dals",Wheat Flour 1 kg,4,140,120,20,2
25-02-2025,Personal Care & Cosmetics,GAYATHRI KUMKUDUKAYA,10,150,150,0,1
25-02-2025,"Grains, Flours & Dals",HS jowar idly rava 500 gms,4,65,65,0,1
25-02-2025,"Grains, Flours & Dals",RAGULU 1 KG,4,35,30,5,0.5
25-02-2025,"Grains, Flours & Dals",JOWAR WHITE 1 KG,4,40,35,5,0.5
25-02-2025,"Health, Wellness & Ayurvedic Products",RB Max Protein PERI PERI 60gm,5,45,45,0,1
25-02-2025,"Dry Fruits, Nuts & Seeds",PULMAKHANA 100 GM,2,360,340,20,2
25-02-2025,"Dry Fruits, Nuts & Seeds",PUMPKIN SEEDS 250GM,2,200,160,40,1
25-02-2025,"Dry Fruits, Nuts & Seeds",WATERMELON SEEDS 250GRM,2,320,280,40,1
25-02-2025,"Dry Fruits, Nuts & Seeds",FLAX SEEDS 250GM,2,120,100,20,2
25-02-2025,"Dry Fruits, Nuts & Seeds",DRYDATES YELLOW 250GM,2,135,120,15,1
25-02-2025,Sweeteners,Natural Honey 500 gms,16,280,240,40,1
25-02-2025,Snacks & Ready-to-Eat,VD MANGO JELLY 250GRMS,14,80,80,0,1
25-02-2025,"Grains, Flours & Dals",RAGI FLOUR 500GRMS,4,40,35,5,1
25-02-2025,"Grains, Flours & Dals",Wheat Flour 1 kg,4,70,60,10,1
25-02-2025,Snacks & Ready-to-Eat,SD Vamu with palm jaggery 250gm,14,135,135,0,1
25-02-2025,Pooja & Spiritual Items,SREE REAL KASTURI STICKS 90GM,12,144,144,0,2
25-02-2025,Snacks & Ready-to-Eat,SD Aswagandha with palm Jaggery250Gm,14,135,135,0,1
25-02-2025,"Dry Fruits, Nuts & Seeds",ANJEER 250GM,2,400,360,40,1
25-02-2025,Sweeteners,Natural Honey 500 gms,16,280,240,40,1
25-02-2025,Spices & Seasonings,ROYAL SAFFRON,15,125,125,0,1
25-02-2025,"Grains, Flours & Dals",Chana Flour 500 gms,4,70,65,5,1
25-02-2025,"Grains, Flours & Dals",Wheat Flour 1 kg,4,70,60,10,1
25-02-2025,Spices & Seasonings,LG 50GM,15,92,92,0,1
25-02-2025,Personal Care & Cosmetics,GA DANT MANJAN TP 50GM,10,60,60,0,1
25-02-2025,"Grains, Flours & Dals",Multigrain 1 kg,4,100,85,15,1
25-02-2025,"Grains, Flours & Dals",RAGI FLOUR 500GRMS,4,40,35,5,1
25-02-2025,Spices & Seasonings,ROYAL SAFFRON,15,125,125,0,1
25-02-2025,Oils & Ghee,BUFFALLO GHEE 500ML,9,410,370,40,1
25-02-2025,Snacks & Ready-to-Eat,COPRA LADDU 200GM,14,300,240,60,3
25-02-2025,Snacks & Ready-to-Eat,SD MASALA GAVVALU 200GM,14,95,95,0,1
25-02-2025,"Grains, Flours & Dals",RICE FLOUR 1KG,4,70,55,15,1
25-02-2025,Oils & Ghee,Groundnut oil 5 L,9,1800,"1,600.00",200,1
25-02-2025,Pooja & Spiritual Items,GD Ramayana Sandal 75GM,12,120,120,0,2
25-02-2025,Snacks & Ready-to-Eat,Popcorn Seeds 500GM,14,90,80,10,1
25-02-2025,Household & Cleaning,HERBAL MOSQUITO REP RS 100ML,6,240,240,0,1
25-02-2025,"Grains, Flours & Dals",THICK POHA 1KG,4,80,70,10,1
25-02-2025,"Grains, Flours & Dals",RAGI FLOUR 500GRMS,4,40,35,5,1
25-02-2025,"Grains, Flours & Dals",Wheat Flour 1 kg,4,210,180,30,3
25-02-2025,Snacks & Ready-to-Eat,Corn Chips 250GM,14,80,70,10,2
25-02-2025,Snacks & Ready-to-Eat,MIX MILLET NOODLES,14,150,150,0,2
25-02-2025,Snacks & Ready-to-Eat,SD RAGI GAVVALU,14,95,95,0,1
25-02-2025,Snacks & Ready-to-Eat,VD Minapa papad 200gm,14,60,60,0,1
25-02-2025,Snacks & Ready-to-Eat,ANNAPURNA APPALAM,14,35,35,0,1
25-02-2025,"Grains, Flours & Dals",Brown RICE 1KG,4,70,65,5,1
25-02-2025,"Grains, Flours & Dals",SINGLE POLISH 1KG,4,195,195,0,3
25-02-2025,Snacks & Ready-to-Eat,SD Ginger Candy 100g,14,60,60,0,1
25-02-2025,Snacks & Ready-to-Eat,urban murmura,14,60,55,5,1
25-02-2025,General Household & Kitchenware,MATCH BOX,3,6,6,0,3
25-02-2025,"Grains, Flours & Dals",HS Multimillet upma r 500g,4,65,65,0,1
25-02-2025,Snacks & Ready-to-Eat,ONION RINGS,14,50,50,0,1
25-02-2025,Sweeteners,YB Brown Sugar 500GM,16,75,75,0,1
25-02-2025,Spices & Seasonings,Coriander seeds 200 gms,15,48,40,8,1
25-02-2025,Snacks & Ready-to-Eat,SD Sesame laddu with dates250gm,14,135,135,0,1
25-02-2025,"Dry Fruits, Nuts & Seeds",YELLOW KISHMISH 250GM,2,130,110,20,1
25-02-2025,Snacks & Ready-to-Eat,PEANUT CHILLI,14,60,60,0,12
25-02-2025,"Grains, Flours & Dals",HS jowar idly rava 500 gms,4,65,65,0,1
25-02-2025,"Dry Fruits, Nuts & Seeds",DRIED KIWI 200GM,2,145,130,15,1
25-02-2025,"Dry Fruits, Nuts & Seeds",Putnalu 250GM,2,45,38,7,1
25-02-2025,"Dry Fruits, Nuts & Seeds",SALTED PISTA 250GM,2,400,350,50,1
25-02-2025,"Grains, Flours & Dals",Multigrain 1 kg,4,100,85,15,1
25-02-2025,"Dry Fruits, Nuts & Seeds",Putnalu 250GM,2,45,38,7,1
25-02-2025,Personal Care & Cosmetics,COLGATE STRONG TEETH,10,20,20,0,1
25-02-2025,"Grains, Flours & Dals",FLOUR CHARGE,4,34.8,34.8,0,2.9
25-02-2025,"Dry Fruits, Nuts & Seeds",Groundnuts 500 gms,2,95,85,10,1
25-02-2025,"Grains, Flours & Dals",VGR rice 1 kg,4,140,130,10,2
25-02-2025,Spices & Seasonings,Tamarind 500GM,15,160,130,30,1
25-02-2025,Snacks & Ready-to-Eat,COPRA LADDU 200GM,14,100,80,20,1
25-02-2025,"Grains, Flours & Dals",SRILATHA RICE RAVVA 500GM,4,210,210,0,6
25-02-2025,Spices & Seasonings,Tamarind 500GM,15,640,520,120,4
25-02-2025,"Grains, Flours & Dals",FLOUR CHARGE,4,22.8,22.8,0,1.9
25-02-2025,"Grains, Flours & Dals",Wheat Flour 1 kg,4,210,180,30,3
25-02-2025,"Grains, Flours & Dals",RAGI FLOUR 500GRMS,4,40,35,5,1
25-02-2025,Snacks & Ready-to-Eat,BATANA NGT 70GMS,14,20,20,0,1
25-02-2025,"Dry Fruits, Nuts & Seeds",PULMAKHANA 100 GM,2,180,170,10,1
25-02-2025,Snacks & Ready-to-Eat,GB SALT COOKIES,14,60,55,5,1
25-02-2025,"Grains, Flours & Dals",Chittimuthaylu rice 1 kg,4,160,140,20,1
25-02-2025,"Grains, Flours & Dals",Multigrain 2 kgs,4,200,170,30,1
25-02-2025,Oils & Ghee,Coconut oil 500 ml,9,220,200,20,1
25-02-2025,"Grains, Flours & Dals",RAGI FLOUR 500GRMS,4,40,35,5,1
25-02-2025,"Grains, Flours & Dals",Yellow jowar .F1 kg,4,110,100,10,1
25-02-2025,Spices & Seasonings,BLACK JEERA 50 GM,15,45,30,15,1
25-02-2025,Snacks & Ready-to-Eat,SD FINGER Millet with palm Jaggery 250gm,14,135,135,0,1
25-02-2025,Oils & Ghee,Groundnut oil 1 L,9,720,660,60,2
25-02-2025,Oils & Ghee,BUFFALLO GHEE 500ML,9,410,370,40,1
25-02-2025,Snacks & Ready-to-Eat,VD PALLI LADDU,14,160,160,0,2
25-02-2025,"Dry Fruits, Nuts & Seeds",Groundnuts 1 kg,2,190,170,20,1
25-02-2025,Spices & Seasonings,DRY MIECHI 200GM,15,80,60,20,1
25-02-2025,Snacks & Ready-to-Eat,VD PALLI LADDU,14,160,160,0,2
25-02-2025,Beverages,BRU GREEN LABEL 1.2G,1,4,4,0,2
25-02-2025,"Grains, Flours & Dals",Wheat Flour 1 kg,4,70,60,10,1
25-02-2025,Oils & Ghee,Sesame oil 1 L,9,1180,"1,120.00",60,2
25-02-2025,"Grains, Flours & Dals",RAGI FLOUR 1KG,4,80,70,10,1
25-02-2025,Snacks & Ready-to-Eat,BATANA NGT 70GMS,14,20,20,0,1
25-02-2025,Sweeteners,SUGAR 1KG,16,60,50,10,1
25-02-2025,Snacks & Ready-to-Eat,VD PAPPU CHEGODI 200GM,14,60,60,0,1
25-02-2025,Spices & Seasonings,Chilli powder 500 gms,15,290,210,80,1
25-02-2025,"Grains, Flours & Dals",Wheat Rava S 1KG,4,65,55,10,1
25-02-2025,"Grains, Flours & Dals",RAGI FLOUR 500GRMS,4,80,70,10,2
25-02-2025,Snacks & Ready-to-Eat,BATANA NGT 70GMS,14,20,20,0,1
25-02-2025,"Grains, Flours & Dals",DESI CHANA,4,25,25,0,1
25-02-2025,Sweeteners,SUGAR 1KG,16,60,50,10,1
25-02-2025,Snacks & Ready-to-Eat,VD PALLI CHIKKI,14,80,80,0,1
25-02-2025,"Dry Fruits, Nuts & Seeds",PULMAKHANA 100 GM,2,180,170,10,1
25-02-2025,Oils & Ghee,Safflower oil 1 L,9,440,400,40,1
25-02-2025,"Grains, Flours & Dals",Em Multimillet upma 500g,4,129,129,0,1
25-02-2025,"Health, Wellness & Ayurvedic Products",MH Millets Malt 500GM,5,200,190,10,1
25-02-2025,"Grains, Flours & Dals",EM Foxtail idli r 500 g,4,109,109,0,1
25-02-2025,"Grains, Flours & Dals",Em Foxtail upma r 500 g,4,109,109,0,1
25-02-2025,"Health, Wellness & Ayurvedic Products",GS Wheat Grass Powder 100GMS,5,349,349,0,1
25-02-2025,"Health, Wellness & Ayurvedic Products",MORINGA LEAF POWDER M,5,80,80,0,1
25-02-2025,"Grains, Flours & Dals",Brown RICE 1KG,4,70,65,5,1
25-02-2025,"Grains, Flours & Dals",RED RICE 1KG,4,150,120,30,1
25-02-2025,"Grains, Flours & Dals",Black RICE 1 KG,4,340,310,30,1
25-02-2025,"Health, Wellness & Ayurvedic Products",MD Hibiscus Flower Choornam 30GM,5,100,100,0,1
25-02-2025,"Grains, Flours & Dals",Wheat Rava M 500GM,4,33,30,3,1
25-02-2025,Baking & Cooking Aids,GONDH 50GRMS,0,50,40,10,1
25-02-2025,"Dry Fruits, Nuts & Seeds",FLAX SEEDS 250GM,2,60,50,10,1
25-02-2025,"Grains, Flours & Dals",VYS.SP.RICE 5 KGS,4,350,325,25,1
25-02-2025,Oils & Ghee,Sesame oil 500ml,9,295,280,15,1
25-02-2025,"Grains, Flours & Dals",turdal 500 gms,4,110,100,10,1
25-02-2025,Pooja & Spiritual Items,SOSR SWATHHI 365,12,30,30,0,1
25-02-2025,"Grains, Flours & Dals",RAGI FLOUR 500GRMS,4,40,35,5,1
25-02-2025,Sweeteners,YB JAGGERY POWDER 500GMS,16,75,75,0,1
25-02-2025,"Grains, Flours & Dals",RAGULU 1 KG,4,35,30,5,0.5
25-02-2025,Beverages,BRU GREEN LABEL 1.2G,1,24,24,0,12
25-02-2025,"Grains, Flours & Dals",DESI CHANA,4,25,25,0,1
25-02-2025,Snacks & Ready-to-Eat,VD PALLI CHIKKI,14,80,80,0,1
25-02-2025,Snacks & Ready-to-Eat,MUTLGRAIN BREAD,14,70,70,0,1
25-02-2025,Snacks & Ready-to-Eat,SD Moringa with plam jaggery 250gm,14,135,135,0,1
25-02-2025,Pooja & Spiritual Items,LOOSE VATHULU,12,30,25,5,1
25-02-2025,Snacks & Ready-to-Eat,VD NUVULU CHEGODI 175GM,14,60,60,0,1
25-02-2025,Pooja & Spiritual Items,V GUGGILAM 50GM,12,45,45,0,1
25-02-2025,Personal Care & Cosmetics,GOW DURBAR NAVA 100GM SOAP,10,40,40,0,1
25-02-2025,Snacks & Ready-to-Eat,VD SAGOPAPAD 150GM,14,55,55,0,1
25-02-2025,Pooja & Spiritual Items,SWASTIK CAMPHOR 10GM,12,20,20,0,1
25-02-2025,Pooja & Spiritual Items,bilwa patra,12,60,60,0,1
25-02-2025,Baking & Cooking Aids,WEIKFIELD CUSTARD POWDER,0,43,43,0,1
25-02-2025,"Grains, Flours & Dals",RAGI FLOUR 1KG,4,80,70,10,1
25-02-2025,"Grains, Flours & Dals",Wheat Flour 1 kg,4,140,120,20,2
25-02-2025,"Dry Fruits, Nuts & Seeds",PUTNALU 500GMS,2,90,76,14,1
25-02-2025,Spices & Seasonings,BLACK JEERA 50 GM,15,45,30,15,1
25-02-2025,Spices & Seasonings,DRY MIECHI 200GM,15,80,60,20,1
25-02-2025,"Dry Fruits, Nuts & Seeds",PULMAKHANA 100 GM,2,180,170,10,1
25-02-2025,Oils & Ghee,Sesame oil 500ml,9,295,280,15,1
25-02-2025,Snacks & Ready-to-Eat,ANNAPURNA APPALAM,14,70,70,0,2
25-02-2025,Spices & Seasonings,NUVVULU 250GM,15,100,85,15,1
25-02-2025,Oils & Ghee,Coconut oil 1 L,9,440,400,40,1
25-02-2025,Snacks & Ready-to-Eat,VD MANGO JELLY 250GRMS,14,80,80,0,1
25-02-2025,Sweeteners,GS Organic Jaggery Powder 600GM,16,99,99,0,1
25-02-2025,Sweeteners,YB JAGGERY POWDER 500GMS,16,150,150,0,2
25-02-2025,Snacks & Ready-to-Eat,VD MINAPA SUNNUNDALU 12P,14,180,180,0,1
25-02-2025,"Grains, Flours & Dals",Green gram 1 kg,4,150,130,20,1
25-02-2025,"Grains, Flours & Dals",Idly Rava L 1KG,4,120,100,20,2
25-02-2025,"Grains, Flours & Dals",split black gram 1 kg,4,180,170,10,1
25-02-2025,"Grains, Flours & Dals",Red Bobarlu 1 kg,4,190,170,20,1
25-02-2025,"Grains, Flours & Dals",SRILATHA RICE RAVVA 500GM,4,35,35,0,1
25-02-2025,"Dry Fruits, Nuts & Seeds",Putnalu 250GM,2,45,38,7,1
25-02-2025,"Grains, Flours & Dals",URAD DALL,4,190,170,20,2
25-02-2025,Personal Care & Cosmetics,ROUND LOOFAH,10,55,55,0,1
25-02-2025,Sweeteners,GS JAGGERY NUGGETS 500GM,16,120,120,0,1
25-02-2025,Pooja & Spiritual Items,GD Aiswarya Deepam 700ML,12,195,195,0,1
25-02-2025,"Grains, Flours & Dals",Idly Rava L 1KG,4,60,50,10,1
25-02-2025,Snacks & Ready-to-Eat,BD LITTLE MILLET NOODLES 200G,14,75,75,0,1
25-02-2025,"Grains, Flours & Dals",CHANA DAL 500GM,4,70,60,10,1
25-02-2025,"Dry Fruits, Nuts & Seeds",Putnalu 250GM,2,45,38,7,1
25-02-2025,"Dry Fruits, Nuts & Seeds",SATHVI CHIA SEEDS 100GM,2,100,80,20,1
25-02-2025,Milk & Dairy,SANGAM CURD 450GM,7,38,38,0,1
25-02-2025,Spices & Seasonings,ROYAL SAFFRON,15,125,125,0,1
25-02-2025,Snacks & Ready-to-Eat,BB VERMICELLI 250GM,14,30,30,0,1
25-02-2025,"Health, Wellness & Ayurvedic Products",RB Max Protein Salt & Caramel Bar 50g,5,240,240,0,3
25-02-2025,Snacks & Ready-to-Eat,RITEBITE MELTING CHOCOLATE,14,50,50,0,1
25-02-2025,Baking & Cooking Aids,MTR GULAB JAMUN MIX 190GM,0,80,80,0,1
25-02-2025,Snacks & Ready-to-Eat,GB SALT COOKIES,14,60,55,5,1
25-02-2025,Sweeteners,MISHRI 250 GM,16,35,30,5,1
25-02-2025,Snacks & Ready-to-Eat,VD PALLI LADDU,14,80,80,0,1
25-02-2025,Snacks & Ready-to-Eat,GB SALT COOKIES,14,60,55,5,1
25-02-2025,Snacks & Ready-to-Eat,GREEN FRIED BATANA,14,20,20,0,1
25-02-2025,Snacks & Ready-to-Eat,VD BELLAM GAVVALU 200GM,14,180,180,0,3
25-02-2025,Snacks & Ready-to-Eat,ZEEDI,14,70,70,0,1
25-02-2025,Oils & Ghee,Mustard oil 1 L,9,440,400,40,1
25-02-2025,Beverages,REFRESH SHARBATH NORMAL,1,199,190,9,1
25-02-2025,Pooja & Spiritual Items,SWATHI POOJA VATHULU,12,50,50,0,1
25-02-2025,Snacks & Ready-to-Eat,COPRA LADDU 200GM,14,200,160,40,2
25-02-2025,"Grains, Flours & Dals",gangam,4,150,150,0,1
25-02-2025,Baking & Cooking Aids,GONDH 50GRMS,0,50,40,10,1
25-02-2025,"Health, Wellness & Ayurvedic Products",MH Baby Food 400GM,5,200,200,0,1
25-02-2025,Oils & Ghee,Groundnut oil 1 L,9,360,330,30,1
25-02-2025,"Grains, Flours & Dals",FLOUR CHARGE,4,36,36,0,3
25-02-2025,Snacks & Ready-to-Eat,Pani Poori Chips 250GM,14,50,40,10,1
25-02-2025,"Grains, Flours & Dals",White jowar.F 1 kg,4,100,80,20,1
25-02-2025,"Grains, Flours & Dals",RAGI FLOUR 500GRMS,4,40,35,5,1
25-02-2025,"Grains, Flours & Dals",Multigrain 1 kg,4,100,85,15,1
25-02-2025,Pooja & Spiritual Items,GD Bhagavatha Mallika 75GM,12,60,60,0,1
25-02-2025,"Grains, Flours & Dals",MAAGAANI SP RICE 20 KGS,4,2300,"1,960.00",340,1
25-02-2025,Spices & Seasonings,DRY MIECHI 200GM,15,80,60,20,1
25-02-2025,Spices & Seasonings,RED COPRA 250GMS,15,85,74,11,1
25-02-2025,"Dry Fruits, Nuts & Seeds",PUTNALU 500GMS,2,90,76,14,1
25-02-2025,Misc,JOKER,8,2,2,0,1
25-02-2025,Spices & Seasonings,Coriander seeds 200 gms,15,48,40,8,1
25-02-2025,Snacks & Ready-to-Eat,VD DAHI MIRCHI(SALTED) 100GM,14,45,45,0,1
25-02-2025,Snacks & Ready-to-Eat,VD PALLI LADDU,14,80,80,0,1
25-02-2025,Spices & Seasonings,Elaichi 25GM,15,290,240,50,2
25-02-2025,Beverages,REFRESH SHARBATH SUGAR FREE,1,299,285,14,1
25-02-2025,Pooja & Spiritual Items,GB Bharatha Woods 75GM,12,60,60,0,1
25-02-2025,Pooja & Spiritual Items,GD Aiswarya Deepam 700ML,12,195,195,0,1
25-02-2025,"Grains, Flours & Dals",SINGLE POLISH 1KG,4,650,650,0,10
25-02-2025,Oils & Ghee,Groundnut oil 1 L,9,360,330,30,1
25-02-2025,Snacks & Ready-to-Eat,NGT CHATPATTA CHANA 90GM,14,25,25,0,1
25-02-2025,Snacks & Ready-to-Eat,VD Pappu Chekkalu 190gm,14,60,60,0,1
25-02-2025,Spices & Seasonings,DRY MIECHI 200GM,15,80,60,20,1
25-02-2025,"Dry Fruits, Nuts & Seeds",PULMAKHANA 100 GM,2,180,170,10,1
25-02-2025,"Dry Fruits, Nuts & Seeds",PULMAKHANA 100 GM,2,180,170,10,1
25-02-2025,"Dry Fruits, Nuts & Seeds",PUTNALU 500GMS,2,180,152,28,2
25-02-2025,"Dry Fruits, Nuts & Seeds",Groundnuts 1 kg,2,380,340,40,2
25-02-2025,"Grains, Flours & Dals",SL Idly Rava 1KG,4,130,110,20,2
25-02-2025,Snacks & Ready-to-Eat,VD NUVVULU LADDU,14,80,80,0,1
25-02-2025,"Grains, Flours & Dals",DH URAD GOTA 1KG,4,430,380,50,2
25-02-2025,"Grains, Flours & Dals",Wheat Flour 1 kg,4,140,120,20,2
25-02-2025,Milk & Dairy,BROWN EGGS 1P,7,84,72,12,6
25-02-2025,Oils & Ghee,Safflower oil 1 L,9,880,800,80,2
25-02-2025,Oils & Ghee,Sesame oil 1 L,9,590,560,30,1
25-02-2025,"Grains, Flours & Dals",RAGULU 1 KG,4,280,240,40,4
25-02-2025,Spices & Seasonings,SATHVI TURMERIC POWDER 500GM,15,180,130,50,1
25-02-2025,Snacks & Ready-to-Eat,Corn Chips 250GM,14,80,70,10,2
25-02-2025,Spices & Seasonings,GS Pink Rock Salt 1KG,15,240,240,0,2
25-02-2025,"Grains, Flours & Dals",DH URAD GOTA 1KG,4,215,190,25,1
25-02-2025,"Health, Wellness & Ayurvedic Products",RB Max Protein Chinese Manchurian,5,90,90,0,2
25-02-2025,"Grains, Flours & Dals",Green gram 500 gms,4,150,140,10,2
25-02-2025,Spices & Seasonings,Turmeric powder 250 gms,15,100,75,25,1
25-02-2025,"Health, Wellness & Ayurvedic Products",RB Max Protein PERI PERI 60gm,5,45,45,0,1
25-02-2025,"Dry Fruits, Nuts & Seeds",Groundnuts 1 kg,2,380,340,40,2
25-02-2025,Snacks & Ready-to-Eat,MB FOXTAIL MILLET NOODLES 180GM,14,95,95,0,1
25-02-2025,"Grains, Flours & Dals",SL Idly Rava 1KG,4,65,55,10,1
25-02-2025,Pickles & Cooking Pastes,SD TAMARIND PICKLE,11,110,110,0,1
25-02-2025,Oils & Ghee,BUFFALLO GHEE 500ML,9,410,370,40,1
25-02-2025,Oils & Ghee,Black Sesame oil 500 ml,9,660,570,90,3
25-02-2025,"Grains, Flours & Dals",RAGI FLOUR 1KG,4,80,70,10,1
25-02-2025,"Grains, Flours & Dals",SABDANA,4,40,35,5,1
25-02-2025,Snacks & Ready-to-Eat,VD PALLI CHIKKI,14,80,80,0,1
25-02-2025,"Grains, Flours & Dals",Em Multimillet upma 500g,4,129,129,0,1
25-02-2025,"Grains, Flours & Dals",Multigrain 1 kg,4,100,85,15,1
25-02-2025,Snacks & Ready-to-Eat,NGT CHATPATTA CHANA 90GM,14,25,25,0,1
25-02-2025,"Grains, Flours & Dals",SINGLE POLISH 1KG,4,650,650,0,10
25-02-2025,"Grains, Flours & Dals",RICE FLOUR 500 GM,4,35,28,7,1
25-02-2025,Sweeteners,YB Brown Sugar 1KG,16,140,140,0,1
25-02-2025,"Grains, Flours & Dals",RAGI FLOUR 1KG,4,80,70,10,1
25-02-2025,Oils & Ghee,Groundnut oil 1 L,9,720,660,60,2
25-02-2025,Snacks & Ready-to-Eat,BB VERMICELLY 500GM,14,53,53,0,1
25-02-2025,Snacks & Ready-to-Eat,GREEN FRIED batana,14,20,20,0,1
25-02-2025,Snacks & Ready-to-Eat,VD MINAPA VADIYAM,14,65,65,0,1
25-02-2025,Snacks & Ready-to-Eat,VD Minapa papad 200gm,14,60,60,0,1
25-02-2025,Snacks & Ready-to-Eat,VD PALLI LADDU,14,160,160,0,2
25-02-2025,Spices & Seasonings,ROYAL SAFFRON 400GRMS,15,65,65,0,1
25-02-2025,"Grains, Flours & Dals",Wheat Flour 1 kg,4,70,60,10,1
25-02-2025,Oils & Ghee,Safflower oil 1 L,9,440,400,40,1
25-02-2025,"Grains, Flours & Dals",HS Multimillet idly R 500 gms,4,65,65,0,1
25-02-2025,"Grains, Flours & Dals",RICE FLOUR 500 GM,4,35,28,7,1
25-02-2025,Beverages,BRU GREEN LABEL 1.2G,1,24,24,0,12
25-02-2025,"Grains, Flours & Dals",Multigrain 1 kg,4,100,85,15,1
25-02-2025,Snacks & Ready-to-Eat,NGT CHATPATTA CHANA 90GM,14,25,25,0,1
25-02-2025,"Dry Fruits, Nuts & Seeds",SABJA SEEDS 100GM,2,80,70,10,1
25-02-2025,"Grains, Flours & Dals",SINGLE POLISH 1KG,4,325,325,0,5
25-02-2025,"Grains, Flours & Dals",SINGLE POLISH 1KG,4,195,195,0,3
25-02-2025,Oils & Ghee,Sesame oil 500ml,9,295,280,15,1
25-02-2025,Oils & Ghee,Groundnut oil 1 L,9,720,660,60,2
25-02-2025,Personal Care & Cosmetics,Soapnut 500GM,10,120,90,30,1
25-02-2025,Beverages,BRU GREEN LABEL 1.2G,1,20,20,0,10
25-02-2025,Snacks & Ready-to-Eat,SATHVI REGIVADA 200GM,14,80,60,20,1
25-02-2025,Snacks & Ready-to-Eat,NGT CHATPATTA CHANA 90GM,14,50,50,0,2
25-02-2025,Snacks & Ready-to-Eat,VD KOBARI LADDU,14,80,80,0,1
25-02-2025,"Grains, Flours & Dals",Quinova 1 kg,4,220,195,25,1
25-02-2025,"Grains, Flours & Dals",PESARA PAPPU 500GMS,4,85,75,10,1
25-02-2025,Snacks & Ready-to-Eat,VD RICE MURUKU 150GM,14,50,50,0,1
25-02-2025,Snacks & Ready-to-Eat,VD RICE SAGO PAPAD 150GM,14,55,55,0,1
25-02-2025,"Grains, Flours & Dals",SINGLE POLISH 1KG,4,65,65,0,1
25-02-2025,"Grains, Flours & Dals",DISANO OATS 1KG,4,285,142.5,142.5,1
25-02-2025,Oils & Ghee,Groundnut oil 1 L,9,360,330,30,1
25-02-2025,"Grains, Flours & Dals",RICE FLOUR 1KG,4,210,165,45,3
25-02-2025,Oils & Ghee,Safflower oil 1 L,9,880,800,80,2
25-02-2025,Oils & Ghee,Sesame oil 1 L,9,590,560,30,1
25-02-2025,"Grains, Flours & Dals",Bajra Flour 500 gms,4,35,30,5,1
25-02-2025,Spices & Seasonings,Chilli powder 500 gms,15,290,210,80,1
25-02-2025,Oils & Ghee,Groundnut oil 1 L,9,1080,990,90,3
25-02-2025,"Dry Fruits, Nuts & Seeds",PUMPKIN SEEDS 250GM,2,200,160,40,1
25-02-2025,"Dry Fruits, Nuts & Seeds",YELLOW KISHMISH 250GM,2,130,110,20,1
25-02-2025,"Grains, Flours & Dals",FLOUR CHARGE,4,25.2,25.2,0,2.1
25-02-2025,Snacks & Ready-to-Eat,GREEN FRIED batana,14,20,20,0,1
25-02-2025,"Grains, Flours & Dals",MAIDA 1KG,4,60,60,0,1
25-02-2025,Snacks & Ready-to-Eat,NGT CHATPATTA CHANA 90GM,14,25,25,0,1
25-02-2025,Household & Cleaning,GOOD KNIGHT GOLD FLASH,6,85,85,0,1
25-02-2025,Sweeteners,GS Organic Jaggery Powder 600GM,16,396,396,0,4
25-02-2025,Oils & Ghee,GANTASALA A2 COW GHEE 500ML,9,550,550,0,1
25-02-2025,Spices & Seasonings,Elaichi 25GM,15,145,120,25,1
25-02-2025,Oils & Ghee,BUFFALLO GHEE 500ML,9,410,370,40,1
25-02-2025,Oils & Ghee,Groundnut oil 1 L,9,720,660,60,2
25-02-2025,"Grains, Flours & Dals",Wheat Flour 2 kgs,4,140,120,20,1
25-02-2025,Oils & Ghee,Sesame oil 1 L,9,590,560,30,1
25-02-2025,"Grains, Flours & Dals",turdal 1kg,4,220,195,25,1
25-02-2025,"Grains, Flours & Dals",Black gram 500 gms,4,75,70,5,1
25-02-2025,"Grains, Flours & Dals",VYS.SP.RICE 5 KGS,4,350,325,25,1
25-02-2025,"Dry Fruits, Nuts & Seeds",YB GRANMA NUTS,2,90,90,0,1
25-02-2025,Snacks & Ready-to-Eat,ZEEDI,14,70,70,0,1
25-02-2025,"Grains, Flours & Dals",Brown RICE 1KG,4,210,195,15,3
25-02-2025,"Dry Fruits, Nuts & Seeds",MAHA BEERA SEEDS 100GM,2,60,60,0,1
25-02-2025,Oils & Ghee,Cow ghee 500 ml,9,860,780,80,2
25-02-2025,"Grains, Flours & Dals",Wheat Rava M 1KG,4,65,55,10,1
25-02-2025,"Dry Fruits, Nuts & Seeds",ALBUKARA 250GM,2,145,120,25,1
25-02-2025,"Dry Fruits, Nuts & Seeds",PULMAKHANA 100 GM,2,360,340,20,2
25-02-2025,Sweeteners,Natural Honey 500 gms,16,280,240,40,1
25-02-2025,Snacks & Ready-to-Eat,ELITE MILK RUSK 200GM,14,35,35,0,1
25-02-2025,"Dry Fruits, Nuts & Seeds",SUNFLOWER SEEDS 250GRM,2,150,130,20,1
25-02-2025,Milk & Dairy,SANGAM FULL CREAM MILK 500ML,7,76,76,0,2
25-02-2025,"Dry Fruits, Nuts & Seeds",PUMPKIN SEEDS 250GM,2,200,160,40,1
25-02-2025,Snacks & Ready-to-Eat,VD Pappu Chekkalu 190gm,14,60,60,0,1
25-02-2025,"Health, Wellness & Ayurvedic Products",RB Max Protein Chinese Manchurian,5,45,45,0,1
25-02-2025,Snacks & Ready-to-Eat,VD RIBBON PAKODI 175GM,14,60,60,0,1
25-02-2025,"Health, Wellness & Ayurvedic Products",RB Max Protein Cheese&amp;,5,45,45,0,1
24-02-2025,"Grains, Flours & Dals",JOWAR UPMA RAVA,4,0,0,0,1
24-02-2025,"Grains, Flours & Dals",SA Sprouted Ragi Flour 500GM,4,69,69,0,1
24-02-2025,Snacks & Ready-to-Eat,SF CEREAL WHEAT APPLE &amp;,14,299,299,0,1
24-02-2025,Sweeteners,DATE POWDER,16,599,569,30,1
24-02-2025,Snacks & Ready-to-Eat,FOXTAIL BIS,14,135,135,0,1
24-02-2025,Snacks & Ready-to-Eat,RINGS 200GM,14,30,30,0,1
24-02-2025,Pooja & Spiritual Items,GD Aiswarya Deepam 700ML,12,195,195,0,1
24-02-2025,"Grains, Flours & Dals",RAGULU 1 KG,4,17.5,15,2.5,0.25
24-02-2025,Personal Care & Cosmetics,UVIS CHARCOAL SOAP 100GM,10,85,85,0,1
24-02-2025,Oils & Ghee,Groundnut oil 1 L,9,360,330,30,1
24-02-2025,"Grains, Flours & Dals",HS JOWAR FLAKES 250GM 1+1,4,119,119,0,1
24-02-2025,"Grains, Flours & Dals",Wheat Rava M 1KG,4,65,55,10,1
24-02-2025,Personal Care & Cosmetics,GOW DURBAR NAVA 100GM SOAP,10,40,40,0,1
24-02-2025,Snacks & Ready-to-Eat,urban murmura,14,60,55,5,1
24-02-2025,"Grains, Flours & Dals",RAJMA 250GM,4,110,90,20,2
24-02-2025,Pooja & Spiritual Items,SST PURE COTTON GUBBA WICKS,12,20,20,0,1
24-02-2025,Pooja & Spiritual Items,SPECIAL DEEPAM SMALL,12,100,100,0,10
24-02-2025,Spices & Seasonings,GS Pink Rock Salt 1KG,15,120,120,0,1
24-02-2025,Spices & Seasonings,Chilli powder 500 gms,15,290,210,80,1
24-02-2025,Spices & Seasonings,GANGOTRI JAJU POWDER 40GM,15,14,14,0,2
24-02-2025,"Dry Fruits, Nuts & Seeds",MAHA BEERA SEEDS 100GM,2,60,60,0,1
24-02-2025,"Grains, Flours & Dals",Red Chana 250GM,4,35,30,5,1
24-02-2025,"Grains, Flours & Dals",Black uluvalu 250 gms,4,45,35,10,1
24-02-2025,"Grains, Flours & Dals",POORI ATTA 500GM,4,70,60,10,2
24-02-2025,Snacks & Ready-to-Eat,BB VERMICELLY 500GM,14,53,53,0,1
24-02-2025,Snacks & Ready-to-Eat,Popcorn Seeds 250GM,14,45,40,5,1
24-02-2025,"Dry Fruits, Nuts & Seeds",SD Mango cubes 100gm,2,45,45,0,1
24-02-2025,Sweeteners,YB JAGGERY POWDER 1KG,16,280,280,0,2
24-02-2025,Pooja & Spiritual Items,BALAJI KEWDA STICKS 220GM,12,150,150,0,1
24-02-2025,Pooja & Spiritual Items,GD Bhagavatha Mallika 75GM,12,120,120,0,2
24-02-2025,Pooja & Spiritual Items,GD Aiswarya Deepam 700ML,12,585,585,0,3
24-02-2025,"Grains, Flours & Dals",RAGI FLOUR 1KG,4,160,140,20,2
24-02-2025,Spices & Seasonings,Lavangam 50GM,15,60,50,10,1
24-02-2025,Pooja & Spiritual Items,GD Yagnadhara 31PC,12,140,140,0,2
24-02-2025,Spices & Seasonings,Elaichi 25GM,15,290,240,50,2
24-02-2025,Snacks & Ready-to-Eat,MB MULTIMILLET NOODLES 180GM,14,95,95,0,1
24-02-2025,"Grains, Flours & Dals",RAGI FLOUR 500GRMS,4,40,35,5,1
24-02-2025,"Grains, Flours & Dals",BOMBAY RAVA,4,70,55,15,1
24-02-2025,Pooja & Spiritual Items,GD Bhagavatha Mallika 75GM,12,60,60,0,1
24-02-2025,Snacks & Ready-to-Eat,SS IDLY BATTER 1KG,14,60,60,0,1
24-02-2025,"Health, Wellness & Ayurvedic Products",RB Max Protein Spanish Tomato,5,45,45,0,1
24-02-2025,"Dry Fruits, Nuts & Seeds",Groundnuts 1 kg,2,190,170,20,1
24-02-2025,"Grains, Flours & Dals",THICK POHA 1KG,4,80,70,10,1
24-02-2025,"Health, Wellness & Ayurvedic Products",RB Max Protein Chinese Manchurian,5,45,45,0,1
24-02-2025,Milk & Dairy,BROWN EGGS 1P,7,84,72,12,6
24-02-2025,Oils & Ghee,Groundnut oil 1 L,9,360,330,30,1
24-02-2025,Snacks & Ready-to-Eat,MB SORGHUM NOODLES 180GM,14,190,190,0,2
24-02-2025,"Health, Wellness & Ayurvedic Products",RB Max Protein Cheese&amp;,5,45,45,0,1
24-02-2025,"Grains, Flours & Dals",RAGULU 1 KG,4,70,60,10,1
24-02-2025,Spices & Seasonings,THREE MANGO RAI 200G,15,42,42,0,1
24-02-2025,"Health, Wellness & Ayurvedic Products",MD Triphala Chorrnam 100GM,5,80,80,0,1
24-02-2025,"Grains, Flours & Dals",MAAGAANI LOW GI SP 1KG,4,149,125,24,1
24-02-2025,Personal Care & Cosmetics,MD Bath Powder 100GM,10,40,40,0,1
24-02-2025,"Grains, Flours & Dals",MAAGAANI W RICE 5KGS,4,899,535,364,1
24-02-2025,"Grains, Flours & Dals",Bajra Flour 500 gms,4,35,30,5,1
24-02-2025,"Grains, Flours & Dals",Yellow jowar.F 500 gms,4,55,50,5,1
24-02-2025,"Dry Fruits, Nuts & Seeds",MAHA BEERA SEEDS 100GM,2,60,60,0,1
24-02-2025,Snacks & Ready-to-Eat,VD PAPPU CHEGODI 200GM,14,60,60,0,1
24-02-2025,Oils & Ghee,Safflower oil 1 L,9,440,400,40,1
24-02-2025,"Dry Fruits, Nuts & Seeds",Groundnuts 1 kg,2,190,170,20,1
24-02-2025,"Grains, Flours & Dals",DESI CHANA,4,25,25,0,1
24-02-2025,Snacks & Ready-to-Eat,PEANUT CHILLI,14,5,5,0,1
24-02-2025,Personal Care & Cosmetics,PARACHUTE 45ML,10,20,20,0,1
24-02-2025,Snacks & Ready-to-Eat,BATANA NGT 70GMS,14,20,20,0,1
24-02-2025,"Grains, Flours & Dals",Wheat Rava S 500GM,4,33,30,3,1
24-02-2025,Sweeteners,Natural Honey 500 gms,16,280,240,40,1
24-02-2025,Oils & Ghee,Castor oil 200 ml,9,100,80,20,1
24-02-2025,"Grains, Flours & Dals",CHANA DAL 1KG,4,35,30,5,0.25
24-02-2025,"Grains, Flours & Dals",SINGLE POLISH 1KG,4,325,325,0,5
24-02-2025,Oils & Ghee,Groundnut oil 1 L,9,360,330,30,1
24-02-2025,Milk & Dairy,BROWN EGGS TRAY 30P,7,360,330,30,1
24-02-2025,"Health, Wellness & Ayurvedic Products",RB Max Protein Chinese Manchurian,5,50,50,0,1
24-02-2025,"Grains, Flours & Dals",Multigrain 1 kg,4,100,85,15,1
24-02-2025,"Health, Wellness & Ayurvedic Products",MD Mandara Leaf Powder 50GM,5,100,100,0,1
24-02-2025,"Grains, Flours & Dals",RAGI FLOUR 500GRMS,4,40,35,5,1
24-02-2025,Spices & Seasonings,Turmeric powder 250 gms,15,100,75,25,1
24-02-2025,"Grains, Flours & Dals",DESI CHANA,4,25,25,0,1
24-02-2025,"Grains, Flours & Dals",Idly Rava L 1KG,4,120,100,20,2
24-02-2025,"Health, Wellness & Ayurvedic Products",MXP CREAM ONION,5,45,45,0,1
24-02-2025,"Dry Fruits, Nuts & Seeds",WALLNUTS 250GM,2,380,360,20,1
24-02-2025,Personal Care & Cosmetics,DWI ALOEVERA 100GM,10,90,90,0,1
24-02-2025,"Health, Wellness & Ayurvedic Products",AMLA PACHAK,5,100,100,0,1
24-02-2025,Snacks & Ready-to-Eat,Popcorn Seeds 250GM,14,45,40,5,1
24-02-2025,Snacks & Ready-to-Eat,GB SALT COOKIES,14,60,55,5,1
24-02-2025,Snacks & Ready-to-Eat,VD PALLI LADDU,14,160,160,0,2
24-02-2025,Snacks & Ready-to-Eat,VD MULTI CHAKKA,14,220,220,0,2
24-02-2025,Snacks & Ready-to-Eat,SD Atreyapuram DRY Fruit ghee,14,300,300,0,2
24-02-2025,Pooja & Spiritual Items,GD Sree Chandan 50GM,12,50,50,0,1
24-02-2025,"Dry Fruits, Nuts & Seeds",PUMPKIN SEEDS 250GM,2,200,160,40,1
24-02-2025,Pickles & Cooking Pastes,SD RED CHILLI PICKLE,11,110,110,0,1
24-02-2025,Snacks & Ready-to-Eat,VD CORNFLAKES MIXTURE 175GM,14,60,60,0,1
24-02-2025,Personal Care & Cosmetics,MYSORE SANDAL BABY SOAP,10,45,45,0,1
24-02-2025,Snacks & Ready-to-Eat,DISANO MACARONI 850GM,14,105,105,0,1
24-02-2025,Snacks & Ready-to-Eat,VD PAPPU CHEGODI 200GM,14,60,60,0,1
24-02-2025,"Grains, Flours & Dals",Wheat Flour 3 kgs,4,210,180,30,1
24-02-2025,Oils & Ghee,Groundnut oil 5 L,9,1800,"1,600.00",200,1
24-02-2025,Household & Cleaning,LIZOL CITRUS 625ML,6,45,45,0,1
24-02-2025,General Household & Kitchenware,NIPPO,3,18,18,0,1
24-02-2025,"Grains, Flours & Dals",Green gram 500 gms,4,75,70,5,1
24-02-2025,"Grains, Flours & Dals",Wheat Flour 1 kg,4,70,60,10,1
24-02-2025,"Grains, Flours & Dals",Brown RICE 1KG,4,140,130,10,2
24-02-2025,"Grains, Flours & Dals",SL Suji Rava 500GM,4,32,32,0,1
24-02-2025,Pooja & Spiritual Items,GD JASMINE 75GM,12,60,60,0,1
24-02-2025,"Grains, Flours & Dals",SL Idly Rava 1KG,4,65,55,10,1
24-02-2025,Pooja & Spiritual Items,GD Ramayana Sandal 75GM,12,60,60,0,1
24-02-2025,"Grains, Flours & Dals",SRILATHA RICE RAVVA 500GM,4,35,35,0,1
24-02-2025,"Grains, Flours & Dals",Wheat Flour 1 kg,4,280,240,40,4
24-02-2025,Spices & Seasonings,Avalu small 250 gms,15,60,40,20,1
24-02-2025,Spices & Seasonings,Jeera 100GM,15,50,45,5,1
24-02-2025,Spices & Seasonings,PRO ORG CORIANDER WHOLE 100G,15,70,70,0,1
24-02-2025,"Grains, Flours & Dals",BOMBAY RAVA,4,70,55,15,1
24-02-2025,Spices & Seasonings,LG 50GM,15,92,92,0,1
24-02-2025,Household & Cleaning,suraf excel,6,152,152,0,2
24-02-2025,"Grains, Flours & Dals",Wheat Flour 1 kg,4,70,60,10,1
24-02-2025,"Dry Fruits, Nuts & Seeds",Putnalu 250GM,2,45,38,7,1
24-02-2025,Misc,TH READ,8,20,20,0,1
24-02-2025,"Grains, Flours & Dals",DESI CHANA,4,75,75,0,3
24-02-2025,Spices & Seasonings,SATHVI KARAKAYA 25 GM,15,50,30,20,1
24-02-2025,"Grains, Flours & Dals",CHANA DAL 500GM,4,70,60,10,1
24-02-2025,Spices & Seasonings,DRY MIECHI 200GM,15,80,60,20,1
24-02-2025,Pooja & Spiritual Items,bilwa patra,12,60,60,0,1
24-02-2025,"Dry Fruits, Nuts & Seeds",Groundnuts 1 kg,2,190,170,20,1
24-02-2025,Sweeteners,SUGAR 1KG,16,120,100,20,2
24-02-2025,Spices & Seasonings,DURGA SALT CRYSTAL 1KG,15,25,25,0,1
24-02-2025,Pooja & Spiritual Items,GB Bharatha Woods 75GM,12,60,60,0,1
24-02-2025,Pooja & Spiritual Items,GD TULASI 75GM,12,60,60,0,1
24-02-2025,Snacks & Ready-to-Eat,VD PALLI CHIKKI,14,80,80,0,1
24-02-2025,Beverages,BRU GREEN LABEL 1.2G,1,48,48,0,24
24-02-2025,"Grains, Flours & Dals",Urad dall 1 Kg,4,555,510,45,3
24-02-2025,"Grains, Flours & Dals",split urad dall 500 gms,4,90,80,10,1
24-02-2025,"Grains, Flours & Dals",Idly Rava L 1KG,4,120,100,20,2
24-02-2025,Personal Care & Cosmetics,COLGATE ACTIVE SALT,10,20,20,0,1
24-02-2025,"Grains, Flours & Dals",turdal 1kg,4,440,390,50,2
24-02-2025,Snacks & Ready-to-Eat,BATANA NGT 70GMS,14,80,80,0,4
24-02-2025,Household & Cleaning,PITAMBARI,6,28,28,0,1
24-02-2025,"Grains, Flours & Dals",PRO ORG SOOJI RAVA 500G,4,74,74,0,1
24-02-2025,"Grains, Flours & Dals",Wheat Flour 1 kg,4,70,60,10,1
24-02-2025,Snacks & Ready-to-Eat,VD NUVULU PAPAD 200GM,14,100,100,0,1
24-02-2025,Spices & Seasonings,Turmeric powder 250 gms,15,100,75,25,1
24-02-2025,"Grains, Flours & Dals",BARLEY SEEDS 1KG,4,80,70,10,0.5
24-02-2025,Personal Care & Cosmetics,SVE TURMERIC SOAP 100GM,10,90,90,0,1
24-02-2025,"Grains, Flours & Dals",RAGI FLOUR 1KG,4,80,70,10,1
24-02-2025,"Grains, Flours & Dals",Multigrain 1 kg,4,100,85,15,1
24-02-2025,Spices & Seasonings,Chilli powder 500 gms,15,290,210,80,1
24-02-2025,"Grains, Flours & Dals",Wheat Flour 1 kg,4,70,60,10,1
24-02-2025,"Grains, Flours & Dals",Em Multimillet idli r 500g,4,129,129,0,1
24-02-2025,Oils & Ghee,Groundnut oil 1 L,9,360,330,30,1
24-02-2025,"Grains, Flours & Dals",Bajra Flour 1 kg,4,70,60,10,1
24-02-2025,Snacks & Ready-to-Eat,BD RAGI NOODLES,14,75,75,0,1
24-02-2025,Oils & Ghee,Coconut oil 1 L,9,440,400,40,1
24-02-2025,"Grains, Flours & Dals",RAJMA 500GM,4,90,90,0,1
24-02-2025,"Grains, Flours & Dals",MELMEKER 250GMS,4,60,45,15,1
24-02-2025,Snacks & Ready-to-Eat,PEANUT CHILLI,14,30,30,0,6
24-02-2025,Snacks & Ready-to-Eat,TILLI CHIKKI,14,10,10,0,2
24-02-2025,"Dry Fruits, Nuts & Seeds",PUTNALU 500GMS,2,90,76,14,1
24-02-2025,"Dry Fruits, Nuts & Seeds",Groundnuts 1 kg,2,190,170,20,1
24-02-2025,"Grains, Flours & Dals",Chana Flour 500 gms,4,70,65,5,1
24-02-2025,Oils & Ghee,Groundnut oil 1 L,9,360,330,30,1
24-02-2025,"Grains, Flours & Dals",White jowar.F 1 kg,4,100,80,20,1
24-02-2025,Snacks & Ready-to-Eat,RITEBITE MELTING CHOCOLATE,14,100,100,0,2
24-02-2025,"Grains, Flours & Dals",SA WHITE JOWAR RAVA 500GM,4,69,69,0,1
24-02-2025,Spices & Seasonings,RED COPRA 250GMS,15,85,74,11,1
24-02-2025,"Grains, Flours & Dals",Red uluvalu 500 gms,4,90,75,15,1
24-02-2025,Spices & Seasonings,Chilli powder 500 gms,15,290,210,80,1
24-02-2025,"Grains, Flours & Dals",Wheat Flour 1 kg,4,70,60,10,1
24-02-2025,Spices & Seasonings,Tamarind 500GM,15,130,130,0,1
24-02-2025,"Grains, Flours & Dals",White jowar.F 1 kg,4,100,80,20,1
24-02-2025,"Grains, Flours & Dals",Urad dall 1 Kg,4,185,170,15,1
24-02-2025,"Dry Fruits, Nuts & Seeds",Groundnuts 500 gms,2,95,85,10,1
24-02-2025,"Grains, Flours & Dals",RAGI FLOUR 1KG,4,80,70,10,1
24-02-2025,"Grains, Flours & Dals",RICE FLOUR 500 GM,4,35,28,7,1
24-02-2025,General Household & Kitchenware,WDN HDI IND KADAI 8,3,180,180,0,1
24-02-2025,"Grains, Flours & Dals",White jowar.F 1 kg,4,100,80,20,1
24-02-2025,Snacks & Ready-to-Eat,PEANUT CHILLI,14,10,10,0,2
24-02-2025,Milk & Dairy,SANGAM TONED MILK 500ML,7,30,30,0,1
24-02-2025,"Dry Fruits, Nuts & Seeds",PULMAKHANA 100 GM,2,180,170,10,1
24-02-2025,Pooja & Spiritual Items,GD Sambrani Cup Dhoop 10 PC,12,96,96,0,1
24-02-2025,"Health, Wellness & Ayurvedic Products",MORINGA LEAF POWDER M,5,80,80,0,1
24-02-2025,"Grains, Flours & Dals",SINGLE POLISH 1KG,4,325,325,0,5
24-02-2025,Personal Care & Cosmetics,GAYATHRI KUMKUDUKAYA,10,300,300,0,2
24-02-2025,"Grains, Flours & Dals",MAAGAANI LOW GI SP L 1KG,4,360,315,45,3
24-02-2025,Spices & Seasonings,Tamarind 500GM,15,130,130,0,1
24-02-2025,Snacks & Ready-to-Eat,VD PALLI LADDU,14,80,80,0,1
24-02-2025,Spices & Seasonings,Chilli powder 500 gms,15,290,210,80,1
24-02-2025,Pooja & Spiritual Items,GOMATHA AGARBATHI,12,75,75,0,1
24-02-2025,Spices & Seasonings,EVEREST PANI PURI MASALA 50GM,15,40,40,0,1
24-02-2025,Snacks & Ready-to-Eat,VD PANIPURI 100GM,14,30,30,0,1
24-02-2025,"Grains, Flours & Dals",Wheat Rava M 500GM,4,33,30,3,1
24-02-2025,Spices & Seasonings,GARAM MASALA 200GM,15,120,95,25,1
24-02-2025,Household & Cleaning,VIM EXTRA 110GM,6,30,30,0,2
24-02-2025,Spices & Seasonings,FLAXSEED KARAM,15,75,75,0,1
24-02-2025,"Grains, Flours & Dals",BARLEY SEEDS 250GMS,4,40,35,5,1
24-02-2025,"Dry Fruits, Nuts & Seeds",Groundnuts 500 gms,2,95,85,10,1
24-02-2025,"Grains, Flours & Dals",MELMEKER 250GMS,4,60,45,15,1
24-02-2025,Milk & Dairy,SANGAM TONED MILK 500ML,7,60,60,0,2
24-02-2025,Oils & Ghee,Groundnut oil 1 L,9,360,330,30,1
24-02-2025,Snacks & Ready-to-Eat,ZEEDI,14,70,70,0,1
24-02-2025,Snacks & Ready-to-Eat,BATANA NGT 70GMS,14,20,20,0,1
24-02-2025,Sweeteners,NATURAL HONEY 1KG,16,560,480,80,1
24-02-2025,"Grains, Flours & Dals",UDALU (Barnyard millet) 500 gms,4,70,60,10,1
24-02-2025,"Grains, Flours & Dals",SAMALU (Little millet) 500 gms,4,85,65,20,1
24-02-2025,Snacks & Ready-to-Eat,VD PALLI LADDU,14,80,80,0,1
24-02-2025,"Grains, Flours & Dals",KORRALU (FOXTAIL M) 500GM,4,65,55,10,1
24-02-2025,"Grains, Flours & Dals",Quinova 500 gms,4,110,100,10,1
24-02-2025,"Grains, Flours & Dals",Arikalu (kodo),4,70,65,5,1
24-02-2025,Snacks & Ready-to-Eat,SALTED PHALLI,14,25,25,0,1
24-02-2025,Snacks & Ready-to-Eat,VD PAPPU CHEGODI 200GM,14,60,60,0,1
24-02-2025,Snacks & Ready-to-Eat,SATHVI REGIVADA 200GM,14,80,60,20,1
24-02-2025,"Grains, Flours & Dals",Brown RICE 1KG,4,140,130,10,2
24-02-2025,Spices & Seasonings,BLACK JEERA 50 GM,15,45,30,15,1
24-02-2025,Misc,tamara wings,8,25,25,0,1
24-02-2025,Spices & Seasonings,BLACK JEERA 50 GM,15,45,30,15,1
24-02-2025,"Dry Fruits, Nuts & Seeds",Groundnuts 500 gms,2,95,85,10,1
24-02-2025,Oils & Ghee,Mustard oil 500 ml,9,220,195,25,1
24-02-2025,Oils & Ghee,Coconut oil 500 ml,9,220,200,20,1
24-02-2025,Oils & Ghee,Black Sesame oil 500 ml,9,220,190,30,1
24-02-2025,Beverages,TAJ MAHAL 250GM,1,235,235,0,1
24-02-2025,Oils & Ghee,Castor oil 200 ml,9,100,80,20,1
24-02-2025,Pooja & Spiritual Items,GD Aiswarya Deepam 700ML,12,195,195,0,1
24-02-2025,Oils & Ghee,Groundnut oil 1 L,9,360,330,30,1
24-02-2025,Oils & Ghee,Castor oil 200 ml,9,500,400,100,5
24-02-2025,"Grains, Flours & Dals",BASMATHI RICE 1KG,4,450,405,45,3
24-02-2025,"Grains, Flours & Dals",Multigrain 1 kg,4,100,85,15,1
24-02-2025,"Grains, Flours & Dals",Wheat Flour 1 kg,4,210,180,30,3
24-02-2025,"Grains, Flours & Dals",Wheat Flour 1 kg,4,140,120,20,2
24-02-2025,Spices & Seasonings,Chilli powder 500 gms,15,290,210,80,1
24-02-2025,Oils & Ghee,Safflower oil 1 L,9,440,400,40,1
24-02-2025,Snacks & Ready-to-Eat,VD MIXTURE 175 GM,14,60,60,0,1
24-02-2025,"Grains, Flours & Dals",DESI CHANA,4,25,25,0,1
24-02-2025,Snacks & Ready-to-Eat,VD PALLI CHIKKI,14,80,80,0,1
24-02-2025,"Health, Wellness & Ayurvedic Products",MD Fenugreek Choornam 100GM,5,80,80,0,1
24-02-2025,Spices & Seasonings,Tamarind 250GMS,15,75,75,0,1
24-02-2025,Spices & Seasonings,SREE MARUTHI IDLY KARAM 200GM,15,60,60,0,1
24-02-2025,General Household & Kitchenware,MATCH BOX,3,20,20,0,1
24-02-2025,"Grains, Flours & Dals",White Chana 500GM,4,120,100,20,1
24-02-2025,Snacks & Ready-to-Eat,VD MULTI CHAKKA,14,110,110,0,1
24-02-2025,Spices & Seasonings,Menthulu 250 gms,15,50,45,5,1
24-02-2025,Spices & Seasonings,Elaichi 25GM,15,290,240,50,2
24-02-2025,Personal Care & Cosmetics,khadhi aleoera,10,90,90,0,1
24-02-2025,Snacks & Ready-to-Eat,ELITE MILK RUSK 200GM,14,35,35,0,1
24-02-2025,"Grains, Flours & Dals",RAGI FLOUR 500GRMS,4,40,35,5,1
24-02-2025,"Grains, Flours & Dals",Chana Flour 1 kg,4,140,130,10,1
24-02-2025,Spices & Seasonings,ROYAL SAFFRON 400GRMS,15,130,130,0,2
24-02-2025,"Grains, Flours & Dals",FLOUR CHARGE,4,50.4,50.4,0,4.2
24-02-2025,"Grains, Flours & Dals",JOWAR WHITE 1 KG,4,40,35,5,0.5
24-02-2025,"Grains, Flours & Dals",RAGULU 1 KG,4,35,30,5,0.5
24-02-2025,"Dry Fruits, Nuts & Seeds",PULMAKHANA 100 GM,2,180,170,10,1
24-02-2025,"Dry Fruits, Nuts & Seeds",Groundnuts 500 gms,2,95,85,10,1
24-02-2025,Snacks & Ready-to-Eat,VD MURMURA LADDU,14,50,50,0,1
24-02-2025,Snacks & Ready-to-Eat,VD GUMMADI CHAKKA,14,130,130,0,1
24-02-2025,Spices & Seasonings,SREE MARUTHI IDLY KARAM 200GM,15,60,60,0,1
24-02-2025,"Dry Fruits, Nuts & Seeds",SATHVI CHIA SEEDS 100GM,2,100,80,20,1
24-02-2025,Personal Care & Cosmetics,GAYATHRI KUMKUDUKAYA,10,150,150,0,1
24-02-2025,"Dry Fruits, Nuts & Seeds",SABJA SEEDS 100GM,2,80,70,10,1
24-02-2025,Snacks & Ready-to-Eat,VD DASA DINUSULU,14,199,199,0,1
24-02-2025,"Dry Fruits, Nuts & Seeds",MAHA BEERA SEEDS 100GM,2,60,60,0,1
24-02-2025,Oils & Ghee,Groundnut oil 1 L,9,360,330,30,1
24-02-2025,Personal Care & Cosmetics,GAYATHRI KUMKUDUKAYA,10,150,150,0,1
24-02-2025,General Household & Kitchenware,B4 BOWL,3,160,160,0,1
24-02-2025,"Dry Fruits, Nuts & Seeds",Groundnuts 1 kg,2,190,170,20,1
24-02-2025,"Grains, Flours & Dals",Bombay Rava 500GM,4,35,30,5,1
24-02-2025,Oils & Ghee,Groundnut oil 1 L,9,1080,990,90,3
24-02-2025,"Grains, Flours & Dals",RAGI FLOUR 1KG,4,80,70,10,1
24-02-2025,Snacks & Ready-to-Eat,PN ORGANIC PUFFED RICE 200GM,14,55,55,0,1
24-02-2025,Spices & Seasonings,ROYAL SAFFRON 400GRMS,15,65,65,0,1
24-02-2025,Sweeteners,SUGAR 1KG,16,60,50,10,1
24-02-2025,"Dry Fruits, Nuts & Seeds",PULMAKHANA 100 GM,2,360,340,20,2
24-02-2025,"Dry Fruits, Nuts & Seeds",Groundnuts 1 kg,2,190,170,20,1
24-02-2025,"Grains, Flours & Dals",Sathya Javva Wheat Rava 500GM,4,190,190,0,2
24-02-2025,Spices & Seasonings,LG 50GM,15,92,92,0,1
24-02-2025,"Grains, Flours & Dals",Wheat Flour 1 kg,4,70,60,10,1
24-02-2025,"Grains, Flours & Dals",SRILATHA RICE RAVVA 500GM,4,70,70,0,2
24-02-2025,Spices & Seasonings,GS Pink Rock Salt 1KG,15,120,120,0,1
24-02-2025,Oils & Ghee,Groundnut oil 500ml,9,180,165,15,1
24-02-2025,"Health, Wellness & Ayurvedic Products",MH Millets Malt 1KG,5,400,380,20,1
24-02-2025,Snacks & Ready-to-Eat,VD BOONDI 175GM,14,60,60,0,1
24-02-2025,Snacks & Ready-to-Eat,VD Pappu Chekkalu 190gm,14,60,60,0,1
24-02-2025,Snacks & Ready-to-Eat,VD CORNFLAKES MIXTURE 175GM,14,60,60,0,1
24-02-2025,"Grains, Flours & Dals",Wheat Flour 1 kg,4,70,60,10,1
24-02-2025,"Grains, Flours & Dals",RAGI FLOUR 500GRMS,4,40,35,5,1
24-02-2025,Oils & Ghee,Freedom Rice Bran Oil 1L,9,388,360,28,2
24-02-2025,"Dry Fruits, Nuts & Seeds",ALMONDS 250GM,2,280,260,20,1
24-02-2025,"Dry Fruits, Nuts & Seeds",SALTED PISTA 250GM,2,400,350,50,1
24-02-2025,"Dry Fruits, Nuts & Seeds",YELLOW KISHMISH 250GM,2,130,110,20,1
24-02-2025,Snacks & Ready-to-Eat,RITEBITE MELTING CHOCOLATE,14,50,50,0,1
24-02-2025,"Dry Fruits, Nuts & Seeds",KAJU HALF 250GM,2,310,290,20,1
24-02-2025,Household & Cleaning,TIDE DOUBLE POWER JASMINE &amp;ROSE,6,66,66,0,1
24-02-2025,Beverages,BRU GREEN LABEL 1.2G,1,24,24,0,12
24-02-2025,Snacks & Ready-to-Eat,RB Choco Delite Almonds Raisins 40g,14,45,45,0,1
24-02-2025,Beverages,RED LABEL NATURAL CARE 100G,1,65,65,0,1
24-02-2025,Snacks & Ready-to-Eat,BB VERMICELLY 500GM,14,53,53,0,1
24-02-2025,Snacks & Ready-to-Eat,GB SALT COOKIES,14,60,55,5,1
24-02-2025,Pooja & Spiritual Items,GB Bharatha Woods 75GM,12,60,60,0,1
24-02-2025,"Grains, Flours & Dals",Chana Flour 500 gms,4,70,65,5,1
24-02-2025,Snacks & Ready-to-Eat,PEANUT CHIKKI 450GM,14,125,125,0,1
24-02-2025,Snacks & Ready-to-Eat,VD MIXTURE 175 GM,14,60,60,0,1
24-02-2025,Sweeteners,YB JAGGERY POWDER 500GMS,16,75,75,0,1
24-02-2025,"Grains, Flours & Dals",RAGULU 1 KG,4,35,30,5,0.5
24-02-2025,General Household & Kitchenware,B4 BOWL,3,160,152,8,1
24-02-2025,"Health, Wellness & Ayurvedic Products",MH Baby Food 400GM,5,200,200,0,1
24-02-2025,Snacks & Ready-to-Eat,RITEBITE BLUEBERRY BLAST,14,45,45,0,1
24-02-2025,"Health, Wellness & Ayurvedic Products",MH Millets Milk Powder 250GM,5,250,250,0,1
24-02-2025,Snacks & Ready-to-Eat,PEANUT CHIKKI 450GM,14,125,125,0,1
24-02-2025,"Dry Fruits, Nuts & Seeds",SD Mango cubes 100gm,2,45,45,0,1
24-02-2025,Snacks & Ready-to-Eat,VD PAPPU CHEGODI 200GM,14,120,120,0,2
24-02-2025,"Grains, Flours & Dals",DH URAD GOTA 1KG,4,430,380,50,2
24-02-2025,"Grains, Flours & Dals",Wheat Flour 1 kg,4,140,120,20,2
24-02-2025,Spices & Seasonings,Tamarind 250GMS,15,150,150,0,2
24-02-2025,Oils & Ghee,Groundnut oil 1 L,9,360,330,30,1
24-02-2025,Snacks & Ready-to-Eat,VD GUMMADI VADIYAM,14,75,75,0,1
24-02-2025,Oils & Ghee,Sesame oil 500ml,9,295,280,15,1
24-02-2025,Snacks & Ready-to-Eat,VD PALLI CHIKKI,14,80,80,0,1
24-02-2025,Snacks & Ready-to-Eat,GB SALT COOKIES,14,60,55,5,1
24-02-2025,"Grains, Flours & Dals",SL Suji Rava 500GM,4,32,32,0,1
24-02-2025,"Grains, Flours & Dals",Brown RICE 1KG,4,140,130,10,2
24-02-2025,"Health, Wellness & Ayurvedic Products",RB Max Protein Choco Berry bar 50g,5,75,75,0,1
24-02-2025,Snacks & Ready-to-Eat,RSC ORANGE 100GMS,14,20,20,0,1
24-02-2025,Snacks & Ready-to-Eat,RB Choco Delite Almonds Raisins 40g,14,45,45,0,1
24-02-2025,"Grains, Flours & Dals",SRILATHA RICE RAVVA 500GM,4,70,70,0,2
24-02-2025,Oils & Ghee,Coconut oil 1 L,9,440,400,40,1
24-02-2025,"Health, Wellness & Ayurvedic Products",RB Max Protein Choco Almond bar 50g,5,75,75,0,1
24-02-2025,Sweeteners,YB JAGGERY POWDER 500GMS,16,75,75,0,1
24-02-2025,Oils & Ghee,Groundnut oil 1 L,9,360,330,30,1
24-02-2025,Snacks & Ready-to-Eat,SD Atreyapuram DRY Fruit ghee,14,150,150,0,1
24-02-2025,"Grains, Flours & Dals",SINGLE POLISH 1KG,4,325,325,0,5
24-02-2025,Milk & Dairy,BROWN EGGS TRAY 30P,7,360,330,30,1
24-02-2025,"Health, Wellness & Ayurvedic Products",ORGANIC MORINGA POWER 100GM,5,249,236.55,12.45,1
24-02-2025,Beverages,RED LABEL NATURAL CARE 100G,1,65,65,0,1
24-02-2025,Snacks & Ready-to-Eat,MILLET PANCAKE CHOCOLATE,14,398,398,0,2
24-02-2025,"Health, Wellness & Ayurvedic Products",MD Gandha Karchural Choornam 30GM,5,60,60,0,1
24-02-2025,"Health, Wellness & Ayurvedic Products",MD Manjistha Choornam 50GM,5,150,150,0,1
24-02-2025,Snacks & Ready-to-Eat,SD Pumpkin Seeds With Dates 175gm,14,340,340,0,2
24-02-2025,"Health, Wellness & Ayurvedic Products",VATTIVERU CHOORNAM,5,90,90,0,1
24-02-2025,"Grains, Flours & Dals",Wheat Rava S 1KG,4,65,55,10,1
24-02-2025,Snacks & Ready-to-Eat,SD Flax seeds with dates 250gm,14,135,135,0,1
24-02-2025,"Health, Wellness & Ayurvedic Products",PULIPIRI WARTS REMOVER 9GM,5,125,125,0,1
24-02-2025,Pooja & Spiritual Items,VRP APOORVA JAVADHU POW,12,35,35,0,1
24-02-2025,Snacks & Ready-to-Eat,SD Aswagandha with palm Jaggery250Gm,14,135,135,0,1
24-02-2025,"Grains, Flours & Dals",KORRALU (FOXTAIL M) 500GM,4,65,55,10,1
24-02-2025,Personal Care & Cosmetics,OVAL BODY LOOFAH,10,55,55,0,1
24-02-2025,Sweeteners,YB JAGGERY POWDER 500GMS,16,75,75,0,1
24-02-2025,Snacks & Ready-to-Eat,Sprouted Ragi Biscuits 450GM,14,150,150,0,1
24-02-2025,"Grains, Flours & Dals",Brown rice 5 kgs,4,350,325,25,1
24-02-2025,Spices & Seasonings,PUTNALA KARAM POWDER 100GM,15,65,65,0,1
24-02-2025,"Grains, Flours & Dals",Hs yellow jowar r 500g,4,99,99,0,1
24-02-2025,"Dry Fruits, Nuts & Seeds",PUMPKIN SEEDS 250GM,2,200,160,40,1
24-02-2025,Spices & Seasonings,NUVVULU 500GM,15,200,170,30,1
24-02-2025,"Grains, Flours & Dals",Brown rice 5 kgs,4,350,325,25,1
24-02-2025,Snacks & Ready-to-Eat,SD Thati thandra 200gm,14,150,150,0,1
24-02-2025,Spices & Seasonings,SD IDLY KARAM,15,65,65,0,1
24-02-2025,Personal Care & Cosmetics,GOW DURBAR NAVA 100GM SOAP,10,40,40,0,1
24-02-2025,Misc,JOKER,8,16,16,0,8
24-02-2025,"Grains, Flours & Dals",White jowar.F 1 kg,4,100,80,20,1
24-02-2025,Personal Care & Cosmetics,UVIS LACTO TAN SOAP 100GM,10,99,99,0,1
24-02-2025,Snacks & Ready-to-Eat,SATHVI REGIVADA 200GM,14,160,120,40,2
24-02-2025,Oils & Ghee,Sesame oil 1 L,9,1180,"1,120.00",60,2
24-02-2025,Spices & Seasonings,Elaichi 25GM,15,145,120,25,1
24-02-2025,"Grains, Flours & Dals",Brown RICE 1KG,4,70,65,5,1
24-02-2025,Oils & Ghee,Sesame oil 500ml,9,295,280,15,1
24-02-2025,"Grains, Flours & Dals",Multigrain 2 kgs,4,200,170,30,1
24-02-2025,"Dry Fruits, Nuts & Seeds",Groundnuts 500 gms,2,190,170,20,2
24-02-2025,"Grains, Flours & Dals",Multigrain 1 kg,4,100,85,15,1
24-02-2025,"Grains, Flours & Dals",THICK POHA 500GM,4,40,35,5,1
24-02-2025,"Grains, Flours & Dals",RAGI FLOUR 500GRMS,4,40,35,5,1
24-02-2025,Oils & Ghee,Coconut oil 500 ml,9,220,200,20,1
24-02-2025,Snacks & Ready-to-Eat,VD NUVULLU CHIKKI,14,80,80,0,1
24-02-2025,Spices & Seasonings,Elaichi 25GM,15,145,120,25,1
24-02-2025,Spices & Seasonings,Lavangam 50GM,15,60,50,10,1
24-02-2025,"Dry Fruits, Nuts & Seeds",ALMONDS 250GM,2,280,260,20,1
24-02-2025,"Grains, Flours & Dals",Idly Rava L 1KG,4,60,50,10,1
24-02-2025,Spices & Seasonings,ROYAL SAFFRON 400GRMS,15,65,65,0,1
24-02-2025,Spices & Seasonings,Masala Karam 250 gms,15,130,120,10,1
24-02-2025,"Grains, Flours & Dals",Urad dall 1 Kg,4,185,170,15,1
24-02-2025,Pooja & Spiritual Items,SWASTIK CAMPHORE,12,180,180,0,1
24-02-2025,"Health, Wellness & Ayurvedic Products",MH Millets Malt 500GM,5,200,190,10,1
24-02-2025,"Grains, Flours & Dals",POORI ATTA 1KG,4,70,60,10,1
24-02-2025,Oils & Ghee,Safflower oil 1 L,9,440,400,40,1
24-02-2025,Oils & Ghee,Groundnut oil 1 L,9,360,330,30,1
24-02-2025,Spices & Seasonings,Coconut Powder 250GM,15,90,90,0,1
24-02-2025,Milk & Dairy,HERITAGE TOTAL CURD 500GM,7,50,50,0,1
24-02-2025,Oils & Ghee,Groundnut oil 5 L,9,1800,"1,600.00",200,1
24-02-2025,Oils & Ghee,Groundnut oil 1 L,9,720,660,60,2
24-02-2025,Oils & Ghee,Safflower oil 1 L,9,880,800,80,2
24-02-2025,"Grains, Flours & Dals",DH URAD GOTA 1KG,4,215,190,25,1
24-02-2025,Oils & Ghee,Sesame oil 1 L,9,590,560,30,1
24-02-2025,"Grains, Flours & Dals",white Bobarlu 500 gms,4,80,75,5,1
24-02-2025,"Dry Fruits, Nuts & Seeds",Groundnuts 1 kg,2,190,170,20,1
24-02-2025,Oils & Ghee,Groundnut oil 1 L,9,360,330,30,1
24-02-2025,Pooja & Spiritual Items,BALAJI GArden dhop sticks,12,0,0,0,1
24-02-2025,Pooja & Spiritual Items,SOSR SWATHHI 365,12,60,60,0,2
24-02-2025,Personal Care & Cosmetics,GOW DURBAR 75G,10,60,60,0,1
24-02-2025,Oils & Ghee,Coconut oil 500 ml,9,220,200,20,1
24-02-2025,Pooja & Spiritual Items,BALAJI LAVENDER DOOP STICK 10STK,12,125,125,0,1
24-02-2025,Pooja & Spiritual Items,GB Bharatha Woods 75GM,12,60,60,0,1
24-02-2025,Pooja & Spiritual Items,GD JASMINE 75GM,12,60,60,0,1
24-02-2025,Snacks & Ready-to-Eat,VD NUVULU PAPAD 200GM,14,100,100,0,1
24-02-2025,Snacks & Ready-to-Eat,SD Aswagandha with palm Jaggery250Gm,14,135,135,0,1
24-02-2025,"Health, Wellness & Ayurvedic Products",JAMBU SEED CHOORNAM 100GM,5,80,80,0,1
24-02-2025,Oils & Ghee,Groundnut oil 1 L,9,360,330,30,1
24-02-2025,"Health, Wellness & Ayurvedic Products",MD Neem Leaf Choornam 100GM,5,160,160,0,2
24-02-2025,Pooja & Spiritual Items,GD Camphor 50GM,12,230,230,0,2
24-02-2025,"Health, Wellness & Ayurvedic Products",MD Vasa Choornam 30GM,5,80,80,0,1
24-02-2025,"Health, Wellness & Ayurvedic Products",HARITHAKI CHOORNAM,5,60,60,0,1
24-02-2025,Spices & Seasonings,YB PINK ROCK SALT 1KG,15,120,120,0,1
24-02-2025,Oils & Ghee,Sesame oil 1 L,9,1770,"1,680.00",90,3
24-02-2025,"Health, Wellness & Ayurvedic Products",MD Trikatu Choornam 30GM,5,150,150,0,1
24-02-2025,Pooja & Spiritual Items,MD Havan Saamagri 50GM,12,60,60,0,1
24-02-2025,Spices & Seasonings,Avalu small 250 gms,15,60,40,20,1
24-02-2025,Oils & Ghee,Coconut oil 500 ml,9,220,200,20,1
24-02-2025,"Grains, Flours & Dals",split black gram 1 kg,4,180,170,10,1
24-02-2025,Snacks & Ready-to-Eat,COPRA LADDU 200GM,14,100,80,20,1
24-02-2025,Spices & Seasonings,NUVVULU 500GM,15,200,170,30,1
24-02-2025,"Grains, Flours & Dals",turdal 500 gms,4,110,100,10,1
24-02-2025,Milk & Dairy,SANGAM FULL CREAM MILK 500ML,7,38,38,0,1
24-02-2025,Milk & Dairy,HERITAGE TONED MILK 500ML,7,31,31,0,1
24-02-2025,"Grains, Flours & Dals",BARLEY SEEDS 250GMS,4,40,35,5,1
24-02-2025,"Grains, Flours & Dals",RAGI FLOUR 1KG,4,80,70,10,1
24-02-2025,"Grains, Flours & Dals",Multigrain 1 kg,4,100,85,15,1
24-02-2025,"Grains, Flours & Dals",SABDANA 500GM,4,90,70,20,1
24-02-2025,Personal Care & Cosmetics,UVIS LACTO TAN SOAP 100GM,10,99,99,0,1
24-02-2025,Snacks & Ready-to-Eat,BATANA NGT 70GMS,14,20,20,0,1
24-02-2025,Snacks & Ready-to-Eat,ZEEDI,14,70,70,0,1
24-02-2025,Snacks & Ready-to-Eat,BROWN BREAD,14,55,55,0,1
24-02-2025,Oils & Ghee,Groundnut oil 1 L,9,360,330,30,1
24-02-2025,"Grains, Flours & Dals",Wheat Rava S 500GM,4,33,30,3,1
24-02-2025,Snacks & Ready-to-Eat,PEANUT CHIKKI,14,22,22,0,1
24-02-2025,"Grains, Flours & Dals",Wheat Rava M 1KG,4,65,55,10,1
24-02-2025,"Grains, Flours & Dals",VGR RICE 10 KGS,4,700,650,50,1
24-02-2025,Spices & Seasonings,SH BAY LEAF / TEJ PATTA 30GM,15,35,35,0,1
24-02-2025,"Dry Fruits, Nuts & Seeds",Putnalu 250GM,2,45,38,7,1
24-02-2025,"Dry Fruits, Nuts & Seeds",SUNFLOWER SEEDS 250GRM,2,150,130,20,1
24-02-2025,"Grains, Flours & Dals",VYS.SP RICE 1 KG,4,210,195,15,3
24-02-2025,Sweeteners,Natural Honey 1 kg,16,560,480,80,1
24-02-2025,"Dry Fruits, Nuts & Seeds",PUMPKIN SEEDS 250GM,2,200,160,40,1
24-02-2025,"Dry Fruits, Nuts & Seeds",Groundnuts 500 gms,2,95,85,10,1
24-02-2025,"Grains, Flours & Dals",Urad dall 500 gms,4,95,85,10,1
24-02-2025,"Grains, Flours & Dals",PESARA PAPPU 1 KG,4,170,145,25,1
24-02-2025,Snacks & Ready-to-Eat,PEANUT CHIKKI 450GM,14,125,125,0,1
24-02-2025,Sweeteners,GS A2 Buffalo Ghee 500ML,16,550,550,0,1
24-02-2025,General Household & Kitchenware,B4 BOWL,3,160,152,8,1
24-02-2025,Milk & Dairy,SANGAM FULL CREAM MILK 500ML,7,38,38,0,1
24-02-2025,Milk & Dairy,SANGAM CURD 450GM,7,38,38,0,1
24-02-2025,Oils & Ghee,Coconut oil 500 ml,9,220,200,20,1
24-02-2025,Beverages,BRU GREEN LABEL 1.2G,1,14,14,0,7
24-02-2025,Personal Care & Cosmetics,GARNIER BRIGHT COMLETE VIT-C 18G,10,45,45,0,1
24-02-2025,Milk & Dairy,SANGAM TONED MILK 500ML,7,30,30,0,1
24-02-2025,Snacks & Ready-to-Eat,COPRA LADDU 200GM,14,100,80,20,1
24-02-2025,Oils & Ghee,Groundnut oil 1 L,9,360,330,30,1
24-02-2025,"Grains, Flours & Dals",Multigrain 1 kg,4,100,85,15,1
24-02-2025,"Grains, Flours & Dals",HS jowar idly rava 500 gms,4,65,65,0,1
24-02-2025,Snacks & Ready-to-Eat,SD Moringa with plam jaggery 250gm,14,135,135,0,1
24-02-2025,Snacks & Ready-to-Eat,Sprouted Ragi Biscuits 450GM,14,150,150,0,1
24-02-2025,Oils & Ghee,Groundnut oil 1 L,9,360,330,30,1
24-02-2025,Oils & Ghee,Groundnut oil 5 L,9,1800,"1,600.00",200,1
24-02-2025,Spices & Seasonings,RED COPRA 250GMS,15,78,78,0,1
23-02-2025,Snacks & Ready-to-Eat,GB SALT COOKIES,14,60,55,5,1
23-02-2025,"Grains, Flours & Dals",Red Chana 250GM,4,35,30,5,1
23-02-2025,"Grains, Flours & Dals",Green gram 1 kg,4,150,130,20,1
23-02-2025,Spices & Seasonings,AVALU 100GM,15,50,40,10,2
23-02-2025,"Grains, Flours & Dals",Green Batani 250GM,4,55,45,10,1
23-02-2025,"Grains, Flours & Dals",RAJMA 500GM,4,90,90,0,1
23-02-2025,"Grains, Flours & Dals",Red Bobarlu 500 gms,4,95,85,10,1
23-02-2025,Spices & Seasonings,PRO ORG MUSTARD SMALL -RAI 200G,15,84,84,0,1
23-02-2025,"Grains, Flours & Dals",BOMBAY RAVA,4,70,55,15,1
23-02-2025,Snacks & Ready-to-Eat,VD CORNFLAKES MIXTURE 175GM,14,60,60,0,1
23-02-2025,Milk & Dairy,BROWN EGGS TRAY 30P,7,360,330,30,1
23-02-2025,Snacks & Ready-to-Eat,Popcorn Seeds 500GM,14,90,80,10,1
23-02-2025,Household & Cleaning,PITAMBARI,6,28,28,0,1
23-02-2025,Oils & Ghee,Castor oil 200 ml,9,100,80,20,1
23-02-2025,"Dry Fruits, Nuts & Seeds",ALMONDS 250GM,2,280,260,20,1
23-02-2025,"Grains, Flours & Dals",White jowar.F 1 kg,4,100,80,20,1
23-02-2025,"Grains, Flours & Dals",SABDANA,4,40,35,5,1
23-02-2025,Personal Care & Cosmetics,OVAL BODY LOOFAH,10,40,40,0,1
23-02-2025,"Dry Fruits, Nuts & Seeds",YELLOW KISHMISH 250GM,2,130,110,20,1
23-02-2025,"Grains, Flours & Dals",MELMEKER 250GMS,4,60,45,15,1
23-02-2025,General Household & Kitchenware,B1 bowl,3,265,251.75,13.25,1
23-02-2025,"Dry Fruits, Nuts & Seeds",KAJU HALF 250GM,2,310,290,20,1
23-02-2025,General Household & Kitchenware,B4 BOWL,3,160,152,8,1
23-02-2025,Snacks & Ready-to-Eat,GS WHEAT GRASS BISCUITS 250GM,14,130,130,0,1
23-02-2025,Spices & Seasonings,SD Garlic Karam Powder 100GM,15,65,65,0,1
23-02-2025,Snacks & Ready-to-Eat,SD Vamu with palm jaggery 250gm,14,135,135,0,1
23-02-2025,Snacks & Ready-to-Eat,SD Flax seeds with dates 250gm,14,135,135,0,1
23-02-2025,Pickles & Cooking Pastes,SD MESTA PICKLE,11,110,110,0,1
23-02-2025,Sweeteners,GS JAGGERY NUGGETS 500GM,16,120,120,0,1
23-02-2025,Spices & Seasonings,FLAXSEED KARAM,15,75,75,0,1
23-02-2025,"Grains, Flours & Dals",HS RAGI Idly rava 500 gms,4,70,70,0,1
23-02-2025,"Health, Wellness & Ayurvedic Products",RB Max Protein PERI PERI 60gm,5,45,45,0,1
23-02-2025,Snacks & Ready-to-Eat,BB VERMICELLY 500GM,14,53,53,0,1
23-02-2025,Snacks & Ready-to-Eat,VD DAHI MIRCHI(SALTED) 100GM,14,45,45,0,1
23-02-2025,Oils & Ghee,Safflower oil 500 ml,9,220,200,20,1
23-02-2025,Snacks & Ready-to-Eat,PN JAGGERY BITES,14,135,135,0,1
23-02-2025,"Grains, Flours & Dals",FLOUR CHARGE,4,24,24,0,2
23-02-2025,General Household & Kitchenware,B1 bowl,3,315,299.25,15.75,1
23-02-2025,Snacks & Ready-to-Eat,BD KODO MILLET NOODLES 200GM,14,75,75,0,1
23-02-2025,Spices & Seasonings,Masala Karam 250 gms,15,130,120,10,1
23-02-2025,"Grains, Flours & Dals",Idly Rava L 1KG,4,60,50,10,1
23-02-2025,"Grains, Flours & Dals",JOWAR YELLOW 1 K,4,50,45,5,0.5
23-02-2025,"Health, Wellness & Ayurvedic Products",MH Millets Malt 500GM,5,200,190,10,1
23-02-2025,"Grains, Flours & Dals",Green gram 1 kg,4,150,130,20,1
23-02-2025,"Grains, Flours & Dals",BASMATHI RICE 1KG,4,150,135,15,1
23-02-2025,"Grains, Flours & Dals",JOWAR WHITE 1 KG,4,120,105,15,1.5
23-02-2025,"Grains, Flours & Dals",SRI LALITHA BROWN RICE,4,740,740,0,2
23-02-2025,Snacks & Ready-to-Eat,SATHVI REGIVADA 200GM,14,80,60,20,1
23-02-2025,Oils & Ghee,Groundnut oil 1 L,9,720,660,60,2
23-02-2025,Snacks & Ready-to-Eat,SALTED PHALLI,14,25,25,0,1
23-02-2025,Snacks & Ready-to-Eat,SD Thati thandra 200gm,14,150,150,0,1
23-02-2025,"Grains, Flours & Dals",KORRALU (FOXTAIL M) 1KG,4,150,110,40,1
23-02-2025,"Grains, Flours & Dals",DISANO OATS 1KG,4,285,142.5,142.5,1
23-02-2025,Oils & Ghee,Groundnut oil 1 L,9,360,330,30,1
23-02-2025,Snacks & Ready-to-Eat,COPRA LADDU 200GM,14,100,80,20,1
23-02-2025,"Grains, Flours & Dals",DESI CHANA,4,25,25,0,1
23-02-2025,Personal Care & Cosmetics,MADDI BATH POWDER 400GM,10,150,150,0,1
23-02-2025,"Grains, Flours & Dals",Wheat Flour 1 kg,4,140,120,20,2
23-02-2025,"Grains, Flours & Dals",PRO ORG DALIYA BROKEN WHEAT 500G,4,72,72,0,1
23-02-2025,Oils & Ghee,Castor oil 200 ml,9,100,80,20,1
23-02-2025,"Grains, Flours & Dals",SA YELLOW JOWAR RAVA 500GM,4,95,95,0,1
23-02-2025,Household & Cleaning,PITAMBARI SHINING POWDER 200G,6,60,60,0,1
23-02-2025,Pooja & Spiritual Items,JVK SAMBRANI STICK 20PCS,12,40,40,0,1
23-02-2025,"Grains, Flours & Dals",Chana Flour 500 gms,4,140,130,10,2
23-02-2025,Snacks & Ready-to-Eat,PEANUT CHILLI,14,20,20,0,4
23-02-2025,Spices & Seasonings,Jeera 100GM,15,50,45,5,1
23-02-2025,"Grains, Flours & Dals",RAGI FLOUR 500GRMS,4,40,35,5,1
23-02-2025,Spices & Seasonings,Tamarind 250GMS,15,75,75,0,1
23-02-2025,"Grains, Flours & Dals",RICE FLOUR 500 GM,4,35,28,7,1
23-02-2025,"Grains, Flours & Dals",UDALU (Barnyard millet) 1 kg,4,280,230,50,2
23-02-2025,"Grains, Flours & Dals",KORRALU (FOXTAIL M) 1KG,4,150,110,40,1
23-02-2025,General Household & Kitchenware,WOODEN SPOON BIG,3,50,50,0,1
23-02-2025,"Grains, Flours & Dals",SAMALU (Little millet) 1 kg,4,170,130,40,1
23-02-2025,"Grains, Flours & Dals",Green gram 1 kg,4,150,130,20,1
23-02-2025,"Grains, Flours & Dals",Arikadu ( kodo),4,140,130,10,1
23-02-2025,Oils & Ghee,Safflower oil 1 L,9,440,400,40,1
23-02-2025,Oils & Ghee,Sesame oil 1 L,9,590,560,30,1
23-02-2025,Oils & Ghee,Groundnut oil 1 L,9,360,330,30,1
23-02-2025,"Grains, Flours & Dals",Wheat Flour 1 kg,4,70,60,10,1
23-02-2025,"Grains, Flours & Dals",Multigrain 1 kg,4,100,85,15,1
23-02-2025,Oils & Ghee,Safflower oil 1 L,9,440,400,40,1
23-02-2025,"Grains, Flours & Dals",RAGI FLOUR 500GRMS,4,40,35,5,1
23-02-2025,Oils & Ghee,Sesame oil 1 L,9,590,560,30,1
23-02-2025,Oils & Ghee,Safflower oil 1 L,9,440,400,40,1
23-02-2025,Oils & Ghee,Groundnut oil 1 L,9,360,330,30,1
23-02-2025,"Dry Fruits, Nuts & Seeds",ALMONDS 250GM,2,280,260,20,1
23-02-2025,"Grains, Flours & Dals",RICE FLOUR 1KG,4,70,55,15,1
23-02-2025,Milk & Dairy,HERITAGE TOTAL CURD 500GM,7,50,50,0,1
23-02-2025,Milk & Dairy,HERITAGE TONED MILK 500ML,7,31,31,0,1
23-02-2025,Personal Care & Cosmetics,OVAL BODY LOOFAH,10,55,55,0,1
23-02-2025,"Grains, Flours & Dals",AISHWARYA LOW GI RICE 5KG,4,700,525,175,1
23-02-2025,Snacks & Ready-to-Eat,ELITE MILK RUSK 200GM,14,35,35,0,1
23-02-2025,"Health, Wellness & Ayurvedic Products",SAI DURGA MORINGA LEAVES 100GM,5,75,75,0,1
23-02-2025,"Grains, Flours & Dals",UDALU (Barnyard millet) 1 kg,4,140,115,25,1
23-02-2025,Pooja & Spiritual Items,SOSR SWATHHI 365,12,60,60,0,2
23-02-2025,Sweeteners,GS JAGGERY NUGGETS 500GM,16,120,120,0,1
23-02-2025,Oils & Ghee,Groundnut oil 5 L,9,1800,"1,600.00",200,1
23-02-2025,"Dry Fruits, Nuts & Seeds",Groundnuts 1 kg,2,190,170,20,1
23-02-2025,Sweeteners,SUGAR 1KG,16,60,50,10,1
23-02-2025,"Grains, Flours & Dals",CHANA DAL 500GM,4,70,60,10,1
23-02-2025,Personal Care & Cosmetics,PARACHUTE 45ML,10,20,20,0,1
23-02-2025,"Dry Fruits, Nuts & Seeds",PUTNALU 500GMS,2,90,76,14,1
23-02-2025,Oils & Ghee,Coconut oil 1 L,9,440,400,40,1
23-02-2025,Personal Care & Cosmetics,MESWAK 100GM,10,70,70,0,1
23-02-2025,Spices & Seasonings,GROUNDNUT KARAM POWDER,15,65,65,0,1
23-02-2025,Spices & Seasonings,PUTNALA KARAM POWDER 100GM,15,65,65,0,1
23-02-2025,General Household & Kitchenware,WOODEN SPOON BIG,3,50,50,0,1
23-02-2025,"Grains, Flours & Dals",SH RED POHA 500GM,4,85,85,0,1
23-02-2025,Sweeteners,YB Brown Sugar 1KG,16,140,140,0,1
23-02-2025,Personal Care & Cosmetics,SVE KHADI ALOEVERA GEL 100GM,10,140,140,0,1
23-02-2025,General Household & Kitchenware,B1 bowl,3,160,152,8,1
23-02-2025,"Grains, Flours & Dals",Chana Flour 500 gms,4,70,65,5,1
23-02-2025,Oils & Ghee,Safflower oil 500 ml,9,220,200,20,1
23-02-2025,Snacks & Ready-to-Eat,RSC ORANGE 100GMS,14,20,20,0,1
23-02-2025,Oils & Ghee,Sesame oil 500ml,9,295,280,15,1
23-02-2025,"Dry Fruits, Nuts & Seeds",SD Mango cubes 100gm,2,45,45,0,1
23-02-2025,"Health, Wellness & Ayurvedic Products",RB Max Protein PERI PERI 60gm,5,45,45,0,1
23-02-2025,Snacks & Ready-to-Eat,GREEN FRIED BATANA,14,20,20,0,1
23-02-2025,"Grains, Flours & Dals",HS jowar idly rava 500 gms,4,65,65,0,1
23-02-2025,Snacks & Ready-to-Eat,NGT CHATPATTA CHANA 90GM,14,25,25,0,1
23-02-2025,"Grains, Flours & Dals",Wheat Rava S 1KG,4,65,55,10,1
23-02-2025,"Grains, Flours & Dals",Sathya Javva Wheat Rava 500GM,4,95,95,0,1
23-02-2025,"Grains, Flours & Dals",RAGI FLOUR 500GRMS,4,40,35,5,1
23-02-2025,Snacks & Ready-to-Eat,BATANA NGT 70GMS,14,20,20,0,1
23-02-2025,Snacks & Ready-to-Eat,SD FINGER Millet with palm Jaggery 250gm,14,135,135,0,1
23-02-2025,"Grains, Flours & Dals",Wheat Rava S 1KG,4,65,55,10,1
23-02-2025,"Grains, Flours & Dals",Multigrain 1 kg,4,100,85,15,1
23-02-2025,"Grains, Flours & Dals",DR.RICE 5KG,4,600,600,0,1
23-02-2025,"Dry Fruits, Nuts & Seeds",MAHA BEERA SEEDS 100GM,2,60,60,0,1
23-02-2025,"Grains, Flours & Dals",HS Multimillet idly R 500 gms,4,260,260,0,4
23-02-2025,"Grains, Flours & Dals",WHEAT 1 KG,4,15,12.5,2.5,0.25
23-02-2025,"Grains, Flours & Dals",DISANO OATS 1KG,4,71.25,71.25,0,0.25
23-02-2025,"Grains, Flours & Dals",SOYA BEANS 1KG,4,50,45,5,0.25
23-02-2025,"Grains, Flours & Dals",BARLEY SEEDS 1KG,4,40,35,5,0.25
23-02-2025,"Grains, Flours & Dals",RAGULU 1 KG,4,17.5,15,2.5,0.25
23-02-2025,"Grains, Flours & Dals",BAJRA 1 KG,4,15,12.5,2.5,0.25
23-02-2025,"Grains, Flours & Dals",JOWAR WHITE 1 KG,4,20,17.5,2.5,0.25
23-02-2025,"Dry Fruits, Nuts & Seeds",FLAX SEEDS 1KG,2,60,50,10,0.25
23-02-2025,"Grains, Flours & Dals",FLOUR CHARGE,4,24,24,0,2
23-02-2025,"Dry Fruits, Nuts & Seeds",Groundnuts 500 gms,2,95,85,10,1
23-02-2025,"Grains, Flours & Dals",SL Idly Rava 1KG,4,65,55,10,1
23-02-2025,Spices & Seasonings,SD Garlic Karam Powder 100GM,15,65,65,0,1
23-02-2025,Spices & Seasonings,Tamarind 250GMS,15,75,75,0,1
23-02-2025,Personal Care & Cosmetics,MYSORE SANDAL,10,138,138,0,2
23-02-2025,Snacks & Ready-to-Eat,GB SALT COOKIES,14,60,55,5,1
23-02-2025,Snacks & Ready-to-Eat,VD PALLI LADDU,14,160,160,0,2
23-02-2025,Oils & Ghee,Groundnut oil 1 L,9,360,330,30,1
23-02-2025,Snacks & Ready-to-Eat,VD NUVULU CHEGODI 175GM,14,60,60,0,1
23-02-2025,"Grains, Flours & Dals",turdal 500 gms,4,110,100,10,1
23-02-2025,"Grains, Flours & Dals",BOBBARA PAPPU 500GM,4,85,80,5,1
23-02-2025,Snacks & Ready-to-Eat,OK Pasta Macaroni 400GM,14,120,120,0,1
23-02-2025,General Household & Kitchenware,SABEENA,3,15,15,0,1
23-02-2025,"Dry Fruits, Nuts & Seeds",ALMONDS 250GM,2,280,260,20,1
23-02-2025,Snacks & Ready-to-Eat,BATANA NGT 70GMS,14,20,20,0,1
23-02-2025,General Household & Kitchenware,B2 bowl,3,315,299.25,15.75,1
23-02-2025,"Grains, Flours & Dals",RAGULU 1 KG,4,70,60,10,1
23-02-2025,"Grains, Flours & Dals",PESARA PAPPU 500GMS,4,85,75,10,1
23-02-2025,"Grains, Flours & Dals",Green gram 1 kg,4,150,130,20,1
23-02-2025,"Dry Fruits, Nuts & Seeds",SD Mango cubes 100gm,2,45,45,0,1
23-02-2025,General Household & Kitchenware,B1 bowl,3,399,379.05,19.95,1
23-02-2025,"Dry Fruits, Nuts & Seeds",PULMAKHANA 100 GM,2,180,170,10,1
23-02-2025,Spices & Seasonings,YB Rock Salt 1KG,15,120,120,0,1
23-02-2025,"Grains, Flours & Dals",SABDANA 500GM,4,90,70,20,1
23-02-2025,"Grains, Flours & Dals",Wheat Flour 2 kgs,4,140,120,20,1
23-02-2025,Oils & Ghee,Safflower oil 1 L,9,440,400,40,1
23-02-2025,Oils & Ghee,Coconut oil 500 ml,9,220,200,20,1
23-02-2025,Spices & Seasonings,Jeera 100GM,15,50,45,5,1
23-02-2025,Snacks & Ready-to-Eat,MB MULTIMILLET NOODLES 180GM,14,95,95,0,1
23-02-2025,Oils & Ghee,Sesame oil 1 L,9,590,560,30,1
23-02-2025,"Grains, Flours & Dals",SH RED POHA 500GM,4,85,85,0,1
23-02-2025,Oils & Ghee,Groundnut oil 1 L,9,720,660,60,2
23-02-2025,"Grains, Flours & Dals",HS RAGI Idly rava 500 gms,4,70,70,0,1
23-02-2025,"Grains, Flours & Dals",turdal 1kg,4,220,195,25,1
23-02-2025,"Grains, Flours & Dals",SL Idly Rava 1KG,4,130,110,20,2
23-02-2025,Snacks & Ready-to-Eat,ZEEDI,14,70,70,0,1
23-02-2025,"Grains, Flours & Dals",RAGI FLOUR 1KG,4,160,140,20,2
23-02-2025,Snacks & Ready-to-Eat,SD Thati thandra 200gm,14,150,150,0,1
23-02-2025,Snacks & Ready-to-Eat,VD PALLI LADDU,14,160,160,0,2
23-02-2025,Spices & Seasonings,JEERA 250 gms,15,125,105,20,1
23-02-2025,"Grains, Flours & Dals",Green gram 1 kg,4,150,130,20,1
23-02-2025,"Grains, Flours & Dals",VGR rice 1 kg,4,70,65,5,1
23-02-2025,"Grains, Flours & Dals",SINGLE POLISH 1KG,4,390,390,0,6
23-02-2025,Oils & Ghee,Groundnut oil 1 L,9,360,330,30,1
23-02-2025,Snacks & Ready-to-Eat,urban murmura,14,45,45,0,1
23-02-2025,Spices & Seasonings,SATHVI BIRYANI LEAF 25GM,15,30,20,10,1
23-02-2025,"Dry Fruits, Nuts & Seeds",SATHVI CHIA SEEDS 100GM,2,100,80,20,1
23-02-2025,Spices & Seasonings,PRO ORG CUMIN 100G,15,176,176,0,1
23-02-2025,"Dry Fruits, Nuts & Seeds",PULMAKHANA 100 GM,2,180,170,10,1
23-02-2025,"Dry Fruits, Nuts & Seeds",SD Mango cubes 200gm,2,90,90,0,1
23-02-2025,Pooja & Spiritual Items,GD Yagnadhara 31PC,12,70,70,0,1
23-02-2025,Snacks & Ready-to-Eat,VD PALLI CHIKKI,14,80,80,0,1
23-02-2025,Sweeteners,GS JAGGERY NUGGETS 500GM,16,120,120,0,1
23-02-2025,Snacks & Ready-to-Eat,VD MURMURA LADDU,14,50,50,0,1
23-02-2025,"Grains, Flours & Dals",SH ROASTED SOOJI 500GM,4,66,59,7,1
23-02-2025,Snacks & Ready-to-Eat,RAJGIRA PEANUT CHIKKI,14,5,5,0,1
23-02-2025,Snacks & Ready-to-Eat,PEANUT CHILLI,14,5,5,0,1
23-02-2025,"Dry Fruits, Nuts & Seeds",SD Mango cubes 100gm,2,45,45,0,1
23-02-2025,"Grains, Flours & Dals",Chana Flour 500 gms,4,70,65,5,1
23-02-2025,Personal Care & Cosmetics,papaya soap,10,90,90,0,1
23-02-2025,Spices & Seasonings,MD Sonti Powder 50GM,15,80,80,0,1
23-02-2025,"Grains, Flours & Dals",RAGI FLOUR 1KG,4,80,70,10,1
23-02-2025,Pooja & Spiritual Items,GD WOODS 150GM,12,110,110,0,1
23-02-2025,Sweeteners,NATURAL HONEY 250GM,16,300,260,40,2
23-02-2025,"Grains, Flours & Dals",Multigrain 1 kg,4,200,170,30,2
23-02-2025,Personal Care & Cosmetics,aleova soap,10,90,90,0,1
23-02-2025,Oils & Ghee,Coconut oil 500 ml,9,220,200,20,1
23-02-2025,Pooja & Spiritual Items,GD Kumkum 50GM,12,30,30,0,1
23-02-2025,"Dry Fruits, Nuts & Seeds",MAHA BEERA SEEDS 100GM,2,60,60,0,1
23-02-2025,Personal Care & Cosmetics,GOW DURBAR 75G,10,60,60,0,1
23-02-2025,Oils & Ghee,Groundnut oil 1 L,9,720,660,60,2
23-02-2025,Pooja & Spiritual Items,GD Kumkum 50GM,12,60,60,0,2
23-02-2025,Oils & Ghee,Safflower oil 500 ml,9,220,200,20,1
23-02-2025,Household & Cleaning,PITAMBARI SHINING POWDER 200G,6,60,60,0,1
23-02-2025,"Grains, Flours & Dals",SL Suji Rava 500GM,4,32,32,0,1
23-02-2025,"Dry Fruits, Nuts & Seeds",Groundnuts 1 kg,2,380,340,40,2
23-02-2025,Spices & Seasonings,Menthulu 500 gms,15,100,90,10,1
23-02-2025,Spices & Seasonings,GARAM MASALA 200GM,15,120,95,25,1
23-02-2025,Household & Cleaning,ROOPERI PITAMBARI SILVER 50ML,6,110,110,0,1
23-02-2025,"Grains, Flours & Dals",DH URAD GOTA 1KG,4,215,190,25,1
23-02-2025,"Dry Fruits, Nuts & Seeds",SATHVI CHIA SEEDS 100GM,2,100,80,20,1
23-02-2025,Spices & Seasonings,GANGOTRI JAJU POWDER 40GM,15,7,7,0,1
23-02-2025,Oils & Ghee,Sesame oil 1 L,9,1180,"1,120.00",60,2
23-02-2025,Snacks & Ready-to-Eat,VD RICE PAPAD 150GM,14,50,50,0,1
23-02-2025,"Grains, Flours & Dals",SL Idly Rava 1KG,4,65,55,10,1
23-02-2025,Snacks & Ready-to-Eat,VD MURMURA LADDU,14,50,50,0,1
23-02-2025,"Grains, Flours & Dals",WHEAT 1 KG,4,15,12.5,2.5,0.25
23-02-2025,Beverages,BRU GREEN LABEL 1.2G,1,10,10,0,5
23-02-2025,"Grains, Flours & Dals",FLOUR CHARGE,4,48,48,0,4
23-02-2025,Snacks & Ready-to-Eat,VD PALLI CHIKKI,14,80,80,0,1
23-02-2025,Oils & Ghee,Safflower oil 1 L,9,440,400,40,1
23-02-2025,Oils & Ghee,Groundnut oil 1 L,9,360,330,30,1
23-02-2025,Oils & Ghee,Safflower oil 500 ml,9,220,200,20,1
23-02-2025,Oils & Ghee,Sesame oil 500ml,9,295,280,15,1
23-02-2025,"Dry Fruits, Nuts & Seeds",SATHVI CHIA SEEDS 100GM,2,100,80,20,1
23-02-2025,Oils & Ghee,Coconut oil 500 ml,9,220,200,20,1
23-02-2025,Oils & Ghee,Mustard oil 1 L,9,440,400,40,1
23-02-2025,Oils & Ghee,Groundnut oil 1 L,9,360,330,30,1
23-02-2025,Spices & Seasonings,SREE MARUTHI IDLY KARAM 200GM,15,60,60,0,1
23-02-2025,Spices & Seasonings,Chilli powder 500 gms,15,290,210,80,1
23-02-2025,Spices & Seasonings,Masala Karam 250 gms,15,130,120,10,1
23-02-2025,Pooja & Spiritual Items,SWASTIK CAMPHORE,12,90,90,0,1
23-02-2025,Pooja & Spiritual Items,GD Aiswarya Deepam 700ML,12,195,195,0,1
23-02-2025,"Dry Fruits, Nuts & Seeds",PUMPKIN SEEDS 250GM,2,200,160,40,1
23-02-2025,Beverages,REFRESH SHARBATH NORMAL,1,199,190,9,1
23-02-2025,Personal Care & Cosmetics,swastik gulab,10,145,72.5,72.5,1
23-02-2025,Beverages,BRU GREEN LABEL 1.2G,1,14,14,0,7
23-02-2025,Personal Care & Cosmetics,MARGO,10,90,84,6,2
23-02-2025,Oils & Ghee,Cow ghee 500 ml,9,430,390,40,1
23-02-2025,Oils & Ghee,Safflower oil 1 L,9,440,400,40,1
23-02-2025,Oils & Ghee,BUFFALLO GHEE 500ML,9,410,370,40,1
23-02-2025,Oils & Ghee,Cow ghee 500 ml,9,430,390,40,1
23-02-2025,"Grains, Flours & Dals",RICE FLOUR 500 GM,4,35,28,7,1
23-02-2025,Spices & Seasonings,Lavangam 50GM,15,60,50,10,1
23-02-2025,"Grains, Flours & Dals",sf moong whole,4,122,122,0,1
23-02-2025,Personal Care & Cosmetics,MADDI BATH POWDER 400GM,10,150,150,0,1
23-02-2025,"Dry Fruits, Nuts & Seeds",MAHA BEERA SEEDS 100GM,2,120,120,0,2
23-02-2025,"Grains, Flours & Dals",Idly Rava L 1KG,4,60,50,10,1
23-02-2025,"Grains, Flours & Dals",Wheat Rava S 1KG,4,65,55,10,1
23-02-2025,"Grains, Flours & Dals",FLOUR CHARGE,4,48,48,0,4
23-02-2025,"Dry Fruits, Nuts & Seeds",PULMAKHANA 100 GM,2,180,170,10,1
23-02-2025,Snacks & Ready-to-Eat,VD MINAPA VADIYAM,14,130,130,0,2
23-02-2025,Snacks & Ready-to-Eat,GS Instant Brown Rice Dosa Mix 400 GM,14,120,120,0,1
23-02-2025,"Grains, Flours & Dals",WHEAT 1 KG,4,240,200,40,4
23-02-2025,Snacks & Ready-to-Eat,COPRA LADDU 200GM,14,100,80,20,1
23-02-2025,Snacks & Ready-to-Eat,BATANA NGT 70GMS,14,20,20,0,1
23-02-2025,Oils & Ghee,Groundnut oil 1 L,9,720,660,60,2
23-02-2025,"Grains, Flours & Dals",SAMALU (Little millet) 500 gms,4,85,65,20,1
23-02-2025,"Grains, Flours & Dals",BASMATHI RICE 1KG,4,150,135,15,1
23-02-2025,Snacks & Ready-to-Eat,VD PALLI CHIKKI,14,80,80,0,1
23-02-2025,Snacks & Ready-to-Eat,VD NUVULU LADDU 9PIC,14,100,100,0,1
23-02-2025,Snacks & Ready-to-Eat,VD MURMURA LADDU,14,50,50,0,1
23-02-2025,"Grains, Flours & Dals",Bajra Flour 1 kg,4,70,60,10,1
23-02-2025,"Health, Wellness & Ayurvedic Products",MD Triphala Chorrnam 100GM,5,80,80,0,1
23-02-2025,Spices & Seasonings,DHANIYA POWDER 200GM,15,100,85,15,1
23-02-2025,Oils & Ghee,Coconut oil 1 L,9,440,400,40,1
23-02-2025,Spices & Seasonings,YB PINK ROCK SALT 1KG,15,120,120,0,1
23-02-2025,Spices & Seasonings,Jeera 100GM,15,50,45,5,1
23-02-2025,Spices & Seasonings,Gasagasalu 50GM,15,130,110,20,1
23-02-2025,"Dry Fruits, Nuts & Seeds",FLAX SEEDS 250GM,2,60,50,10,1
23-02-2025,Oils & Ghee,Safflower oil 1 L,9,440,400,40,1
23-02-2025,Spices & Seasonings,Masala Karam 500 gms,15,260,240,20,1
23-02-2025,Oils & Ghee,Sesame oil 1 L,9,590,560,30,1
23-02-2025,"Grains, Flours & Dals",split green gram 500 gms,4,75,70,5,1
23-02-2025,Milk & Dairy,BROWN EGGS 1P,7,210,180,30,15
23-02-2025,Oils & Ghee,Groundnut oil 1 L,9,360,330,30,1
23-02-2025,Spices & Seasonings,DHANIYA POWDER 200GM,15,100,85,15,1
23-02-2025,"Grains, Flours & Dals",POORI ATTA 500GM,4,35,30,5,1
23-02-2025,Oils & Ghee,Sesame oil 500ml,9,295,280,15,1
23-02-2025,Sweeteners,YB FOREST HONEY 250GM,16,180,180,0,1
23-02-2025,"Grains, Flours & Dals",JOWAR WHITE 1 KG,4,80,70,10,1
23-02-2025,Snacks & Ready-to-Eat,VD SAGOPAPAD 150GM,14,55,55,0,1
23-02-2025,Spices & Seasonings,Chilli powder 500 gms,15,290,210,80,1
23-02-2025,Oils & Ghee,Sesame oil 1 L,9,590,560,30,1
23-02-2025,Oils & Ghee,Safflower oil 1 L,9,440,400,40,1
23-02-2025,Snacks & Ready-to-Eat,SD Thati thandra 200gm,14,150,150,0,1
23-02-2025,Milk & Dairy,HERITAGE TOTAL CURD 500GM,7,50,50,0,1
23-02-2025,Household & Cleaning,VIM COOLING FRESHNESS MINT,6,15,15,0,1
23-02-2025,Oils & Ghee,Castor oil 200 ml,9,100,80,20,1
23-02-2025,"Grains, Flours & Dals",KORRALU (FOXTAIL M) 1KG,4,150,110,40,1
23-02-2025,Snacks & Ready-to-Eat,VD MURMURA LADDU,14,50,50,0,1
23-02-2025,"Grains, Flours & Dals",Multigrain 1 kg,4,100,85,15,1
23-02-2025,Oils & Ghee,Sesame oil 1 L,9,590,560,30,1
23-02-2025,"Grains, Flours & Dals",Multigrain 1 kg,4,100,85,15,1
23-02-2025,"Grains, Flours & Dals",RAGI FLOUR 500GRMS,4,40,35,5,1
23-02-2025,Personal Care & Cosmetics,DETTOL SANITIZER,10,47,30,17,1
23-02-2025,Oils & Ghee,Sesame oil 500ml,9,295,280,15,1
23-02-2025,"Grains, Flours & Dals",Chana Flour 500 gms,4,70,65,5,1
23-02-2025,"Grains, Flours & Dals",VGR RICE bag 1,4,1899,"1,650.00",249,1
23-02-2025,Spices & Seasonings,ROYAL SAFFRON,15,125,125,0,1
23-02-2025,Snacks & Ready-to-Eat,RSC ORANGE 100GMS,14,20,20,0,1
23-02-2025,Snacks & Ready-to-Eat,VD PALLI LADDU,14,80,80,0,1
23-02-2025,"Grains, Flours & Dals",Chittimuthaylu rice 1 kg,4,160,140,20,1
23-02-2025,"Grains, Flours & Dals",KORRALU (FOXTAIL M) 500GM,4,65,55,10,1
23-02-2025,"Grains, Flours & Dals",Arikalu (kodo),4,70,65,5,1
23-02-2025,"Grains, Flours & Dals",BASMATHI RICE 1KG,4,150,135,15,1
23-02-2025,"Grains, Flours & Dals",SAMALU (Little millet) 500 gms,4,85,65,20,1
23-02-2025,"Grains, Flours & Dals",idly/Dosa rice 1 kg,4,70,60,10,1
23-02-2025,Snacks & Ready-to-Eat,VD MURMURA LADDU,14,50,50,0,1
23-02-2025,"Dry Fruits, Nuts & Seeds",FLAX SEEDS 250GM,2,60,50,10,1
23-02-2025,"Grains, Flours & Dals",SL Idly Rava 1KG,4,65,55,10,1
23-02-2025,"Dry Fruits, Nuts & Seeds",SUNFLOWER SEEDS 250GRM,2,150,130,20,1
23-02-2025,"Grains, Flours & Dals",FLOUR CHARGE,4,24,24,0,2
23-02-2025,"Grains, Flours & Dals",AISHWARYA SP 1KG,4,400,350,50,5
23-02-2025,Snacks & Ready-to-Eat,VD MINAPA VADIYAM,14,65,65,0,1
23-02-2025,"Grains, Flours & Dals",split urad dall 250 gms,4,45,40,5,1
23-02-2025,"Grains, Flours & Dals",CHANA DAL 500GM,4,70,60,10,1
23-02-2025,Snacks & Ready-to-Eat,GROUNDNUT LADDU WITH DATES,14,135,135,0,1
23-02-2025,"Dry Fruits, Nuts & Seeds",Groundnuts 1 kg,2,190,170,20,1
23-02-2025,Spices & Seasonings,Coriander seeds 200 gms,15,48,40,8,1
23-02-2025,"Grains, Flours & Dals",UDALU (Barnyard millet) 1 kg,4,140,115,25,1
23-02-2025,"Grains, Flours & Dals",SB Javva Wheat Ravva 500GM,4,95,95,0,1
23-02-2025,Personal Care & Cosmetics,COLGATE ACTIVE SALT,10,40,40,0,2
23-02-2025,Oils & Ghee,Groundnut oil 1 L,9,360,330,30,1
23-02-2025,"Grains, Flours & Dals",BOBBARA PAPPU 500GM,4,85,80,5,1
23-02-2025,Personal Care & Cosmetics,HERBAL BATH POWDER 200GM,10,80,80,0,1
23-02-2025,Personal Care & Cosmetics,boroline,10,45,45,0,1
23-02-2025,"Grains, Flours & Dals",SABDANA 500GM,4,90,70,20,1
23-02-2025,"Grains, Flours & Dals",THICK POHA 1KG,4,80,70,10,1
23-02-2025,Spices & Seasonings,NUVVULU 250GM,15,80,65,15,1
23-02-2025,"Grains, Flours & Dals",RAGI FLOUR 500GRMS,4,40,35,5,1
23-02-2025,"Grains, Flours & Dals",Bajra Flour 500 gms,4,35,30,5,1
23-02-2025,Sweeteners,GS Organic Jaggery Powder 600GM,16,99,99,0,1
23-02-2025,Oils & Ghee,Coconut oil 500 ml,9,220,200,20,1
23-02-2025,Spices & Seasonings,DRY MIECHI 200GM,15,80,60,20,1
23-02-2025,"Grains, Flours & Dals",AISHWARYA SP 1KG,4,80,70,10,1
23-02-2025,"Grains, Flours & Dals",turdal 1kg,4,660,585,75,3
23-02-2025,Oils & Ghee,Groundnut oil 1 L,9,720,660,60,2
23-02-2025,"Grains, Flours & Dals",SINGLE POLISH 1KG,4,195,195,0,3
23-02-2025,Oils & Ghee,Groundnut oil 1 L,9,720,660,60,2
23-02-2025,"Grains, Flours & Dals",turdal 1kg,4,220,195,25,1
23-02-2025,Spices & Seasonings,Jeera 100GM,15,50,45,5,1
23-02-2025,Spices & Seasonings,Tamarind 250GMS,15,75,75,0,1
23-02-2025,Oils & Ghee,Coconut oil 500 ml,9,220,200,20,1
23-02-2025,"Grains, Flours & Dals",Urad dall 1 Kg,4,185,170,15,1
23-02-2025,"Dry Fruits, Nuts & Seeds",Groundnuts 1 kg,2,190,170,20,1
23-02-2025,Spices & Seasonings,Turmeric powder 250 gms,15,100,75,25,1
23-02-2025,Snacks & Ready-to-Eat,VD PALLI CHIKKI,14,80,80,0,1
23-02-2025,Oils & Ghee,Coconut oil 1 L,9,440,400,40,1
23-02-2025,Snacks & Ready-to-Eat,PALLI LADDU 200GMS,14,80,60,20,1
23-02-2025,"Grains, Flours & Dals",VYS.SP RICE 1 KG,4,350,325,25,5
23-02-2025,Oils & Ghee,Groundnut oil 1 L,9,360,330,30,1
23-02-2025,Snacks & Ready-to-Eat,COPRA LADDU 200GM,14,100,80,20,1
23-02-2025,Snacks & Ready-to-Eat,SD Sesame laddu with dates250gm,14,135,135,0,1
23-02-2025,Snacks & Ready-to-Eat,GROUNDNUT LADDU WITH DATES,14,135,135,0,1
23-02-2025,"Grains, Flours & Dals",VYS.SP.RICE BAG 1,4,1800,"1,650.00",150,1
23-02-2025,"Grains, Flours & Dals",AISHWARYA SP 25KG,4,1999,"1,690.00",309,1
23-02-2025,Snacks & Ready-to-Eat,Popcorn Seeds 250GM,14,45,40,5,1
23-02-2025,Snacks & Ready-to-Eat,ELITE MILK RUSK 200GM,14,35,35,0,1
23-02-2025,"Dry Fruits, Nuts & Seeds",ALMONDS 250GM,2,280,260,20,1
23-02-2025,Pooja & Spiritual Items,GD Aiswarya Deepam 700ML,12,195,195,0,1
23-02-2025,Oils & Ghee,Groundnut oil 1 L,9,360,330,30,1
23-02-2025,Pooja & Spiritual Items,SWATHI POOJA VATHULU,12,50,50,0,1
23-02-2025,Pooja & Spiritual Items,VRP APOORVA JAVADHU POW,12,35,35,0,1
23-02-2025,Personal Care & Cosmetics,DWIBHASHI GULABA ARKA ROSA WATER,10,60,60,0,1
23-02-2025,Sweeteners,MISHRI 250 GM,16,35,30,5,1
23-02-2025,General Household & Kitchenware,CANDLE,3,120,120,0,4
23-02-2025,Personal Care & Cosmetics,MYSORE SANDAL SOAP 75G,10,45,45,0,1
23-02-2025,Household & Cleaning,TIDE DOUBLE POWER JASMINE &amp;ROSE,6,66,66,0,1
23-02-2025,Pooja & Spiritual Items,AMRUTHA SURABHI,12,80,80,0,1
23-02-2025,"Grains, Flours & Dals",SINGLE POLISH 1KG,4,130,130,0,2
23-02-2025,Snacks & Ready-to-Eat,VD MULTI CHAKKA,14,220,220,0,2
23-02-2025,Snacks & Ready-to-Eat,VD Pappu Chekkalu 190gm,14,60,60,0,1
23-02-2025,Spices & Seasonings,EV Chicken Masala 50GM,15,48,48,0,1
23-02-2025,Spices & Seasonings,Masala Karam 250 gms,15,130,120,10,1
23-02-2025,Milk & Dairy,HERITAGE TONED MILK 500ML,7,31,31,0,1
23-02-2025,"Dry Fruits, Nuts & Seeds",SABJA SEEDS 100GM,2,80,70,10,1
23-02-2025,Milk & Dairy,HERITAGE TOTAL CURD 500GM,7,50,50,0,1
23-02-2025,"Grains, Flours & Dals",Green gram 1 kg,4,150,130,20,1
23-02-2025,"Health, Wellness & Ayurvedic Products",RB Max Protein Choco Berry bar 50g,5,75,75,0,1
23-02-2025,"Grains, Flours & Dals",Red uluvalu 500 gms,4,90,75,15,1
23-02-2025,"Grains, Flours & Dals",Wheat Flour 1 kg,4,140,120,20,2
23-02-2025,"Grains, Flours & Dals",RAGI FLOUR 500GRMS,4,40,35,5,1
23-02-2025,"Grains, Flours & Dals",RAGULU 1 KG,4,35,30,5,0.5
23-02-2025,Spices & Seasonings,ROYAL SAFFRON,15,125,125,0,1
23-02-2025,"Grains, Flours & Dals",BARLEY SEEDS 250GMS,4,40,35,5,1
23-02-2025,Spices & Seasonings,DURGA SALT CRYSTAL 1KG,15,25,25,0,1
23-02-2025,"Grains, Flours & Dals",Chana Flour 500 gms,4,70,65,5,1
23-02-2025,"Dry Fruits, Nuts & Seeds",ALBUKARA 250GM,2,145,120,25,1
23-02-2025,"Grains, Flours & Dals",Brown RICE 1KG,4,210,195,15,3
23-02-2025,Snacks & Ready-to-Eat,VD PALLI LADDU,14,160,160,0,2
23-02-2025,Oils & Ghee,Sesame oil 1 L,9,590,560,30,1
23-02-2025,"Grains, Flours & Dals",DH URAD GOTA 1KG,4,430,380,50,2
23-02-2025,"Grains, Flours & Dals",Idly Rava L 1KG,4,120,100,20,2
23-02-2025,"Dry Fruits, Nuts & Seeds",Groundnuts 1 kg,2,380,340,40,2
23-02-2025,Oils & Ghee,Groundnut oil 1 L,9,360,330,30,1
23-02-2025,Oils & Ghee,Black Sesame oil 500 ml,9,220,190,30,1
23-02-2025,"Grains, Flours & Dals",turdal 1kg,4,440,390,50,2
23-02-2025,Oils & Ghee,Groundnut oil 500ml,9,180,165,15,1
23-02-2025,Spices & Seasonings,Karakaya,15,100,100,0,2
23-02-2025,Sweeteners,NATURAL HONEY 250GM,16,150,130,20,1
23-02-2025,"Grains, Flours & Dals",Quinova 1 kg,4,220,195,25,1
23-02-2025,Spices & Seasonings,Jeera 100GM,15,100,90,10,2
23-02-2025,"Grains, Flours & Dals",Wheat Flour 1 kg,4,350,300,50,5
23-02-2025,"Grains, Flours & Dals",THICK POHA 1KG,4,160,140,20,2
23-02-2025,"Grains, Flours & Dals",Red Bobarlu 500 gms,4,95,85,10,1
23-02-2025,"Grains, Flours & Dals",RICE FLOUR 1KG,4,210,165,45,3
23-02-2025,"Grains, Flours & Dals",UDALU (Barnyard millet) 1 kg,4,140,115,25,1
23-02-2025,"Grains, Flours & Dals",KORRALU (FOXTAIL M) 1KG,4,150,110,40,1
23-02-2025,"Grains, Flours & Dals",turdal 1kg,4,660,585,75,3
23-02-2025,"Grains, Flours & Dals",White Chana 500GM,4,120,100,20,1
23-02-2025,"Grains, Flours & Dals",SAMALU (Little millet) 1 kg,4,170,130,40,1
23-02-2025,"Grains, Flours & Dals",SINGLE POLISH 1KG,4,65,65,0,1
23-02-2025,"Dry Fruits, Nuts & Seeds",Groundnuts 1 kg,2,190,170,20,1
23-02-2025,Spices & Seasonings,DRY MIECHI 200GM,15,80,60,20,1
23-02-2025,"Grains, Flours & Dals",CHANA DAL 500GM,4,140,120,20,2
23-02-2025,"Grains, Flours & Dals",white Bobarlu 500 gms,4,80,75,5,1
23-02-2025,"Grains, Flours & Dals",Green gram 1 kg,4,150,130,20,1
23-02-2025,"Grains, Flours & Dals",PESARA PAPPU 1 KG,4,170,145,25,1
23-02-2025,Oils & Ghee,Coconut oil 500 ml,9,220,200,20,1
23-02-2025,Pooja & Spiritual Items,GD Camphor 50GM,12,115,115,0,1
23-02-2025,"Grains, Flours & Dals",turdal 1kg,4,220,195,25,1
23-02-2025,Snacks & Ready-to-Eat,Sprouted Ragi Biscuits 450GM,14,150,150,0,1
23-02-2025,"Grains, Flours & Dals",RAGULU 1 KG,4,70,60,10,1
23-02-2025,"Grains, Flours & Dals",DISANO OATS 1KG,4,285,142.5,142.5,1
23-02-2025,"Grains, Flours & Dals",SL Idly Rava 1KG,4,65,55,10,1
23-02-2025,Milk & Dairy,HERITAGE TOTAL CURD 500GM,7,50,50,0,1
23-02-2025,"Grains, Flours & Dals",POORI ATTA 500GM,4,35,30,5,1
23-02-2025,"Dry Fruits, Nuts & Seeds",SATHVI CHIA SEEDS 100GM,2,100,80,20,1
23-02-2025,Oils & Ghee,Coconut oil 500 ml,9,220,200,20,1
23-02-2025,Snacks & Ready-to-Eat,VD PALLI CHIKKI,14,80,80,0,1
23-02-2025,Personal Care & Cosmetics,MADDI BATH POWDER 400GM,10,150,150,0,1
23-02-2025,Spices & Seasonings,Japatri 25GM,15,100,80,20,1
23-02-2025,Spices & Seasonings,SATHVI ANASAPUVUU 25GM,15,90,65,25,1
23-02-2025,Spices & Seasonings,Biryani Leaf 25GM,15,30,30,0,1
23-02-2025,Pooja & Spiritual Items,JAGI KAYA 25GM,12,80,60,20,1
23-02-2025,Spices & Seasonings,kasturi methi,15,60,60,0,1
23-02-2025,Pooja & Spiritual Items,BANDA PUVVU 25GM 25GM,12,80,60,20,1
23-02-2025,Spices & Seasonings,Gasagasalu 50GM,15,130,110,20,1
23-02-2025,Milk & Dairy,BROWN EGGS 1P,7,210,180,30,15
23-02-2025,Spices & Seasonings,GS Pink Rock Salt 1KG,15,120,120,0,1
23-02-2025,"Grains, Flours & Dals",DOCTOR RICE DIABETIC SFR 1KG,4,600,600,0,5
23-02-2025,Spices & Seasonings,SWASTIKS GINGER&amp;GARLIC,15,49,49,0,1
23-02-2025,Milk & Dairy,SANGAM TONED MILK 500ML,7,90,90,0,3
23-02-2025,"Dry Fruits, Nuts & Seeds",Groundnuts 1 kg,2,190,170,20,1
23-02-2025,"Grains, Flours & Dals",Wheat Rava M 1KG,4,65,55,10,1
23-02-2025,Sweeteners,YB Brown Sugar 1KG,16,140,140,0,1
23-02-2025,Spices & Seasonings,YB Rock Salt 1KG,15,120,120,0,1
23-02-2025,"Dry Fruits, Nuts & Seeds",Putnalu 250GM,2,45,38,7,1
23-02-2025,"Health, Wellness & Ayurvedic Products",RB Max Protein Choco Berry bar 50g,5,150,150,0,2
23-02-2025,Oils & Ghee,Groundnut oil 5 L,9,1800,"1,600.00",200,1
23-02-2025,"Grains, Flours & Dals",AISHWARYA SP 25KG,4,1999,"1,690.00",309,1
23-02-2025,Milk & Dairy,BROWN EGGS 1P,7,224,192,32,16
23-02-2025,Snacks & Ready-to-Eat,VD RICE MURUKU 150GM,14,100,100,0,2
23-02-2025,Oils & Ghee,Safflower oil 1 L,9,440,400,40,1
23-02-2025,Pooja & Spiritual Items,GD JASMINE 75GM,12,60,60,0,1
23-02-2025,"Grains, Flours & Dals",Idly Rava L 1KG,4,120,100,20,2
23-02-2025,"Dry Fruits, Nuts & Seeds",Groundnuts 1 kg,2,380,340,40,2
23-02-2025,Personal Care & Cosmetics,GOW DURBAR 75G,10,60,60,0,1
23-02-2025,Pooja & Spiritual Items,GD Aiswarya Deepam 700ML,12,390,390,0,2
23-02-2025,Oils & Ghee,Groundnut oil 1 L,9,720,660,60,2
23-02-2025,"Health, Wellness & Ayurvedic Products",RB Max Protein Salt & Caramel Bar 50g,5,75,75,0,1
23-02-2025,"Grains, Flours & Dals",Wheat Flour 1 kg,4,70,60,10,1
23-02-2025,Oils & Ghee,Safflower oil 1 L,9,440,400,40,1
23-02-2025,"Grains, Flours & Dals",Multigrain 1 kg,4,100,85,15,1
23-02-2025,Beverages,BRU GREEN LABEL 1.2G,1,10,10,0,5
23-02-2025,"Grains, Flours & Dals",Multigrain 1 kg,4,200,170,30,2
23-02-2025,"Grains, Flours & Dals",Wheat Flour 1 kg,4,70,60,10,1
23-02-2025,"Grains, Flours & Dals",SABDANA 500GM,4,90,70,20,1
23-02-2025,"Grains, Flours & Dals",THICK POHA 500GM,4,40,35,5,1
23-02-2025,Milk & Dairy,SANGAM CURD 450GM,7,38,38,0,1
23-02-2025,Snacks & Ready-to-Eat,BB VERMICELLY 500GM,14,53,53,0,1
23-02-2025,Snacks & Ready-to-Eat,VD SAGOPAPAD 150GM,14,55,55,0,1
23-02-2025,Milk & Dairy,SANGAM TONED MILK 500ML,7,60,60,0,2
23-02-2025,Spices & Seasonings,Turmeric powder 250 gms,15,100,75,25,1
23-02-2025,"Dry Fruits, Nuts & Seeds",SATHVI CHIA SEEDS 100GM,2,100,80,20,1
23-02-2025,"Grains, Flours & Dals",Wheat Flour 2 kgs,4,280,240,40,2
23-02-2025,Oils & Ghee,Safflower oil 1 L,9,880,800,80,2
23-02-2025,"Grains, Flours & Dals",Wheat Rava S 1KG,4,130,110,20,2
23-02-2025,Spices & Seasonings,SH BAY LEAF / TEJ PATTA 30GM,15,35,35,0,1
23-02-2025,"Grains, Flours & Dals",UDALU (Barnyard millet) 500 gms,4,70,60,10,1
23-02-2025,"Grains, Flours & Dals",RAGI FLOUR 500GRMS,4,40,35,5,1
23-02-2025,"Grains, Flours & Dals",SAMALU (Little millet) 1 kg,4,170,130,40,1
23-02-2025,"Grains, Flours & Dals",Bajra Flour 1 kg,4,70,60,10,1
23-02-2025,"Grains, Flours & Dals",Em Little idli R 500g,4,129,129,0,1
23-02-2025,"Grains, Flours & Dals",Quinova 500 gms,4,110,100,10,1
23-02-2025,"Grains, Flours & Dals",split black gram 1 kg,4,180,170,10,1
23-02-2025,"Grains, Flours & Dals",White jowar.F 1 kg,4,100,80,20,1
23-02-2025,"Grains, Flours & Dals",Arikalu (kodo),4,70,65,5,1
23-02-2025,Snacks & Ready-to-Eat,BD LITTLE MILLET NOODLES 200G,14,75,75,0,1
23-02-2025,Personal Care & Cosmetics,Soapnut 250GM,10,120,90,30,2
23-02-2025,Oils & Ghee,Sesame oil 500ml,9,590,560,30,2
23-02-2025,"Grains, Flours & Dals",Multigrain 1 kg,4,100,85,15,1
23-02-2025,Oils & Ghee,Mustard oil 500 ml,9,220,195,25,1
23-02-2025,Milk & Dairy,ID PANEER,7,135,135,0,1
23-02-2025,Beverages,TAJ MAHAL 250GM,1,235,235,0,1
23-02-2025,Oils & Ghee,Groundnut oil 1 L,9,1080,990,90,3
23-02-2025,"Grains, Flours & Dals",Bombay Rava 500GM,4,35,30,5,1
23-02-2025,Snacks & Ready-to-Eat,VD MINAPA VADIYAM,14,65,65,0,1
23-02-2025,Snacks & Ready-to-Eat,VD DAHI MIRCHI(SALTED) 100GM,14,45,45,0,1
23-02-2025,Snacks & Ready-to-Eat,VD Minapa papad 200gm,14,60,60,0,1
23-02-2025,Household & Cleaning,VIM TROPICAL LEMON FRESHNESS 250ML,6,55,55,0,1
23-02-2025,Household & Cleaning,SRFR EXCEL,6,30,30,0,3
23-02-2025,"Grains, Flours & Dals",RAGI FLOUR 500GRMS,4,40,35,5,1
23-02-2025,Milk & Dairy,BROWN EGGS 1P,7,140,120,20,10
23-02-2025,"Grains, Flours & Dals",VL Sabdana 500GM,4,77,77,0,1
22-02-2025,"Dry Fruits, Nuts & Seeds",ANJEER 250GM,2,400,360,40,1
22-02-2025,"Grains, Flours & Dals",Arikadu ( kodo),4,140,130,10,1
22-02-2025,"Dry Fruits, Nuts & Seeds",SUNFLOWER SEEDS 250GRM,2,150,130,20,1
22-02-2025,"Dry Fruits, Nuts & Seeds",PLAIN PISTA 250GM,2,660,550,110,1
22-02-2025,"Grains, Flours & Dals",KORRALU (FOXTAIL M) 1KG,4,150,110,40,1
22-02-2025,"Dry Fruits, Nuts & Seeds",FLAX SEEDS 250GM,2,60,50,10,1
22-02-2025,"Dry Fruits, Nuts & Seeds",PUMPKIN SEEDS 250GM,2,200,160,40,1
22-02-2025,"Dry Fruits, Nuts & Seeds",WATERMELON SEEDS 250GRM,2,320,280,40,1
22-02-2025,"Grains, Flours & Dals",ANDU KORRALU (Browntop.m) 1 kg,4,260,220,40,1
22-02-2025,"Dry Fruits, Nuts & Seeds",WALLNUTS 250GM,2,380,360,20,1
22-02-2025,"Grains, Flours & Dals",Multigrain 1 kg,4,200,170,30,2
22-02-2025,Snacks & Ready-to-Eat,SD FINGER Millet with palm Jaggery 250gm,14,135,135,0,1
22-02-2025,Snacks & Ready-to-Eat,VD MURMURA LADDU,14,50,50,0,1
22-02-2025,Snacks & Ready-to-Eat,VD NUVVULU LADDU,14,80,80,0,1
22-02-2025,Snacks & Ready-to-Eat,VD PAPPU CHEGODI 200GM,14,60,60,0,1
22-02-2025,"Grains, Flours & Dals",Multigrain 1 kg,4,100,85,15,1
22-02-2025,"Grains, Flours & Dals",RAGI FLOUR 500GRMS,4,40,35,5,1
22-02-2025,"Health, Wellness & Ayurvedic Products",MH Millets Malt 500GM,5,200,190,10,1
22-02-2025,Oils & Ghee,BUFFALLO GHEE 500ML,9,410,370,40,1
22-02-2025,"Grains, Flours & Dals",BASMATHI RICE 1KG,4,150,135,15,1
22-02-2025,Snacks & Ready-to-Eat,SD Atreyapuram DRY Fruit ghee,14,150,150,0,1
22-02-2025,"Health, Wellness & Ayurvedic Products",VAMU WATER,5,70,70,0,1
22-02-2025,"Grains, Flours & Dals",KORRALU (FOXTAIL M) 1KG,4,150,110,40,1
22-02-2025,"Grains, Flours & Dals",Wheat Flour 1 kg,4,140,120,20,2
22-02-2025,"Grains, Flours & Dals",Chana Flour 500 gms,4,70,65,5,1
22-02-2025,"Grains, Flours & Dals",JOWAR WHITE 1 KG,4,80,70,10,1
22-02-2025,"Dry Fruits, Nuts & Seeds",SD Mango cubes 100gm,2,45,45,0,1
22-02-2025,Snacks & Ready-to-Eat,PEANUT CHILLI,14,10,10,0,2
22-02-2025,Snacks & Ready-to-Eat,SD Thati thandra 200gm,14,150,150,0,1
22-02-2025,Personal Care & Cosmetics,YB Bath Powder 200GM,10,100,100,0,1
22-02-2025,"Grains, Flours & Dals",Multigrain 1 kg,4,100,85,15,1
22-02-2025,Snacks & Ready-to-Eat,SD Flax seeds with dates 250gm,14,135,135,0,1
22-02-2025,Snacks & Ready-to-Eat,SD Moringa with plam jaggery 250gm,14,270,270,0,2
22-02-2025,Snacks & Ready-to-Eat,VD PALLI LADDU,14,240,240,0,3
22-02-2025,Snacks & Ready-to-Eat,VD PALLI CHIKKI,14,80,80,0,1
22-02-2025,Snacks & Ready-to-Eat,SD KODO MILLET WITH PALM JAGGERY,14,135,135,0,1
22-02-2025,Oils & Ghee,Groundnut oil 1 L,9,360,330,30,1
22-02-2025,Snacks & Ready-to-Eat,COPRA LADDU 200GM,14,100,80,20,1
22-02-2025,Snacks & Ready-to-Eat,VD ATUKULU MIXTURE 175GM,14,60,60,0,1
22-02-2025,Snacks & Ready-to-Eat,VD PAPPU CHEGODI 200GM,14,60,60,0,1
22-02-2025,Spices & Seasonings,Chilli powder 1 kg,15,580,420,160,1
22-02-2025,Snacks & Ready-to-Eat,SALTED PHALLI,14,25,25,0,1
22-02-2025,Snacks & Ready-to-Eat,VD PALLI LADDU,14,80,80,0,1
22-02-2025,"Grains, Flours & Dals",SA YELLOW JOWAR RAVA 500GM,4,285,285,0,3
22-02-2025,"Dry Fruits, Nuts & Seeds",SUNFLOWER SEEDS 250GRM,2,150,130,20,1
22-02-2025,Spices & Seasonings,NUVVULU 250GM,15,80,65,15,1
22-02-2025,"Dry Fruits, Nuts & Seeds",PUMPKIN SEEDS 250GM,2,200,160,40,1
22-02-2025,"Dry Fruits, Nuts & Seeds",FLAX SEEDS 250GM,2,60,50,10,1
22-02-2025,"Dry Fruits, Nuts & Seeds",WATERMELON SEEDS 250GRM,2,320,280,40,1
22-02-2025,"Health, Wellness & Ayurvedic Products",MXP CHOCO CLASSIC BAR,5,70,70,0,1
22-02-2025,Snacks & Ready-to-Eat,ZEEDI,14,70,70,0,1
22-02-2025,Personal Care & Cosmetics,KHADI COCONUT,10,90,90,0,1
22-02-2025,"Grains, Flours & Dals",CHANA DAL 500GM,4,70,60,10,1
22-02-2025,Personal Care & Cosmetics,SVE REETHA KUNKUDUKAYALU,10,199,199,0,1
22-02-2025,"Dry Fruits, Nuts & Seeds",DRYDATES YELLOW 250GM,2,135,120,15,1
22-02-2025,"Grains, Flours & Dals",RICE FLOUR 1KG,4,70,55,15,1
22-02-2025,"Grains, Flours & Dals",RICE FLOUR 500 GM,4,35,28,7,1
22-02-2025,Snacks & Ready-to-Eat,PEANUT CHIKKI 450GM,14,125,125,0,1
22-02-2025,"Grains, Flours & Dals",BASMATHI RICE 1KG,4,150,135,15,1
22-02-2025,Snacks & Ready-to-Eat,NGT CHATPATTA CHANA 90GM,14,50,50,0,2
22-02-2025,Snacks & Ready-to-Eat,VD ATUKULU MIXTURE 175GM,14,60,60,0,1
22-02-2025,Snacks & Ready-to-Eat,VD MULTI CHAKKA,14,110,110,0,1
22-02-2025,Snacks & Ready-to-Eat,ZEEDI,14,70,70,0,1
22-02-2025,Snacks & Ready-to-Eat,VD MIXTURE 175 GM,14,60,60,0,1
22-02-2025,Snacks & Ready-to-Eat,VD MURMURA LADDU,14,50,50,0,1
22-02-2025,"Grains, Flours & Dals",Wheat Rava S 500GM,4,33,30,3,1
22-02-2025,Snacks & Ready-to-Eat,COPRA LADDU 200GM,14,200,160,40,2
22-02-2025,Personal Care & Cosmetics,ORAL B KIDS,10,25,25,0,1
22-02-2025,Snacks & Ready-to-Eat,VD PALLI LADDU,14,80,80,0,1
22-02-2025,Personal Care & Cosmetics,UVIS CHARCOAL SOAP 100GM,10,85,85,0,1
22-02-2025,Snacks & Ready-to-Eat,Popcorn Seeds 250GM,14,45,40,5,1
22-02-2025,Snacks & Ready-to-Eat,VD PALLI CHIKKI,14,80,80,0,1
22-02-2025,"Grains, Flours & Dals",Arikalu (kodo),4,70,65,5,1
22-02-2025,"Grains, Flours & Dals",KORRALU (FOXTAIL M) 500GM,4,65,55,10,1
22-02-2025,Sweeteners,MISHRI 250 GM,16,35,30,5,1
22-02-2025,Snacks & Ready-to-Eat,BATANA NGT 70GMS,14,20,20,0,1
22-02-2025,Snacks & Ready-to-Eat,NGT CHATPATTA CHANA 90GM,14,25,25,0,1
22-02-2025,Snacks & Ready-to-Eat,RB Choco Delite Almonds Raisins 40g,14,45,45,0,1
22-02-2025,"Health, Wellness & Ayurvedic Products",RB Nuts& Seeds cashews 35g,5,45,45,0,1
22-02-2025,"Grains, Flours & Dals",RAGI FLOUR 1KG,4,80,70,10,1
22-02-2025,Beverages,GANTASALA TEJ DRY GINGER COFFEE,1,149,149,0,1
22-02-2025,Spices & Seasonings,NUVVULU 250GM,15,100,85,15,1
22-02-2025,"Grains, Flours & Dals",RAGI FLOUR 500GRMS,4,40,35,5,1
22-02-2025,"Grains, Flours & Dals",Wheat Flour 1 kg,4,70,60,10,1
22-02-2025,Sweeteners,YB FOREST HONEY 250GM,16,180,180,0,1
22-02-2025,Snacks & Ready-to-Eat,GB SALT COOKIES,14,60,55,5,1
22-02-2025,Pooja & Spiritual Items,GD Aiswarya Deepam 700ML,12,390,390,0,2
22-02-2025,"Dry Fruits, Nuts & Seeds",SD Mango cubes 200gm,2,90,90,0,1
22-02-2025,Sweeteners,GS JAGGERY NUGGETS 500GM,16,120,120,0,1
22-02-2025,"Health, Wellness & Ayurvedic Products",MH Millets Milk Powder 250GM,5,250,250,0,1
22-02-2025,Snacks & Ready-to-Eat,VD Pappu Chekkalu 190gm,14,60,60,0,1
22-02-2025,Snacks & Ready-to-Eat,GANTASALA GINGER CANDY 200GM,14,105,105,0,1
22-02-2025,Snacks & Ready-to-Eat,SH PUFFED RICE 500GM,14,112,112,0,1
22-02-2025,Snacks & Ready-to-Eat,GS WHEAT GRASS BISCUITS 250GM,14,130,130,0,1
22-02-2025,Snacks & Ready-to-Eat,Sprouted Ragi Biscuits 450GM,14,150,150,0,1
22-02-2025,Snacks & Ready-to-Eat,VD GUMMADI CHAKKA,14,130,130,0,1
22-02-2025,Snacks & Ready-to-Eat,SESAME CHIKKI,14,120,100,20,1
22-02-2025,"Grains, Flours & Dals",RAGI FLOUR 1KG,4,160,140,20,2
22-02-2025,"Health, Wellness & Ayurvedic Products",RB Max Protein Spanish Tomato,5,45,45,0,1
22-02-2025,Snacks & Ready-to-Eat,SD Thati thandra 200gm,14,150,150,0,1
22-02-2025,"Health, Wellness & Ayurvedic Products",MH Millets Malt 1KG,5,400,380,20,1
22-02-2025,Snacks & Ready-to-Eat,JUNNU POWDER 100GM,14,70,70,0,1
22-02-2025,Snacks & Ready-to-Eat,SD Moringa with plam jaggery 250gm,14,135,135,0,1
22-02-2025,Personal Care & Cosmetics,UVIS ONION SHAMPOO,10,210,210,0,1
22-02-2025,"Grains, Flours & Dals",RAGI FLOUR 500GRMS,4,80,70,10,2
22-02-2025,Snacks & Ready-to-Eat,GS WHEAT GRASS BISCUITS 250GM,14,130,130,0,1
22-02-2025,"Grains, Flours & Dals",Wheat Flour 1 kg,4,140,120,20,2
22-02-2025,"Grains, Flours & Dals",Multigrain 1 kg,4,200,170,30,2
22-02-2025,Snacks & Ready-to-Eat,SD JOWAR WITH PALM JAGGERY 250GM,14,135,135,0,1
22-02-2025,Snacks & Ready-to-Eat,VD DAHI MIRCHI(SALTED) 100GM,14,45,45,0,1
22-02-2025,Snacks & Ready-to-Eat,VD Pappu Chekkalu 190gm,14,60,60,0,1
22-02-2025,"Grains, Flours & Dals",VGR RICE 5 KGS,4,350,325,25,1
22-02-2025,"Grains, Flours & Dals",doctor rice 1kg,4,360,360,0,3
22-02-2025,"Grains, Flours & Dals",White jowar.F 1 kg,4,100,80,20,1
22-02-2025,"Grains, Flours & Dals",POORI ATTA 1KG,4,70,60,10,1
22-02-2025,Snacks & Ready-to-Eat,KURNOOL MARMURA,14,70,55,15,1
22-02-2025,Sweeteners,YB JAGGERY POWDER 1KG,16,280,280,0,2
22-02-2025,Snacks & Ready-to-Eat,VD PALLI LADDU,14,80,80,0,1
22-02-2025,Snacks & Ready-to-Eat,VD MURMURA LADDU,14,50,50,0,1
22-02-2025,Snacks & Ready-to-Eat,VD NUVULU CHEGODI 175GM,14,60,60,0,1
22-02-2025,Snacks & Ready-to-Eat,VD NUVVULU LADDU,14,80,80,0,1
22-02-2025,Snacks & Ready-to-Eat,SD Atreyapuram DRY Fruit ghee,14,150,150,0,1
22-02-2025,"Grains, Flours & Dals",Hs yellow jowar r 500g,4,396,396,0,4
22-02-2025,Sweeteners,SD PALM JAGGERY 500GM,16,200,200,0,1
22-02-2025,Pooja & Spiritual Items,GD WOODS 150GM,12,110,110,0,1
22-02-2025,Sweeteners,YB JAGGERY POWDER 500GMS,16,150,150,0,2
22-02-2025,Oils & Ghee,Coconut oil 500 ml,9,220,200,20,1
22-02-2025,Spices & Seasonings,GD Turmeric 50GM,15,50,50,0,2
22-02-2025,Oils & Ghee,Sesame oil 500ml,9,295,280,15,1
22-02-2025,Pooja & Spiritual Items,GD KUMKUM 50GM,12,60,60,0,2
22-02-2025,Snacks & Ready-to-Eat,VD PALLI CHIKKI,14,80,80,0,1
22-02-2025,Snacks & Ready-to-Eat,VD SAGOPAPAD 150GM,14,55,55,0,1
22-02-2025,Spices & Seasonings,Turmeric powder 250 gms,15,100,75,25,1
22-02-2025,Snacks & Ready-to-Eat,SALTED PHALLI,14,130,130,0,2
22-02-2025,"Grains, Flours & Dals",MAAGAANI SP RICE 20 KGS,4,2300,"1,960.00",340,1
22-02-2025,"Grains, Flours & Dals",RAGI FLOUR 1KG,4,80,70,10,1
22-02-2025,"Grains, Flours & Dals",RICE FLOUR 1KG,4,140,110,30,2
22-02-2025,"Grains, Flours & Dals",turdal 1kg,4,220,195,25,1
22-02-2025,Pooja & Spiritual Items,GD Dhoop Cones 40GM,12,30,30,0,1
22-02-2025,"Grains, Flours & Dals",Wheat Flour 1 kg,4,70,60,10,1
22-02-2025,Sweeteners,YB JAGGERY POWDER 500GMS,16,75,75,0,1
22-02-2025,"Grains, Flours & Dals",Wheat Flour 1 kg,4,70,60,10,1
22-02-2025,Snacks & Ready-to-Eat,RINGS 200GM,14,30,30,0,1
22-02-2025,"Grains, Flours & Dals",Idly Rava L 1KG,4,60,50,10,1
22-02-2025,Snacks & Ready-to-Eat,SD MASALA GAVVALU 200GM,14,95,95,0,1
22-02-2025,Oils & Ghee,Groundnut oil 1 L,9,720,660,60,2
22-02-2025,Snacks & Ready-to-Eat,FOXTAIL NOODLES,14,75,75,0,1
22-02-2025,"Grains, Flours & Dals",WHEAT 1 KG,4,120,100,20,2
22-02-2025,"Grains, Flours & Dals",RAGULU 1 KG,4,70,60,10,1
22-02-2025,"Grains, Flours & Dals",VGR RICE 10 KGS,4,700,650,50,1
22-02-2025,General Household & Kitchenware,IRN WDN HDI KADAIA 10,3,275,275,0,1
22-02-2025,"Grains, Flours & Dals",JOWAR WHITE 1 KG,4,80,70,10,1
22-02-2025,"Grains, Flours & Dals",FLOUR CHARGE,4,192,192,0,16
22-02-2025,Snacks & Ready-to-Eat,VD Pappu Chekkalu 190gm,14,60,60,0,1
22-02-2025,"Grains, Flours & Dals",MELMEKER 250GMS,4,60,45,15,1
22-02-2025,"Grains, Flours & Dals",Brown RICE 1KG,4,210,199.5,10.5,3
22-02-2025,Snacks & Ready-to-Eat,VD SANNAPUSA 175GM,14,60,60,0,1
22-02-2025,Snacks & Ready-to-Eat,VD MIXTURE 175 GM,14,60,60,0,1
22-02-2025,Snacks & Ready-to-Eat,VD NUVVULU LADDU,14,80,80,0,1
22-02-2025,Oils & Ghee,Groundnut oil 1 L,9,360,330,30,1
22-02-2025,"Grains, Flours & Dals",MAAGAANI W RICE 5KGS,4,899,535,364,1
22-02-2025,Oils & Ghee,Safflower oil 1 L,9,440,400,40,1
22-02-2025,Snacks & Ready-to-Eat,VD RIBBON PAKODI 175GM,14,60,60,0,1
22-02-2025,"Grains, Flours & Dals",Bajra Flour 500 gms,4,35,30,5,1
22-02-2025,Milk & Dairy,SANGAM TONED MILK 500ML,7,90,90,0,3
22-02-2025,Personal Care & Cosmetics,KHADI LEMONGRASS SOAP 125GM,10,90,90,0,1
22-02-2025,"Grains, Flours & Dals",SRILATHA RICE RAVVA 500GM,4,35,35,0,1
22-02-2025,Milk & Dairy,BROWN EGGS 1P,7,10,10,0,1
22-02-2025,General Household & Kitchenware,WOODEN SPOON BIG,3,100,100,0,2
22-02-2025,"Grains, Flours & Dals",SL Idly Rava 1KG,4,65,55,10,1
22-02-2025,Snacks & Ready-to-Eat,VD NUVVULU LADDU,14,80,80,0,1
22-02-2025,Snacks & Ready-to-Eat,VD MURMURA LADDU,14,50,50,0,1
22-02-2025,Sweeteners,MISHRI D,16,40,30,10,1
22-02-2025,"Grains, Flours & Dals",White jowar.F 500 Gms,4,50,40,10,1
22-02-2025,"Grains, Flours & Dals",RAGI FLOUR 500GRMS,4,40,35,5,1
22-02-2025,"Grains, Flours & Dals",RAGI FLOUR 500GRMS,4,40,35,5,1
22-02-2025,Snacks & Ready-to-Eat,VD MANGO JELLY 250GRMS,14,80,80,0,1
22-02-2025,"Grains, Flours & Dals",MELMEKER 250GMS,4,60,45,15,1
22-02-2025,Milk & Dairy,SANGAM TONED MILK 500ML,7,30,30,0,1
22-02-2025,"Grains, Flours & Dals",Wheat Flour 3 kgs,4,210,180,30,1
22-02-2025,"Grains, Flours & Dals",White jowar.F 1 kg,4,100,80,20,1
22-02-2025,"Grains, Flours & Dals",Multigrain 1 kg,4,100,85,15,1
22-02-2025,"Health, Wellness & Ayurvedic Products",SAI DURGA MORINGA LEAVES 100GM,5,75,75,0,1
22-02-2025,"Dry Fruits, Nuts & Seeds",ANJEER 250GM,2,400,360,40,1
22-02-2025,Snacks & Ready-to-Eat,Sprouted Ragi Biscuits 450GM,14,150,150,0,1
22-02-2025,"Grains, Flours & Dals",SINGLE POLISH 1KG,4,65,65,0,1
22-02-2025,"Dry Fruits, Nuts & Seeds",PUMPKIN SEEDS 250GM,2,200,160,40,1
22-02-2025,"Grains, Flours & Dals",HS Multimillet idly R 500 gms,4,65,65,0,1
22-02-2025,"Grains, Flours & Dals",White jowar.F 500 Gms,4,50,40,10,1
22-02-2025,"Grains, Flours & Dals",JOWAR WHITE 1 KG,4,48,42,6,0.6
22-02-2025,"Grains, Flours & Dals",JOWAR YELLOW 1 K,4,60,54,6,0.6
22-02-2025,"Grains, Flours & Dals",RAGI FLOUR 500GRMS,4,40,35,5,1
22-02-2025,Oils & Ghee,Coconut oil 1 L,9,440,400,40,1
22-02-2025,Oils & Ghee,Safflower oil 1 L,9,440,400,40,1
22-02-2025,"Grains, Flours & Dals",Red uluvalu 250 gms,4,45,40,5,1
22-02-2025,Snacks & Ready-to-Eat,KURNOOL MARMURA,14,70,55,15,1
22-02-2025,Spices & Seasonings,Masala Karam 500 gms,15,260,240,20,1
22-02-2025,"Grains, Flours & Dals",Brown RICE 1KG,4,140,130,10,2
22-02-2025,"Grains, Flours & Dals",Chittimuthaylu rice 1 kg,4,160,140,20,1
22-02-2025,"Grains, Flours & Dals",BASMATHI RICE 1KG,4,150,135,15,1
22-02-2025,Beverages,REFRESH SHARBATH NORMAL,1,199,190,9,1
22-02-2025,Spices & Seasonings,Tamarind 250GMS,15,75,75,0,1
22-02-2025,"Grains, Flours & Dals",UDALU (Barnyard millet) 1 kg,4,140,115,25,1
22-02-2025,Oils & Ghee,Groundnut oil 1 L,9,720,660,60,2
22-02-2025,Oils & Ghee,Groundnut oil 500ml,9,180,165,15,1
22-02-2025,"Grains, Flours & Dals",Red Chana 500 GM,4,150,120,30,2
22-02-2025,"Grains, Flours & Dals",Arikalu (kodo),4,70,65,5,1
22-02-2025,"Grains, Flours & Dals",KORRALU (FOXTAIL M) 500GM,4,65,55,10,1
22-02-2025,"Grains, Flours & Dals",UDALU (Barnyard millet) 500 gms,4,70,60,10,1
22-02-2025,"Grains, Flours & Dals",ANDU KORRALU (Brown top .mlt) 500,4,130,110,20,1
22-02-2025,"Grains, Flours & Dals",SAMALU (Little millet) 500 gms,4,85,65,20,1
22-02-2025,Personal Care & Cosmetics,SVE PREMIUM WILD TURMEIC 100GM,10,110,110,0,1
22-02-2025,"Grains, Flours & Dals",MAA TEJA RICE BAG 26KG,4,4420,"3,500.00",920,2
22-02-2025,Snacks & Ready-to-Eat,ID IDLY DOSA BATTER,14,95,95,0,1
22-02-2025,Milk & Dairy,SANGAM TONED MILK 500ML,7,30,30,0,1
22-02-2025,"Grains, Flours & Dals",split black gram 1 kg,4,180,170,10,1
22-02-2025,"Grains, Flours & Dals",Black gram 500 gms,4,75,70,5,1
22-02-2025,"Dry Fruits, Nuts & Seeds",MAHA BEERA SEEDS 100GM,2,120,120,0,2
22-02-2025,Spices & Seasonings,Masala Karam 500 gms,15,260,240,20,1
22-02-2025,Oils & Ghee,Coconut oil 500 ml,9,220,200,20,1
22-02-2025,"Grains, Flours & Dals",Wheat Flour 1 kg,4,70,60,10,1
22-02-2025,"Grains, Flours & Dals",Multigrain 1 kg,4,100,85,15,1
22-02-2025,Personal Care & Cosmetics,MD Bath Powder 100GM,10,40,40,0,1
22-02-2025,Spices & Seasonings,Chilli powder 1 kg,15,580,420,160,1
22-02-2025,"Health, Wellness & Ayurvedic Products",MD Kasturi Pasupu Choornam 50GM,5,80,80,0,1
22-02-2025,"Grains, Flours & Dals",RICE FLOUR 500 GM,4,35,28,7,1
22-02-2025,Beverages,REFRESH SHARBATH NORMAL,1,199,190,9,1
22-02-2025,Spices & Seasonings,SD IDLY KARAM,15,65,65,0,1
22-02-2025,"Grains, Flours & Dals",turdal 1kg,4,220,195,25,1
22-02-2025,"Grains, Flours & Dals",RAJMA 250GM,4,55,45,10,1
22-02-2025,Oils & Ghee,Groundnut oil 1 L,9,360,330,30,1
22-02-2025,Spices & Seasonings,Lavangam 50GM,15,60,50,10,1
22-02-2025,"Grains, Flours & Dals",BLACK GRAM 1KG,4,150,140,10,1
22-02-2025,"Grains, Flours & Dals",Black gram 500 gms,4,75,70,5,1
22-02-2025,"Grains, Flours & Dals",split urad dall 500 gms,4,90,80,10,1
22-02-2025,Spices & Seasonings,Menthulu 250 gms,15,50,45,5,1
22-02-2025,"Grains, Flours & Dals",white Bobarlu 500 gms,4,80,75,5,1
22-02-2025,Spices & Seasonings,Black Till 250GM,15,90,75,15,1
22-02-2025,"Grains, Flours & Dals",BAJRA 1 KG,4,60,50,10,1
22-02-2025,Spices & Seasonings,BLACK JEERA 50 GM,15,45,30,15,1
22-02-2025,"Grains, Flours & Dals",AISHWARYA SP 5KG,4,800,750,50,2
22-02-2025,Snacks & Ready-to-Eat,Popcorn Seeds 250GM,14,45,40,5,1
22-02-2025,"Grains, Flours & Dals",JOWAR WHITE 1 KG,4,80,70,10,1
22-02-2025,Snacks & Ready-to-Eat,VD DAHI MIRCHI(SALTED) 100GM,14,45,45,0,1
22-02-2025,"Grains, Flours & Dals",Green Batani 250GM,4,55,45,10,1
22-02-2025,"Grains, Flours & Dals",BASMATHI RICE 1KG,4,150,135,15,1
22-02-2025,"Grains, Flours & Dals",Chittimuthaylu rice 1 kg,4,160,140,20,1
22-02-2025,"Grains, Flours & Dals",RED RICE 1KG,4,150,120,30,1
22-02-2025,Spices & Seasonings,Avalu small 250 gms,15,60,40,20,1
22-02-2025,Spices & Seasonings,Jeera 100GM,15,50,45,5,1
22-02-2025,Snacks & Ready-to-Eat,Corn Chips 250GM,14,80,70,10,2
22-02-2025,Spices & Seasonings,Vamu 100GM,15,60,50,10,1
22-02-2025,"Dry Fruits, Nuts & Seeds",SABJA SEEDS 100GM,2,80,70,10,1
22-02-2025,Sweeteners,YB JAGGERY POWDER 500GMS,16,150,150,0,2
22-02-2025,"Grains, Flours & Dals",Red Bobarlu 500 gms,4,95,85,10,1
22-02-2025,Spices & Seasonings,Tamarind 250GMS,15,75,75,0,1
22-02-2025,Spices & Seasonings,Tamarind 250GMS,15,225,225,0,3
22-02-2025,Snacks & Ready-to-Eat,NGT CHATPATTA CHANA 90GM,14,25,25,0,1
22-02-2025,General Household & Kitchenware,B4 BOWL,3,160,160,0,1
22-02-2025,"Grains, Flours & Dals",Wheat Rava S 1KG,4,65,55,10,1
22-02-2025,Pickles & Cooking Pastes,SD RED CHILLI PICKLE,11,110,110,0,1
22-02-2025,Personal Care & Cosmetics,DWI GULABA ARKA 60ML,10,30,30,0,1
22-02-2025,Sweeteners,MISHRI D,16,40,30,10,1
22-02-2025,"Grains, Flours & Dals",Bombay Rava 500GM,4,35,30,5,1
22-02-2025,"Grains, Flours & Dals",RICE FLOUR 500 GM,4,35,28,7,1
22-02-2025,General Household & Kitchenware,SABEENA,3,45,45,0,3
22-02-2025,Snacks & Ready-to-Eat,BELLAM MINAPA SUNADULLU,14,180,180,0,1
22-02-2025,"Grains, Flours & Dals",split green gram 1 kg,4,150,140,10,1
22-02-2025,Snacks & Ready-to-Eat,SD Sesame laddu with dates250gm,14,135,135,0,1
22-02-2025,Spices & Seasonings,Tamarind 500GM,15,148,148,0,1
22-02-2025,"Dry Fruits, Nuts & Seeds",PUTNALU 500GMS,2,90,76,14,1
22-02-2025,Spices & Seasonings,AVALU 100GM,15,50,40,10,2
22-02-2025,"Dry Fruits, Nuts & Seeds",Groundnuts 500 gms,2,95,85,10,1
22-02-2025,"Grains, Flours & Dals",SABDANA,4,40,35,5,1
22-02-2025,Snacks & Ready-to-Eat,ANNAPURNA APPALAM,14,35,35,0,1
22-02-2025,"Grains, Flours & Dals",POORI ATTA 1KG,4,70,60,10,1
22-02-2025,Personal Care & Cosmetics,MADDI BATH POWDER 400GM,10,150,150,0,1
22-02-2025,Snacks & Ready-to-Eat,RAJGIRA PEANUT CHIKKI 450GM,14,125,125,0,1
22-02-2025,Sweeteners,YB JAGGERY POWDER 1KG,16,140,140,0,1
22-02-2025,Snacks & Ready-to-Eat,VD CORNFLAKES MIXTURE 175GM,14,60,60,0,1
22-02-2025,Oils & Ghee,Coconut oil 1 L,9,440,400,40,1
22-02-2025,"Dry Fruits, Nuts & Seeds",SUNFLOWER SEEDS 250GRM,2,150,130,20,1
22-02-2025,"Health, Wellness & Ayurvedic Products",RB FRUITS &amp;seeds Cranberries,5,45,45,0,1
22-02-2025,"Grains, Flours & Dals",RAGULU 1 KG,4,35,30,5,0.5
22-02-2025,Snacks & Ready-to-Eat,VD MANGO JELLY 250GRMS,14,80,80,0,1
22-02-2025,"Grains, Flours & Dals",RAGI FLOUR 500GRMS,4,40,35,5,1
22-02-2025,"Grains, Flours & Dals",Chana Flour 500 gms,4,70,65,5,1
22-02-2025,General Household & Kitchenware,VERMI COMPOST MIX,3,30,30,0,1
22-02-2025,Spices & Seasonings,AVALU 100GM,15,25,20,5,1
22-02-2025,"Grains, Flours & Dals",Brown RICE 1KG,4,70,65,5,1
22-02-2025,"Grains, Flours & Dals",VGR rice 1 kg,4,210,195,15,3
22-02-2025,Snacks & Ready-to-Eat,SD Ginger Candy 100g,14,60,60,0,1
22-02-2025,Milk & Dairy,ID PANEER,7,135,135,0,1
22-02-2025,"Grains, Flours & Dals",Bajra Flour 1 kg,4,70,60,10,1
22-02-2025,"Dry Fruits, Nuts & Seeds",PUMPKIN SEEDS 250GM,2,200,160,40,1
22-02-2025,Beverages,REFRESH SHARBATH SUGAR FREE,1,299,285,14,1
22-02-2025,"Grains, Flours & Dals",MELMEKER 250GMS,4,60,45,15,1
22-02-2025,Oils & Ghee,Coconut oil 500 ml,9,220,200,20,1
22-02-2025,Oils & Ghee,Safflower oil 1 L,9,440,400,40,1
22-02-2025,"Grains, Flours & Dals",Wheat Rava S 1KG,4,130,110,20,2
22-02-2025,"Grains, Flours & Dals",SL Idly Rava 1KG,4,130,110,20,2
22-02-2025,"Grains, Flours & Dals",RICE FLOUR 1KG,4,140,110,30,2
22-02-2025,"Grains, Flours & Dals",RAGI FLOUR 1KG,4,80,70,10,1
22-02-2025,Snacks & Ready-to-Eat,SD Sesame laddu with dates250gm,14,135,135,0,1
22-02-2025,"Grains, Flours & Dals",KORRALU (FOXTAIL M) 500GM,4,65,55,10,1
22-02-2025,"Grains, Flours & Dals",Arikalu (kodo),4,70,65,5,1
22-02-2025,"Grains, Flours & Dals",SAMALU (Little millet) 500 gms,4,85,65,20,1
22-02-2025,"Grains, Flours & Dals",UDALU (Barnyard millet) 500 gms,4,70,60,10,1
22-02-2025,"Grains, Flours & Dals",ANDU KORRALU (Brown top .mlt) 500,4,130,110,20,1
22-02-2025,"Grains, Flours & Dals",PRO SABUDHANA 500GM,4,89,89,0,1
22-02-2025,"Grains, Flours & Dals",ANDU KORRALU (Browntop.m) 1 kg,4,260,220,40,1
22-02-2025,Spices & Seasonings,DURGA SALT CRYSTAL 1KG,15,25,25,0,1
22-02-2025,"Grains, Flours & Dals",SH RED POHA 500GM,4,85,85,0,1
22-02-2025,"Health, Wellness & Ayurvedic Products",VAMU WATER,5,70,70,0,1
22-02-2025,"Grains, Flours & Dals",UDALU (Barnyard millet) 1 kg,4,140,115,25,1
22-02-2025,"Grains, Flours & Dals",turdal 1kg,4,220,195,25,1
22-02-2025,Snacks & Ready-to-Eat,BATANA NGT 70GMS,14,20,20,0,1
22-02-2025,Snacks & Ready-to-Eat,PEANUT CHIKKI,14,44,44,0,2
22-02-2025,Spices & Seasonings,NUVVULU 250GM,15,80,65,15,1
22-02-2025,"Grains, Flours & Dals",Wheat Flour 1 kg,4,70,60,10,1
22-02-2025,Snacks & Ready-to-Eat,NGT CHATPATTA CHANA 90GM,14,25,25,0,1
22-02-2025,Spices & Seasonings,PRO ORG CORIANDER WHOLE 100G,15,70,70,0,1
22-02-2025,"Grains, Flours & Dals",Chana Flour 500 gms,4,70,65,5,1
22-02-2025,Sweeteners,SUGAR 1KG,16,60,50,10,1
22-02-2025,"Grains, Flours & Dals",Urad dall 1 Kg,4,185,170,15,1
22-02-2025,Spices & Seasonings,RED COPRA 250GMS,15,78,78,0,1
22-02-2025,Personal Care & Cosmetics,UVIS RED SANDAL SOAP 100GM,10,85,85,0,1
22-02-2025,Spices & Seasonings,TATA SALT 1KG,15,30,30,0,1
22-02-2025,"Grains, Flours & Dals",PESARA PAPPU 1 KG,4,170,145,25,1
22-02-2025,"Grains, Flours & Dals",CHANA DAL 500GM,4,70,60,10,1
22-02-2025,"Health, Wellness & Ayurvedic Products",GS Wheat Grass Powder 100GMS,5,349,349,0,1
22-02-2025,"Grains, Flours & Dals",Brown RICE 1KG,4,210,195,15,3
22-02-2025,"Grains, Flours & Dals",Red Wheat Flour 1 kg,4,140,130,10,1
22-02-2025,"Grains, Flours & Dals",RED RICE 1KG,4,150,120,30,1
22-02-2025,Snacks & Ready-to-Eat,NGT CHATPATTA CHANA 90GM,14,50,50,0,2
22-02-2025,"Grains, Flours & Dals",RAGI FLOUR 500GRMS,4,40,35,5,1
22-02-2025,Milk & Dairy,BROWN EGGS 1P,7,84,72,12,6
22-02-2025,"Grains, Flours & Dals",RICE FLOUR 1KG,4,70,55,15,1
22-02-2025,"Grains, Flours & Dals",VGR RICE 5 KGS,4,350,325,25,1
22-02-2025,"Grains, Flours & Dals",Chana Flour 500 gms,4,70,65,5,1
22-02-2025,Snacks & Ready-to-Eat,VD PALLI LADDU,14,80,80,0,1
22-02-2025,"Grains, Flours & Dals",Multigrain 1 kg,4,100,85,15,1
22-02-2025,Snacks & Ready-to-Eat,NGT CHATPATTA CHANA 90GM,14,25,25,0,1
22-02-2025,"Grains, Flours & Dals",RICE FLOUR 1KG,4,70,55,15,1
22-02-2025,Snacks & Ready-to-Eat,FOXTAIL NOODLES,14,75,75,0,1
22-02-2025,Snacks & Ready-to-Eat,ZEEDI,14,70,70,0,1
22-02-2025,"Grains, Flours & Dals",Chana Flour 1 kg,4,140,130,10,1
22-02-2025,Snacks & Ready-to-Eat,VD MURMURA LADDU,14,50,50,0,1
22-02-2025,Oils & Ghee,Groundnut oil 1 L,9,360,330,30,1
22-02-2025,Pooja & Spiritual Items,SOSR SWATHHI 365,12,120,120,0,4
22-02-2025,Snacks & Ready-to-Eat,SD FINGER Millet with palm Jaggery 250gm,14,135,135,0,1
22-02-2025,Snacks & Ready-to-Eat,VD PALLI LADDU,14,80,80,0,1
22-02-2025,Snacks & Ready-to-Eat,VD PAPPU CHEGODI 200GM,14,60,60,0,1
22-02-2025,"Dry Fruits, Nuts & Seeds",SALTED PISTA 250GM,2,400,350,50,1
22-02-2025,Snacks & Ready-to-Eat,PUMPKIN CHIKKI 200GM,14,130,130,0,1
22-02-2025,"Grains, Flours & Dals",AISHWARYA SP 1KG,4,600,525,75,7.5
22-02-2025,Spices & Seasonings,Biryani Leaf 25GM,15,20,20,0,1
22-02-2025,"Grains, Flours & Dals",idly/Dosa rice 1 kg,4,280,240,40,4
22-02-2025,Spices & Seasonings,RED COPRA 500GM,15,170,148,22,1
22-02-2025,Snacks & Ready-to-Eat,BATANA NGT 70GMS,14,40,40,0,2
22-02-2025,Snacks & Ready-to-Eat,VD MURMURA LADDU,14,50,50,0,1
22-02-2025,Snacks & Ready-to-Eat,RSC ORANGE 100GMS,14,20,20,0,1
22-02-2025,Spices & Seasonings,SWEET SOUNF,15,20,20,0,1
22-02-2025,Milk & Dairy,SANGAM TONED MILK 500ML,7,30,30,0,1
22-02-2025,"Grains, Flours & Dals",split black gram 1 kg,4,180,170,10,1
22-02-2025,"Dry Fruits, Nuts & Seeds",PUTNALU 500GMS,2,90,76,14,1
22-02-2025,"Dry Fruits, Nuts & Seeds",PULMAKHANA 100 GM,2,180,170,10,1
22-02-2025,"Grains, Flours & Dals",Idly Rava L 1KG,4,60,50,10,1
22-02-2025,"Grains, Flours & Dals",White jowar.F 1 kg,4,100,80,20,1
22-02-2025,Snacks & Ready-to-Eat,KURNOOL MARMURA,14,70,55,15,1
22-02-2025,"Grains, Flours & Dals",RICE FLOUR 1KG,4,70,55,15,1
22-02-2025,"Grains, Flours & Dals",turdal 1kg,4,220,195,25,1
22-02-2025,"Grains, Flours & Dals",Bombay Rava 500GM,4,35,30,5,1
22-02-2025,"Grains, Flours & Dals",SINGLE POLISH 1KG,4,325,325,0,5
22-02-2025,Spices & Seasonings,Tamarind 250GMS,15,75,75,0,1
22-02-2025,"Grains, Flours & Dals",THICK POHA 500GM,4,40,35,5,1
22-02-2025,Spices & Seasonings,ROYAL SAFFRON 400GRMS,15,65,65,0,1
22-02-2025,Sweeteners,SUGAR 500 GM,16,30,25,5,1
22-02-2025,Household & Cleaning,PITAMBARI SHINING POWDER 200G,6,60,60,0,1
22-02-2025,"Grains, Flours & Dals",Wheat Flour 1 kg,4,70,60,10,1
22-02-2025,Oils & Ghee,Groundnut oil 1 L,9,360,330,30,1
22-02-2025,Snacks & Ready-to-Eat,VD MURMURA LADDU,14,50,50,0,1
22-02-2025,"Grains, Flours & Dals",Multigrain 1 kg,4,300,255,45,3
22-02-2025,"Grains, Flours & Dals",Quinova 1 kg,4,220,195,25,1
22-02-2025,"Grains, Flours & Dals",MELMEKER 250GMS,4,120,90,30,2
22-02-2025,Milk & Dairy,BROWN EGGS TRAY 30P,7,360,330,30,1
22-02-2025,Milk & Dairy,BROWN EGGS TRAY 30P,7,360,330,30,1
22-02-2025,"Dry Fruits, Nuts & Seeds",PRO ORG RAW PEANUTS 500GM,2,174,174,0,1
22-02-2025,Milk & Dairy,SANGAM FULL CREAM MILK 500ML,7,76,76,0,2
22-02-2025,Milk & Dairy,SANGAM CURD 450GM,7,38,38,0,1
22-02-2025,"Grains, Flours & Dals",SINGLE POLISH 1KG,4,130,130,0,2
22-02-2025,Personal Care & Cosmetics,HERBAL BATH POWDER 200GM,10,80,80,0,1
22-02-2025,"Grains, Flours & Dals",DOCTOR RICE DIABETIC SFR 1KG,4,120,120,0,1
22-02-2025,"Grains, Flours & Dals",JOWAR WHITE 1 KG,4,80,70,10,1
22-02-2025,"Dry Fruits, Nuts & Seeds",WALNUT ROUND 250GM,2,320,280,40,1
22-02-2025,"Grains, Flours & Dals",JOWAR YELLOW 1 K,4,100,90,10,1
22-02-2025,"Grains, Flours & Dals",Urad dall 1 Kg,4,185,170,15,1
22-02-2025,"Dry Fruits, Nuts & Seeds",Groundnuts 500 gms,2,95,85,10,1
22-02-2025,Snacks & Ready-to-Eat,BD RED RICE NOODLES 200G,14,70,70,0,1
21-02-2025,Spices & Seasonings,Tamarind 500GM,15,148,148,0,1
21-02-2025,Spices & Seasonings,AVALU 100GM,15,25,20,5,1
21-02-2025,"Grains, Flours & Dals",CHANADALL 250 GMS,4,35,30,5,1
21-02-2025,Sweeteners,SUGAR 500 GM,16,30,25,5,1
21-02-2025,Oils & Ghee,Groundnut oil 1 L,9,360,330,30,1
21-02-2025,Pooja & Spiritual Items,VRP APOORVA JAVADHU POW,12,35,35,0,1
21-02-2025,Spices & Seasonings,ROYAL SAFFRON,15,125,125,0,1
21-02-2025,Snacks & Ready-to-Eat,VAKKALU,14,80,60,20,1
21-02-2025,"Grains, Flours & Dals",RICE FLOUR 1KG,4,70,55,15,1
21-02-2025,"Grains, Flours & Dals",BOMBAY RAVA,4,70,55,15,1
21-02-2025,Spices & Seasonings,Jeera 100GM,15,50,45,5,1
21-02-2025,Snacks & Ready-to-Eat,SD Flax seeds with dates 250gm,14,135,135,0,1
21-02-2025,Snacks & Ready-to-Eat,SALTED PHALLI,14,50,50,0,2
21-02-2025,"Grains, Flours & Dals",UDALU (Barnyard millet) 1 kg,4,140,115,25,1
21-02-2025,"Grains, Flours & Dals",SAMALU (Little millet) 1 kg,4,170,130,40,1
21-02-2025,"Grains, Flours & Dals",Bombay Rava 500GM,4,35,30,5,1
21-02-2025,"Dry Fruits, Nuts & Seeds",Groundnuts 500 gms,2,95,85,10,1
21-02-2025,"Grains, Flours & Dals",RAGI FLOUR 500GRMS,4,40,35,5,1
21-02-2025,Oils & Ghee,Sesame oil 1 L,9,590,560,30,1
21-02-2025,"Dry Fruits, Nuts & Seeds",DRYDATES YELLOW 250GM,2,135,120,15,1
21-02-2025,Spices & Seasonings,Turmeric powder 250 gms,15,100,75,25,1
21-02-2025,Snacks & Ready-to-Eat,SD RAGI GAVVALU,14,95,95,0,1
21-02-2025,Snacks & Ready-to-Eat,VD BELLAM GAVVALU 200GM,14,60,60,0,1
21-02-2025,Snacks & Ready-to-Eat,PUMPKIN CHIKKI 200GM,14,560,520,40,4
21-02-2025,"Grains, Flours & Dals",UDALU (Barnyard millet) 500 gms,4,70,60,10,1
21-02-2025,"Grains, Flours & Dals",ANDU KORRALU (Brown top .mlt) 500,4,130,110,20,1
21-02-2025,"Grains, Flours & Dals",SAMALU (Little millet) 500 gms,4,85,65,20,1
21-02-2025,"Grains, Flours & Dals",KORRALU (FOXTAIL M) 500GM,4,65,55,10,1
21-02-2025,"Grains, Flours & Dals",Arikalu (kodo),4,70,65,5,1
21-02-2025,"Grains, Flours & Dals",RAGI FLOUR 1KG,4,80,70,10,1
21-02-2025,Household & Cleaning,SURF EXCEL QUICK WASH 500GM,6,99,99,0,1
21-02-2025,Personal Care & Cosmetics,MYSORE SANDAL,10,69,69,0,1
21-02-2025,Household & Cleaning,VIM SOAP,6,20,20,0,4
21-02-2025,"Grains, Flours & Dals",SRILATHA RICE RAVVA 500GM,4,35,35,0,1
21-02-2025,"Grains, Flours & Dals",RAGI FLOUR 500GRMS,4,40,35,5,1
21-02-2025,"Grains, Flours & Dals",SL Idly Rava 1KG,4,65,55,10,1
21-02-2025,"Grains, Flours & Dals",DESI CHANA,4,25,25,0,1
21-02-2025,"Grains, Flours & Dals",Multigrain 1 kg,4,300,255,45,3
21-02-2025,Milk & Dairy,BROWN EGGS 1P,7,56,48,8,4
21-02-2025,Snacks & Ready-to-Eat,ZEEDI,14,70,70,0,1
21-02-2025,Snacks & Ready-to-Eat,VD Minapa papad 200gm,14,60,60,0,1
21-02-2025,Snacks & Ready-to-Eat,VD PALLI LADDU,14,80,80,0,1
21-02-2025,"Grains, Flours & Dals",Wheat Flour 2 kgs,4,140,120,20,1
21-02-2025,Snacks & Ready-to-Eat,ELITE ELAICHI RUSK 200GM,14,35,35,0,1
21-02-2025,Snacks & Ready-to-Eat,MB LITTLE MILLET COOKIES,14,75,75,0,1
21-02-2025,Snacks & Ready-to-Eat,NGT CHATPATTA CHANA 90GM,14,25,25,0,1
21-02-2025,"Grains, Flours & Dals",Chana Flour 1 kg,4,140,130,10,1
21-02-2025,"Grains, Flours & Dals",HS Multimillet idly R 500 gms,4,130,130,0,2
21-02-2025,"Grains, Flours & Dals",BAJRA 1 KG,4,60,50,10,1
21-02-2025,General Household & Kitchenware,VERMI COMPOST MIX,3,60,60,0,2
21-02-2025,"Grains, Flours & Dals",AISHWARYA SP 1KG,4,800,700,100,10
21-02-2025,Snacks & Ready-to-Eat,VD SAGOPAPAD 150GM,14,55,55,0,1
21-02-2025,Snacks & Ready-to-Eat,urban murmura,14,70,65,5,1
21-02-2025,Snacks & Ready-to-Eat,VD RICE MURUKU 150GM,14,50,50,0,1
21-02-2025,"Grains, Flours & Dals",Wheat Flour 1 kg,4,140,120,20,2
21-02-2025,"Grains, Flours & Dals",Brown RICE 1KG,4,140,130,10,2
21-02-2025,Snacks & Ready-to-Eat,RSC ORANGE 100GMS,14,20,20,0,1
21-02-2025,"Grains, Flours & Dals",SL Idly Rava 1KG,4,65,55,10,1
21-02-2025,"Dry Fruits, Nuts & Seeds",SD Mango cubes 200gm,2,90,90,0,1
21-02-2025,Personal Care & Cosmetics,ORAL B KIDS,10,25,25,0,1
21-02-2025,"Grains, Flours & Dals",RICE FLOUR 500 GM,4,35,28,7,1
21-02-2025,"Grains, Flours & Dals",SA Sprouted Ragi Flour 500GM,4,69,69,0,1
21-02-2025,"Grains, Flours & Dals",AISHWARYA SP 5KG,4,400,375,25,1
21-02-2025,General Household & Kitchenware,VERMI COMPOST MIX,3,30,30,0,1
21-02-2025,Oils & Ghee,Sesame oil 500ml,9,295,280,15,1
21-02-2025,"Grains, Flours & Dals",FLOUR CHARGE,4,21.6,21.6,0,1.8
21-02-2025,Personal Care & Cosmetics,DWI GULABA ARKA 60ML,10,30,30,0,1
21-02-2025,"Grains, Flours & Dals",SH ROASTED SOOJI 500GM,4,66,59,7,1
21-02-2025,"Grains, Flours & Dals",HS Multimillet idly R 500 gms,4,65,65,0,1
21-02-2025,"Grains, Flours & Dals",Sathya Javva Wheat Rava 500GM,4,95,95,0,1
21-02-2025,Sweeteners,GS Organic Jaggery Powder 600GM,16,99,99,0,1
21-02-2025,Milk & Dairy,BROWN EGGS 1P,7,70,60,10,5
21-02-2025,"Grains, Flours & Dals",RAGI FLOUR 500GRMS,4,40,35,5,1
21-02-2025,"Grains, Flours & Dals",Sathya Javva Wheat Rava 500GM,4,95,95,0,1
21-02-2025,Spices & Seasonings,PURO Healthy Salt Crystal 1KG,15,135,135,0,1
21-02-2025,Sweeteners,GS Organic Jaggery Powder 600GM,16,99,99,0,1
21-02-2025,"Dry Fruits, Nuts & Seeds",SATHVI CHIA SEEDS 100GM,2,100,80,20,1
21-02-2025,"Dry Fruits, Nuts & Seeds",Groundnuts 1 kg,2,190,170,20,1
21-02-2025,"Grains, Flours & Dals",SPLIT BLACK GRAM 500 GM,4,90,85,5,1
21-02-2025,Spices & Seasonings,JEERA 250 gms,15,125,105,20,1
21-02-2025,Spices & Seasonings,AVALU 100GM,15,25,20,5,1
21-02-2025,"Grains, Flours & Dals",CHANA DAL 1KG,4,35,30,5,0.25
21-02-2025,"Grains, Flours & Dals",RAGI FLOUR 1KG,4,80,70,10,1
21-02-2025,Snacks & Ready-to-Eat,VD RED CHILLI RICEPAPAD 150GM,14,50,50,0,1
21-02-2025,Snacks & Ready-to-Eat,SD Ginger Candy 100g,14,60,60,0,1
21-02-2025,Snacks & Ready-to-Eat,ZEEDI,14,70,70,0,1
21-02-2025,Snacks & Ready-to-Eat,VD RICE PAPAD 150GM,14,50,50,0,1
21-02-2025,Snacks & Ready-to-Eat,VD PALLI LADDU,14,80,80,0,1
21-02-2025,Snacks & Ready-to-Eat,SD FLAX SEED APPADALU,14,90,90,0,1
21-02-2025,Snacks & Ready-to-Eat,VD DAHI MIRCHI(SALTED) 100GM,14,45,45,0,1
21-02-2025,Oils & Ghee,Sesame oil 500ml,9,295,280,15,1
21-02-2025,"Dry Fruits, Nuts & Seeds",WALLNUTS 250GM,2,380,360,20,1
21-02-2025,"Grains, Flours & Dals",KORRALU (FOXTAIL M) 500GM,4,65,55,10,1
21-02-2025,"Grains, Flours & Dals",UDALU (Barnyard millet) 500 gms,4,70,60,10,1
21-02-2025,Spices & Seasonings,GS Pink Rock Salt 1KG,15,120,120,0,1
21-02-2025,Oils & Ghee,Groundnut oil 1 L,9,360,330,30,1
21-02-2025,"Dry Fruits, Nuts & Seeds",PUMPKIN SEEDS 250GM,2,200,160,40,1
21-02-2025,General Household & Kitchenware,BB BOWL,3,475,451.25,23.75,1
21-02-2025,General Household & Kitchenware,CLAY JUG J1,3,265,251.75,13.25,1
21-02-2025,"Grains, Flours & Dals",RAGI FLOUR 1KG,4,80,70,10,1
21-02-2025,Snacks & Ready-to-Eat,ZEEDI,14,70,70,0,1
21-02-2025,Sweeteners,NATURAL HONEY 1KG,16,560,480,80,1
21-02-2025,Personal Care & Cosmetics,SVE PREMIUM WILD TURMEIC 100GM,10,110,110,0,1
21-02-2025,Snacks & Ready-to-Eat,RITEBITE BLUEBERRY BLAST,14,50,50,0,1
21-02-2025,Snacks & Ready-to-Eat,VD MURMURA LADDU,14,50,50,0,1
21-02-2025,Personal Care & Cosmetics,GOW DURBAR NAVA 100GM SOAP,10,40,40,0,1
21-02-2025,Personal Care & Cosmetics,UVIS RED SANDAL SOAP 100GM,10,85,85,0,1
21-02-2025,Personal Care & Cosmetics,SVE HIBISCUS SOAP,10,90,90,0,1
21-02-2025,Spices & Seasonings,AVALU 100GM,15,25,20,5,1
21-02-2025,"Dry Fruits, Nuts & Seeds",YELLOW KISHMISH 250GM,2,130,110,20,1
21-02-2025,Personal Care & Cosmetics,UVIS CHARCOAL SOAP 100GM,10,85,85,0,1
21-02-2025,"Grains, Flours & Dals",CHANA DAL 500GM,4,70,60,10,1
21-02-2025,Spices & Seasonings,Masala Karam 250 gms,15,260,240,20,2
21-02-2025,Personal Care & Cosmetics,NEEM SOAP 100GM,10,100,100,0,1
21-02-2025,Snacks & Ready-to-Eat,ANNAPURNA APPALAM,14,70,70,0,2
21-02-2025,"Dry Fruits, Nuts & Seeds",PULMAKHANA 100 GM,2,180,170,10,1
21-02-2025,Personal Care & Cosmetics,BIO HIMALAYAN PLUM BATHING BAR 150GM,10,105,105,0,1
21-02-2025,"Dry Fruits, Nuts & Seeds",ANJEER 250GM,2,400,360,40,1
21-02-2025,Spices & Seasonings,Jeera 100GM,15,50,45,5,1
21-02-2025,Personal Care & Cosmetics,BIOTIQUE ANTI DRADRUFF S&C,10,99,99,0,1
21-02-2025,Personal Care & Cosmetics,BIOTIQUE MORNING NECTAR MOISTURING,10,120,120,0,1
21-02-2025,"Dry Fruits, Nuts & Seeds",DIANUTS 500GM,2,240,240,0,2
21-02-2025,"Grains, Flours & Dals",RAGULU 1 KG,4,70,60,10,1
21-02-2025,"Grains, Flours & Dals",JOWAR WHITE 1 KG,4,80,70,10,1
21-02-2025,Spices & Seasonings,Black Till 250GM,15,450,375,75,5
21-02-2025,Snacks & Ready-to-Eat,VD SANNAPUSA 175GM,14,60,60,0,1
21-02-2025,"Grains, Flours & Dals",Wheat Flour 1 kg,4,87.5,75,12.5,1.25
21-02-2025,Snacks & Ready-to-Eat,RAJGIRA PEANUT CHIKKI,14,15,15,0,3
21-02-2025,"Grains, Flours & Dals",Wheat Flour 1 kg,4,70,60,10,1
21-02-2025,Oils & Ghee,Groundnut oil 500ml,9,180,165,15,1
21-02-2025,Oils & Ghee,Sesame oil 500ml,9,295,280,15,1
21-02-2025,Snacks & Ready-to-Eat,PEANUT CHILLI,14,15,15,0,3
21-02-2025,Sweeteners,YB FOREST HONEY 250GM,16,180,180,0,1
21-02-2025,Oils & Ghee,Sesame oil 1 L,9,1180,"1,120.00",60,2
21-02-2025,Spices & Seasonings,GROUNDNUT KARAM POWDER,15,65,65,0,1
21-02-2025,Oils & Ghee,Groundnut oil 1 L,9,720,660,60,2
21-02-2025,Snacks & Ready-to-Eat,BATANA NGT 70GMS,14,40,40,0,2
21-02-2025,"Grains, Flours & Dals",CORN FLOUR,4,80,70,10,1
21-02-2025,"Grains, Flours & Dals",Chana Flour 500 gms,4,70,65,5,1
21-02-2025,Snacks & Ready-to-Eat,VD PAPPU CHEGODI 200GM,14,60,60,0,1
21-02-2025,"Grains, Flours & Dals",Wheat Flour 1 kg,4,70,60,10,1
21-02-2025,Spices & Seasonings,DURGA SALT CRYSTAL 1KG,15,25,25,0,1
21-02-2025,Spices & Seasonings,THOKA MIRYALU 50GM,15,210,180,30,1
21-02-2025,Spices & Seasonings,DURGA SALT CRYSTAL 1KG,15,25,25,0,1
21-02-2025,Spices & Seasonings,JEERA 250 gms,15,125,105,20,1
21-02-2025,Snacks & Ready-to-Eat,VD MURMURA LADDU,14,50,50,0,1
21-02-2025,Spices & Seasonings,Chilli powder 1 kg,15,580,420,160,1
21-02-2025,Oils & Ghee,GROUNDNUT OIL 1KG,9,1170,"1,050.00",120,3
21-02-2025,"Grains, Flours & Dals",MAAGAANI W RICE 5KGS,4,899,535,364,1
21-02-2025,Pooja & Spiritual Items,AMRUTHA SURABHI,12,80,80,0,1
21-02-2025,"Grains, Flours & Dals",Wheat Flour 1 kg,4,70,60,10,1
21-02-2025,"Grains, Flours & Dals",VGR rice 1 kg,4,140,130,10,2
21-02-2025,Pooja & Spiritual Items,GB Bharatha Woods 75GM,12,60,60,0,1
21-02-2025,"Grains, Flours & Dals",SINGLE POLISH 1KG,4,65,65,0,1
21-02-2025,"Grains, Flours & Dals",SAMALU (Little millet) 1 kg,4,170,130,40,1
21-02-2025,Oils & Ghee,Groundnut oil 1 L,9,360,330,30,1
21-02-2025,Snacks & Ready-to-Eat,SS IDLY BATTER 1KG,14,60,60,0,1
21-02-2025,Oils & Ghee,Sesame oil 1 L,9,590,560,30,1
21-02-2025,Snacks & Ready-to-Eat,DOSA BATTER 1KG,14,60,60,0,1
21-02-2025,"Grains, Flours & Dals",MELMEKER 250GMS,4,60,45,15,1
21-02-2025,"Grains, Flours & Dals",maida 500grms,4,60,60,0,1
21-02-2025,Spices & Seasonings,ROYAL SAFFRON 400GRMS,15,65,65,0,1
21-02-2025,Spices & Seasonings,Turmeric powder 250 gms,15,100,75,25,1
21-02-2025,Sweeteners,MISHRI D,16,40,30,10,1
21-02-2025,Snacks & Ready-to-Eat,Corn Chips 250GM,14,40,35,5,1
21-02-2025,"Grains, Flours & Dals",Wheat Flour 1 kg,4,210,180,30,3
21-02-2025,Spices & Seasonings,Jeera 100GM,15,50,45,5,1
21-02-2025,"Dry Fruits, Nuts & Seeds",SATHVI CHIA SEEDS 100GM,2,100,80,20,1
21-02-2025,Spices & Seasonings,Gasagasalu 50GM,15,130,110,20,1
21-02-2025,Spices & Seasonings,YB PINK ROCK SALT 1KG,15,120,120,0,1
21-02-2025,"Grains, Flours & Dals",SRILATHA RICE RAVVA 500GM,4,35,35,0,1
21-02-2025,"Health, Wellness & Ayurvedic Products",RB Max Protein Choco chips 55gm,5,50,50,0,1
21-02-2025,"Grains, Flours & Dals",SABDANA,4,40,35,5,1
21-02-2025,"Dry Fruits, Nuts & Seeds",Groundnuts 500 gms,2,95,85,10,1
21-02-2025,General Household & Kitchenware,BLADE,3,12,12,0,1
21-02-2025,Sweeteners,SUGAR 500 GM,16,30,25,5,1
21-02-2025,Snacks & Ready-to-Eat,VD Minapa papad 200gm,14,60,60,0,1
21-02-2025,Personal Care & Cosmetics,SANTOOR,10,120,100,20,1
21-02-2025,Oils & Ghee,Groundnut oil 1 L,9,360,330,30,1
21-02-2025,Pooja & Spiritual Items,SWASTIK CAMPHOR 25GM,12,45,45,0,1
21-02-2025,Sweeteners,Natural Honey 500 gms,16,280,240,40,1
21-02-2025,"Grains, Flours & Dals",Wheat Flour 1 kg,4,70,60,10,1
21-02-2025,"Grains, Flours & Dals",White jowar.F 1 kg,4,100,80,20,1
21-02-2025,"Grains, Flours & Dals",PESARA PAPPU 1 KG,4,340,290,50,2
21-02-2025,Spices & Seasonings,DURGA SALT CRYSTAL 1KG,15,50,50,0,2
21-02-2025,Sweeteners,YB Brown Sugar 500GM,16,150,150,0,2
21-02-2025,"Grains, Flours & Dals",Urad dall 1 Kg,4,185,170,15,1
21-02-2025,Spices & Seasonings,Coriander seeds 200 gms,15,48,40,8,1
21-02-2025,"Grains, Flours & Dals",Red Chana 250GM,4,70,60,10,2
21-02-2025,"Grains, Flours & Dals",POORI ATTA 500GM,4,35,30,5,1
21-02-2025,Spices & Seasonings,AVALU 100GM,15,25,20,5,1
21-02-2025,"Grains, Flours & Dals",BASMATHI RICE 1KG,4,300,270,30,2
21-02-2025,"Dry Fruits, Nuts & Seeds",Groundnuts 1 kg,2,190,170,20,1
21-02-2025,Sweeteners,SUGAR 500 GM,16,30,25,5,1
21-02-2025,"Grains, Flours & Dals",Chittimuthaylu rice 1 kg,4,160,140,20,1
21-02-2025,Spices & Seasonings,Miriyalu 50GM,15,100,80,20,1
21-02-2025,"Dry Fruits, Nuts & Seeds",Groundnuts 500 gms,2,95,85,10,1
21-02-2025,"Grains, Flours & Dals",split green gram 1 kg,4,150,140,10,1
21-02-2025,"Grains, Flours & Dals",RICE FLOUR 500 GM,4,70,56,14,2
21-02-2025,"Dry Fruits, Nuts & Seeds",PUMPKIN SEEDS 250GM,2,200,160,40,1
21-02-2025,"Grains, Flours & Dals",RAJMA 250GM,4,55,45,10,1
21-02-2025,Snacks & Ready-to-Eat,urban murmura,14,60,55,5,1
21-02-2025,"Grains, Flours & Dals",turdal 1kg,4,220,195,25,1
21-02-2025,"Grains, Flours & Dals",Wheat Rava S 500GM,4,33,30,3,1
21-02-2025,Oils & Ghee,Groundnut oil 1 L,9,360,330,30,1
21-02-2025,"Grains, Flours & Dals",BOMBAY RAVA,4,70,55,15,1
21-02-2025,Oils & Ghee,Sesame oil 1 L,9,590,560,30,1
21-02-2025,"Grains, Flours & Dals",Multigrain 1 kg,4,200,170,30,2
21-02-2025,Spices & Seasonings,Jeera 100GM,15,50,45,5,1
21-02-2025,Oils & Ghee,Mustard oil 500 ml,9,220,195,25,1
21-02-2025,"Grains, Flours & Dals",THICK POHA 1KG,4,80,70,10,1
21-02-2025,"Grains, Flours & Dals",Wheat Flour 1 kg,4,210,180,30,3
21-02-2025,Spices & Seasonings,PURO Healthy Salt Crystal 1KG,15,135,135,0,1
21-02-2025,Snacks & Ready-to-Eat,GROUNDNUT LADDU WITH DATES,14,135,135,0,1
21-02-2025,Snacks & Ready-to-Eat,SD Bajra with palm Jaggery 250gm,14,135,135,0,1
21-02-2025,Snacks & Ready-to-Eat,VD MULTI CHAKKA,14,110,110,0,1
21-02-2025,Snacks & Ready-to-Eat,SD FINGER Millet with palm Jaggery 250gm,14,135,135,0,1
21-02-2025,"Health, Wellness & Ayurvedic Products",DWI EUCALYPTUS 50ML,5,210,210,0,1
21-02-2025,Snacks & Ready-to-Eat,ONION RINGS,14,50,50,0,1
21-02-2025,Snacks & Ready-to-Eat,Pani Poori Chips 250GM,14,50,40,10,1
21-02-2025,Sweeteners,GS JAGGERY NUGGETS 500GM,16,120,120,0,1
21-02-2025,"Grains, Flours & Dals",COW B rice 1 kg,4,144,138,6,2
21-02-2025,Personal Care & Cosmetics,MD Bath Powder 100GM,10,40,40,0,1
21-02-2025,Pooja & Spiritual Items,OM SAINATH ISOBORNEOL 10GM,12,60,60,0,1
21-02-2025,Oils & Ghee,Groundnut oil 1 L,9,360,330,30,1
21-02-2025,Oils & Ghee,Safflower oil 1 L,9,440,400,40,1
21-02-2025,"Health, Wellness & Ayurvedic Products",RB Max Protein Choco chips 55gm,5,50,50,0,1
21-02-2025,"Health, Wellness & Ayurvedic Products",RB Max Protein NUTS &SEEDS 55gm,5,50,50,0,1
21-02-2025,Oils & Ghee,Safflower oil 5 L,9,2200,"1,950.00",250,1
21-02-2025,Personal Care & Cosmetics,COW DURBAR 7 HERBS SHAMPOO,10,125,125,0,1
21-02-2025,"Grains, Flours & Dals",Idly Rava L 1KG,4,60,50,10,1
21-02-2025,"Grains, Flours & Dals",KORRALU (FOXTAIL M) 500GM,4,65,55,10,1
21-02-2025,"Grains, Flours & Dals",Arikalu (kodo),4,70,65,5,1
21-02-2025,"Grains, Flours & Dals",UDALU (Barnyard millet) 500 gms,4,70,60,10,1
21-02-2025,"Grains, Flours & Dals",SAMALU (Little millet) 500 gms,4,85,65,20,1
21-02-2025,Spices & Seasonings,Vamu 100GM,15,60,50,10,1
21-02-2025,Oils & Ghee,Groundnut oil 1 L,9,360,330,30,1
21-02-2025,"Grains, Flours & Dals",RICE FLOUR 500 GM,4,35,28,7,1
21-02-2025,"Grains, Flours & Dals",RAJMA 250GM,4,55,45,10,1
21-02-2025,Spices & Seasonings,Menthulu 250 gms,15,50,45,5,1
21-02-2025,"Grains, Flours & Dals",BASMATHI RICE 1KG,4,150,135,15,1
21-02-2025,"Grains, Flours & Dals",Chana Flour 500 gms,4,70,65,5,1
21-02-2025,"Grains, Flours & Dals",POORI ATTA 500GM,4,35,30,5,1
21-02-2025,"Grains, Flours & Dals",SAMALU (Little millet) 1 kg,4,170,130,40,1
21-02-2025,"Grains, Flours & Dals",KORRALU (FOXTAIL M) 1KG,4,150,110,40,1
21-02-2025,"Grains, Flours & Dals",UDALU (Barnyard millet) 1 kg,4,280,230,50,2
21-02-2025,"Grains, Flours & Dals",Wheat Flour 2 kgs,4,280,240,40,2
21-02-2025,"Grains, Flours & Dals",Wheat Flour 1 kg,4,70,60,10,1
21-02-2025,"Grains, Flours & Dals",VGR rice 1 kg,4,280,260,20,4
21-02-2025,"Grains, Flours & Dals",SINGLE POLISH 1KG,4,325,325,0,5
21-02-2025,Personal Care & Cosmetics,HERBAL BATH POWDER 200GM,10,80,80,0,1
21-02-2025,Snacks & Ready-to-Eat,NGT CHATPATTA CHANA 90GM,14,25,25,0,1
21-02-2025,"Grains, Flours & Dals",VYS.SP.RICE BAG 1,4,1800,"1,650.00",150,1
21-02-2025,"Grains, Flours & Dals",Multigrain 1 kg,4,100,85,15,1
21-02-2025,"Grains, Flours & Dals",BOMBAY RAVA,4,70,55,15,1
21-02-2025,Oils & Ghee,Safflower oil 500 ml,9,220,200,20,1
21-02-2025,Spices & Seasonings,NUVVULU 250GM,15,100,85,15,1
21-02-2025,Oils & Ghee,Groundnut oil 500ml,9,180,165,15,1
21-02-2025,"Grains, Flours & Dals",RAJMA 250GM,4,55,45,10,1
21-02-2025,Snacks & Ready-to-Eat,BATANA NGT 70GMS,14,60,60,0,3
21-02-2025,Snacks & Ready-to-Eat,VD NUVVULU LADDU,14,80,80,0,1
21-02-2025,"Grains, Flours & Dals",RAGULU 1 KG,4,35,30,5,0.5
21-02-2025,Snacks & Ready-to-Eat,VD PAPPU CHEGODI 200GM,14,60,60,0,1
21-02-2025,"Grains, Flours & Dals",White Chana 250 GM,4,60,50,10,1
21-02-2025,"Grains, Flours & Dals",FLOUR CHARGE,4,32.4,32.4,0,2.7
21-02-2025,Snacks & Ready-to-Eat,VD Pappu Chekkalu 190gm,14,60,60,0,1
21-02-2025,Snacks & Ready-to-Eat,SD RAGI GAVVALU,14,95,95,0,1
21-02-2025,Snacks & Ready-to-Eat,RINGS 200GM,14,30,30,0,1
21-02-2025,"Grains, Flours & Dals",Black uluvalu 250 gms,4,45,35,10,1
21-02-2025,"Grains, Flours & Dals",Red Chana 250GM,4,35,30,5,1
21-02-2025,Snacks & Ready-to-Eat,ANNAPURNA APPALAM,14,35,35,0,1
21-02-2025,Spices & Seasonings,NUVVULU 500GM,15,200,170,30,1
21-02-2025,Oils & Ghee,cow ghee 500 ml,9,430,390,40,1
21-02-2025,Oils & Ghee,Sesame oil 1 L,9,590,560,30,1
21-02-2025,Oils & Ghee,Mustard oil 500 ml,9,220,195,25,1
21-02-2025,"Grains, Flours & Dals",Chana Flour 500 gms,4,70,65,5,1
21-02-2025,"Grains, Flours & Dals",PRO SOYA CHUNKS 200G,4,79,79,0,1
21-02-2025,"Dry Fruits, Nuts & Seeds",ALMONDS 250GM,2,280,260,20,1
21-02-2025,Spices & Seasonings,Vamu 100GM,15,60,50,10,1
21-02-2025,"Grains, Flours & Dals",Wheat Flour 1 kg,4,140,120,20,2
21-02-2025,"Grains, Flours & Dals",Wheat Rava S 1KG,4,65,55,10,1
21-02-2025,"Dry Fruits, Nuts & Seeds",PULMAKHANA 100 GM,2,180,170,10,1
21-02-2025,"Dry Fruits, Nuts & Seeds",PUTNALU 500GMS,2,90,76,14,1
21-02-2025,Snacks & Ready-to-Eat,RB Choco Delite Almonds Raisins 40g,14,45,45,0,1
21-02-2025,"Grains, Flours & Dals",Chana Flour 500 gms,4,70,65,5,1
21-02-2025,"Grains, Flours & Dals",MAAGAANI LOW GI SP L 1KG,4,120,105,15,1
21-02-2025,"Grains, Flours & Dals",UDALU (Barnyard millet) 500 gms,4,70,60,10,1
21-02-2025,"Grains, Flours & Dals",BOMBAY RAVA,4,70,55,15,1
21-02-2025,"Grains, Flours & Dals",White Chana 250 GM,4,60,50,10,1
21-02-2025,"Dry Fruits, Nuts & Seeds",Putnalu 250GM,2,45,38,7,1
21-02-2025,Pooja & Spiritual Items,GD Dhoop Sticks 26GM,12,40,40,0,2
21-02-2025,"Grains, Flours & Dals",PESARA PAPPU 1 KG,4,170,145,25,1
21-02-2025,"Grains, Flours & Dals",CHANA DAL 500GM,4,70,60,10,1
21-02-2025,Milk & Dairy,BROWN EGGS TRAY 30P,7,360,330,30,1
21-02-2025,"Health, Wellness & Ayurvedic Products",MH Millets Malt 1KG,5,400,380,20,1
21-02-2025,Pooja & Spiritual Items,VRP APOORVA JAVADHU POW,12,35,35,0,1
21-02-2025,"Grains, Flours & Dals",MAA TEJA RICE BAG 26KG,4,2210,"1,750.00",460,1
21-02-2025,"Grains, Flours & Dals",Wheat Flour 2 kgs,4,140,120,20,1
21-02-2025,"Grains, Flours & Dals",White jowar .F 2 KGS,4,200,160,40,1
21-02-2025,Spices & Seasonings,Gasagasalu 50GM,15,130,110,20,1
21-02-2025,"Grains, Flours & Dals",White jowar .F 2 KGS,4,200,160,40,1
21-02-2025,Oils & Ghee,GANTASALA A2 COW GHEE 500ML,9,550,550,0,1
21-02-2025,"Grains, Flours & Dals",turdal 1kg,4,220,195,25,1
21-02-2025,Spices & Seasonings,NUVVULU 500GM,15,200,170,30,1
21-02-2025,Spices & Seasonings,TATA SALT 1KG,15,60,60,0,2
21-02-2025,General Household & Kitchenware,BLADE,3,24,24,0,2
21-02-2025,Snacks & Ready-to-Eat,VD MANGO JELLY 250GRMS,14,80,80,0,1
21-02-2025,Snacks & Ready-to-Eat,SATHVI REGIVADA 200GM,14,160,120,40,2
21-02-2025,"Health, Wellness & Ayurvedic Products",RB Max Protein Fruit &amp;Nut 50g,5,75,75,0,1
21-02-2025,"Grains, Flours & Dals",Wheat Flour 1 kg,4,70,60,10,1
21-02-2025,"Grains, Flours & Dals",MAAGAANI LOW GI SP 1KG,4,596,500,96,4
21-02-2025,"Grains, Flours & Dals",white Bobarlu 500 gms,4,80,75,5,1
21-02-2025,"Grains, Flours & Dals",Red Wheat Flour 1 kg,4,140,130,10,1
21-02-2025,"Dry Fruits, Nuts & Seeds",Groundnuts 1 kg,2,190,170,20,1
21-02-2025,Snacks & Ready-to-Eat,VD MINAPA SUNNUNDALU 12P,14,180,180,0,1
21-02-2025,Snacks & Ready-to-Eat,VD PALLI LADDU,14,80,80,0,1
21-02-2025,Snacks & Ready-to-Eat,COPRA LADDU 200GM,14,100,80,20,1
21-02-2025,"Grains, Flours & Dals",MAAGAANI LOW GI SP L 1KG,4,120,105,15,1
21-02-2025,Spices & Seasonings,Chilli powder 500 gms,15,290,210,80,1
21-02-2025,"Dry Fruits, Nuts & Seeds",SATHVI CHIA SEEDS 100GM,2,100,80,20,1
21-02-2025,"Grains, Flours & Dals",Wheat Flour 1 kg,4,140,120,20,2
21-02-2025,Spices & Seasonings,Tamarind 250GMS,15,75,75,0,1
21-02-2025,"Grains, Flours & Dals",RICE FLOUR 1KG,4,210,165,45,3
21-02-2025,Snacks & Ready-to-Eat,VD RED CHILLI RICEPAPAD 150GM,14,50,50,0,1
21-02-2025,Spices & Seasonings,RED COPRA 250GMS,15,85,74,11,1
21-02-2025,"Grains, Flours & Dals",White jowar.F 1 kg,4,300,240,60,3
21-02-2025,Snacks & Ready-to-Eat,KURNOOL MARMURA,14,70,55,15,1
21-02-2025,Snacks & Ready-to-Eat,SD Pumpkin Seeds With Dates 175gm,14,170,170,0,1
21-02-2025,"Grains, Flours & Dals",Multigrain 1 kg,4,200,170,30,2
21-02-2025,Sweeteners,GS Palm Jaggery Powder 400GM,16,360,360,0,2
21-02-2025,Oils & Ghee,Sesame oil 1 L,9,590,560,30,1
21-02-2025,"Grains, Flours & Dals",Urad dall 1 Kg,4,185,170,15,1
21-02-2025,Snacks & Ready-to-Eat,FOXTAIL BIS,14,135,135,0,1
21-02-2025,"Grains, Flours & Dals",FLOUR CHARGE,4,120,120,0,10
21-02-2025,"Grains, Flours & Dals",Red Wheat Flour 1 kg,4,140,130,10,1
21-02-2025,"Grains, Flours & Dals",Em Multimillet idli r 500g,4,129,129,0,1
21-02-2025,Snacks & Ready-to-Eat,VD Minapa papad 200gm,14,60,60,0,1
21-02-2025,Oils & Ghee,Groundnut oil 1 L,9,720,660,60,2
21-02-2025,Oils & Ghee,Sesame oil 1 L,9,590,560,30,1
21-02-2025,"Grains, Flours & Dals",Wheat Flour 1 kg,4,70,60,10,1
21-02-2025,"Dry Fruits, Nuts & Seeds",DRYDATES YELLOW 250GM,2,405,360,45,3
21-02-2025,Personal Care & Cosmetics,HERBAL BATH POWDER 200GM,10,80,80,0,1
21-02-2025,Oils & Ghee,Castor oil 200 ml,9,100,80,20,1
21-02-2025,"Grains, Flours & Dals",Red uluvalu 250 gms,4,45,40,5,1
21-02-2025,"Health, Wellness & Ayurvedic Products",MD Neem Leaf Choornam 100GM,5,110,110,0,1
21-02-2025,Snacks & Ready-to-Eat,HS JOWAR BISCUITS,14,50,50,0,1
21-02-2025,"Health, Wellness & Ayurvedic Products",SAI DURGA MORINGA LEAVES 100GM,5,75,75,0,1
21-02-2025,Spices & Seasonings,KALONJI SEEDS,15,90,80,10,1
21-02-2025,Spices & Seasonings,ER GARAM MASALA,15,10,10,0,2
21-02-2025,"Grains, Flours & Dals",DESI CHANA,4,25,25,0,1
21-02-2025,"Grains, Flours & Dals",JOWAR WHITE 1 KG,4,20,17.5,2.5,0.25
21-02-2025,"Grains, Flours & Dals",RICE FLOUR 1KG,4,70,55,15,1
21-02-2025,"Dry Fruits, Nuts & Seeds",ALMONDS 250GM,2,280,260,20,1
21-02-2025,"Dry Fruits, Nuts & Seeds",PLAIN PISTA 250GM,2,660,550,110,1
21-02-2025,"Grains, Flours & Dals",Wheat Flour 1 kg,4,70,60,10,1
21-02-2025,Snacks & Ready-to-Eat,ELITE MILK RUSK 200GM,14,35,35,0,1
21-02-2025,General Household & Kitchenware,B4 BOWL,3,160,152,8,1
21-02-2025,Oils & Ghee,Sesame oil 1 L,9,590,560,30,1
21-02-2025,Snacks & Ready-to-Eat,SATHVI REGIVADA 200GM,14,80,60,20,1
21-02-2025,Spices & Seasonings,Turmeric powder 250 gms,15,100,75,25,1
21-02-2025,Spices & Seasonings,SAMBAR POWDER 200GM,15,110,110,0,1
21-02-2025,Oils & Ghee,Groundnut oil 1 L,9,1080,990,90,3
21-02-2025,Spices & Seasonings,SONTI 50GM,15,30,30,0,1
21-02-2025,Milk & Dairy,BROWN EGGS TRAY 30P,7,360,330,30,1
21-02-2025,Oils & Ghee,Castor oil 200 ml,9,100,80,20,1
21-02-2025,"Dry Fruits, Nuts & Seeds",SABJA SEEDS 100GM,2,80,70,10,1
21-02-2025,Sweeteners,NATURAL HONEY 250GM,16,150,130,20,1
21-02-2025,Sweeteners,Natural Honey 500 gms,16,280,240,40,1
21-02-2025,"Grains, Flours & Dals",RAGI FLOUR 500GRMS,4,40,35,5,1
21-02-2025,"Grains, Flours & Dals",split green gram 500 gms,4,75,70,5,1
21-02-2025,"Grains, Flours & Dals",White jowar.F 1 kg,4,100,80,20,1
21-02-2025,"Grains, Flours & Dals",KORRALU (FOXTAIL M) 500GM,4,65,55,10,1
21-02-2025,"Grains, Flours & Dals",split green gram 500 gms,4,75,70,5,1
21-02-2025,"Grains, Flours & Dals",JOWAR YELLOW 1 K,4,100,90,10,1
21-02-2025,Snacks & Ready-to-Eat,PEANUT CHILLI,14,30,30,0,6
21-02-2025,"Grains, Flours & Dals",BAJRA 1 KG,4,30,25,5,0.5
21-02-2025,"Grains, Flours & Dals",Arikalu (kodo),4,70,65,5,1
21-02-2025,"Grains, Flours & Dals",Red Chana 250GM,4,70,60,10,2
21-02-2025,Snacks & Ready-to-Eat,TILLI CHIKKI,14,30,30,0,6
21-02-2025,Sweeteners,SUGAR 500 GM,16,30,25,5,1
21-02-2025,"Grains, Flours & Dals",WHEAT 1 KG,4,60,50,10,1
21-02-2025,"Dry Fruits, Nuts & Seeds",FLAX SEEDS 250GM,2,60,50,10,1
21-02-2025,Oils & Ghee,Groundnut oil 1 L,9,360,330,30,1
21-02-2025,"Grains, Flours & Dals",SAMALU (Little millet) 500 gms,4,85,65,20,1
21-02-2025,"Grains, Flours & Dals",Green gram 500 gms,4,75,70,5,1
21-02-2025,Oils & Ghee,Sesame oil 1 L,9,590,560,30,1
21-02-2025,"Grains, Flours & Dals",Red Bobarlu 500 gms,4,95,85,10,1
21-02-2025,"Grains, Flours & Dals",RAGULU 1 KG,4,70,60,10,1
21-02-2025,Spices & Seasonings,NUVVULU 250GM,15,80,65,15,1
21-02-2025,Snacks & Ready-to-Eat,RAJGIRA PEANUT CHIKKI,14,30,30,0,6
21-02-2025,"Health, Wellness & Ayurvedic Products",GD 27 HERBS OIL 120ML,5,150,150,0,1
21-02-2025,Beverages,GANTASALA TEJ DRY GINGER COFFEE,1,149,149,0,1
21-02-2025,"Dry Fruits, Nuts & Seeds",FLAX SEEDS 250GM,2,60,50,10,1
21-02-2025,"Grains, Flours & Dals",Em little upma R 500g,4,129,129,0,1
21-02-2025,"Grains, Flours & Dals",Em Little idli R 500g,4,129,129,0,1
21-02-2025,"Grains, Flours & Dals",EM Ragi idli R 500G,4,75,75,0,1
21-02-2025,"Grains, Flours & Dals",Em kodo idli R 500G,4,258,258,0,2
21-02-2025,"Grains, Flours & Dals",EM Foxtail idli r 500 g,4,109,109,0,1
21-02-2025,"Grains, Flours & Dals",Em Foxtail upma r 500 g,4,109,109,0,1
21-02-2025,"Dry Fruits, Nuts & Seeds",Groundnuts 500 gms,2,95,85,10,1
21-02-2025,Pooja & Spiritual Items,GD Dhoop Sticks 26GM,12,20,20,0,1
21-02-2025,"Grains, Flours & Dals",AISHWARYA SP 1KG,4,240,210,30,3
21-02-2025,Pooja & Spiritual Items,GD Sambrani Cup Dhoop 10 PC,12,96,96,0,1
21-02-2025,General Household & Kitchenware,VERMI COMPOST MIX,3,30,30,0,1
21-02-2025,Pooja & Spiritual Items,GD Aiswarya Deepam 700ML,12,390,390,0,2
21-02-2025,"Grains, Flours & Dals",KORRALU (FOXTAIL M) 1KG,4,150,110,40,1
21-02-2025,Sweeteners,SD PALM JAGGERY 500GM,16,200,200,0,1
21-02-2025,Snacks & Ready-to-Eat,SD Vamu with palm jaggery 250gm,14,135,135,0,1
21-02-2025,Oils & Ghee,Coconut oil 1 L,9,880,800,80,2
21-02-2025,"Grains, Flours & Dals",DH URAD GOTA 1KG,4,215,190,25,1
21-02-2025,Snacks & Ready-to-Eat,VD MINAPA VADIYAM,14,65,65,0,1
21-02-2025,"Grains, Flours & Dals",Idly Rava L 1KG,4,60,50,10,1
21-02-2025,Snacks & Ready-to-Eat,RINGS 200GM,14,30,30,0,1
21-02-2025,Oils & Ghee,Groundnut oil 1 L,9,360,330,30,1
21-02-2025,"Grains, Flours & Dals",KORRALU (FOXTAIL M) 1KG,4,150,110,40,1
21-02-2025,"Grains, Flours & Dals",VYS.SP RICE 1 KG,4,70,65,5,1
21-02-2025,"Grains, Flours & Dals",KORRALU (FOXTAIL M) 500GM,4,65,55,10,1
21-02-2025,Snacks & Ready-to-Eat,VD NUVULU CHEGODI 175GM,14,240,240,0,4
21-02-2025,"Grains, Flours & Dals",Wheat Flour 1 kg,4,70,60,10,1
21-02-2025,Oils & Ghee,Coconut oil 1 L,9,440,400,40,1
21-02-2025,"Health, Wellness & Ayurvedic Products",SAI DURGA MORINGA LEAVES 100GM,5,75,75,0,1
21-02-2025,"Grains, Flours & Dals",RAGI FLOUR 500GRMS,4,40,35,5,1
21-02-2025,Pooja & Spiritual Items,BANDA PUVVU 25GM 25GM,12,80,60,20,1
21-02-2025,"Grains, Flours & Dals",Multigrain 2 kgs,4,200,170,30,1
21-02-2025,Spices & Seasonings,BLACK JEERA 50 GM,15,45,30,15,1
21-02-2025,"Grains, Flours & Dals",Bombay Rava 500GM,4,35,30,5,1
21-02-2025,"Grains, Flours & Dals",RAJMA 250GM,4,55,45,10,1
21-02-2025,Oils & Ghee,Coconut oil 500 ml,9,220,200,20,1
21-02-2025,Milk & Dairy,SANGAM FULL CREAM MILK 500ML,7,38,38,0,1
21-02-2025,Milk & Dairy,HERITAGE TONED MILK 500ML,7,31,31,0,1
21-02-2025,Snacks & Ready-to-Eat,SD FLAX SEED APPADALU,14,90,90,0,1
21-02-2025,Snacks & Ready-to-Eat,VD PAPPU CHEGODI 200GM,14,60,60,0,1
21-02-2025,"Grains, Flours & Dals",RAGI FLOUR 500GRMS,4,40,35,5,1
21-02-2025,"Grains, Flours & Dals",Em jowar idly R 500G,4,75,75,0,1
21-02-2025,Sweeteners,YB JAGGERY POWDER 500GMS,16,75,75,0,1
21-02-2025,"Grains, Flours & Dals",HS Jowar upma rava 500 gms,4,65,65,0,1
21-02-2025,"Grains, Flours & Dals",UDALU (Barnyard millet) 500 gms,4,70,60,10,1
21-02-2025,"Grains, Flours & Dals",Arikalu (kodo),4,70,65,5,1
21-02-2025,Snacks & Ready-to-Eat,VD MURMURA LADDU,14,50,50,0,1
21-02-2025,Milk & Dairy,BROWN EGGS 1P,7,140,120,20,10
21-02-2025,"Health, Wellness & Ayurvedic Products",SAI DURGA MORINGA LEAVES 100GM,5,75,75,0,1
21-02-2025,"Dry Fruits, Nuts & Seeds",SABJA SEEDS 100GM,2,80,70,10,1
21-02-2025,Oils & Ghee,BUFFALLO GHEE 500ML,9,820,740,80,2
20-02-2025,Snacks & Ready-to-Eat,BROWN BREAD,14,55,55,0,1
20-02-2025,"Health, Wellness & Ayurvedic Products",RB Max Protein Spanish Tomato,5,45,45,0,1
20-02-2025,"Grains, Flours & Dals",RAGI FLOUR 1KG,4,80,70,10,1
20-02-2025,Spices & Seasonings,Chilli powder 500 gms,15,290,210,80,1
20-02-2025,Spices & Seasonings,Masala Karam 250 gms,15,130,120,10,1
20-02-2025,Snacks & Ready-to-Eat,RAJGIRA PEANUT CHIKKI 450GM,14,125,125,0,1
20-02-2025,"Grains, Flours & Dals",Chana Flour 500 gms,4,140,130,10,2
20-02-2025,Oils & Ghee,Groundnut oil 1 L,9,360,330,30,1
20-02-2025,Oils & Ghee,Sesame oil 1 L,9,590,560,30,1
20-02-2025,"Grains, Flours & Dals",HS BAJRA FLAKES 250GM 1+1,4,119,119,0,1
20-02-2025,Oils & Ghee,Mustard oil 500 ml,9,220,195,25,1
20-02-2025,Oils & Ghee,Coconut oil 1 L,9,440,400,40,1
20-02-2025,"Grains, Flours & Dals",BARLEY SEEDS 250GMS,4,40,35,5,1
20-02-2025,Oils & Ghee,Groundnut oil 1 L,9,360,330,30,1
20-02-2025,"Dry Fruits, Nuts & Seeds",FLAX SEEDS 250GM,2,60,50,10,1
20-02-2025,Spices & Seasonings,KALONJI SEEDS,15,90,80,10,1
20-02-2025,Spices & Seasonings,PRO ORG CUMIN 100G,15,176,176,0,1
20-02-2025,Spices & Seasonings,Tamarind 250GMS,15,75,75,0,1
20-02-2025,Spices & Seasonings,Dalchin Rolls 50GM,15,70,70,0,1
20-02-2025,Spices & Seasonings,BLACK JEERA 50 GM,15,45,30,15,1
20-02-2025,"Grains, Flours & Dals",maida 500grms,4,60,60,0,1
20-02-2025,"Dry Fruits, Nuts & Seeds",PUTNALU 500GMS,2,90,76,14,1
20-02-2025,"Grains, Flours & Dals",Sathya Javva Wheat Rava 500GM,4,95,95,0,1
20-02-2025,"Grains, Flours & Dals",Wheat Flour 1 kg,4,70,60,10,1
20-02-2025,Sweeteners,YB FOREST HONEY 250GM,16,180,180,0,1
20-02-2025,"Grains, Flours & Dals",turdal 500 gms,4,220,200,20,2
20-02-2025,"Grains, Flours & Dals",turdal 1kg,4,220,195,25,1
20-02-2025,Snacks & Ready-to-Eat,PUMPKIN CHIKKI 200GM,14,140,120,20,1
20-02-2025,Oils & Ghee,Sesame oil 1 L,9,590,560,30,1
20-02-2025,Oils & Ghee,Safflower oil 1 L,9,440,400,40,1
20-02-2025,Snacks & Ready-to-Eat,SATHVI REGIVADA 200GM,14,80,60,20,1
20-02-2025,"Dry Fruits, Nuts & Seeds",Groundnuts 1 kg,2,190,170,20,1
20-02-2025,"Grains, Flours & Dals",Hs yellow jowar r 500g,4,99,99,0,1
20-02-2025,Oils & Ghee,Groundnut oil 1 L,9,360,330,30,1
20-02-2025,Milk & Dairy,BROWN EGGS 1P,7,168,144,24,12
20-02-2025,General Household & Kitchenware,VERMI COMPOST MIX,3,30,30,0,1
20-02-2025,Milk & Dairy,HERITAGE TONED MILK 500ML,7,31,31,0,1
20-02-2025,Snacks & Ready-to-Eat,PEANUT CHIKKI 450GM,14,375,375,0,3
20-02-2025,"Grains, Flours & Dals",RED TURDAL 500GM,4,75,70,5,1
20-02-2025,"Grains, Flours & Dals",Chana Flour 500 gms,4,70,65,5,1
20-02-2025,"Grains, Flours & Dals",SINGLE POLISH 1KG,4,195,195,0,3
20-02-2025,Oils & Ghee,Groundnut oil 1 L,9,360,330,30,1
20-02-2025,"Grains, Flours & Dals",turdal 500 gms,4,110,100,10,1
20-02-2025,"Grains, Flours & Dals",THICK POHA 1KG,4,80,70,10,1
20-02-2025,Oils & Ghee,Coconut oil 1 L,9,440,400,40,1
20-02-2025,Spices & Seasonings,Coriander seeds 200 gms,15,48,40,8,1
20-02-2025,"Grains, Flours & Dals",SABDANA,4,40,35,5,1
20-02-2025,"Grains, Flours & Dals",Wheat Rava M 1KG,4,65,55,10,1
20-02-2025,Sweeteners,MISHRI D,16,40,30,10,1
20-02-2025,"Dry Fruits, Nuts & Seeds",PUMPKIN SEEDS 250GM,2,200,160,40,1
20-02-2025,"Dry Fruits, Nuts & Seeds",WATERMELON SEEDS 250GRM,2,320,280,40,1
20-02-2025,Spices & Seasonings,SH CASSIA STICKS 50GM,15,75,75,0,1
20-02-2025,"Dry Fruits, Nuts & Seeds",SUNFLOWER SEEDS 250GRM,2,150,130,20,1
20-02-2025,Snacks & Ready-to-Eat,BATANA NGT 70GMS,14,20,20,0,1
20-02-2025,Snacks & Ready-to-Eat,VD MURMURA LADDU,14,50,50,0,1
20-02-2025,Snacks & Ready-to-Eat,VD MIXTURE 175 GM,14,60,60,0,1
20-02-2025,Spices & Seasonings,Black Till 250GM,15,90,75,15,1
20-02-2025,Oils & Ghee,Groundnut oil 1 L,9,1080,990,90,3
20-02-2025,Oils & Ghee,Groundnut oil 1 L,9,360,330,30,1
20-02-2025,"Health, Wellness & Ayurvedic Products",NEELI LEAF CHOORNAM,5,110,110,0,1
20-02-2025,"Grains, Flours & Dals",Arikadu ( kodo),4,140,130,10,1
20-02-2025,Beverages,3ROSES,1,90,90,0,1
20-02-2025,Snacks & Ready-to-Eat,SD RAGI GAVVALU,14,95,95,0,1
20-02-2025,Oils & Ghee,Groundnut oil 1 L,9,720,660,60,2
20-02-2025,Snacks & Ready-to-Eat,SD Atreyapuram DRY Fruit ghee,14,150,150,0,1
20-02-2025,"Dry Fruits, Nuts & Seeds",DRIED KIWI 200GM,2,145,130,15,1
20-02-2025,Spices & Seasonings,Elaichi 25GM,15,145,120,25,1
20-02-2025,Spices & Seasonings,Jeera 100GM,15,50,45,5,1
20-02-2025,Spices & Seasonings,AVALU 100GM,15,25,20,5,1
20-02-2025,Pooja & Spiritual Items,SWASTIK CAMPHORE,12,90,90,0,1
20-02-2025,Personal Care & Cosmetics,ORGANIC SPONGE LOOFAH,10,70,70,0,1
20-02-2025,"Dry Fruits, Nuts & Seeds",PULMAKHANA 100 GM,2,180,170,10,1
20-02-2025,Oils & Ghee,Groundnut oil 1 L,9,360,330,30,1
20-02-2025,Personal Care & Cosmetics,Khadi Red Onion Shampoo 200ML,10,796,796,0,4
20-02-2025,Pooja & Spiritual Items,SWASTIK CAMPHOR 25GM,12,45,45,0,1
20-02-2025,Personal Care & Cosmetics,SUNNUPINDI SOAP UVS,10,99,99,0,1
20-02-2025,Snacks & Ready-to-Eat,BELLAM MINAPA SUNADULLU,14,180,180,0,1
20-02-2025,"Dry Fruits, Nuts & Seeds",WATERMELON SEEDS 250GRM,2,320,280,40,1
20-02-2025,"Dry Fruits, Nuts & Seeds",ALMONDS 250GM,2,280,260,20,1
20-02-2025,"Dry Fruits, Nuts & Seeds",DRYDATES YELLOW 250GM,2,135,120,15,1
20-02-2025,"Dry Fruits, Nuts & Seeds",SATHVI CHIA SEEDS 100GM,2,100,80,20,1
20-02-2025,"Dry Fruits, Nuts & Seeds",YELLOW KISHMISH 250GM,2,130,110,20,1
20-02-2025,Household & Cleaning,VIM SOAP,6,20,20,0,4
20-02-2025,Beverages,BRU GREEN LABEL 100G,1,65,65,0,1
20-02-2025,Personal Care & Cosmetics,ORGANIC SPONGE LOOFAH,10,70,70,0,1
20-02-2025,Household & Cleaning,SURF EXCEL MATIC TL 500ML,6,152,152,0,2
20-02-2025,Snacks & Ready-to-Eat,SD FINGER Millet with palm Jaggery 250gm,14,135,135,0,1
20-02-2025,"Health, Wellness & Ayurvedic Products",MXP CHOCO CLASSIC BAR,5,70,70,0,1
20-02-2025,"Grains, Flours & Dals",HS Multimillet idly R 500 gms,4,130,130,0,2
20-02-2025,"Grains, Flours & Dals",Wheat Flour 1 kg,4,70,60,10,1
20-02-2025,Oils & Ghee,Safflower oil 1 L,9,440,400,40,1
20-02-2025,"Grains, Flours & Dals",Wheat Flour 1 kg,4,700,600,100,10
20-02-2025,"Grains, Flours & Dals",turdal 1kg,4,440,390,50,2
20-02-2025,"Grains, Flours & Dals",RICE FLOUR 1KG,4,140,110,30,2
20-02-2025,Oils & Ghee,Groundnut oil 1 L,9,360,330,30,1
20-02-2025,"Grains, Flours & Dals",POORI ATTA 500GM,4,35,30,5,1
20-02-2025,"Grains, Flours & Dals",Wheat Flour 1 kg,4,70,60,10,1
20-02-2025,Snacks & Ready-to-Eat,VD MANGO JELLY 250GRMS,14,80,80,0,1
20-02-2025,Snacks & Ready-to-Eat,SD Ginger Candy 100g,14,60,60,0,1
20-02-2025,Oils & Ghee,Groundnut oil 5 L,9,1800,"1,600.00",200,1
20-02-2025,"Grains, Flours & Dals",RAGULU 1 KG,4,70,60,10,1
20-02-2025,"Grains, Flours & Dals",JOWAR WHITE 1 KG,4,80,70,10,1
20-02-2025,"Grains, Flours & Dals",Multigrain 1 kg,4,200,170,30,2
20-02-2025,Spices & Seasonings,Telaga Pindi 500GM,15,80,70,10,1
20-02-2025,"Grains, Flours & Dals",turdal 1kg,4,440,390,50,2
20-02-2025,General Household & Kitchenware,CLASSMATE,3,22,22,0,1
20-02-2025,Milk & Dairy,SANGAM TONED MILK 500ML,7,60,60,0,2
20-02-2025,Spices & Seasonings,Turmeric powder 250 gms,15,100,75,25,1
20-02-2025,Oils & Ghee,Sesame oil 1 L,9,590,560,30,1
20-02-2025,Spices & Seasonings,Masala Karam 500 gms,15,520,480,40,2
20-02-2025,Spices & Seasonings,Telaga Pindi 500GM,15,80,70,10,1
20-02-2025,"Grains, Flours & Dals",RAGI FLOUR 1KG,4,80,70,10,1
20-02-2025,"Grains, Flours & Dals",White jowar.F 1 kg,4,100,80,20,1
20-02-2025,Snacks & Ready-to-Eat,ANNAPURNA APPALAM,14,35,35,0,1
20-02-2025,"Grains, Flours & Dals",Multigrain 1 kg,4,200,170,30,2
20-02-2025,"Grains, Flours & Dals",PESARA PAPPU 500GMS,4,85,75,10,1
20-02-2025,Pickles & Cooking Pastes,SD RED CHILLI PICKLE,11,110,110,0,1
20-02-2025,"Grains, Flours & Dals",Wheat Flour 1 kg,4,140,120,20,2
20-02-2025,Spices & Seasonings,Tamarind 250GMS,15,75,75,0,1
20-02-2025,"Grains, Flours & Dals",POORI ATTA 1KG,4,70,60,10,1
20-02-2025,Snacks & Ready-to-Eat,ANNAPURNA APPALAM,14,35,35,0,1
20-02-2025,Beverages,BRU GREEN LABEL 1.2G,1,24,24,0,12
20-02-2025,"Health, Wellness & Ayurvedic Products",MD Triphala Chorrnam 100GM,5,80,80,0,1
20-02-2025,"Grains, Flours & Dals",RAGI FLOUR 500GRMS,4,40,35,5,1
20-02-2025,"Grains, Flours & Dals",Chana Flour 1 kg,4,280,260,20,2
20-02-2025,Sweeteners,YB Brown Sugar 1KG,16,140,140,0,1
20-02-2025,Snacks & Ready-to-Eat,VD NUVULU LADDU 9PIC,14,100,100,0,1
20-02-2025,"Grains, Flours & Dals",Urad dall 1 Kg,4,370,340,30,2
20-02-2025,"Grains, Flours & Dals",Multigrain 1 kg,4,200,170,30,2
20-02-2025,"Dry Fruits, Nuts & Seeds",YB GRANMA NUTS,2,90,90,0,1
20-02-2025,Oils & Ghee,Groundnut oil 1 L,9,360,330,30,1
20-02-2025,Snacks & Ready-to-Eat,PEANUT CHILLI,14,20,20,0,4
20-02-2025,Personal Care & Cosmetics,KHADI LEMONGRASS SOAP 125GM,10,80,80,0,1
20-02-2025,Snacks & Ready-to-Eat,Pani Poori Chips 250GM,14,50,40,10,1
20-02-2025,"Grains, Flours & Dals",RED TURDAL 500GM,4,75,70,5,1
20-02-2025,Snacks & Ready-to-Eat,SATHVI REGIVADA 200GM,14,160,120,40,2
20-02-2025,Oils & Ghee,Sesame oil 1 L,9,590,560,30,1
20-02-2025,"Grains, Flours & Dals",Wheat Flour 1 kg,4,70,60,10,1
20-02-2025,Spices & Seasonings,EVEREST PANI PURI MASALA 50GM,15,40,40,0,1
20-02-2025,"Grains, Flours & Dals",Multigrain 1 kg,4,200,170,30,2
20-02-2025,Spices & Seasonings,SWEET SOUNF,15,20,20,0,1
20-02-2025,"Grains, Flours & Dals",RAGI FLOUR 1KG,4,80,70,10,1
20-02-2025,Milk & Dairy,BROWN EGGS TRAY 30P,7,360,330,30,1
20-02-2025,"Grains, Flours & Dals",HS JOWAR FLAKES 250GM 1+1,4,119,119,0,1
20-02-2025,Snacks & Ready-to-Eat,SH PUFFED RICE 500GM,14,55,55,0,1
20-02-2025,"Grains, Flours & Dals",White jowar.F 1 kg,4,100,80,20,1
20-02-2025,"Grains, Flours & Dals",Chana Flour 500 gms,4,70,65,5,1
20-02-2025,Spices & Seasonings,Masala Karam 250 gms,15,130,120,10,1
20-02-2025,"Grains, Flours & Dals",SRILATHA RICE RAVVA 500GM,4,35,35,0,1
20-02-2025,Milk & Dairy,HRITAGE TOTAL CURD 130GM,7,20,20,0,2
20-02-2025,Oils & Ghee,Safflower oil 1 L,9,440,400,40,1
20-02-2025,"Grains, Flours & Dals",RAGI FLOUR 500GRMS,4,40,35,5,1
20-02-2025,"Grains, Flours & Dals",Green gram 500 gms,4,75,70,5,1
20-02-2025,Oils & Ghee,Sesame oil 1 L,9,590,560,30,1
20-02-2025,"Grains, Flours & Dals",Wheat Rava S 500GM,4,33,30,3,1
20-02-2025,"Grains, Flours & Dals",RICE FLOUR 500 GM,4,35,28,7,1
20-02-2025,Oils & Ghee,Groundnut oil 500ml,9,180,165,15,1
20-02-2025,"Grains, Flours & Dals",SINGLE POLISH 1KG,4,650,650,0,10
20-02-2025,Sweeteners,SUGAR 1KG,16,120,100,20,2
20-02-2025,Milk & Dairy,HERITAGE TONED MILK 500ML,7,31,31,0,1
20-02-2025,"Grains, Flours & Dals",Chana Flour 500 gms,4,70,65,5,1
20-02-2025,Spices & Seasonings,Tamarind 500GM,15,296,296,0,2
20-02-2025,"Grains, Flours & Dals",RICE FLOUR 500 GM,4,35,28,7,1
20-02-2025,"Grains, Flours & Dals",VYS.SP.RICE BAG 1,4,1800,"1,650.00",150,1
20-02-2025,"Dry Fruits, Nuts & Seeds",SATHVI CHIA SEEDS 100GM,2,100,80,20,1
20-02-2025,Snacks & Ready-to-Eat,VD CORNFLAKES MIXTURE 175GM,14,60,60,0,1
20-02-2025,Spices & Seasonings,Vamu 100GM,15,60,50,10,1
20-02-2025,Spices & Seasonings,JEERA 250 gms,15,125,105,20,1
20-02-2025,Snacks & Ready-to-Eat,VD BOONDI 175GM,14,60,60,0,1
20-02-2025,Spices & Seasonings,AVALU 100GM,15,25,20,5,1
20-02-2025,"Grains, Flours & Dals",Idly Rava L 1KG,4,60,50,10,1
20-02-2025,Spices & Seasonings,NUVVULU 250GM,15,100,85,15,1
20-02-2025,Snacks & Ready-to-Eat,SD FINGER Millet with palm Jaggery 250gm,14,135,135,0,1
20-02-2025,"Grains, Flours & Dals",RICE FLOUR 500 GM,4,35,28,7,1
20-02-2025,"Grains, Flours & Dals",maida 500grms,4,60,60,0,1
20-02-2025,"Grains, Flours & Dals",CORN FOUR 250GM,4,40,35,5,1
20-02-2025,Snacks & Ready-to-Eat,ELITE MILK RUSK 200GM,14,35,35,0,1
20-02-2025,Sweeteners,YB JAGGERY POWDER 500GMS,16,75,75,0,1
20-02-2025,Snacks & Ready-to-Eat,BD BARELY NOODLES 200G,14,70,70,0,1
20-02-2025,"Dry Fruits, Nuts & Seeds",BLACK KISMIS 250GM,2,175,140,35,1
20-02-2025,"Dry Fruits, Nuts & Seeds",YELLOW KISHMISH 250GM,2,130,110,20,1
20-02-2025,Milk & Dairy,HERITAGE TONED MILK 500ML,7,31,31,0,1
20-02-2025,"Dry Fruits, Nuts & Seeds",DRYDATES YELLOW 250GM,2,135,120,15,1
20-02-2025,Oils & Ghee,Groundnut oil 1 L,9,360,330,30,1
20-02-2025,Milk & Dairy,HERITAGE TOTAL CURD 500GM,7,50,50,0,1
20-02-2025,Sweeteners,YB Brown Sugar 1KG,16,140,140,0,1
20-02-2025,Snacks & Ready-to-Eat,SD FINGER Millet with palm Jaggery 250gm,14,135,135,0,1
20-02-2025,Oils & Ghee,Safflower oil 1 L,9,440,400,40,1
20-02-2025,"Grains, Flours & Dals",Green gram 500 gms,4,75,70,5,1
20-02-2025,Oils & Ghee,Sesame oil 500ml,9,295,280,15,1
20-02-2025,Household & Cleaning,VIM SOAP,6,15,15,0,3
20-02-2025,Sweeteners,Natural Honey 500 gms,16,280,240,40,1
20-02-2025,"Grains, Flours & Dals",Wheat Rava S 500GM,4,66,60,6,2
20-02-2025,Oils & Ghee,Freedom Rice Bran Oil 1L,9,194,180,14,1
20-02-2025,Spices & Seasonings,RED COPRA 500GM,15,170,148,22,1
20-02-2025,Oils & Ghee,Groundnut oil 1 L,9,360,330,30,1
20-02-2025,Spices & Seasonings,Marati Magga 50GM,15,130,110,20,1
20-02-2025,"Grains, Flours & Dals",Wheat Flour 2 kgs,4,280,240,40,2
20-02-2025,Sweeteners,SUGAR 1KG,16,60,50,10,1
20-02-2025,Oils & Ghee,Coconut oil 1 L,9,440,400,40,1
20-02-2025,"Dry Fruits, Nuts & Seeds",ALBUKARA 250GM,2,145,120,25,1
20-02-2025,Snacks & Ready-to-Eat,VD PALLI LADDU,14,80,80,0,1
20-02-2025,Snacks & Ready-to-Eat,GREEN FRIED batana,14,40,40,0,2
20-02-2025,Snacks & Ready-to-Eat,BLACK SESAME CHIKKI,14,35,35,0,7
20-02-2025,Snacks & Ready-to-Eat,SD Thati thandra 200gm,14,150,150,0,1
20-02-2025,"Health, Wellness & Ayurvedic Products",MD Triphala Chorrnam 100GM,5,80,80,0,1
20-02-2025,Personal Care & Cosmetics,HERBAL BATH POWDER 200GM,10,80,80,0,1
20-02-2025,Snacks & Ready-to-Eat,VD MURMURA LADDU,14,50,50,0,1
20-02-2025,"Grains, Flours & Dals",Wheat Rava M 1KG,4,65,55,10,1
20-02-2025,"Grains, Flours & Dals",RAGI FLOUR 500GRMS,4,80,70,10,2
20-02-2025,"Grains, Flours & Dals",Wheat Flour 2 kgs,4,140,120,20,1
20-02-2025,"Grains, Flours & Dals",White jowar.F 1 kg,4,100,80,20,1
20-02-2025,"Grains, Flours & Dals",KORRALU (FOXTAIL M) 500GM,4,65,55,10,1
20-02-2025,Oils & Ghee,Safflower oil 5 L,9,2200,"1,950.00",250,1
20-02-2025,Sweeteners,MADHUR SUGAR 1KG,16,65,55,10,1
20-02-2025,"Grains, Flours & Dals",Wheat Flour 1 kg,4,70,60,10,1
20-02-2025,"Grains, Flours & Dals",SRILATHA RICE RAVVA 500GM,4,70,70,0,2
20-02-2025,"Grains, Flours & Dals",Red uluvalu 500 gms,4,360,300,60,4
20-02-2025,"Grains, Flours & Dals",White jowar .F 2 KGS,4,200,160,40,1
20-02-2025,"Grains, Flours & Dals",DH URAD GOTA 1KG,4,645,570,75,3
20-02-2025,"Grains, Flours & Dals",RAGULU 1 KG,4,140,120,20,2
20-02-2025,"Grains, Flours & Dals",Sathya Javva Wheat Rava 500GM,4,190,190,0,2
20-02-2025,"Grains, Flours & Dals",Wheat Rava S 1KG,4,130,110,20,2
20-02-2025,"Grains, Flours & Dals",JOWAR WHITE 1 KG,4,160,140,20,2
20-02-2025,Snacks & Ready-to-Eat,RINGS 200GM,14,90,90,0,3
20-02-2025,Spices & Seasonings,Tamarind 500GM,15,592,592,0,4
20-02-2025,"Dry Fruits, Nuts & Seeds",Groundnuts 1 kg,2,380,340,40,2
20-02-2025,"Grains, Flours & Dals",ANDU KORRALU (Browntop.m) 1 kg,4,520,440,80,2
20-02-2025,Snacks & Ready-to-Eat,VD SAGOPAPAD 150GM,14,110,110,0,2
20-02-2025,Spices & Seasonings,SAMBAR POWDER 200GM,15,130,110,20,1
20-02-2025,"Grains, Flours & Dals",Green gram 1 kg,4,300,260,40,2
20-02-2025,"Dry Fruits, Nuts & Seeds",PULMAKHANA 100 GM,2,900,850,50,5
20-02-2025,Snacks & Ready-to-Eat,3D PAPAD,14,120,120,0,3
20-02-2025,Spices & Seasonings,ROYAL SAFFRON 400GRMS,15,65,65,0,1
20-02-2025,Spices & Seasonings,DRY MIRCHI 1KG,15,300,240,60,1
20-02-2025,"Grains, Flours & Dals",turdal 1kg,4,660,585,75,3
20-02-2025,"Grains, Flours & Dals",SL Idly Rava 1KG,4,65,55,10,1
20-02-2025,"Grains, Flours & Dals",SAMALU (Little millet) 1 kg,4,340,260,80,2
20-02-2025,"Grains, Flours & Dals",RAGI FLOUR 1KG,4,160,140,20,2
20-02-2025,"Grains, Flours & Dals",UDALU (Barnyard millet) 1 kg,4,280,230,50,2
20-02-2025,"Grains, Flours & Dals",KORRALU (FOXTAIL M) 1KG,4,300,220,80,2
20-02-2025,Snacks & Ready-to-Eat,urban murmura,14,60,55,5,1
20-02-2025,"Grains, Flours & Dals",idly/Dosa rice 1 kg,4,140,120,20,2
20-02-2025,"Grains, Flours & Dals",VGR rice 1 kg,4,350,325,25,5
20-02-2025,Sweeteners,SUGAR 1KG,16,60,50,10,1
20-02-2025,Snacks & Ready-to-Eat,VD PALLI CHIKKI,14,80,80,0,1
20-02-2025,Oils & Ghee,Groundnut oil 1 L,9,360,330,30,1
20-02-2025,"Grains, Flours & Dals",RAGI FLOUR 1KG,4,80,70,10,1
20-02-2025,"Grains, Flours & Dals",Wheat Flour 1 kg,4,140,120,20,2
20-02-2025,Oils & Ghee,Coconut oil 1 L,9,440,400,40,1
20-02-2025,Sweeteners,Mishri 500GM,16,70,60,10,1
20-02-2025,"Grains, Flours & Dals",BARLEY SEEDS 250GMS,4,80,70,10,2
20-02-2025,"Grains, Flours & Dals",Yellow jowar .F1 kg,4,110,100,10,1
20-02-2025,Snacks & Ready-to-Eat,GREEN FRIED batana,14,100,100,0,5
20-02-2025,Snacks & Ready-to-Eat,KURNOOL MARMURA,14,70,55,15,1
20-02-2025,Snacks & Ready-to-Eat,TILLI CHIKKI,14,125,125,0,1
20-02-2025,Snacks & Ready-to-Eat,PEANUT CHIKKI 450GM,14,125,125,0,1
20-02-2025,Snacks & Ready-to-Eat,BATANA NGT 70GMS,14,60,60,0,3
20-02-2025,Spices & Seasonings,RED COPRA 500GM,15,170,148,22,1
20-02-2025,"Grains, Flours & Dals",SINGLE POLISH 1KG,4,65,65,0,1
20-02-2025,"Dry Fruits, Nuts & Seeds",PUTNALU 500GMS,2,90,76,14,1
20-02-2025,Sweeteners,GS Organic Jaggery Powder 600GM,16,99,99,0,1
20-02-2025,Oils & Ghee,Sesame oil 1 L,9,590,560,30,1
20-02-2025,"Health, Wellness & Ayurvedic Products",RB FRUITS &amp;seeds Cranberries,5,45,45,0,1
20-02-2025,Snacks & Ready-to-Eat,RI Yogurt Berry Oats 35g,14,45,45,0,1
20-02-2025,"Grains, Flours & Dals",Sathya Javva Wheat Rava 500GM,4,95,95,0,1
20-02-2025,Oils & Ghee,Groundnut oil 1 L,9,720,660,60,2
20-02-2025,Snacks & Ready-to-Eat,RB Choco Delite Almonds Raisins 40g,14,45,45,0,1
20-02-2025,Snacks & Ready-to-Eat,RITEBITE MELTING CHOCOLATE,14,50,50,0,1
20-02-2025,"Grains, Flours & Dals",Chana Flour 500 gms,4,70,65,5,1
20-02-2025,Spices & Seasonings,Vamu 100GM,15,60,50,10,1
20-02-2025,Snacks & Ready-to-Eat,VD MURMURA LADDU,14,50,50,0,1
20-02-2025,Snacks & Ready-to-Eat,SD Thati thandra 200gm,14,300,300,0,2
20-02-2025,"Grains, Flours & Dals",Urad dall 1 Kg,4,185,170,15,1
20-02-2025,Snacks & Ready-to-Eat,PUMPKIN CHIKKI 200GM,14,140,120,20,1
20-02-2025,"Grains, Flours & Dals",Sathya Javva Wheat Rava 500GM,4,95,95,0,1
20-02-2025,"Grains, Flours & Dals",ANDU KORRALU (Brown top .mlt) 500,4,130,110,20,1
20-02-2025,"Grains, Flours & Dals",Green gram 500 gms,4,75,70,5,1
20-02-2025,"Grains, Flours & Dals",RAGI FLOUR 500GRMS,4,40,35,5,1
20-02-2025,"Grains, Flours & Dals",Em Multimillet upma 500g,4,129,129,0,1
20-02-2025,Personal Care & Cosmetics,GAYATHRI KUMKUDUKAYA,10,150,150,0,1
20-02-2025,"Dry Fruits, Nuts & Seeds",WATERMELON SEEDS 250GRM,2,320,280,40,1
20-02-2025,"Grains, Flours & Dals",Red uluvalu 500 gms,4,70,70,0,1
20-02-2025,Oils & Ghee,Groundnut oil 1 L,9,360,330,30,1
20-02-2025,Spices & Seasonings,ROYAL SAFFRON,15,125,125,0,1
20-02-2025,"Grains, Flours & Dals",RAJMA 250GM,4,55,45,10,1
20-02-2025,"Grains, Flours & Dals",MIXED FLOUR,4,154,154,0,1
20-02-2025,"Dry Fruits, Nuts & Seeds",PULMAKHANA 100 GM,2,180,170,10,1
20-02-2025,"Health, Wellness & Ayurvedic Products",MORINGA LEAF POWDER M,5,80,75,5,1
20-02-2025,"Grains, Flours & Dals",SA YELLOW JOWAR RAVA 500GM,4,95,95,0,1
20-02-2025,"Grains, Flours & Dals",Yellow jowar .F1 kg,4,110,100,10,1
20-02-2025,Snacks & Ready-to-Eat,VD SANNAPUSA 175GM,14,60,60,0,1
20-02-2025,"Health, Wellness & Ayurvedic Products",DETTOL PLASTER,5,20,20,0,8
20-02-2025,Snacks & Ready-to-Eat,RSC ORANGE 100GMS,14,20,20,0,1
20-02-2025,"Dry Fruits, Nuts & Seeds",PULMAKHANA 100 GM,2,180,170,10,1
20-02-2025,"Grains, Flours & Dals",DESI CHANA,4,25,25,0,1
20-02-2025,"Grains, Flours & Dals",MIXED FLOUR,4,154,154,0,1
20-02-2025,Snacks & Ready-to-Eat,RINGS 200GM,14,30,30,0,1
20-02-2025,"Dry Fruits, Nuts & Seeds",Putnalu 250GM,2,45,38,7,1
20-02-2025,Pickles & Cooking Pastes,SD AMALA PICKLE,11,110,110,0,1
20-02-2025,Personal Care & Cosmetics,GAYATHRI KUMKUDUKAYA,10,150,150,0,1
20-02-2025,"Grains, Flours & Dals",Green gram 500 gms,4,75,70,5,1
20-02-2025,Snacks & Ready-to-Eat,VD RIBBON PAKODI 175GM,14,60,60,0,1
20-02-2025,Personal Care & Cosmetics,KAIPO SANDALWOOD SOAP 100GM,10,100,100,0,1
20-02-2025,Snacks & Ready-to-Eat,VD MIXTURE 175 GM,14,60,60,0,1
20-02-2025,Snacks & Ready-to-Eat,VD MURMURA LADDU,14,50,50,0,1
20-02-2025,Personal Care & Cosmetics,SANTOOR,10,120,100,20,1
20-02-2025,Personal Care & Cosmetics,DWI FOOT CARE 30G,10,90,90,0,1
20-02-2025,Oils & Ghee,Freedom Rice Bran Oil 1L,9,194,180,14,1
20-02-2025,"Grains, Flours & Dals",RICE FLOUR 1KG,4,140,110,30,2
20-02-2025,Snacks & Ready-to-Eat,SUNNUNDALU,14,100,100,0,1
20-02-2025,General Household & Kitchenware,B3 BOWL,3,265,251.75,13.25,1
20-02-2025,Sweeteners,MISHRI 250 GM,16,35,30,5,1
20-02-2025,"Grains, Flours & Dals",Wheat Rava S 1KG,4,65,55,10,1
20-02-2025,"Dry Fruits, Nuts & Seeds",Putnalu 250GM,2,45,38,7,1
20-02-2025,Spices & Seasonings,Vamu 100GM,15,60,50,10,1
20-02-2025,"Grains, Flours & Dals",Wheat Flour 1 kg,4,140,120,20,2
20-02-2025,"Grains, Flours & Dals",THICK POHA 500GM,4,40,35,5,1
20-02-2025,Oils & Ghee,Groundnut oil 1 L,9,360,330,30,1
20-02-2025,"Grains, Flours & Dals",Bombay Rava 500GM,4,35,30,5,1
20-02-2025,"Grains, Flours & Dals",Idly Rava L 1KG,4,60,50,10,1
20-02-2025,"Grains, Flours & Dals",White jowar.F 1 kg,4,100,80,20,1
20-02-2025,Snacks & Ready-to-Eat,BD BARELY NOODLES 200G,14,70,70,0,1
20-02-2025,Snacks & Ready-to-Eat,BD RAGI NOODLES,14,75,75,0,1
20-02-2025,"Grains, Flours & Dals",RAGI FLOUR 1KG,4,80,70,10,1
20-02-2025,"Grains, Flours & Dals",RAGI FLOUR 1KG,4,80,70,10,1
20-02-2025,"Grains, Flours & Dals",Yellow jowar.F 500 gms,4,55,50,5,1
20-02-2025,"Grains, Flours & Dals",Arikalu (kodo),4,70,65,5,1
20-02-2025,"Grains, Flours & Dals",split black gram 1 kg,4,180,170,10,1
20-02-2025,"Grains, Flours & Dals",UDALU (Barnyard millet) 500 gms,4,70,60,10,1
20-02-2025,"Grains, Flours & Dals",RAGULU 1 KG,4,35,30,5,0.5
20-02-2025,"Grains, Flours & Dals",Green gram 500 gms,4,75,70,5,1
20-02-2025,Spices & Seasonings,NUVVULU 250GM,15,80,65,15,1
20-02-2025,"Grains, Flours & Dals",ANDU KORRALU (Brown top .mlt) 500,4,130,110,20,1
20-02-2025,Snacks & Ready-to-Eat,SATHVI REGIVADA 200GM,14,80,60,20,1
20-02-2025,"Grains, Flours & Dals",THICK POHA 500GM,4,40,35,5,1
20-02-2025,"Grains, Flours & Dals",UDALU (Barnyard millet) 500 gms,4,70,60,10,1
20-02-2025,"Grains, Flours & Dals",SAMALU (Little millet) 500 gms,4,85,65,20,1
20-02-2025,Snacks & Ready-to-Eat,NGT CHATPATTA CHANA 90GM,14,25,25,0,1
20-02-2025,"Dry Fruits, Nuts & Seeds",SUNFLOWER SEEDS 250GRM,2,150,130,20,1
20-02-2025,"Grains, Flours & Dals",Multigrain 1 kg,4,100,85,15,1
20-02-2025,"Dry Fruits, Nuts & Seeds",ALMONDS 250GM,2,280,260,20,1
20-02-2025,"Dry Fruits, Nuts & Seeds",FLAX SEEDS 250GM,2,60,50,10,1
20-02-2025,"Dry Fruits, Nuts & Seeds",PUMPKIN SEEDS 250GM,2,200,160,40,1
20-02-2025,"Dry Fruits, Nuts & Seeds",WATERMELON SEEDS 250GRM,2,320,280,40,1
20-02-2025,"Grains, Flours & Dals",KORRALU (FOXTAIL M) 1KG,4,150,110,40,1
20-02-2025,Snacks & Ready-to-Eat,KURNOOL MARMURA,14,70,55,15,1
20-02-2025,"Grains, Flours & Dals",idly/Dosa rice 1 kg,4,70,60,10,1
20-02-2025,"Grains, Flours & Dals",Arikalu (kodo),4,70,65,5,1
20-02-2025,Snacks & Ready-to-Eat,RSC ORANGE 100GMS,14,20,20,0,1
20-02-2025,"Dry Fruits, Nuts & Seeds",BLACK KISMIS 250GM,2,175,140,35,1
20-02-2025,General Household & Kitchenware,BB BOWL,3,420,399,21,1
20-02-2025,Snacks & Ready-to-Eat,SD Sesame laddu with dates250gm,14,135,135,0,1
20-02-2025,General Household & Kitchenware,B2 bowl,3,315,299.25,15.75,1
20-02-2025,Sweeteners,GS Palm Jaggery Powder 400GM,16,180,180,0,1
20-02-2025,Spices & Seasonings,Masala Karam 500 gms,15,520,480,40,2
20-02-2025,Spices & Seasonings,ROYAL SAFFRON,15,375,375,0,3
20-02-2025,Sweeteners,SD PALM JAGGERY 500GM,16,200,200,0,1
20-02-2025,"Grains, Flours & Dals",White jowar.F 1 kg,4,100,80,20,1
20-02-2025,"Health, Wellness & Ayurvedic Products",DWI BHRINGARAJA TAILAM 100ML,5,150,150,0,1
20-02-2025,"Grains, Flours & Dals",Wheat Flour 5 kgs,4,350,300,50,1
20-02-2025,"Grains, Flours & Dals",Chana Flour 500 gms,4,70,65,5,1
20-02-2025,Snacks & Ready-to-Eat,KURNOOL MARMURA,14,70,55,15,1
20-02-2025,Oils & Ghee,BUFFALLO GHEE 500ML,9,410,370,40,1
20-02-2025,Spices & Seasonings,ROYAL SAFFRON 400GRMS,15,65,65,0,1
20-02-2025,"Grains, Flours & Dals",DESI CHANA,4,25,25,0,1
20-02-2025,Sweeteners,SD PALM JAGGERY 500GM,16,200,200,0,1
20-02-2025,Spices & Seasonings,NUVVULU 500GM,15,160,130,30,1
20-02-2025,Pooja & Spiritual Items,OM SAINATH ISOBORNEOL 10GM,12,60,60,0,1
20-02-2025,"Dry Fruits, Nuts & Seeds",Groundnuts 1 kg,2,190,170,20,1
20-02-2025,"Grains, Flours & Dals",Idly Rava L 1KG,4,60,50,10,1
20-02-2025,"Grains, Flours & Dals",White jowar.F 1 kg,4,100,80,20,1
20-02-2025,Snacks & Ready-to-Eat,SATHVI REGIVADA 200GM,14,80,60,20,1
20-02-2025,Sweeteners,MISHRI D,16,40,30,10,1
20-02-2025,"Grains, Flours & Dals",turdal 1kg,4,220,195,25,1
20-02-2025,"Grains, Flours & Dals",SL Idly Rava 1KG,4,130,110,20,2
20-02-2025,"Grains, Flours & Dals",RICE FLOUR 1KG,4,70,55,15,1
20-02-2025,Oils & Ghee,Groundnut oil 1 L,9,1080,990,90,3
20-02-2025,"Grains, Flours & Dals",JOWAR YELLOW 1 K,4,100,90,10,1
20-02-2025,"Grains, Flours & Dals",Urad dall 1 Kg,4,185,170,15,1
20-02-2025,"Grains, Flours & Dals",Yellow jowar .F1 kg,4,110,100,10,1
20-02-2025,Spices & Seasonings,AVALU 100GM,15,25,20,5,1
20-02-2025,"Grains, Flours & Dals",CHANA DAL 500GM,4,70,60,10,1
20-02-2025,Spices & Seasonings,Jeera 100GM,15,50,45,5,1
20-02-2025,"Grains, Flours & Dals",Sathya Javva Wheat Rava 500GM,4,95,95,0,1
20-02-2025,"Grains, Flours & Dals",Wheat Flour 1 kg,4,140,120,20,2
20-02-2025,Sweeteners,YB JAGGERY POWDER 500GMS,16,75,75,0,1
20-02-2025,"Dry Fruits, Nuts & Seeds",Groundnuts 1 kg,2,380,340,40,2
20-02-2025,"Grains, Flours & Dals",SPLIT BLACK GRAM 500 GM,4,90,85,5,1
20-02-2025,"Grains, Flours & Dals",RAGI FLOUR 500GRMS,4,40,35,5,1
20-02-2025,Sweeteners,YB JAGGERY POWDER 500GMS,16,75,75,0,1
20-02-2025,Snacks & Ready-to-Eat,NGT CHATPATTA CHANA 90GM,14,50,50,0,2
20-02-2025,"Grains, Flours & Dals",RAGI FLOUR 1KG,4,80,70,10,1
20-02-2025,Snacks & Ready-to-Eat,VD DAHI MIRCHI(SALTED) 100GM,14,45,45,0,1
20-02-2025,Spices & Seasonings,NUVVULU 500GM,15,160,130,30,1
20-02-2025,Sweeteners,SD PALM JAGGERY 500GM,16,200,200,0,1
20-02-2025,Sweeteners,YB Brown Sugar 1KG,16,140,140,0,1
20-02-2025,Spices & Seasonings,ROYAL SAFFRON 400GRMS,15,65,65,0,1
20-02-2025,"Health, Wellness & Ayurvedic Products",SAI DURGA MORINGA LEAVES 100GM,5,75,75,0,1
20-02-2025,"Grains, Flours & Dals",RAGI FLOUR 500GRMS,4,40,35,5,1
20-02-2025,Snacks & Ready-to-Eat,RAJGIRA PEANUT CHIKKI,14,20,20,0,4
20-02-2025,Oils & Ghee,Groundnut oil 500ml,9,180,165,15,1
20-02-2025,"Grains, Flours & Dals",RICE FLOUR 500 GM,4,35,28,7,1
20-02-2025,Pooja & Spiritual Items,SREEJA R.B.OIL POOJA 80ML,12,38,38,0,1
20-02-2025,Snacks & Ready-to-Eat,TILLI CHIKKI,14,20,20,0,4
20-02-2025,"Grains, Flours & Dals",Urad dall 1 Kg,4,185,170,15,1
20-02-2025,Snacks & Ready-to-Eat,ELITE MILK RUSK 200GM,14,35,35,0,1
20-02-2025,"Grains, Flours & Dals",SRILATHA RICE RAVVA 500GM,4,35,35,0,1
20-02-2025,"Grains, Flours & Dals",SL Idly Rava 1KG,4,65,55,10,1
19-02-2025,Snacks & Ready-to-Eat,BD RED RICE NOODLES 200G,14,70,70,0,1
19-02-2025,Snacks & Ready-to-Eat,NGT CHATPATTA CHANA 90GM,14,25,25,0,1
19-02-2025,"Grains, Flours & Dals",DH URAD GOTA 1KG,4,645,570,75,3
19-02-2025,"Grains, Flours & Dals",SRILATHA RICE RAVVA 500GM,4,35,35,0,1
19-02-2025,"Grains, Flours & Dals",URAD DALL,4,95,85,10,1
19-02-2025,"Grains, Flours & Dals",PESARA PAPPU 500GMS,4,85,75,10,1
19-02-2025,Oils & Ghee,Groundnut oil 1 L,9,720,660,60,2
19-02-2025,"Grains, Flours & Dals",turdal 1kg,4,220,195,25,1
19-02-2025,Spices & Seasonings,AVALU 100GM,15,25,20,5,1
19-02-2025,"Grains, Flours & Dals",Idly Rava L 1KG,4,60,50,10,1
19-02-2025,Sweeteners,SUGAR 1KG,16,60,50,10,1
19-02-2025,Snacks & Ready-to-Eat,BB VERMICELLY 500GM,14,53,53,0,1
19-02-2025,"Health, Wellness & Ayurvedic Products",MXP CREAM ONION,5,45,45,0,1
19-02-2025,Snacks & Ready-to-Eat,DOSA BATTER 1KG,14,60,60,0,1
19-02-2025,Snacks & Ready-to-Eat,GREEN FRIED BATANA,14,40,40,0,2
19-02-2025,Snacks & Ready-to-Eat,VD MIXTURE 175 GM,14,60,60,0,1
19-02-2025,Oils & Ghee,Groundnut oil 1 L,9,360,330,30,1
19-02-2025,Snacks & Ready-to-Eat,SATHVI MIXED CHIKKI 200GM,14,120,100,20,1
19-02-2025,Snacks & Ready-to-Eat,SATHVI REGIVADA 200GM,14,160,120,40,2
19-02-2025,Snacks & Ready-to-Eat,VD PAPPU CHEGODI 200GM,14,60,60,0,1
19-02-2025,"Health, Wellness & Ayurvedic Products",RB Peanut butter Peanuts Dark 40g,5,45,45,0,1
19-02-2025,"Grains, Flours & Dals",Wheat Flour 1 kg,4,70,60,10,1
19-02-2025,"Health, Wellness & Ayurvedic Products",RB Max Protein Fruit &amp;Nut 50g,5,75,75,0,1
19-02-2025,Oils & Ghee,Groundnut oil 500ml,9,180,165,15,1
19-02-2025,"Grains, Flours & Dals",RICE FLOUR 500 GM,4,35,28,7,1
19-02-2025,Spices & Seasonings,NUVVULU 250GM,15,200,170,30,2
19-02-2025,Oils & Ghee,Sesame oil 500ml,9,295,280,15,1
19-02-2025,"Dry Fruits, Nuts & Seeds",SD Mango cubes 100gm,2,45,45,0,1
19-02-2025,Oils & Ghee,Sesame oil 500ml,9,295,280,15,1
19-02-2025,"Health, Wellness & Ayurvedic Products",MORINGA LEAF POWDER M,5,80,75,5,1
19-02-2025,"Dry Fruits, Nuts & Seeds",Groundnuts 1 kg,2,190,170,20,1
19-02-2025,"Grains, Flours & Dals",CHANADALL 250 GMS,4,35,30,5,1
19-02-2025,"Grains, Flours & Dals",White jowar.F 1 kg,4,100,80,20,1
19-02-2025,"Grains, Flours & Dals",HS jowar idly rava 500 gms,4,65,65,0,1
19-02-2025,"Health, Wellness & Ayurvedic Products",MD Guduchi Choornam 100GM,5,110,110,0,1
19-02-2025,"Grains, Flours & Dals",Multigrain 1 kg,4,100,85,15,1
19-02-2025,"Health, Wellness & Ayurvedic Products",MD Aamlaki Choornam 100GM,5,80,80,0,1
19-02-2025,"Grains, Flours & Dals",DH URAD GOTA 1KG,4,215,190,25,1
19-02-2025,Oils & Ghee,Groundnut oil 500ml,9,180,165,15,1
19-02-2025,Milk & Dairy,HERITAGE TOTAL CURD 500GM,7,50,50,0,1
19-02-2025,"Dry Fruits, Nuts & Seeds",ALBUKARA 250GM,2,145,120,25,1
19-02-2025,"Grains, Flours & Dals",THICK POHA 1KG,4,80,70,10,1
19-02-2025,"Grains, Flours & Dals",RAGI FLOUR 500GRMS,4,40,35,5,1
19-02-2025,Snacks & Ready-to-Eat,SD FINGER Millet with palm Jaggery 250gm,14,135,135,0,1
19-02-2025,Personal Care & Cosmetics,Soapnut 500GM,10,120,90,30,1
19-02-2025,Spices & Seasonings,Vamu 100GM,15,60,50,10,1
19-02-2025,Oils & Ghee,castor oil 100 ml,9,100,90,10,1
19-02-2025,"Dry Fruits, Nuts & Seeds",PULMAKHANA 100 GM,2,180,170,10,1
19-02-2025,Snacks & Ready-to-Eat,VD PALLI LADDU,14,80,80,0,1
19-02-2025,"Grains, Flours & Dals",Green gram 1 kg,4,150,130,20,1
19-02-2025,"Grains, Flours & Dals",SPLIT BLACK GRAM 500 GM,4,90,85,5,1
19-02-2025,Sweeteners,MISHRI 250 GM,16,35,30,5,1
19-02-2025,Snacks & Ready-to-Eat,SH PUFFED RICE 500GM,14,112,112,0,1
19-02-2025,Snacks & Ready-to-Eat,BATANA NGT 70GMS,14,20,20,0,1
19-02-2025,Spices & Seasonings,GS Pink Rock Salt 1KG,15,120,120,0,1
19-02-2025,Pickles & Cooking Pastes,SD MESTA PICKLE,11,110,110,0,1
19-02-2025,Oils & Ghee,Safflower oil 1 L,9,440,400,40,1
19-02-2025,"Dry Fruits, Nuts & Seeds",Groundnuts 1 kg,2,190,170,20,1
19-02-2025,Milk & Dairy,BROWN EGGS 1P,7,84,72,12,6
19-02-2025,Oils & Ghee,Coconut oil 1 L,9,440,400,40,1
19-02-2025,Snacks & Ready-to-Eat,VD PALLI LADDU,14,80,80,0,1
19-02-2025,Pooja & Spiritual Items,GD Dhoop Sticks 26GM,12,20,20,0,1
19-02-2025,Pooja & Spiritual Items,SWATHI POOJA VATHULU,12,60,60,0,2
19-02-2025,Pooja & Spiritual Items,GD Camphor 50GM,12,115,115,0,1
19-02-2025,Snacks & Ready-to-Eat,VD NUVVULU LADDU,14,80,80,0,1
19-02-2025,Pooja & Spiritual Items,GOW DURBAR GEETHA CAMPHOR,12,60,60,0,1
19-02-2025,Snacks & Ready-to-Eat,SS IDLY BATTER 1KG,14,60,60,0,1
19-02-2025,Pooja & Spiritual Items,GD Aiswarya Deepam 700ML,12,195,195,0,1
19-02-2025,Milk & Dairy,HRITAGE TOTAL CURD 130GM,7,20,20,0,2
19-02-2025,Snacks & Ready-to-Eat,RAJGIRA PEANUT CHIKKI,14,50,50,0,10
19-02-2025,"Health, Wellness & Ayurvedic Products",MH Millets Milk Powder 250GM,5,250,250,0,1
19-02-2025,"Health, Wellness & Ayurvedic Products",MH Millets Malt 500GM,5,200,190,10,1
19-02-2025,"Grains, Flours & Dals",Multigrain 1 kg,4,100,85,15,1
19-02-2025,General Household & Kitchenware,SABEENA,3,15,15,0,1
19-02-2025,"Grains, Flours & Dals",SL Idly Rava 1KG,4,65,55,10,1
19-02-2025,"Grains, Flours & Dals",DH URAD GOTA 1KG,4,430,380,50,2
19-02-2025,"Dry Fruits, Nuts & Seeds",SABJA SEEDS 100GM,2,80,70,10,1
19-02-2025,"Grains, Flours & Dals",RAGI FLOUR 500GRMS,4,40,35,5,1
19-02-2025,Snacks & Ready-to-Eat,VD CORNFLAKES MIXTURE 175GM,14,60,60,0,1
19-02-2025,Snacks & Ready-to-Eat,ANNAPURNA APPALAM,14,35,35,0,1
19-02-2025,Pooja & Spiritual Items,VRP APOORVA JAVADHU POW,12,35,35,0,1
19-02-2025,"Grains, Flours & Dals",RICE FLOUR 500 GM,4,35,28,7,1
19-02-2025,"Grains, Flours & Dals",Wheat Flour 1 kg,4,70,60,10,1
19-02-2025,Snacks & Ready-to-Eat,NGT CHATPATTA CHANA 90GM,14,25,25,0,1
19-02-2025,"Grains, Flours & Dals",RAGI FLOUR 500GRMS,4,40,35,5,1
19-02-2025,Snacks & Ready-to-Eat,BATANA NGT 70GMS,14,20,20,0,1
19-02-2025,"Grains, Flours & Dals",SINGLE POLISH 1KG,4,325,325,0,5
19-02-2025,"Grains, Flours & Dals",Yellow jowar .F1 kg,4,110,100,10,1
19-02-2025,"Grains, Flours & Dals",White jowar.F 1 kg,4,100,80,20,1
19-02-2025,Oils & Ghee,Coconut oil 500 ml,9,220,200,20,1
19-02-2025,Sweeteners,YB JAGGERY POWDER 500GMS,16,75,75,0,1
19-02-2025,Milk & Dairy,HERITAGE TONED MILK 500ML,7,31,31,0,1
19-02-2025,Sweeteners,MISHRI D,16,40,30,10,1
19-02-2025,"Grains, Flours & Dals",RAGI FLOUR 500GRMS,4,40,35,5,1
19-02-2025,Snacks & Ready-to-Eat,3D PAPAD,14,40,40,0,1
19-02-2025,"Grains, Flours & Dals",FLOUR CHARGE,4,36,36,0,3
19-02-2025,Snacks & Ready-to-Eat,PEANUT CHILLI,14,10,10,0,2
19-02-2025,Spices & Seasonings,Masala Karam 250 gms,15,130,120,10,1
19-02-2025,Spices & Seasonings,Masala Karam 500 gms,15,260,240,20,1
19-02-2025,"Grains, Flours & Dals",RAGULU 1 KG,4,70,60,10,1
19-02-2025,Milk & Dairy,BROWN EGGS TRAY 30P,7,360,330,30,1
19-02-2025,Sweeteners,YB FOREST HONEY 250GM,16,180,180,0,1
19-02-2025,"Dry Fruits, Nuts & Seeds",BLACK KISMIS 250GM,2,175,140,35,1
19-02-2025,Snacks & Ready-to-Eat,NGT CHATPATTA CHANA 90GM,14,25,25,0,1
19-02-2025,"Grains, Flours & Dals",SINGLE POLISH 1KG,4,260,260,0,4
19-02-2025,"Grains, Flours & Dals",SL Idly Rava 1KG,4,65,55,10,1
19-02-2025,"Dry Fruits, Nuts & Seeds",FLAX SEEDS 250GM,2,60,50,10,1
19-02-2025,"Grains, Flours & Dals",WHEAT 1 KG,4,120,100,20,2
19-02-2025,"Grains, Flours & Dals",FLOUR CHARGE,4,24,24,0,2
19-02-2025,"Grains, Flours & Dals",RAGULU 1 KG,4,35,30,5,0.5
19-02-2025,"Grains, Flours & Dals",Arikadu ( kodo),4,280,260,20,2
19-02-2025,"Grains, Flours & Dals",SAMALU (Little millet) 1 kg,4,340,260,80,2
19-02-2025,"Grains, Flours & Dals",DISANO ROLED OATS,4,395,395,0,1
19-02-2025,"Grains, Flours & Dals",UDALU (Barnyard millet) 1 kg,4,280,230,50,2
19-02-2025,Oils & Ghee,Groundnut oil 1 L,9,360,330,30,1
19-02-2025,Oils & Ghee,Sesame oil 1 L,9,590,560,30,1
19-02-2025,General Household & Kitchenware,VERMI COMPOST MIX,3,150,150,0,5
19-02-2025,Spices & Seasonings,Masala Karam 250 gms,15,130,120,10,1
19-02-2025,"Grains, Flours & Dals",Green gram 1 kg,4,150,130,20,1
19-02-2025,"Grains, Flours & Dals",Multigrain 2 kgs,4,200,170,30,1
19-02-2025,Snacks & Ready-to-Eat,ELITE ELAICHI RUSK 200GM,14,35,35,0,1
19-02-2025,"Grains, Flours & Dals",SABDANA 500GM,4,180,140,40,2
19-02-2025,Pooja & Spiritual Items,SOSR SWATHHI 365,12,90,90,0,3
19-02-2025,Oils & Ghee,Sesame oil 500ml,9,295,280,15,1
19-02-2025,Spices & Seasonings,ELACHI 25 GM,15,145,120,25,1
19-02-2025,Spices & Seasonings,TATA SALT 1KG,15,30,30,0,1
19-02-2025,"Grains, Flours & Dals",BARLEY FLOUR 250GM,4,45,40,5,1
19-02-2025,"Grains, Flours & Dals",FLOUR CHARGE,4,24,24,0,2
19-02-2025,"Grains, Flours & Dals",URAD DALL,4,95,85,10,1
19-02-2025,Personal Care & Cosmetics,MD Bath Powder 100GM,10,40,40,0,1
19-02-2025,Spices & Seasonings,Lavangam 50GM,15,60,50,10,1
19-02-2025,"Grains, Flours & Dals",Wheat Rava M 500GM,4,33,30,3,1
19-02-2025,"Grains, Flours & Dals",WHEAT 1 KG,4,120,100,20,2
19-02-2025,Personal Care & Cosmetics,DETTOL 50ML,10,154,154,0,1
19-02-2025,Snacks & Ready-to-Eat,KURNOOL MARMURA,14,70,55,15,1
19-02-2025,Sweeteners,YB JAGGERY POWDER 1KG,16,140,140,0,1
19-02-2025,"Dry Fruits, Nuts & Seeds",Groundnuts 1 kg,2,190,170,20,1
19-02-2025,Spices & Seasonings,PURO Healthy Salt Crystal 1KG,15,135,135,0,1
19-02-2025,Snacks & Ready-to-Eat,SATHVI REGIVADA 200GM,14,80,60,20,1
19-02-2025,Snacks & Ready-to-Eat,VD MURMURA LADDU,14,50,50,0,1
19-02-2025,"Grains, Flours & Dals",Chana Flour 1 kg,4,140,130,10,1
19-02-2025,Baking & Cooking Aids,MTR GULAB JAMUN MIX 190GM,0,160,160,0,2
19-02-2025,Sweeteners,SUGAR 1KG,16,60,50,10,1
19-02-2025,"Dry Fruits, Nuts & Seeds",KAJU HALF 250GM,2,310,290,20,1
19-02-2025,Snacks & Ready-to-Eat,SD Bajra with palm Jaggery 250gm,14,135,135,0,1
19-02-2025,"Grains, Flours & Dals",RAGULU 1 KG,4,35,30,5,0.5
19-02-2025,"Grains, Flours & Dals",Wheat Flour 1 kg,4,140,120,20,2
19-02-2025,"Grains, Flours & Dals",RICE FLOUR 1KG,4,280,220,60,4
19-02-2025,"Grains, Flours & Dals",Chana Flour 1 kg,4,140,130,10,1
19-02-2025,"Health, Wellness & Ayurvedic Products",MORINGA LEAF POWDER M,5,80,75,5,1
19-02-2025,"Dry Fruits, Nuts & Seeds",MAHA BEERA SEEDS 100GM,2,120,120,0,2
19-02-2025,"Grains, Flours & Dals",Wheat Flour 2 kgs,4,140,120,20,1
19-02-2025,Spices & Seasonings,KALONJI SEEDS,15,90,80,10,1
19-02-2025,"Grains, Flours & Dals",Wheat Flour 2 kgs,4,280,240,40,2
19-02-2025,"Grains, Flours & Dals",SAMALU (Little millet) 500 gms,4,85,65,20,1
19-02-2025,"Grains, Flours & Dals",Sathya Javva Wheat Rava 500GM,4,95,95,0,1
19-02-2025,"Health, Wellness & Ayurvedic Products",RB Max Protein Choco Berry bar 50g,5,75,75,0,1
19-02-2025,"Grains, Flours & Dals",Green gram 1 kg,4,150,130,20,1
19-02-2025,"Grains, Flours & Dals",Quinova 500 gms,4,110,100,10,1
19-02-2025,"Grains, Flours & Dals",KORRALU (FOXTAIL M) 500GM,4,65,55,10,1
19-02-2025,"Grains, Flours & Dals",Arikalu (kodo),4,70,65,5,1
19-02-2025,"Grains, Flours & Dals",SPLIT BLACK GRAM 500 GM,4,90,85,5,1
19-02-2025,Personal Care & Cosmetics,MYSORE SANDAL SOAP 75G,10,42,42,0,1
19-02-2025,Snacks & Ready-to-Eat,SD FINGER Millet with palm Jaggery 250gm,14,135,135,0,1
19-02-2025,Oils & Ghee,Mustard oil 500 ml,9,220,195,25,1
19-02-2025,"Health, Wellness & Ayurvedic Products",MH Millets Malt 500GM,5,200,190,10,1
19-02-2025,"Grains, Flours & Dals",FLOUR CHARGE,4,43.2,43.2,0,3.6
19-02-2025,"Grains, Flours & Dals",BARLEY SEEDS 250GMS,4,40,35,5,1
19-02-2025,Spices & Seasonings,Biryani Leaf 25GM,15,30,30,0,1
19-02-2025,"Grains, Flours & Dals",EM Ragi idli R 500G,4,75,75,0,1
19-02-2025,"Grains, Flours & Dals",Sathya Javva Wheat Rava 500GM,4,95,95,0,1
19-02-2025,Spices & Seasonings,NUVVULU 500GM,15,160,130,30,1
19-02-2025,Spices & Seasonings,Jeera 100GM,15,50,45,5,1
19-02-2025,"Grains, Flours & Dals",Chana Flour 500 gms,4,70,65,5,1
19-02-2025,Oils & Ghee,Groundnut oil 1 L,9,360,330,30,1
19-02-2025,"Grains, Flours & Dals",SINGLE POLISH 1KG,4,325,325,0,5
19-02-2025,Snacks & Ready-to-Eat,BATANA NGT 70GMS,14,20,20,0,1
19-02-2025,Snacks & Ready-to-Eat,SD Moringa with plam jaggery 250gm,14,135,135,0,1
19-02-2025,"Grains, Flours & Dals",Multigrain 1 kg,4,100,85,15,1
19-02-2025,"Health, Wellness & Ayurvedic Products",RB Peanut butter Peanuts Dark 40g,5,45,45,0,1
19-02-2025,Snacks & Ready-to-Eat,NGT CHATPATTA CHANA 90GM,14,25,25,0,1
19-02-2025,Snacks & Ready-to-Eat,VD RIBBON PAKODI 175GM,14,60,60,0,1
19-02-2025,"Grains, Flours & Dals",Wheat Flour 1 kg,4,70,60,10,1
19-02-2025,Snacks & Ready-to-Eat,GB SALT COOKIES,14,60,55,5,1
19-02-2025,"Health, Wellness & Ayurvedic Products",RB Nuts& Seeds cashews 35g,5,45,45,0,1
19-02-2025,Snacks & Ready-to-Eat,MP CHOCO ALMOND COOKIE,14,60,60,0,1
19-02-2025,Snacks & Ready-to-Eat,VD SANNAPUSA 175GM,14,60,60,0,1
19-02-2025,Snacks & Ready-to-Eat,SD Groundnut with palm jaggery 250gm,14,135,135,0,1
19-02-2025,Snacks & Ready-to-Eat,PEANUT CHIKKI 450GM,14,125,125,0,1
19-02-2025,"Dry Fruits, Nuts & Seeds",Groundnuts 1 kg,2,190,170,20,1
19-02-2025,Snacks & Ready-to-Eat,SD Ginger Candy 100g,14,60,60,0,1
19-02-2025,Oils & Ghee,Groundnut oil 1 L,9,360,330,30,1
19-02-2025,"Dry Fruits, Nuts & Seeds",PULMAKHANA 100 GM,2,180,170,10,1
19-02-2025,Snacks & Ready-to-Eat,TILLI CHIKKI,14,10,10,0,2
19-02-2025,"Grains, Flours & Dals",Urad dall 1 Kg,4,185,170,15,1
19-02-2025,"Grains, Flours & Dals",split black gram 1 kg,4,180,170,10,1
19-02-2025,Spices & Seasonings,Jeera 100GM,15,50,45,5,1
19-02-2025,"Grains, Flours & Dals",Wheat Rava S 1KG,4,130,110,20,2
19-02-2025,"Grains, Flours & Dals",VYS.SP.RICE 10 KGS,4,700,650,50,1
19-02-2025,"Health, Wellness & Ayurvedic Products",RB Max Protein Fruit &amp;Nut 50g,5,375,375,0,5
19-02-2025,"Health, Wellness & Ayurvedic Products",RB Max Protein Spanish Tomato,5,45,45,0,1
19-02-2025,"Health, Wellness & Ayurvedic Products",MXP CREAM ONION,5,45,45,0,1
19-02-2025,Snacks & Ready-to-Eat,VD SANNAPUSA 175GM,14,60,60,0,1
19-02-2025,"Grains, Flours & Dals",DESI CHANA,4,25,25,0,1
19-02-2025,"Dry Fruits, Nuts & Seeds",CASHEW 250GM,2,680,620,60,2
19-02-2025,Snacks & Ready-to-Eat,VD RIBBON PAKODI 175GM,14,60,60,0,1
19-02-2025,Snacks & Ready-to-Eat,BATANA NGT 70GMS,14,20,20,0,1
19-02-2025,Pooja & Spiritual Items,GD Kailash 60 GM,12,60,60,0,1
19-02-2025,Snacks & Ready-to-Eat,VD SAGOPAPAD 150GM,14,55,55,0,1
19-02-2025,"Dry Fruits, Nuts & Seeds",YELLOW KISHMISH 250GM,2,130,110,20,1
19-02-2025,Personal Care & Cosmetics,Soapnut 250GM,10,120,90,30,2
19-02-2025,Spices & Seasonings,NUVVULU 500GM,15,160,130,30,1
19-02-2025,Oils & Ghee,Groundnut oil 500ml,9,180,165,15,1
19-02-2025,Spices & Seasonings,pickles chilli .pwdr 1 kg,15,175,162.5,12.5,0.25
19-02-2025,Spices & Seasonings,DRY MIECHI 200GM,15,80,60,20,1
19-02-2025,Oils & Ghee,BUFFALLO GHEE 500ML,9,410,370,40,1
19-02-2025,"Health, Wellness & Ayurvedic Products",RB Max Protein Chinese Manchurian,5,45,45,0,1
19-02-2025,Oils & Ghee,Groundnut oil 1 L,9,1080,990,90,3
19-02-2025,Personal Care & Cosmetics,COLGATE ACTIVE SALT,10,20,20,0,1
19-02-2025,Beverages,REFRESH SHARBATH NORMAL,1,199,190,9,1
19-02-2025,"Grains, Flours & Dals",FLOUR CHARGE,4,54,54,0,4.5
19-02-2025,Milk & Dairy,HRITAGE TOTAL CURD 130GM,7,10,10,0,1
19-02-2025,Pickles & Cooking Pastes,SD TAMARIND PICKLE,11,110,110,0,1
19-02-2025,Snacks & Ready-to-Eat,NGT CHATPATTA CHANA 90GM,14,50,50,0,2
19-02-2025,Snacks & Ready-to-Eat,VD RIBBON PAKODI 175GM,14,60,60,0,1
19-02-2025,"Dry Fruits, Nuts & Seeds",YELLOW KISHMISH 250GM,2,130,110,20,1
19-02-2025,Household & Cleaning,PITAMBARI SHINING POWDER 200G,6,120,120,0,2
19-02-2025,"Grains, Flours & Dals",BARLEY SEEDS 250GMS,4,80,70,10,2
19-02-2025,Sweeteners,MISHRI D,16,40,30,10,1
19-02-2025,"Grains, Flours & Dals",RAGI FLOUR 1KG,4,80,70,10,1
19-02-2025,"Grains, Flours & Dals",Wheat Flour 1 kg,4,210,180,30,3
19-02-2025,Oils & Ghee,Mustard oil 500 ml,9,220,195,25,1
19-02-2025,"Grains, Flours & Dals",URAD DALL,4,95,85,10,1
19-02-2025,"Grains, Flours & Dals",Em jowar idly R 500G,4,75,75,0,1
19-02-2025,"Grains, Flours & Dals",Sathya Javva Wheat Rava 500GM,4,95,95,0,1
19-02-2025,"Grains, Flours & Dals",THICK POHA 1KG,4,80,70,10,1
19-02-2025,"Grains, Flours & Dals",RAGULU 1 KG,4,70,60,10,1
19-02-2025,Spices & Seasonings,SATHVI TURMERIC POWDER 500GM,15,180,130,50,1
19-02-2025,Spices & Seasonings,Chilli powder 1 kg,15,580,420,160,1
19-02-2025,"Grains, Flours & Dals",SL Suji Rava 500GM,4,32,32,0,1
19-02-2025,"Grains, Flours & Dals",SA WHITE JOWAR RAVA 500GM,4,69,69,0,1
19-02-2025,"Grains, Flours & Dals",White jowar.F 1 kg,4,200,160,40,2
19-02-2025,Pooja & Spiritual Items,SWASTIK CAMPHORE,12,90,90,0,1
19-02-2025,"Grains, Flours & Dals",Wheat Rava M 1KG,4,65,55,10,1
19-02-2025,"Grains, Flours & Dals",EM Ragi upma R 500g,4,75,75,0,1
19-02-2025,Pooja & Spiritual Items,SREE REAL KASTURI STICKS 90GM,12,72,72,0,1
19-02-2025,Pooja & Spiritual Items,VRP APOORVA JAVADHU POW,12,35,35,0,1
19-02-2025,Snacks & Ready-to-Eat,VD MIXTURE 175 GM,14,60,60,0,1
19-02-2025,"Grains, Flours & Dals",DISANO OATS 1KG,4,570,570,0,2
19-02-2025,"Grains, Flours & Dals",Multigrain 1 kg,4,200,170,30,2
19-02-2025,Pooja & Spiritual Items,GD Kumkum 50GM,12,30,30,0,1
19-02-2025,Snacks & Ready-to-Eat,VD RIBBON PAKODI 175GM,14,60,60,0,1
19-02-2025,Spices & Seasonings,SWEET SOUNF,15,20,20,0,1
19-02-2025,Spices & Seasonings,Turmeric powder 250 gms,15,100,75,25,1
19-02-2025,"Grains, Flours & Dals",Em jowar idly R 500G,4,150,150,0,2
19-02-2025,"Grains, Flours & Dals",RAGULU 1 KG,4,140,120,20,2
19-02-2025,Sweeteners,Natural Honey 500 gms,16,280,240,40,1
19-02-2025,Spices & Seasonings,AV Iodized Salt 1KG,15,56,50,6,2
19-02-2025,"Grains, Flours & Dals",THICK POHA 1KG,4,80,70,10,1
19-02-2025,"Dry Fruits, Nuts & Seeds",SABJA SEEDS 100GM,2,80,70,10,1
19-02-2025,"Grains, Flours & Dals",Wheat Rava S 1KG,4,65,55,10,1
19-02-2025,Snacks & Ready-to-Eat,SD Moringa with plam jaggery 250gm,14,135,135,0,1
19-02-2025,Spices & Seasonings,DRY MIECHI 200GM,15,80,60,20,1
19-02-2025,"Grains, Flours & Dals",Idly Rava L 1KG,4,60,50,10,1
19-02-2025,Snacks & Ready-to-Eat,FOXTAIL BIS,14,135,135,0,1
19-02-2025,"Dry Fruits, Nuts & Seeds",YELLOW KISHMISH 250GM,2,130,110,20,1
19-02-2025,"Dry Fruits, Nuts & Seeds",Groundnuts 500 gms,2,95,85,10,1
19-02-2025,Oils & Ghee,Groundnut oil 1 L,9,360,330,30,1
19-02-2025,Oils & Ghee,Safflower oil 1 L,9,440,400,40,1
19-02-2025,"Dry Fruits, Nuts & Seeds",SALTED PISTA 250GM,2,400,350,50,1
19-02-2025,Milk & Dairy,SANGAM CURD 450GM,7,38,38,0,1
19-02-2025,Oils & Ghee,cow ghee 500 ml,9,430,390,40,1
19-02-2025,Milk & Dairy,SANGAM TONED MILK 500ML,7,30,30,0,1
19-02-2025,"Health, Wellness & Ayurvedic Products",DWI MANDARA TAILAM 100ML,5,160,160,0,1
19-02-2025,Pooja & Spiritual Items,SOSR SWATHHI 365,12,30,30,0,1
19-02-2025,Milk & Dairy,HERITAGE TOTAL CURD 500GM,7,50,50,0,1
19-02-2025,"Grains, Flours & Dals",RAGULU 1 KG,4,17.5,15,2.5,0.25
19-02-2025,Snacks & Ready-to-Eat,VD MANGO JELLY 250GRMS,14,80,80,0,1
19-02-2025,Milk & Dairy,HERITAGE TONED MILK 500ML,7,31,31,0,1
19-02-2025,"Grains, Flours & Dals",BAJRA 1 KG,4,15,12.5,2.5,0.25
19-02-2025,"Grains, Flours & Dals",KORRALU (FOXTAIL M) 500GM,4,65,55,10,1
19-02-2025,Pooja & Spiritual Items,SWASTIK PURE CAMPHOR 50GM,12,180,180,0,2
19-02-2025,Pooja & Spiritual Items,GD Aiswarya Deepam 700ML,12,390,390,0,2
19-02-2025,Pooja & Spiritual Items,BALAJI BEL PHOOL DHOOP STICKS 10STK,12,70,70,0,1
19-02-2025,Beverages,REFRESH SHARBATH SUGAR FREE,1,299,285,14,1
19-02-2025,"Grains, Flours & Dals",SRILATHA RICE RAVVA 500GM,4,70,70,0,2
19-02-2025,"Grains, Flours & Dals",Hs yellow jowar r 500g,4,198,198,0,2
19-02-2025,Spices & Seasonings,GARAM MASALA 200GM,15,120,95,25,1
19-02-2025,Spices & Seasonings,EVEREST MEAT MASALA 50GM,15,48,48,0,1
19-02-2025,"Grains, Flours & Dals",White jowar.F 500 Gms,4,50,40,10,1
19-02-2025,Sweeteners,YB Brown Sugar 1KG,16,140,140,0,1
19-02-2025,Sweeteners,SD PALM JAGGERY 500GM,16,200,200,0,1
19-02-2025,Snacks & Ready-to-Eat,SD Ginger Candy 100g,14,60,60,0,1
19-02-2025,"Dry Fruits, Nuts & Seeds",PUMPKIN SEEDS 250GM,2,200,160,40,1
19-02-2025,"Grains, Flours & Dals",RICE FLOUR 500 GM,4,35,28,7,1
19-02-2025,Snacks & Ready-to-Eat,PEANUT CHIKKI,14,22,22,0,1
19-02-2025,Spices & Seasonings,NUVVULU 500GM,15,160,130,30,1
19-02-2025,"Grains, Flours & Dals",Wheat Flour 1 kg,4,70,60,10,1
19-02-2025,"Dry Fruits, Nuts & Seeds",SUNFLOWER SEEDS 250GRM,2,150,130,20,1
19-02-2025,"Dry Fruits, Nuts & Seeds",ANJEER 250GM,2,400,360,40,1
19-02-2025,Snacks & Ready-to-Eat,VD BELLAM GAVVALU 200GM,14,60,60,0,1
19-02-2025,Snacks & Ready-to-Eat,PEANUT CHILLI,14,30,30,0,6
19-02-2025,"Grains, Flours & Dals",Chana Flour 1 kg,4,140,130,10,1
19-02-2025,"Grains, Flours & Dals",MAATEJA rice 1 kg,4,72,69,3,1
19-02-2025,Oils & Ghee,Groundnut oil 1 L,9,360,330,30,1
19-02-2025,"Grains, Flours & Dals",RAGI FLOUR 1KG,4,80,70,10,1
19-02-2025,"Grains, Flours & Dals",turdal 1kg,4,220,195,25,1
19-02-2025,"Dry Fruits, Nuts & Seeds",SH GROUNDNUT 500GM,2,163,130,33,1
19-02-2025,Snacks & Ready-to-Eat,SALTED PHALLI,14,25,25,0,1
19-02-2025,"Grains, Flours & Dals",RAGI FLOUR 1KG,4,80,70,10,1
19-02-2025,"Grains, Flours & Dals",SABDANA,4,40,35,5,1
18-02-2025,Snacks & Ready-to-Eat,SD JOWAR WITH PALM JAGGERY 250GM,14,135,135,0,1
18-02-2025,Snacks & Ready-to-Eat,SD Aswagandha with palm Jaggery250Gm,14,135,135,0,1
18-02-2025,"Dry Fruits, Nuts & Seeds",PUMPKIN SEEDS 250GM,2,200,160,40,1
18-02-2025,"Dry Fruits, Nuts & Seeds",FLAX SEEDS 250GM,2,60,50,10,1
18-02-2025,Sweeteners,SH JAGGERY POWDER 500GM,16,80,68,12,1
18-02-2025,Beverages,REFRESH SHARBATH NORMAL,1,199,190,9,1
18-02-2025,"Grains, Flours & Dals",Wheat Rava M 500GM,4,33,30,3,1
18-02-2025,"Grains, Flours & Dals",RAGI FLOUR 500GRMS,4,40,35,5,1
18-02-2025,"Grains, Flours & Dals",Wheat Flour 1 kg,4,350,300,50,5
18-02-2025,"Grains, Flours & Dals",White Chana 250 GM,4,60,50,10,1
18-02-2025,"Grains, Flours & Dals",SRILATHA RICE RAVVA 500GM,4,35,35,0,1
18-02-2025,Spices & Seasonings,Gasagasalu 50GM,15,130,110,20,1
18-02-2025,Snacks & Ready-to-Eat,PEANUT CHIKKI 450GM,14,125,125,0,1
18-02-2025,"Grains, Flours & Dals",DESI CHANA,4,25,25,0,1
18-02-2025,"Grains, Flours & Dals",Green gram 1 kg,4,150,130,20,1
18-02-2025,"Grains, Flours & Dals",Chittimuthaylu rice 1 kg,4,120,100,20,1
18-02-2025,"Grains, Flours & Dals",Chana Flour 500 gms,4,70,65,5,1
18-02-2025,Spices & Seasonings,SWEET SOUNF,15,20,20,0,1
18-02-2025,Snacks & Ready-to-Eat,VD PALLI LADDU,14,80,80,0,1
18-02-2025,Sweeteners,SD PALM JAGGERY 500GM,16,200,200,0,1
18-02-2025,Snacks & Ready-to-Eat,SD KODO MILLET WITH PALM JAGGERY,14,135,135,0,1
18-02-2025,Oils & Ghee,Freedom Rice Bran Oil 1L,9,194,180,14,1
18-02-2025,"Grains, Flours & Dals",White Chana 250 GM,4,60,50,10,1
18-02-2025,Spices & Seasonings,SREE MARUTHI IDLY KARAM 200GM,15,60,60,0,1
18-02-2025,"Health, Wellness & Ayurvedic Products",RB Max Protein Choco chips 55gm,5,80,80,0,1
18-02-2025,Snacks & Ready-to-Eat,RSC ORANGE 100GMS,14,20,20,0,1
18-02-2025,"Health, Wellness & Ayurvedic Products",RB Max Protein Choco Berry bar 50g,5,75,75,0,1
18-02-2025,Snacks & Ready-to-Eat,BATANA NGT 70GMS,14,40,40,0,2
18-02-2025,Oils & Ghee,Groundnut oil 1 L,9,360,330,30,1
18-02-2025,"Grains, Flours & Dals",BOMBAY RAVA,4,70,55,15,1
18-02-2025,Milk & Dairy,HRITAGE TOTAL CURD 130GM,7,20,20,0,2
18-02-2025,Sweeteners,SUGAR 500 GM,16,30,25,5,1
18-02-2025,"Grains, Flours & Dals",Idly Rava L 1KG,4,60,50,10,1
18-02-2025,"Grains, Flours & Dals",SABDANA,4,40,35,5,1
18-02-2025,"Grains, Flours & Dals",MELMEKER 250GMS,4,60,45,15,1
18-02-2025,Sweeteners,MISHRI D,16,40,30,10,1
18-02-2025,Personal Care & Cosmetics,GOW DURBAR 75G,10,120,120,0,2
18-02-2025,Sweeteners,GS Organic Jaggery Powder 600GM,16,99,99,0,1
18-02-2025,"Grains, Flours & Dals",Em Multimillet upma 500g,4,129,129,0,1
18-02-2025,"Grains, Flours & Dals",ANDU KORRALU (Brown top .mlt) 500,4,260,220,40,2
18-02-2025,"Health, Wellness & Ayurvedic Products",AMLAKI CHOORNAM,5,100,100,0,1
18-02-2025,"Dry Fruits, Nuts & Seeds",Groundnuts 500 gms,2,95,85,10,1
18-02-2025,Snacks & Ready-to-Eat,SD Vamu with palm jaggery 250gm,14,135,135,0,1
18-02-2025,Oils & Ghee,Safflower oil 1 L,9,880,800,80,2
18-02-2025,Snacks & Ready-to-Eat,VD MULTI CHAKKA,14,110,110,0,1
18-02-2025,Spices & Seasonings,GS Moringa Leaves Spicy Powder 100GM,15,90,90,0,1
18-02-2025,Milk & Dairy,BROWN EGGS TRAY 30P,7,360,330,30,1
18-02-2025,Sweeteners,GS Organic Jaggery Powder 600GM,16,198,198,0,2
18-02-2025,Snacks & Ready-to-Eat,PUMPKIN CHIKKI 200GM,14,280,240,40,2
18-02-2025,Snacks & Ready-to-Eat,Sprouted Ragi Biscuits 450GM,14,150,150,0,1
18-02-2025,Oils & Ghee,cow ghee 500 ml,9,430,390,40,1
18-02-2025,"Health, Wellness & Ayurvedic Products",DWI LAVANGA TAILA 20ML,5,60,60,0,1
18-02-2025,Pooja & Spiritual Items,SWASTIK PURE CAMPHOR 50GM,12,180,180,0,1
18-02-2025,Snacks & Ready-to-Eat,VD PALLI CHIKKI,14,160,160,0,2
18-02-2025,Sweeteners,Natural Honey 500 gms,16,280,240,40,1
18-02-2025,Pooja & Spiritual Items,VRP APOORVA JAVADHU POW,12,35,35,0,1
18-02-2025,Personal Care & Cosmetics,GOW DURBAR 75G,10,60,60,0,1
18-02-2025,Snacks & Ready-to-Eat,VD MULTI CHAKKA,14,220,220,0,2
18-02-2025,Pooja & Spiritual Items,SREE REAL KASTURI STICKS 90GM,12,72,72,0,1
18-02-2025,Sweeteners,GS JAGGERY NUGGETS 500GM,16,120,120,0,1
18-02-2025,Spices & Seasonings,Dalchin Chekka 50GM,15,50,40,10,1
18-02-2025,Snacks & Ready-to-Eat,SD Vamu with palm jaggery 250gm,14,135,135,0,1
18-02-2025,"Grains, Flours & Dals",SH WHITE POHA 500GM,4,75,75,0,1
18-02-2025,Spices & Seasonings,Menthulu 250 gms,15,50,45,5,1
18-02-2025,Snacks & Ready-to-Eat,VD SAGOPAPAD 150GM,14,55,55,0,1
18-02-2025,Oils & Ghee,Sesame oil 1 L,9,590,560,30,1
18-02-2025,Oils & Ghee,Coconut oil 500 ml,9,220,200,20,1
18-02-2025,Spices & Seasonings,YB Rock Salt 1KG,15,120,120,0,1
18-02-2025,Spices & Seasonings,NUVVULU 250GM,15,80,65,15,1
18-02-2025,Spices & Seasonings,Tamarind 250GMS,15,75,75,0,1
18-02-2025,Snacks & Ready-to-Eat,Corn Chips 250GM,14,40,35,5,1
18-02-2025,Pooja & Spiritual Items,VRP APOORVA JAVADHU POW,12,35,35,0,1
18-02-2025,Oils & Ghee,Groundnut oil 1 L,9,360,330,30,1
18-02-2025,Spices & Seasonings,Menthulu 250 gms,15,50,45,5,1
18-02-2025,"Dry Fruits, Nuts & Seeds",Groundnuts 500 gms,2,95,85,10,1
18-02-2025,"Dry Fruits, Nuts & Seeds",ALBUKARA 250GM,2,145,120,25,1
18-02-2025,"Grains, Flours & Dals",Brown RICE 1KG,4,70,65,5,1
18-02-2025,Personal Care & Cosmetics,MYSORE SANDAL SOAP 75G,10,42,42,0,1
18-02-2025,Oils & Ghee,Sesame oil 1 L,9,590,560,30,1
18-02-2025,"Grains, Flours & Dals",RAGI FLOUR 500GRMS,4,40,35,5,1
18-02-2025,Oils & Ghee,Sesame oil 1 L,9,1180,"1,120.00",60,2
18-02-2025,"Grains, Flours & Dals",Multigrain 1 kg,4,100,85,15,1
18-02-2025,Oils & Ghee,Flaxseed oil 500 ml,9,300,270,30,1
18-02-2025,Snacks & Ready-to-Eat,VD DASA DINUSULU,14,199,199,0,1
18-02-2025,"Grains, Flours & Dals",THICK POHA 1KG,4,80,70,10,1
18-02-2025,Snacks & Ready-to-Eat,SD Moringa with plam jaggery 250gm,14,135,135,0,1
18-02-2025,Oils & Ghee,Coconut oil 500 ml,9,220,200,20,1
18-02-2025,"Grains, Flours & Dals",Yellow jowar .F1 kg,4,110,100,10,1
18-02-2025,Snacks & Ready-to-Eat,SH PUFFED RICE 500GM,14,112,112,0,1
18-02-2025,Oils & Ghee,Groundnut oil 1 L,9,360,330,30,1
18-02-2025,Snacks & Ready-to-Eat,SD Thati thandra 200gm,14,150,150,0,1
18-02-2025,"Grains, Flours & Dals",Bajra Flour 1 kg,4,70,60,10,1
18-02-2025,Snacks & Ready-to-Eat,VD MULTI CHAKKA,14,110,110,0,1
18-02-2025,Oils & Ghee,Groundnut oil 1 L,9,360,330,30,1
18-02-2025,Sweeteners,GS JAGGERY NUGGETS 500GM,16,120,120,0,1
18-02-2025,"Health, Wellness & Ayurvedic Products",MD Kasturi Pasupu Choornam 50GM,5,80,80,0,1
18-02-2025,Snacks & Ready-to-Eat,NGT CHATPATTA CHANA 90GM,14,25,25,0,1
18-02-2025,Oils & Ghee,Sesame oil 1 L,9,590,560,30,1
18-02-2025,Oils & Ghee,Coconut oil 1 L,9,440,400,40,1
18-02-2025,Oils & Ghee,Safflower oil 1 L,9,440,400,40,1
18-02-2025,Snacks & Ready-to-Eat,VD DASA DINUSULU,14,199,199,0,1
18-02-2025,Personal Care & Cosmetics,HERBAL BATH POWDER,10,160,160,0,1
18-02-2025,Personal Care & Cosmetics,MADDI BATH POWDER 400GM,10,150,150,0,1
18-02-2025,"Dry Fruits, Nuts & Seeds",CASHEW,2,680,590,90,1
18-02-2025,Sweeteners,MISHRI 250 GM,16,35,30,5,1
18-02-2025,"Health, Wellness & Ayurvedic Products",MD Hibiscus Flower Choornam 30GM,5,100,100,0,1
18-02-2025,Snacks & Ready-to-Eat,BATANA NGT 70GMS,14,20,20,0,1
18-02-2025,"Health, Wellness & Ayurvedic Products",RB Max Protein Choco Creamy Spread,5,175,175,0,1
18-02-2025,Oils & Ghee,Coconut oil 500 ml,9,220,200,20,1
18-02-2025,Snacks & Ready-to-Eat,MB LITTLE MILLET NOODLES 180G,14,95,95,0,1
18-02-2025,Snacks & Ready-to-Eat,VD MANGO JELLY 250GRMS,14,80,80,0,1
18-02-2025,Oils & Ghee,Coconut oil 1 L,9,440,400,40,1
18-02-2025,Oils & Ghee,Groundnut oil 1 L,9,360,330,30,1
18-02-2025,"Grains, Flours & Dals",White jowar.F 1 kg,4,100,80,20,1
18-02-2025,"Grains, Flours & Dals",Multigrain 1 kg,4,100,85,15,1
18-02-2025,"Grains, Flours & Dals",RAGI FLOUR 500GRMS,4,40,35,5,1
18-02-2025,"Grains, Flours & Dals",Sathya Javva Wheat Rava 500GM,4,95,95,0,1
18-02-2025,Oils & Ghee,Groundnut oil 1 L,9,1080,990,90,3
18-02-2025,Household & Cleaning,SCOTCH BRITE,6,179,179,0,1
18-02-2025,"Dry Fruits, Nuts & Seeds",FLAX SEEDS 250GM,2,60,50,10,1
18-02-2025,Snacks & Ready-to-Eat,SH PUFFED RICE 500GM,14,112,112,0,1
18-02-2025,Snacks & Ready-to-Eat,FOXTAIL BIS,14,135,135,0,1
18-02-2025,"Health, Wellness & Ayurvedic Products",GS Wheat Grass Powder 100GMS,5,349,349,0,1
18-02-2025,Sweeteners,YB JAGGERY POWDER 1KG,16,140,140,0,1
18-02-2025,"Grains, Flours & Dals",split black gram 1 kg,4,180,170,10,1
18-02-2025,Snacks & Ready-to-Eat,RSC ORANGE 100GMS,14,20,20,0,1
18-02-2025,"Health, Wellness & Ayurvedic Products",MH Millets Malt 500GM,5,200,190,10,1
18-02-2025,Sweeteners,Mishri 500GM,16,70,60,10,1
18-02-2025,"Health, Wellness & Ayurvedic Products",ORGANIC MORINGA POWER 100GM,5,249,249,0,1
18-02-2025,"Health, Wellness & Ayurvedic Products",DWI LAVANGA TAILA 20ML,5,60,60,0,1
18-02-2025,Oils & Ghee,Sesame oil 1 L,9,590,560,30,1
18-02-2025,Personal Care & Cosmetics,GA DANT MANJAN TP 50GM,10,60,60,0,1
18-02-2025,"Health, Wellness & Ayurvedic Products",SAI DURGA MORINGA LEAVES 100GM,5,75,75,0,1
18-02-2025,Pickles & Cooking Pastes,SD MESTA PICKLE,11,110,110,0,1
18-02-2025,"Grains, Flours & Dals",SRILATHA RICE RAVVA 500GM,4,35,35,0,1
18-02-2025,"Grains, Flours & Dals",SH RED POHA 500GM,4,85,85,0,1
18-02-2025,Sweeteners,SD PALM JAGGERY 500GM,16,200,200,0,1
18-02-2025,Oils & Ghee,Groundnut oil 1 L,9,360,330,30,1
18-02-2025,Spices & Seasonings,SONTI 50GM,15,30,30,0,1
18-02-2025,"Dry Fruits, Nuts & Seeds",Putnalu 250GM,2,45,38,7,1
18-02-2025,"Grains, Flours & Dals",FLOUR CHARGE,4,48,48,0,4
18-02-2025,Milk & Dairy,SANGAM TONED MILK 500ML,7,90,90,0,3
18-02-2025,Milk & Dairy,SANGAM CURD 450GM,7,38,38,0,1
18-02-2025,"Grains, Flours & Dals",SRILATHA RICE RAVVA 500GM,4,35,35,0,1
18-02-2025,"Dry Fruits, Nuts & Seeds",SUNFLOWER SEEDS 250GRM,2,150,130,20,1
18-02-2025,"Dry Fruits, Nuts & Seeds",PUMPKIN SEEDS 250GM,2,200,160,40,1
18-02-2025,Personal Care & Cosmetics,COLGATE ACTIVE SALT,10,20,20,0,1
18-02-2025,"Health, Wellness & Ayurvedic Products",MH Millets Malt 500GM,5,200,190,10,1
18-02-2025,Snacks & Ready-to-Eat,VD Pappu Chekkalu 190gm,14,60,60,0,1
18-02-2025,Snacks & Ready-to-Eat,VD BOONDI 175GM,14,60,60,0,1
18-02-2025,"Dry Fruits, Nuts & Seeds",PULMAKHANA 100 GM,2,180,170,10,1
18-02-2025,Snacks & Ready-to-Eat,Pani Poori Chips 250GM,14,50,40,10,1
18-02-2025,Snacks & Ready-to-Eat,VD MIXTURE 175 GM,14,60,60,0,1
18-02-2025,Snacks & Ready-to-Eat,VD MURUKU 175GM,14,60,60,0,1
18-02-2025,Snacks & Ready-to-Eat,VD BELLAM GAVVALU 200GM,14,60,60,0,1
18-02-2025,"Grains, Flours & Dals",Urad dall 1 Kg,4,370,340,30,2
18-02-2025,"Grains, Flours & Dals",Wheat Rava M 500GM,4,66,60,6,2
18-02-2025,Oils & Ghee,Groundnut oil 5 L,9,1800,"1,600.00",200,1
18-02-2025,"Grains, Flours & Dals",Wheat Flour 1 kg,4,140,120,20,2
18-02-2025,Oils & Ghee,Coconut oil 500 ml,9,220,200,20,1
18-02-2025,"Grains, Flours & Dals",RAGI FLOUR 1KG,4,80,70,10,1
18-02-2025,"Grains, Flours & Dals",KORRALU (FOXTAIL M) 1KG,4,150,110,40,1
18-02-2025,"Grains, Flours & Dals",White jowar.F 1 kg,4,100,80,20,1
18-02-2025,"Grains, Flours & Dals",Em jowar idly R 500G,4,75,75,0,1
18-02-2025,"Grains, Flours & Dals",Em kodo idli R 500G,4,129,129,0,1
18-02-2025,"Grains, Flours & Dals",Wheat Flour 1 kg,4,70,60,10,1
18-02-2025,"Grains, Flours & Dals",Red Wheat Flour 1 kg,4,140,130,10,1
18-02-2025,"Grains, Flours & Dals",FLOUR CHARGE,4,12,12,0,1
18-02-2025,Spices & Seasonings,JEERA 250 gms,15,125,105,20,1
18-02-2025,Snacks & Ready-to-Eat,OK MACARONI,14,120,120,0,1
18-02-2025,Snacks & Ready-to-Eat,PEANUT CHIKKI,14,44,44,0,2
18-02-2025,Pooja & Spiritual Items,GD Aiswarya Deepam 700ML,12,195,195,0,1
18-02-2025,"Grains, Flours & Dals",RICE FLOUR 500 GM,4,35,28,7,1
18-02-2025,General Household & Kitchenware,MATCH BOX,3,20,20,0,1
18-02-2025,Household & Cleaning,ARIEL MATIC TP 2KG,6,595,595,0,1
18-02-2025,Spices & Seasonings,YB Rock Salt 1KG,15,240,240,0,2
18-02-2025,"Grains, Flours & Dals",SA Sprouted Ragi Flour 500GM,4,69,69,0,1
18-02-2025,"Dry Fruits, Nuts & Seeds",Groundnuts 1 kg,2,190,170,20,1
18-02-2025,Sweeteners,MISHRI 250 GM,16,35,30,5,1
18-02-2025,Pooja & Spiritual Items,DASANGAM DHOOP POWDER 50GM,12,43,43,0,1
18-02-2025,Household & Cleaning,PITAMBARI SHINING POWDER 200G,6,60,60,0,1
18-02-2025,Pooja & Spiritual Items,OM SAINATH ISOBORNEOL 10GM,12,60,60,0,1
18-02-2025,"Grains, Flours & Dals",maida 500grms,4,60,60,0,1
18-02-2025,"Grains, Flours & Dals",Idly Rava L 1KG,4,60,50,10,1
18-02-2025,Snacks & Ready-to-Eat,RINGS 200GM,14,30,30,0,1
18-02-2025,Snacks & Ready-to-Eat,ANNAPURNA APPALAM,14,35,35,0,1
18-02-2025,Snacks & Ready-to-Eat,VD SAGOPAPAD 150GM,14,55,55,0,1
18-02-2025,Snacks & Ready-to-Eat,ID IDLY DOSA BATTER,14,90,90,0,1
18-02-2025,"Grains, Flours & Dals",Red Bobarlu 500 gms,4,95,85,10,1
18-02-2025,"Grains, Flours & Dals",PESARA PAPPU 500GMS,4,85,75,10,1
18-02-2025,"Grains, Flours & Dals",Green gram 500 gms,4,75,70,5,1
18-02-2025,"Grains, Flours & Dals",turdal 1kg,4,220,195,25,1
18-02-2025,"Grains, Flours & Dals",HS Multimillet idly R 500 gms,4,65,65,0,1
18-02-2025,Sweeteners,MISHRI D,16,40,30,10,1
18-02-2025,Oils & Ghee,Groundnut oil 1 L,9,360,330,30,1
18-02-2025,Spices & Seasonings,SWEET SOUNF,15,20,20,0,1
18-02-2025,Snacks & Ready-to-Eat,RSC ORANGE 100GMS,14,20,20,0,1
18-02-2025,"Health, Wellness & Ayurvedic Products",RB Max Protein Choco Berry bar 50g,5,75,75,0,1
18-02-2025,Snacks & Ready-to-Eat,MILK BREAD,14,55,55,0,1
18-02-2025,Sweeteners,SUGAR 1KG,16,60,50,10,1
18-02-2025,"Grains, Flours & Dals",Yellow jowar .F1 kg,4,220,200,20,2
18-02-2025,"Dry Fruits, Nuts & Seeds",Groundnuts 500 gms,2,95,85,10,1
18-02-2025,"Grains, Flours & Dals",Chana Flour 500 gms,4,70,65,5,1
18-02-2025,"Grains, Flours & Dals",VGR rice 1 kg,4,210,195,15,3
18-02-2025,"Grains, Flours & Dals",White jowar.F 1 kg,4,200,160,40,2
18-02-2025,Spices & Seasonings,LG 50GM,15,92,92,0,1
18-02-2025,"Grains, Flours & Dals",Bajra Flour 1 kg,4,70,60,10,1
18-02-2025,"Grains, Flours & Dals",SL Idly Rava 1KG,4,65,55,10,1
18-02-2025,Snacks & Ready-to-Eat,MILK BREAD,14,30,30,0,1
18-02-2025,Snacks & Ready-to-Eat,SD FINGER Millet with palm Jaggery 250gm,14,135,135,0,1
18-02-2025,Snacks & Ready-to-Eat,BATANA NGT 70GMS,14,20,20,0,1
18-02-2025,Snacks & Ready-to-Eat,VD SAGOPAPAD 150GM,14,55,55,0,1
18-02-2025,"Grains, Flours & Dals",idly/Dosa rice 1 kg,4,70,60,10,1
18-02-2025,Snacks & Ready-to-Eat,RINGS 200GM,14,30,30,0,1
18-02-2025,"Grains, Flours & Dals",SABDANA,4,40,35,5,1
18-02-2025,"Grains, Flours & Dals",DESI CHANA,4,25,25,0,1
18-02-2025,Snacks & Ready-to-Eat,BD KODO MILLET NOODLES 200GM,14,75,75,0,1
18-02-2025,Snacks & Ready-to-Eat,VD RICE MURUKU 150GM,14,50,50,0,1
18-02-2025,"Grains, Flours & Dals",Chittimuthaylu rice 1 kg,4,480,420,60,3
18-02-2025,"Grains, Flours & Dals",JOWAR WHITE 1 KG,4,20,17.5,2.5,0.25
18-02-2025,"Grains, Flours & Dals",WHEAT 1 KG,4,15,12.5,2.5,0.25
18-02-2025,Snacks & Ready-to-Eat,SD Thati thandra 200gm,14,150,150,0,1
18-02-2025,"Dry Fruits, Nuts & Seeds",SD Mango cubes 200gm,2,90,90,0,1
18-02-2025,Snacks & Ready-to-Eat,SD Vamu with palm jaggery 250gm,14,270,270,0,2
18-02-2025,Pooja & Spiritual Items,AMRUTHA SURABHI,12,80,80,0,1
18-02-2025,"Grains, Flours & Dals",Wheat Flour 1 kg,4,70,60,10,1
18-02-2025,"Grains, Flours & Dals",Multigrain 1 kg,4,100,85,15,1
18-02-2025,"Dry Fruits, Nuts & Seeds",Putnalu 250GM,2,45,38,7,1
18-02-2025,"Grains, Flours & Dals",JOWAR YELLOW 1 K,4,100,90,10,1
18-02-2025,Spices & Seasonings,PRO ORG FENUGREEK 200GM,15,75,75,0,1
18-02-2025,"Grains, Flours & Dals",KORRALU (FOXTAIL M) 500GM,4,65,55,10,1
18-02-2025,"Grains, Flours & Dals",Yellow jowar .F1 kg,4,110,100,10,1
18-02-2025,Snacks & Ready-to-Eat,PN ORGANIC PUFFED RICE 200GM,14,55,55,0,1
18-02-2025,Spices & Seasonings,DRY MIECHI 200GM,15,80,60,20,1
18-02-2025,"Grains, Flours & Dals",CHANA DAL 500GM,4,70,60,10,1
18-02-2025,"Dry Fruits, Nuts & Seeds",Groundnuts 1 kg,2,190,170,20,1
18-02-2025,Spices & Seasonings,Tamarind 500GM,15,148,148,0,1
18-02-2025,Pooja & Spiritual Items,BALAJI KEWDA STICKS 220GM,12,150,150,0,1
18-02-2025,Milk & Dairy,HERITAGE TOTAL CURD 500GM,7,50,50,0,1
18-02-2025,"Grains, Flours & Dals",RAGI FLOUR 1KG,4,80,70,10,1
18-02-2025,"Grains, Flours & Dals",DISANO OATS 1KG,4,71.25,71.25,0,0.25
18-02-2025,Snacks & Ready-to-Eat,SD FINGER Millet with palm Jaggery 250gm,14,135,135,0,1
18-02-2025,"Grains, Flours & Dals",SL Idly Rava 1KG,4,65,55,10,1
18-02-2025,Spices & Seasonings,SD Curry Leaves Karam Powder 100GM,15,65,65,0,1
18-02-2025,"Health, Wellness & Ayurvedic Products",MD Orange Peel Choornam 50GM,5,80,80,0,1
18-02-2025,"Health, Wellness & Ayurvedic Products",SAI DURGA MORINGA LEAVES 100GM,5,75,75,0,1
18-02-2025,"Grains, Flours & Dals",HS Multimillet idly R 500 gms,4,65,65,0,1
18-02-2025,Oils & Ghee,Groundnut oil 1 L,9,360,330,30,1
18-02-2025,Snacks & Ready-to-Eat,VD MANGO JELLY 250GRMS,14,80,80,0,1
18-02-2025,"Dry Fruits, Nuts & Seeds",Groundnuts 500 gms,2,95,85,10,1
18-02-2025,Oils & Ghee,Sesame oil 500ml,9,295,280,15,1
18-02-2025,Oils & Ghee,Sesame oil 500ml,9,295,280,15,1
18-02-2025,Snacks & Ready-to-Eat,FUN TIME CRUNCH,14,45,45,0,1
18-02-2025,"Grains, Flours & Dals",SA Multi Grain Mix 500GM,4,159,159,0,1
18-02-2025,Snacks & Ready-to-Eat,VD MULTI CHAKKA,14,110,110,0,1
18-02-2025,"Dry Fruits, Nuts & Seeds",FLAX SEEDS 250GM,2,60,50,10,1
18-02-2025,"Health, Wellness & Ayurvedic Products",RB Nuts& Seeds cashews 35g,5,45,45,0,1
18-02-2025,"Grains, Flours & Dals",Yellow jowar .F1 kg,4,110,100,10,1
18-02-2025,Spices & Seasonings,Jeera 100GM,15,50,45,5,1
18-02-2025,"Dry Fruits, Nuts & Seeds",SATHVI CHIA SEEDS 100GM,2,100,80,20,1
18-02-2025,Spices & Seasonings,Telaga Pindi 250 GM,15,40,35,5,1
18-02-2025,"Grains, Flours & Dals",Arikadu ( kodo),4,280,260,20,2
18-02-2025,Oils & Ghee,Safflower oil 1 L,9,880,800,80,2
18-02-2025,Spices & Seasonings,Avalu small 250 gms,15,60,40,20,1
18-02-2025,"Grains, Flours & Dals",Wheat Rava S 1KG,4,65,55,10,1
18-02-2025,"Grains, Flours & Dals",Multigrain 1 kg,4,200,170,30,2
18-02-2025,Snacks & Ready-to-Eat,SD Moringa with plam jaggery 250gm,14,135,135,0,1
18-02-2025,Snacks & Ready-to-Eat,VD RED CHILLI RICEPAPAD 150GM,14,50,50,0,1
18-02-2025,"Grains, Flours & Dals",Hs yellow jowar r 500g,4,198,198,0,2
18-02-2025,"Grains, Flours & Dals",AS Maize Rava 500GM,4,42,38,4,1
18-02-2025,Oils & Ghee,Groundnut oil 1 L,9,360,330,30,1
18-02-2025,"Grains, Flours & Dals",MELMEKER 250GMS,4,60,45,15,1
18-02-2025,"Grains, Flours & Dals",ANDU KORRALU (Browntop.m) 1 kg,4,260,220,40,1
18-02-2025,"Grains, Flours & Dals",split black gram 1 kg,4,180,170,10,1
18-02-2025,"Grains, Flours & Dals",Red Wheat Flour 1 kg,4,420,390,30,3
18-02-2025,"Grains, Flours & Dals",Green gram 1 kg,4,300,260,40,2
18-02-2025,"Grains, Flours & Dals",White jowar.F 1 kg,4,100,80,20,1
18-02-2025,Snacks & Ready-to-Eat,SD Pumpkin Seeds With Dates 175gm,14,170,170,0,1
18-02-2025,Spices & Seasonings,JEERA 250 gms,15,125,105,20,1
18-02-2025,Snacks & Ready-to-Eat,FOXTAIL BIS,14,270,270,0,2
18-02-2025,"Grains, Flours & Dals",Yellow jowar .F1 kg,4,220,200,20,2
18-02-2025,Oils & Ghee,Sesame oil 500ml,9,295,280,15,1
18-02-2025,Snacks & Ready-to-Eat,BD KODO MILLET NOODLES 200GM,14,75,75,0,1
18-02-2025,Snacks & Ready-to-Eat,RB Choco Delite Almonds Raisins 40g,14,45,45,0,1
18-02-2025,"Grains, Flours & Dals",JOWAR WHITE 1 KG,4,80,70,10,1
18-02-2025,Oils & Ghee,Coconut oil 500 ml,9,220,200,20,1
18-02-2025,Oils & Ghee,cow ghee 500 ml,9,430,390,40,1
18-02-2025,"Health, Wellness & Ayurvedic Products",RB FRUITS &amp;seeds Cranberries,5,45,45,0,1
18-02-2025,Oils & Ghee,Safflower oil 1 L,9,440,400,40,1
18-02-2025,"Grains, Flours & Dals",KORRALU (FOXTAIL M) 1KG,4,150,110,40,1
18-02-2025,Oils & Ghee,Groundnut oil 1 L,9,360,330,30,1
18-02-2025,Snacks & Ready-to-Eat,VD MULTI CHAKKA,14,110,110,0,1
18-02-2025,"Health, Wellness & Ayurvedic Products",AMLAKI CHOORNAM,5,100,100,0,1
18-02-2025,Personal Care & Cosmetics,MD Bath Powder 100GM,10,40,40,0,1
18-02-2025,Spices & Seasonings,Jeera 100GM,15,50,45,5,1
18-02-2025,Milk & Dairy,BROWN EGGS 1P,7,140,120,20,10
18-02-2025,"Grains, Flours & Dals",White Chana 250 GM,4,60,50,10,1
18-02-2025,"Dry Fruits, Nuts & Seeds",SUNFLOWER SEEDS 250GRM,2,150,130,20,1
18-02-2025,Snacks & Ready-to-Eat,BB VERMICELLI 1KG,14,95,90,5,1
18-02-2025,Oils & Ghee,Safflower oil 500 ml,9,220,200,20,1
18-02-2025,"Dry Fruits, Nuts & Seeds",PUMPKIN SEEDS 250GM,2,200,160,40,1
18-02-2025,Oils & Ghee,Groundnut oil 1 L,9,720,660,60,2
18-02-2025,Snacks & Ready-to-Eat,SD Moringa with plam jaggery 250gm,14,135,135,0,1
18-02-2025,Snacks & Ready-to-Eat,SD Aswagandha with palm Jaggery250Gm,14,135,135,0,1
18-02-2025,Snacks & Ready-to-Eat,SD Bajra with palm Jaggery 250gm,14,135,135,0,1
18-02-2025,Snacks & Ready-to-Eat,FOXTAIL BIS,14,135,135,0,1
18-02-2025,Sweeteners,Natural Honey 500 gms,16,280,240,40,1
18-02-2025,Oils & Ghee,Groundnut oil 1 L,9,360,330,30,1
18-02-2025,Personal Care & Cosmetics,Soapnut 500GM,10,120,90,30,1
18-02-2025,Spices & Seasonings,LG 50GM,15,92,92,0,1
18-02-2025,"Grains, Flours & Dals",Wheat Flour 1 kg,4,70,60,10,1
18-02-2025,Snacks & Ready-to-Eat,NGT CHATPATTA CHANA 90GM,14,25,25,0,1
18-02-2025,"Dry Fruits, Nuts & Seeds",SALTED PISTA 250GM,2,400,350,50,1
18-02-2025,Snacks & Ready-to-Eat,RSC ORANGE 100GMS,14,20,20,0,1
18-02-2025,Snacks & Ready-to-Eat,SD FINGER Millet with palm Jaggery 250gm,14,135,135,0,1
18-02-2025,Oils & Ghee,Groundnut oil 1 L,9,360,330,30,1
18-02-2025,"Dry Fruits, Nuts & Seeds",SD Mango cubes 200gm,2,90,90,0,1
18-02-2025,Oils & Ghee,BUFFALLO GHEE 500ML,9,1230,"1,110.00",120,3
18-02-2025,Snacks & Ready-to-Eat,FOXTAIL BIS,14,135,135,0,1
18-02-2025,"Grains, Flours & Dals",Green gram 1 kg,4,150,130,20,1
18-02-2025,"Grains, Flours & Dals",WHITE BATANI,4,40,30,10,1
18-02-2025,Snacks & Ready-to-Eat,SD Groundnut with palm jaggery 250gm,14,135,135,0,1
18-02-2025,"Grains, Flours & Dals",Red Chana 250GM,4,35,30,5,1
18-02-2025,Snacks & Ready-to-Eat,VD ATUKULU MIXTURE 175GM,14,60,60,0,1
18-02-2025,"Grains, Flours & Dals",White Chana 250 GM,4,60,50,10,1
18-02-2025,Spices & Seasonings,Tamalapaku Karam Powder 100GM,15,80,80,0,1
18-02-2025,Snacks & Ready-to-Eat,SD FINGER Millet with palm Jaggery 250gm,14,135,135,0,1
18-02-2025,"Dry Fruits, Nuts & Seeds",DRYDATES YELLOW 250GM,2,135,120,15,1
18-02-2025,"Dry Fruits, Nuts & Seeds",ALMONDS 250GM,2,280,260,20,1
18-02-2025,Snacks & Ready-to-Eat,SD Ginger Candy 100g,14,60,60,0,1
18-02-2025,"Dry Fruits, Nuts & Seeds",YELLOW KISHMISH 250GM,2,130,110,20,1
18-02-2025,Snacks & Ready-to-Eat,ELITE ELAICHI RUSK 200GM,14,35,35,0,1
18-02-2025,Snacks & Ready-to-Eat,VD DASA DINUSULU,14,199,199,0,1
18-02-2025,Sweeteners,YB JAGGERY POWDER 500GMS,16,450,450,0,6
18-02-2025,"Dry Fruits, Nuts & Seeds",SALTED PISTA 250GM,2,400,350,50,1
18-02-2025,Snacks & Ready-to-Eat,SESAME CHIKKI,14,240,200,40,2
18-02-2025,Snacks & Ready-to-Eat,VD NUVVULU LADDU,14,160,160,0,2
18-02-2025,Snacks & Ready-to-Eat,VD MULTI CHAKKA,14,110,110,0,1
18-02-2025,Snacks & Ready-to-Eat,VD PALLI LADDU,14,240,240,0,3
18-02-2025,"Dry Fruits, Nuts & Seeds",Groundnuts 1 kg,2,190,170,20,1
18-02-2025,Snacks & Ready-to-Eat,VD PALLI CHIKKI,14,80,80,0,1
18-02-2025,"Dry Fruits, Nuts & Seeds",PULMAKHANA 100 GM,2,180,170,10,1
18-02-2025,Oils & Ghee,Groundnut oil 1 L,9,360,330,30,1
18-02-2025,"Grains, Flours & Dals",SL Idly Rava 1KG,4,65,55,10,1
18-02-2025,"Grains, Flours & Dals",RAGI FLOUR 1KG,4,80,70,10,1
18-02-2025,Spices & Seasonings,RED COPRA 500GM,15,170,148,22,1
18-02-2025,"Grains, Flours & Dals",White Chana 500GM,4,120,100,20,1
18-02-2025,"Grains, Flours & Dals",Red Bobarlu 500 gms,4,95,85,10,1
18-02-2025,"Grains, Flours & Dals",SRILATHA RICE RAVVA 500GM,4,210,210,0,6
18-02-2025,Spices & Seasonings,Chilli powder 500 gms,15,290,210,80,1
18-02-2025,Pooja & Spiritual Items,GB Bharatha Woods 75GM,12,120,120,0,2
18-02-2025,"Grains, Flours & Dals",VGR rice 1 kg,4,350,325,25,5
18-02-2025,"Dry Fruits, Nuts & Seeds",YELLOW KISHMISH 250GM,2,130,110,20,1
18-02-2025,"Dry Fruits, Nuts & Seeds",MAHA BEERA SEEDS 100GM,2,60,60,0,1
18-02-2025,"Dry Fruits, Nuts & Seeds",CASHEW 250GM,2,340,310,30,1
18-02-2025,"Grains, Flours & Dals",maida 500grms,4,60,60,0,1
18-02-2025,Spices & Seasonings,Avalu small 250 gms,15,60,40,20,1
18-02-2025,"Dry Fruits, Nuts & Seeds",ANJEER 250GM,2,400,360,40,1
18-02-2025,"Grains, Flours & Dals",HS jowar idly rava 500 gms,4,65,65,0,1
18-02-2025,Milk & Dairy,BROWN EGGS 1P,7,84,72,12,6
18-02-2025,"Grains, Flours & Dals",MAAGAANI W RICE 5KGS,4,899,535,364,1
18-02-2025,Personal Care & Cosmetics,BAMBOO TOOTH BRUSH,10,120,120,0,1
18-02-2025,Pooja & Spiritual Items,GD Aiswarya Deepam 700ML,12,195,195,0,1
18-02-2025,"Grains, Flours & Dals",THICK POHA 1KG,4,80,70,10,1
18-02-2025,"Grains, Flours & Dals",Wheat Flour 1 kg,4,70,60,10,1
18-02-2025,"Grains, Flours & Dals",Red Bobarlu 1 kg,4,190,170,20,1
18-02-2025,"Grains, Flours & Dals",Green gram 500 gms,4,75,70,5,1
18-02-2025,"Grains, Flours & Dals",SINGLE POLISH 1KG,4,455,455,0,7
18-02-2025,"Grains, Flours & Dals",MAAGAANI LOW GI SP L 1KG,4,240,210,30,2
18-02-2025,"Grains, Flours & Dals",Green gram 1 kg,4,150,130,20,1
18-02-2025,"Grains, Flours & Dals",Black gram 500 gms,4,75,70,5,1
18-02-2025,"Grains, Flours & Dals",RED TUDAL 1KG,4,150,140,10,1
18-02-2025,"Dry Fruits, Nuts & Seeds",Groundnuts 1 kg,2,190,170,20,1
18-02-2025,Spices & Seasonings,Tamarind 500GM,15,148,148,0,1
18-02-2025,"Grains, Flours & Dals",THICK POHA 500GM,4,40,35,5,1
17-02-2025,"Grains, Flours & Dals",Wheat Flour 1 kg,4,140,120,20,2
17-02-2025,Oils & Ghee,Groundnut oil 1 L,9,720,660,60,2
17-02-2025,"Grains, Flours & Dals",Bombay Rava 500GM,4,35,30,5,1
17-02-2025,"Grains, Flours & Dals",maida 500grms,4,60,60,0,1
17-02-2025,"Grains, Flours & Dals",Urad dall 1 Kg,4,185,170,15,1
17-02-2025,"Grains, Flours & Dals",Chana Flour 500 gms,4,70,65,5,1
17-02-2025,"Grains, Flours & Dals",SL Idly Rava 1KG,4,65,55,10,1
17-02-2025,Oils & Ghee,Freedom Rice Bran Oil 1L,9,194,180,14,1
17-02-2025,Snacks & Ready-to-Eat,VD MIXTURE 175 GM,14,60,60,0,1
17-02-2025,"Health, Wellness & Ayurvedic Products",MH Millets Malt 1KG,5,400,380,20,1
17-02-2025,Snacks & Ready-to-Eat,VD ATUKULU MIXTURE 175GM,14,60,60,0,1
17-02-2025,Snacks & Ready-to-Eat,VD PALLI LADDU,14,80,80,0,1
17-02-2025,Snacks & Ready-to-Eat,VD Pappu Chekkalu 190gm,14,60,60,0,1
17-02-2025,Spices & Seasonings,TATA SALT 1KG,15,30,30,0,1
17-02-2025,"Grains, Flours & Dals",SABDANA,4,40,35,5,1
17-02-2025,"Grains, Flours & Dals",Urad dall 1 Kg,4,185,170,15,1
17-02-2025,Spices & Seasonings,Turmeric powder 250 gms,15,100,75,25,1
17-02-2025,"Grains, Flours & Dals",THIN POHA 500GM,4,40,35,5,1
17-02-2025,Sweeteners,GS JAGGERY NUGGETS 500GM,16,120,120,0,1
17-02-2025,Oils & Ghee,Groundnut oil 1 L,9,360,330,30,1
17-02-2025,Oils & Ghee,Coconut oil 1 L,9,440,400,40,1
17-02-2025,Oils & Ghee,Sesame oil 1 L,9,590,560,30,1
17-02-2025,Snacks & Ready-to-Eat,VD BELLAM GAVVALU 200GM,14,60,60,0,1
17-02-2025,Snacks & Ready-to-Eat,VD RIBBON PAKODI 175GM,14,60,60,0,1
17-02-2025,Spices & Seasonings,GS Pink Rock Salt 1KG,15,120,120,0,1
17-02-2025,"Grains, Flours & Dals",MAAGAANI W RICE 5KGS,4,899,535,364,1
17-02-2025,"Grains, Flours & Dals",JOWAR YELLOW 1 K,4,200,180,20,2
17-02-2025,Personal Care & Cosmetics,MADDI HIBISCUS HAIR SHAMPOO 500ML,10,300,300,0,1
17-02-2025,"Grains, Flours & Dals",Black uluvalu 250 gms,4,45,35,10,1
17-02-2025,Spices & Seasonings,Japatri 25GM,15,100,80,20,1
17-02-2025,Spices & Seasonings,Menthulu 250 gms,15,50,45,5,1
17-02-2025,"Grains, Flours & Dals",Red Bobarlu 500 gms,4,95,85,10,1
17-02-2025,"Grains, Flours & Dals",HS jowar idly rava 500 gms,4,65,65,0,1
17-02-2025,"Grains, Flours & Dals",Green gram 1 kg,4,150,130,20,1
17-02-2025,"Grains, Flours & Dals",Wheat Rava S 500GM,4,33,30,3,1
17-02-2025,Snacks & Ready-to-Eat,SD Ginger Candy 100g,14,60,60,0,1
17-02-2025,Snacks & Ready-to-Eat,VD MIXTURE 175 GM,14,60,60,0,1
17-02-2025,Snacks & Ready-to-Eat,VD DAHI MIRCHI(SALTED) 100GM,14,45,45,0,1
17-02-2025,"Grains, Flours & Dals",RAGI FLOUR 1KG,4,80,70,10,1
17-02-2025,Sweeteners,Natural Honey 500 gms,16,280,240,40,1
17-02-2025,"Grains, Flours & Dals",RAGULU 1 KG,4,210,180,30,3
17-02-2025,Snacks & Ready-to-Eat,VD MINAPA VADIYAM,14,65,65,0,1
17-02-2025,Beverages,BRU GREEN LABEL 1.2G,1,48,48,0,24
17-02-2025,"Dry Fruits, Nuts & Seeds",Groundnuts 500 gms,2,95,85,10,1
17-02-2025,Beverages,BRU GREEN LABEL 1.2G,1,48,48,0,24
17-02-2025,"Grains, Flours & Dals",JOWAR UPMA RAVA,4,65,65,0,1
17-02-2025,Spices & Seasonings,SWEET SOUNF,15,20,20,0,1
17-02-2025,Snacks & Ready-to-Eat,VD GUMMADI VADIYAM,14,75,75,0,1
17-02-2025,Snacks & Ready-to-Eat,VD SAGOPAPAD 150GM,14,55,55,0,1
17-02-2025,"Dry Fruits, Nuts & Seeds",YELLOW KISHMISH 250GM,2,130,110,20,1
17-02-2025,"Grains, Flours & Dals",RAGI FLOUR 1KG,4,80,70,10,1
17-02-2025,Beverages,REFRESH SHARBATH NORMAL,1,199,190,9,1
17-02-2025,Sweeteners,Natural Honey 500 gms,16,280,240,40,1
17-02-2025,"Grains, Flours & Dals",SL Idly Rava 1KG,4,65,55,10,1
17-02-2025,Spices & Seasonings,LG 50GM,15,92,92,0,1
17-02-2025,Snacks & Ready-to-Eat,Corn Chips 250GM,14,40,35,5,1
17-02-2025,Pickles & Cooking Pastes,SD TAMARIND PICKLE,11,110,110,0,1
17-02-2025,"Grains, Flours & Dals",Multigrain 1 kg,4,100,85,15,1
17-02-2025,Milk & Dairy,BROWN EGGS 1P,7,140,120,20,10
17-02-2025,Spices & Seasonings,NUVVULU 250GM,15,80,65,15,1
17-02-2025,Snacks & Ready-to-Eat,Corn Chips 250GM,14,40,35,5,1
17-02-2025,"Dry Fruits, Nuts & Seeds",Groundnuts 500 gms,2,95,85,10,1
17-02-2025,Snacks & Ready-to-Eat,RSC ORANGE 100GMS,14,20,20,0,1
17-02-2025,Snacks & Ready-to-Eat,BB VERMICELLY 500GM,14,53,53,0,1
17-02-2025,Beverages,BRU GREEN LABEL 1.2G,1,48,48,0,24
17-02-2025,"Grains, Flours & Dals",Green Batani 250GM,4,55,45,10,1
17-02-2025,"Dry Fruits, Nuts & Seeds",WALNUT ROUND 250GM,2,320,280,40,1
17-02-2025,Household & Cleaning,VIM SOAP,6,10,10,0,2
17-02-2025,Snacks & Ready-to-Eat,VD PALLI CHIKKI,14,80,80,0,1
17-02-2025,"Dry Fruits, Nuts & Seeds",PULMAKHANA 100 GM,2,180,170,10,1
17-02-2025,Oils & Ghee,Freedom Rice Bran Oil 1L,9,194,180,14,1
17-02-2025,"Grains, Flours & Dals",BARLEY SEEDS 1KG,4,80,70,10,0.5
17-02-2025,"Grains, Flours & Dals",HS Multimillet upma r 500g,4,65,65,0,1
17-02-2025,"Grains, Flours & Dals",PRO ORG MEDIUM POHA 500G,4,78,78,0,1
17-02-2025,"Dry Fruits, Nuts & Seeds",PUMPKIN SEEDS 250GM,2,200,160,40,1
17-02-2025,Spices & Seasonings,GS Moringa Leaves Spicy Powder 100GM,15,90,90,0,1
17-02-2025,"Grains, Flours & Dals",RAGULU 1 KG,4,7,6,1,0.1
17-02-2025,Personal Care & Cosmetics,HERBAL BATH POWDER,10,160,160,0,1
17-02-2025,"Grains, Flours & Dals",FLOUR CHARGE,4,130,130,0,1
17-02-2025,"Grains, Flours & Dals",BLACK GRAM 1KG,4,150,140,10,1
17-02-2025,Milk & Dairy,BROWN EGGS 1P,7,210,180,30,15
17-02-2025,"Grains, Flours & Dals",RAGI FLOUR 1KG,4,80,70,10,1
17-02-2025,Snacks & Ready-to-Eat,VD RED CHILLI RICEPAPAD 150GM,14,50,50,0,1
17-02-2025,Snacks & Ready-to-Eat,urban murmura,14,70,70,0,1
17-02-2025,Spices & Seasonings,AV Iodized Salt 1KG,15,28,25,3,1
17-02-2025,"Grains, Flours & Dals",turdal 1kg,4,220,195,25,1
17-02-2025,"Grains, Flours & Dals",RICE FLOUR 1KG,4,70,55,15,1
17-02-2025,"Grains, Flours & Dals",CHANA DAL 1KG,4,35,30,5,0.25
17-02-2025,"Grains, Flours & Dals",Wheat Rava M 1KG,4,65,55,10,1
17-02-2025,"Grains, Flours & Dals",RAJMA 250GM,4,55,45,10,1
17-02-2025,"Grains, Flours & Dals",Bombay Rava 500GM,4,35,30,5,1
17-02-2025,"Grains, Flours & Dals",Chana Flour 1 kg,4,140,130,10,1
17-02-2025,"Grains, Flours & Dals",Red Bobarlu 1 kg,4,190,170,20,1
17-02-2025,"Grains, Flours & Dals",Wheat Flour 1 kg,4,140,120,20,2
17-02-2025,Spices & Seasonings,Jeera 100GM,15,50,45,5,1
17-02-2025,Snacks & Ready-to-Eat,Popcorn Seeds 250GM,14,45,40,5,1
17-02-2025,Spices & Seasonings,THOKA MIRYALU 50GM,15,210,180,30,1
17-02-2025,Spices & Seasonings,AVALU 100GM,15,25,20,5,1
17-02-2025,Snacks & Ready-to-Eat,RINGS 200GM,14,30,30,0,1
17-02-2025,Snacks & Ready-to-Eat,BB VERMICELLI 1KG,14,95,90,5,1
17-02-2025,Spices & Seasonings,ROYAL SAFFRON 400GRMS,15,65,65,0,1
17-02-2025,"Grains, Flours & Dals",PESARA PAPPU 1 KG,4,170,145,25,1
17-02-2025,Spices & Seasonings,DURGA SALT CRYSTAL 1KG,15,25,25,0,1
17-02-2025,"Grains, Flours & Dals",Yellow jowar .F1 kg,4,110,100,10,1
17-02-2025,Spices & Seasonings,DRY MIECHI 200GM,15,80,60,20,1
17-02-2025,Snacks & Ready-to-Eat,VD NUVVULU LADDU,14,80,80,0,1
17-02-2025,Snacks & Ready-to-Eat,VD RIBBON PAKODI 175GM,14,60,60,0,1
17-02-2025,Snacks & Ready-to-Eat,VD MURUKU 175GM,14,60,60,0,1
17-02-2025,Snacks & Ready-to-Eat,RAJGIRA PEANUT CHIKKI,14,5,5,0,1
17-02-2025,"Grains, Flours & Dals",Em jowar idly R 500G,4,150,150,0,2
17-02-2025,Snacks & Ready-to-Eat,VD RICE MURUKU 150GM,14,45,45,0,1
17-02-2025,Oils & Ghee,Groundnut oil 1 L,9,1080,990,90,3
17-02-2025,"Grains, Flours & Dals",SAMALU (Little millet) 1 kg,4,170,130,40,1
17-02-2025,"Grains, Flours & Dals",SINGLE POLISH 1KG,4,130,130,0,2
17-02-2025,Oils & Ghee,Groundnut oil 1 L,9,360,330,30,1
17-02-2025,"Grains, Flours & Dals",turdal 1kg,4,220,195,25,1
17-02-2025,Spices & Seasonings,Tamarind 250GMS,15,75,75,0,1
17-02-2025,Spices & Seasonings,SV Dried Kasuri Methi 100GM,15,95,95,0,1
17-02-2025,Milk & Dairy,BROWN EGGS 1P,7,140,120,20,10
17-02-2025,Spices & Seasonings,Black Till 250GM,15,450,375,75,5
17-02-2025,Snacks & Ready-to-Eat,VD PALLI CHIKKI,14,80,80,0,1
17-02-2025,"Grains, Flours & Dals",Wheat Flour 1 kg,4,70,60,10,1
17-02-2025,"Grains, Flours & Dals",RED TUDAL 1KG,4,150,140,10,1
17-02-2025,"Dry Fruits, Nuts & Seeds",Groundnuts 1 kg,2,95,85,10,0.5
17-02-2025,"Grains, Flours & Dals",turdal 1kg,4,220,195,25,1
17-02-2025,Oils & Ghee,Groundnut oil 1 L,9,360,330,30,1
17-02-2025,"Dry Fruits, Nuts & Seeds",DRYDATES YELLOW 250GM,2,135,120,15,1
17-02-2025,"Dry Fruits, Nuts & Seeds",YELLOW KISHMISH 250GM,2,130,110,20,1
17-02-2025,"Grains, Flours & Dals",KORRALU (FOXTAIL M) 500GM,4,65,55,10,1
17-02-2025,"Grains, Flours & Dals",JOWAR UPMA RAVA,4,65,65,0,1
17-02-2025,"Grains, Flours & Dals",FLOUR CHARGE,4,18,18,0,1.5
17-02-2025,"Grains, Flours & Dals",BAJRA 1 KG,4,15,12.5,2.5,0.25
17-02-2025,"Grains, Flours & Dals",JOWAR YELLOW 1 K,4,25,22.5,2.5,0.25
17-02-2025,"Grains, Flours & Dals",RAGULU 1 KG,4,70,60,10,1
17-02-2025,"Grains, Flours & Dals",RAGULU 1 KG,4,70,60,10,1
17-02-2025,"Grains, Flours & Dals",FLOUR CHARGE,4,24,24,0,2
17-02-2025,"Grains, Flours & Dals",JOWAR WHITE 1 KG,4,160,140,20,2
17-02-2025,"Grains, Flours & Dals",BARLEY SEEDS 1KG,4,160,140,20,1
17-02-2025,Snacks & Ready-to-Eat,urban murmura,14,70,70,0,1
17-02-2025,Snacks & Ready-to-Eat,SALTED PHALLI,14,25,25,0,1
17-02-2025,Snacks & Ready-to-Eat,Corn Chips 250GM,14,40,35,5,1
17-02-2025,Snacks & Ready-to-Eat,TILLI CHIKKI,14,20,20,0,4
17-02-2025,Sweeteners,YB JAGGERY POWDER 1KG,16,140,140,0,1
17-02-2025,"Dry Fruits, Nuts & Seeds",Groundnuts 1 kg,2,190,170,20,1
17-02-2025,Snacks & Ready-to-Eat,BD LITTLE MILLET NOODLES 200G,14,75,75,0,1
17-02-2025,"Grains, Flours & Dals",Em Foxtail upma r 500 g,4,109,109,0,1
17-02-2025,Spices & Seasonings,SAMBAR POWDER 200GM,15,130,110,20,1
17-02-2025,Spices & Seasonings,GARAM MASALA 200GM,15,120,95,25,1
17-02-2025,Snacks & Ready-to-Eat,MB LITTLE MILLET COOKIES,14,75,75,0,1
17-02-2025,Oils & Ghee,Coconut oil 1 L,9,440,400,40,1
17-02-2025,"Dry Fruits, Nuts & Seeds",SATHVI CHIA SEEDS 100GM,2,100,80,20,1
17-02-2025,"Grains, Flours & Dals",Multigrain 1 kg,4,200,170,30,2
17-02-2025,"Grains, Flours & Dals",White jowar.F 1 kg,4,100,80,20,1
17-02-2025,Personal Care & Cosmetics,MYSORE SANDAL,10,138,138,0,2
17-02-2025,"Dry Fruits, Nuts & Seeds",FLAX SEEDS 250GM,2,60,50,10,1
17-02-2025,"Grains, Flours & Dals",BARLEY SEEDS 1KG,4,80,70,10,0.5
17-02-2025,"Grains, Flours & Dals",Wheat Rava M 500GM,4,33,30,3,1
17-02-2025,Snacks & Ready-to-Eat,SESAME CHIKKI,14,120,100,20,1
17-02-2025,"Grains, Flours & Dals",turdal 500 gms,4,110,100,10,1
17-02-2025,Spices & Seasonings,NUVVULU 250GM,15,100,85,15,1
17-02-2025,"Dry Fruits, Nuts & Seeds",SALTED PISTA 250GM,2,400,350,50,1
17-02-2025,"Grains, Flours & Dals",URAD DALL,4,190,170,20,2
17-02-2025,"Grains, Flours & Dals",SRILATHA RICE RAVVA 500GM,4,35,35,0,1
17-02-2025,"Grains, Flours & Dals",Wheat Flour 1 kg,4,70,60,10,1
17-02-2025,"Grains, Flours & Dals",MAAGAANI W RICE 1KG,4,139,110,29,1
17-02-2025,"Dry Fruits, Nuts & Seeds",Groundnuts 500 gms,2,95,85,10,1
17-02-2025,Snacks & Ready-to-Eat,VD MINAPA VADIYAM,14,65,65,0,1
17-02-2025,"Dry Fruits, Nuts & Seeds",WALLNUTS 250GM,2,380,360,20,1
17-02-2025,Sweeteners,MADHUR SUGAR 1KG,16,65,55,10,1
17-02-2025,Oils & Ghee,Groundnut oil 1 L,9,360,330,30,1
17-02-2025,Oils & Ghee,Sesame oil 1 L,9,590,560,30,1
17-02-2025,"Grains, Flours & Dals",MAAGAANI W RICE 1KG,4,139,110,29,1
17-02-2025,"Grains, Flours & Dals",Wheat Rava M 500GM,4,33,30,3,1
17-02-2025,"Grains, Flours & Dals",MAAGAANI LOW GI SP L 1KG,4,120,105,15,1
17-02-2025,Snacks & Ready-to-Eat,BATANA NGT 70GMS,14,20,20,0,1
17-02-2025,Oils & Ghee,cow ghee 500 ml,9,430,390,40,1
17-02-2025,Spices & Seasonings,Elaichi 25GM,15,145,120,25,1
17-02-2025,Snacks & Ready-to-Eat,MILK BREAD,14,55,55,0,1
17-02-2025,Spices & Seasonings,Masala Karam 250 gms,15,130,120,10,1
17-02-2025,"Grains, Flours & Dals",Wheat Flour 1 kg,4,140,120,20,2
17-02-2025,"Grains, Flours & Dals",Multigrain 1 kg,4,200,170,30,2
17-02-2025,Snacks & Ready-to-Eat,RI Yogurt Berry Oats 35g,14,90,90,0,2
17-02-2025,"Grains, Flours & Dals",MAAGAANI LOW GI SP L 1KG,4,600,525,75,5
17-02-2025,"Grains, Flours & Dals",VGR RICE 5 KGS,4,350,325,25,1
17-02-2025,Personal Care & Cosmetics,OVAL BODY LOOFAH,10,165,165,0,3
17-02-2025,"Grains, Flours & Dals",Idly Rava L 1KG,4,60,50,10,1
17-02-2025,"Grains, Flours & Dals",FLOUR CHARGE,4,54,54,0,4.5
17-02-2025,Snacks & Ready-to-Eat,TILLI CHIKKI,14,5,5,0,1
17-02-2025,"Grains, Flours & Dals",CHANA DAL 1KG,4,140,120,20,1
17-02-2025,Personal Care & Cosmetics,KHADI Amla Bringaraj Shampoo 200ML,10,220,220,0,1
17-02-2025,Personal Care & Cosmetics,GAYATHRI KUMKUDUKAYA,10,150,150,0,1
17-02-2025,"Grains, Flours & Dals",SRILATHA RICE RAVVA 500GM,4,35,35,0,1
17-02-2025,Oils & Ghee,Groundnut oil 1 L,9,360,330,30,1
17-02-2025,Pooja & Spiritual Items,GD SANDAL 150GM,12,110,110,0,1
17-02-2025,"Grains, Flours & Dals",SINGLE POLISH 1KG,4,650,650,0,10
17-02-2025,Personal Care & Cosmetics,ORAL B KIDS,10,25,25,0,1
17-02-2025,"Dry Fruits, Nuts & Seeds",Groundnuts 500 gms,2,95,85,10,1
17-02-2025,"Grains, Flours & Dals",CHANA DAL 500GM,4,70,60,10,1
17-02-2025,"Grains, Flours & Dals",Multigrain 1 kg,4,100,85,15,1
17-02-2025,"Grains, Flours & Dals",Sathya Javva Wheat Rava 500GM,4,95,95,0,1
17-02-2025,"Grains, Flours & Dals",turdal 500 gms,4,110,100,10,1
17-02-2025,Oils & Ghee,Groundnut oil 1 L,9,360,330,30,1
17-02-2025,"Grains, Flours & Dals",SINGLE POLISH 1KG,4,130,130,0,2
17-02-2025,"Grains, Flours & Dals",HS RAGI Idly rava 500 gms,4,70,70,0,1
17-02-2025,"Grains, Flours & Dals",DISANO ROLED OATS,4,395,197.5,197.5,1
17-02-2025,"Grains, Flours & Dals",HS RAGI Idly rava 500 gms,4,70,70,0,1
17-02-2025,"Dry Fruits, Nuts & Seeds",ALMONDS 250GM,2,280,260,20,1
17-02-2025,"Grains, Flours & Dals",JOWAR WHITE 1 KG,4,80,70,10,1
17-02-2025,"Grains, Flours & Dals",SPLIT BLACK GRAM 500 GM,4,90,85,5,1
17-02-2025,"Dry Fruits, Nuts & Seeds",BLACK KISMIS 250GM,2,175,140,35,1
17-02-2025,"Grains, Flours & Dals",BAJRA 1 KG,4,60,50,10,1
17-02-2025,"Dry Fruits, Nuts & Seeds",Groundnuts 1 kg,2,190,170,20,1
17-02-2025,"Grains, Flours & Dals",RAGULU 1 KG,4,35,30,5,0.5
17-02-2025,"Grains, Flours & Dals",Sathya Javva Wheat Rava 500GM,4,95,95,0,1
17-02-2025,Oils & Ghee,Safflower oil 1 L,9,440,400,40,1
17-02-2025,Oils & Ghee,Sesame oil 1 L,9,1180,"1,120.00",60,2
17-02-2025,"Grains, Flours & Dals",Wheat Flour 1 kg,4,140,120,20,2
17-02-2025,Oils & Ghee,Groundnut oil 1 L,9,360,330,30,1
17-02-2025,"Grains, Flours & Dals",Bombay Rava 500GM,4,35,30,5,1
17-02-2025,Spices & Seasonings,GS GARLIC KARAM 100GM,15,75,75,0,1
17-02-2025,"Health, Wellness & Ayurvedic Products",MD Neem Leaf Choornam 100GM,5,110,110,0,1
17-02-2025,Beverages,RED LABEL 100GM,1,10,10,0,1
17-02-2025,"Grains, Flours & Dals",Wheat Flour 1 kg,4,140,120,20,2
17-02-2025,"Grains, Flours & Dals",URAD DALL,4,95,85,10,1
17-02-2025,Oils & Ghee,Sesame oil 500ml,9,295,280,15,1
17-02-2025,Household & Cleaning,VIM SOAP,6,15,15,0,3
17-02-2025,"Grains, Flours & Dals",CORN FOUR 250GM,4,40,35,5,1
17-02-2025,"Grains, Flours & Dals",Chana Flour 500 gms,4,70,65,5,1
17-02-2025,Oils & Ghee,Safflower oil 500 ml,9,220,200,20,1
17-02-2025,Snacks & Ready-to-Eat,VD SAGOPAPAD 150GM,14,55,55,0,1
17-02-2025,Beverages,BRU GREEN LABEL 1.2G,1,48,48,0,24
17-02-2025,Snacks & Ready-to-Eat,VD RICE PAPAD 150GM,14,50,50,0,1
17-02-2025,Spices & Seasonings,SWEET SOUNF,15,20,20,0,1
17-02-2025,"Grains, Flours & Dals",BAJRA 1 KG,4,30,25,5,0.5
17-02-2025,"Grains, Flours & Dals",Urad dall 1 Kg,4,185,170,15,1
17-02-2025,"Grains, Flours & Dals",JOWAR WHITE 1 KG,4,160,140,20,2
17-02-2025,Oils & Ghee,Groundnut oil 1 L,9,360,330,30,1
17-02-2025,"Grains, Flours & Dals",Idly Rava L 1KG,4,60,50,10,1
17-02-2025,Sweeteners,MISHRI 250 GM,16,35,30,5,1
17-02-2025,Sweeteners,NATURAL HONEY 250GM,16,150,130,20,1
17-02-2025,Snacks & Ready-to-Eat,Corn Chips 250GM,14,40,35,5,1
17-02-2025,"Grains, Flours & Dals",Wheat Flour 1 kg,4,70,60,10,1
17-02-2025,Snacks & Ready-to-Eat,SD Moringa with plam jaggery 250gm,14,135,135,0,1
17-02-2025,Oils & Ghee,Safflower oil 1 L,9,880,800,80,2
17-02-2025,"Grains, Flours & Dals",VGR RICE bag 1,4,1899,"1,650.00",249,1
17-02-2025,Spices & Seasonings,Turmeric powder 250 gms,15,100,75,25,1
17-02-2025,"Grains, Flours & Dals",VGR RICE bag 1,4,1899,"1,650.00",249,1
17-02-2025,"Grains, Flours & Dals",VGR RICE bag 1,4,3798,"3,300.00",498,2
17-02-2025,Snacks & Ready-to-Eat,SD FINGER Millet with palm Jaggery 250gm,14,135,135,0,1
17-02-2025,Milk & Dairy,BROWN EGGS TRAY 30P,7,360,330,30,1
17-02-2025,"Grains, Flours & Dals",RAGI FLOUR 500GRMS,4,40,35,5,1
17-02-2025,Snacks & Ready-to-Eat,VD PALLI LADDU,14,80,80,0,1
17-02-2025,"Dry Fruits, Nuts & Seeds",Groundnuts 1 kg,2,190,170,20,1
17-02-2025,Sweeteners,YB Brown Sugar 500GM,16,75,75,0,1
17-02-2025,Household & Cleaning,VIM SOAP,6,5,5,0,1
17-02-2025,Beverages,BRU GREEN LABEL 1.2G,1,24,24,0,12
17-02-2025,Milk & Dairy,SANGAM TONED MILK 500ML,7,30,30,0,1
17-02-2025,Spices & Seasonings,DRY MIECHI 200GM,15,80,60,20,1
17-02-2025,Snacks & Ready-to-Eat,RSC ORANGE 100GMS,14,40,40,0,2
17-02-2025,"Grains, Flours & Dals",RED TURDAL 500GM,4,75,70,5,1
17-02-2025,"Grains, Flours & Dals",Green gram 1 kg,4,150,130,20,1
17-02-2025,"Dry Fruits, Nuts & Seeds",PULMAKHANA 100 GM,2,180,170,10,1
17-02-2025,Snacks & Ready-to-Eat,VD Pappu Chekkalu 190gm,14,60,60,0,1
17-02-2025,"Grains, Flours & Dals",White Chana 500GM,4,120,100,20,1
17-02-2025,"Grains, Flours & Dals",UDALU (Barnyard millet) 1 kg,4,140,115,25,1
17-02-2025,Spices & Seasonings,FLAXSEED KARAM,15,75,75,0,1
17-02-2025,Spices & Seasonings,NUVVULU 500GM,15,200,170,30,1
17-02-2025,"Dry Fruits, Nuts & Seeds",ALMONDS 250GM,2,280,260,20,1
17-02-2025,"Grains, Flours & Dals",SAMALU (Little millet) 1 kg,4,170,130,40,1
17-02-2025,Sweeteners,GS Organic Jaggery Powder 600GM,16,99,99,0,1
17-02-2025,Snacks & Ready-to-Eat,PUMPKIN CHIKKI 200GM,14,140,120,20,1
17-02-2025,Spices & Seasonings,Masala Karam 500 gms,15,260,240,20,1
17-02-2025,"Grains, Flours & Dals",Red Bobarlu 500 gms,4,95,85,10,1
17-02-2025,"Grains, Flours & Dals",white Bobarlu 1 KG,4,170,150,20,1
17-02-2025,Snacks & Ready-to-Eat,VD MURUKU 175GM,14,60,60,0,1
17-02-2025,Oils & Ghee,Coconut oil 1 L,9,440,400,40,1
17-02-2025,Pooja & Spiritual Items,GD KUMKUM 50GM,12,30,30,0,1
17-02-2025,Oils & Ghee,Sesame oil 500ml,9,295,280,15,1
17-02-2025,Oils & Ghee,Groundnut oil 500ml,9,180,165,15,1
17-02-2025,"Grains, Flours & Dals",Multigrain 1 kg,4,100,85,15,1
17-02-2025,"Grains, Flours & Dals",Sathya Javva Wheat Rava 500GM,4,95,95,0,1
17-02-2025,"Health, Wellness & Ayurvedic Products",JAMBU SEED CHOORNAM 100GM,5,80,80,0,1
17-02-2025,Snacks & Ready-to-Eat,SD Aswagandha with palm Jaggery250Gm,14,135,135,0,1
17-02-2025,"Dry Fruits, Nuts & Seeds",Groundnuts 1 kg,2,190,170,20,1
17-02-2025,Snacks & Ready-to-Eat,GB SALT COOKIES,14,60,55,5,1
17-02-2025,"Grains, Flours & Dals",Idly Rava L 1KG,4,60,50,10,1
17-02-2025,"Grains, Flours & Dals",SL Idly Rava 1KG,4,65,55,10,1
17-02-2025,Milk & Dairy,BROWN EGGS 1P,7,56,48,8,4
17-02-2025,"Grains, Flours & Dals",Wheat Flour 1 kg,4,70,60,10,1
17-02-2025,"Grains, Flours & Dals",Multigrain 1 kg,4,100,85,15,1
17-02-2025,"Grains, Flours & Dals",Wheat Flour 2 kgs,4,140,120,20,1
17-02-2025,Sweeteners,SUGAR 1KG,16,60,50,10,1
17-02-2025,"Grains, Flours & Dals",VGR RICE bag 1,4,1899,"1,650.00",249,1
17-02-2025,Snacks & Ready-to-Eat,PEANUT CHIKKI,14,44,44,0,2
17-02-2025,"Dry Fruits, Nuts & Seeds",ALMONDS 250GM,2,280,260,20,1
17-02-2025,"Health, Wellness & Ayurvedic Products",RB Max Protein Salt & Caramel Bar 50g,5,75,75,0,1
17-02-2025,"Health, Wellness & Ayurvedic Products",MXP CHOCO CLASSIC BAR,5,80,80,0,1
17-02-2025,Spices & Seasonings,SD Curry Leaves Karam Powder 100GM,15,65,65,0,1
17-02-2025,"Health, Wellness & Ayurvedic Products",MAX PROTEIN PEANUT,5,175,175,0,1
17-02-2025,"Health, Wellness & Ayurvedic Products",RB Max Protein Spanish Tomato,5,90,90,0,2
17-02-2025,"Grains, Flours & Dals",RAJMA 250GM,4,55,45,10,1
17-02-2025,Snacks & Ready-to-Eat,SD Atreyapuram DRY Fruit ghee,14,150,150,0,1
17-02-2025,"Dry Fruits, Nuts & Seeds",PUMPKIN SEEDS 250GM,2,200,160,40,1
17-02-2025,Snacks & Ready-to-Eat,BATANA NGT 70GMS,14,20,20,0,1
17-02-2025,"Dry Fruits, Nuts & Seeds",WATERMELON SEEDS 250GRM,2,320,280,40,1
17-02-2025,Snacks & Ready-to-Eat,NGT CHATPATTA CHANA 90GM,14,25,25,0,1
17-02-2025,"Grains, Flours & Dals",Green gram 500 gms,4,75,70,5,1
17-02-2025,"Grains, Flours & Dals",RAGI FLOUR 500GRMS,4,40,35,5,1
17-02-2025,"Health, Wellness & Ayurvedic Products",RB Max Protein Choco Almond bar 50g,5,150,150,0,2
17-02-2025,"Health, Wellness & Ayurvedic Products",MAX PROTEIN ALMOND BAR,5,80,80,0,1
17-02-2025,"Health, Wellness & Ayurvedic Products",RB Max Protein Choco Berry bar 50g,5,225,225,0,3
17-02-2025,Snacks & Ready-to-Eat,RSC ORANGE 100GMS,14,20,20,0,1
17-02-2025,"Dry Fruits, Nuts & Seeds",CASHEW 250GM,2,340,310,30,1
17-02-2025,Sweeteners,SUGAR 1KG,16,60,50,10,1
17-02-2025,Snacks & Ready-to-Eat,VD PALLI LADDU,14,80,80,0,1
17-02-2025,Spices & Seasonings,ROYAL SAFFRON 400GRMS,15,65,65,0,1
17-02-2025,Snacks & Ready-to-Eat,MILK BREAD,14,55,55,0,1
17-02-2025,Snacks & Ready-to-Eat,VD Pappu Chekkalu 190gm,14,60,60,0,1
17-02-2025,Spices & Seasonings,MD Sonti Powder 50GM,15,100,100,0,1
17-02-2025,Personal Care & Cosmetics,UVIS HENNA 100GM,10,35,35,0,1
17-02-2025,Pooja & Spiritual Items,GOMATHA AGARBATHI,12,75,75,0,1
17-02-2025,Sweeteners,YB JAGGERY POWDER 500GMS,16,150,150,0,2
17-02-2025,Spices & Seasonings,Biryani Leaf 25GM,15,20,20,0,1
17-02-2025,Snacks & Ready-to-Eat,GB SALT COOKIES,14,60,55,5,1
17-02-2025,"Grains, Flours & Dals",split urad dall 500 gms,4,90,80,10,1
17-02-2025,"Dry Fruits, Nuts & Seeds",Groundnuts 500 gms,2,95,85,10,1
17-02-2025,Spices & Seasonings,Menthulu 250 gms,15,50,45,5,1
17-02-2025,Spices & Seasonings,Coriander seeds 200 gms,15,48,40,8,1
17-02-2025,Snacks & Ready-to-Eat,PEANUT CHILLI,14,25,25,0,5
17-02-2025,Snacks & Ready-to-Eat,VD PALLI LADDU,14,80,80,0,1
17-02-2025,"Grains, Flours & Dals",SINGLE POLISH 1KG,4,260,260,0,4
17-02-2025,Oils & Ghee,Groundnut oil 1 L,9,360,330,30,1
17-02-2025,Household & Cleaning,LIZOL JAQSMINE 500ML,6,116,116,0,1
17-02-2025,Spices & Seasonings,NUVVULU 250GM,15,80,65,15,1
17-02-2025,"Grains, Flours & Dals",RAGI FLOUR 500GRMS,4,40,35,5,1
17-02-2025,Oils & Ghee,Sesame oil 500ml,9,295,280,15,1
17-02-2025,"Dry Fruits, Nuts & Seeds",YELLOW KISHMISH 250GM,2,130,110,20,1
17-02-2025,Household & Cleaning,VIM SOAP,6,20,20,0,4
17-02-2025,"Grains, Flours & Dals",white Bobarlu 500 gms,4,80,75,5,1
17-02-2025,"Health, Wellness & Ayurvedic Products",BRAHMI CHOORNAM 100GM,5,100,100,0,1
17-02-2025,Pooja & Spiritual Items,GD Dhoop Sticks 26GM,12,20,20,0,1
17-02-2025,Snacks & Ready-to-Eat,BD KODO MILLET NOODLES 200GM,14,75,75,0,1
17-02-2025,Oils & Ghee,Black Sesame oil 1 L,9,440,380,60,1
17-02-2025,Snacks & Ready-to-Eat,VD RED CHILLI RICEPAPAD 150GM,14,50,50,0,1
17-02-2025,Spices & Seasonings,Jeera 100GM,15,50,45,5,1
17-02-2025,"Grains, Flours & Dals",Wheat Flour 1 kg,4,70,60,10,1
17-02-2025,Oils & Ghee,Coconut oil 500 ml,9,220,200,20,1
17-02-2025,Oils & Ghee,cow ghee 500 ml,9,430,390,40,1
17-02-2025,"Grains, Flours & Dals",HS jowar idly rava 500 gms,4,65,65,0,1
17-02-2025,"Grains, Flours & Dals",RED TURDAL 500GM,4,75,70,5,1
17-02-2025,Spices & Seasonings,Turmeric powder 250 gms,15,100,75,25,1
17-02-2025,Spices & Seasonings,Chilli powder 1 kg,15,580,420,160,1
17-02-2025,"Health, Wellness & Ayurvedic Products",RB Peanut butter Peanuts Dark 40g,5,90,90,0,2
17-02-2025,"Health, Wellness & Ayurvedic Products",RB FRUITS &amp;seeds Cranberries,5,45,45,0,1
17-02-2025,"Health, Wellness & Ayurvedic Products",MXP CHOCO CLASSIC BAR,5,140,140,0,2
17-02-2025,Oils & Ghee,Groundnut oil 500ml,9,180,165,15,1
17-02-2025,"Dry Fruits, Nuts & Seeds",Groundnuts 500 gms,2,95,85,10,1
17-02-2025,"Grains, Flours & Dals",Urad dall 500 gms,4,95,85,10,1
17-02-2025,Milk & Dairy,SANGAM TONED MILK 500ML,7,30,30,0,1
17-02-2025,Snacks & Ready-to-Eat,GROUNDNUT LADDU WITH DATES,14,135,135,0,1
17-02-2025,"Grains, Flours & Dals",THIN POHA 500GM,4,40,35,5,1
17-02-2025,"Grains, Flours & Dals",MELMEKER 250GMS,4,60,45,15,1
17-02-2025,Snacks & Ready-to-Eat,SD FINGER Millet with palm Jaggery 250gm,14,135,135,0,1
17-02-2025,"Dry Fruits, Nuts & Seeds",DRYDATES YELLOW 250GM,2,135,120,15,1
17-02-2025,Snacks & Ready-to-Eat,VD MANGO JELLY 250GRMS,14,80,80,0,1
17-02-2025,Snacks & Ready-to-Eat,Sprouted Ragi Biscuits 450GM,14,150,150,0,1
17-02-2025,Snacks & Ready-to-Eat,TILLI CHIKKI,14,125,125,0,1
17-02-2025,Snacks & Ready-to-Eat,PEANUT CHIKKI 450GM,14,125,125,0,1
17-02-2025,Snacks & Ready-to-Eat,Popcorn Seeds 500GM,14,90,80,10,1
17-02-2025,Snacks & Ready-to-Eat,VD MULTI CHAKKA,14,110,110,0,1
17-02-2025,"Grains, Flours & Dals",Em little upma R 500g,4,129,129,0,1
17-02-2025,Snacks & Ready-to-Eat,VD PALLI CHIKKI,14,80,80,0,1
17-02-2025,"Grains, Flours & Dals",JOWAR UPMA RAVA,4,65,65,0,1
17-02-2025,"Grains, Flours & Dals",RAGI FLOUR 500GRMS,4,40,35,5,1
17-02-2025,Personal Care & Cosmetics,SVE KHADI ALOEVERA GEL 100GM,10,140,140,0,1
17-02-2025,Spices & Seasonings,Dalchin Chekka 50GM,15,50,40,10,1
17-02-2025,"Dry Fruits, Nuts & Seeds",PUMPKIN SEEDS 250GM,2,200,160,40,1
17-02-2025,Oils & Ghee,OLIVANA 100ML,9,179,169,10,1
17-02-2025,Spices & Seasonings,MD Sonti Powder 50GM,15,80,80,0,1
17-02-2025,"Dry Fruits, Nuts & Seeds",FLAX SEEDS 250GM,2,120,100,20,2
17-02-2025,Oils & Ghee,DWI VATADATEL 100ML,9,310,310,0,1
17-02-2025,Spices & Seasonings,Vamu 100GM,15,60,50,10,1
17-02-2025,Spices & Seasonings,Jeera 100GM,15,50,45,5,1
17-02-2025,Spices & Seasonings,KALONJI SEEDS,15,90,80,10,1
17-02-2025,Spices & Seasonings,NUVVULU 250GM,15,80,65,15,1
17-02-2025,Oils & Ghee,Black Sesame oil 500 ml,9,220,190,30,1
17-02-2025,Pooja & Spiritual Items,GD KUMKUM 50GM,12,30,30,0,1
17-02-2025,Sweeteners,SUGAR 1KG,16,60,50,10,1
17-02-2025,"Grains, Flours & Dals",turdal 1kg,4,220,195,25,1
17-02-2025,"Grains, Flours & Dals",Chana Flour 1 kg,4,140,130,10,1
17-02-2025,"Grains, Flours & Dals",RICE FLOUR 1KG,4,70,55,15,1
17-02-2025,Oils & Ghee,Groundnut oil 5 L,9,1800,"1,600.00",200,1
17-02-2025,Snacks & Ready-to-Eat,NGT CHATPATTA CHANA 90GM,14,25,25,0,1
17-02-2025,Oils & Ghee,Sesame oil 1 L,9,1180,"1,120.00",60,2
17-02-2025,"Health, Wellness & Ayurvedic Products",MADDI NEEM OIL 100ML,5,70,70,0,1
17-02-2025,Spices & Seasonings,GREEN SOUNF,15,60,40,20,1
17-02-2025,"Grains, Flours & Dals",Wheat Flour 2 kgs,4,140,120,20,1
17-02-2025,Snacks & Ready-to-Eat,RINGS 200GM,14,30,30,0,1
17-02-2025,"Dry Fruits, Nuts & Seeds",SD Mango cubes 100gm,2,45,45,0,1
17-02-2025,Snacks & Ready-to-Eat,PEANUT CHILLI,14,65,65,0,13
17-02-2025,"Grains, Flours & Dals",Bajra Flour 1 kg,4,70,60,10,1
17-02-2025,"Grains, Flours & Dals",Wheat Flour 1 kg,4,140,120,20,2
17-02-2025,"Grains, Flours & Dals",THICK POHA 1KG,4,80,70,10,1
17-02-2025,"Grains, Flours & Dals",Wheat Flour 1 kg,4,140,120,20,2
17-02-2025,"Grains, Flours & Dals",Multigrain 1 kg,4,200,170,30,2
17-02-2025,Oils & Ghee,Groundnut oil 1 L,9,720,660,60,2
17-02-2025,"Grains, Flours & Dals",turdal 1kg,4,440,390,50,2
17-02-2025,"Grains, Flours & Dals",CHANA DAL 1KG,4,140,120,20,1
17-02-2025,"Grains, Flours & Dals",SPLIT BLACK GRAM 500 GM,4,90,85,5,1
17-02-2025,Snacks & Ready-to-Eat,RINGS 200GM,14,30,30,0,1
17-02-2025,"Grains, Flours & Dals",SRILATHA RICE RAVVA 500GM,4,70,70,0,2
17-02-2025,Spices & Seasonings,Chilli powder 1 kg,15,580,420,160,1
17-02-2025,"Grains, Flours & Dals",Wheat Rava S 1KG,4,130,110,20,2
17-02-2025,General Household & Kitchenware,MATCH BOX,3,20,20,0,1
17-02-2025,Household & Cleaning,PITAMBARI,6,28,28,0,1
17-02-2025,Spices & Seasonings,Coriander seeds 200 gms,15,48,40,8,1
17-02-2025,"Dry Fruits, Nuts & Seeds",PULMAKHANA 100 GM,2,180,170,10,1
17-02-2025,"Dry Fruits, Nuts & Seeds",WALLNUTS 250GM,2,380,360,20,1
17-02-2025,Oils & Ghee,GANTASALA A2 COW GHEE 500ML,9,550,550,0,1
17-02-2025,Milk & Dairy,BROWN EGGS TRAY 30P,7,360,330,30,1
17-02-2025,Snacks & Ready-to-Eat,SD Sesame laddu with dates250gm,14,135,135,0,1
17-02-2025,Sweeteners,GS A2 Buffalo Ghee 500ML,16,550,550,0,1
17-02-2025,Oils & Ghee,Sesame oil 1 L,9,590,560,30,1
17-02-2025,Oils & Ghee,Sesame oil 1 L,9,590,560,30,1
17-02-2025,Spices & Seasonings,Tamarind 250GMS,15,80,65,15,1
17-02-2025,"Grains, Flours & Dals",THICK POHA 500GM,4,40,35,5,1
17-02-2025,Oils & Ghee,Coconut oil 500 ml,9,220,200,20,1
17-02-2025,"Grains, Flours & Dals",BOMBAY RAVA,4,70,55,15,1
17-02-2025,Oils & Ghee,Groundnut oil 1 L,9,720,660,60,2
17-02-2025,"Grains, Flours & Dals",SINGLE POLISH 1KG,4,650,650,0,10
17-02-2025,"Grains, Flours & Dals",Idly Rava L 1KG,4,120,100,20,2
17-02-2025,Spices & Seasonings,Menthulu 250 gms,15,50,45,5,1
17-02-2025,"Dry Fruits, Nuts & Seeds",Groundnuts 500 gms,2,95,85,10,1
17-02-2025,Snacks & Ready-to-Eat,PN ORGANIC PUFFED RICE 200GM,14,55,55,0,1
17-02-2025,Sweeteners,SUGAR 500 GM,16,30,25,5,1
17-02-2025,Spices & Seasonings,DRY MIECHI 200GM,15,80,60,20,1
17-02-2025,"Grains, Flours & Dals",THICK POHA 500GM,4,40,35,5,1
17-02-2025,"Grains, Flours & Dals",CHANA DAL 1KG,4,35,30,5,0.25
17-02-2025,Snacks & Ready-to-Eat,BATANA NGT 70GMS,14,20,20,0,1
17-02-2025,Oils & Ghee,Freedom Rice Bran Oil 1L,9,388,360,28,2
17-02-2025,Snacks & Ready-to-Eat,TILLI CHIKKI,14,45,45,0,9
17-02-2025,Spices & Seasonings,AVALU 100GM,15,25,20,5,1
17-02-2025,Snacks & Ready-to-Eat,VD SANNAPUSA 175GM,14,60,60,0,1
17-02-2025,Sweeteners,SUGAR 1KG,16,60,50,10,1
17-02-2025,Snacks & Ready-to-Eat,VD BOONDI 175GM,14,60,60,0,1
17-02-2025,Spices & Seasonings,Jeera 100GM,15,50,45,5,1
17-02-2025,"Grains, Flours & Dals",Wheat Flour 1 kg,4,70,60,10,1
17-02-2025,"Grains, Flours & Dals",RICE FLOUR 1KG,4,140,110,30,2
17-02-2025,"Grains, Flours & Dals",split green gram 500 gms,4,75,70,5,1
17-02-2025,Spices & Seasonings,GS Pink Rock Salt 1KG,15,120,120,0,1
17-02-2025,"Grains, Flours & Dals",HS Multimillet idly R 500 gms,4,130,130,0,2
17-02-2025,Pickles & Cooking Pastes,SD MANGO PICKLE,11,110,110,0,1
17-02-2025,Pickles & Cooking Pastes,CHICKEN PICKLE 200GM,11,300,280,20,1
17-02-2025,Spices & Seasonings,Chilli powder 1 kg,15,580,420,160,1
17-02-2025,Spices & Seasonings,AV Iodized Salt 1KG,15,28,25,3,1
16-02-2025,"Grains, Flours & Dals",RAGI FLOUR 1KG,4,80,70,10,1
16-02-2025,Snacks & Ready-to-Eat,SALTED PHALLI,14,65,65,0,1
16-02-2025,"Grains, Flours & Dals",Chana Flour 500 gms,4,70,65,5,1
16-02-2025,Snacks & Ready-to-Eat,RAJGIRA PEANUT CHIKKI,14,20,20,0,4
16-02-2025,"Grains, Flours & Dals",Wheat Rava M 500GM,4,33,30,3,1
16-02-2025,"Dry Fruits, Nuts & Seeds",CASHEW 500GRMS,2,680,590,90,1
16-02-2025,"Dry Fruits, Nuts & Seeds",Groundnuts 1 kg,2,190,170,20,1
16-02-2025,Oils & Ghee,Groundnut oil 1 L,9,360,330,30,1
16-02-2025,Snacks & Ready-to-Eat,urban murmura,14,70,70,0,1
16-02-2025,Oils & Ghee,Groundnut oil 1 L,9,360,330,30,1
16-02-2025,Milk & Dairy,HERITAGE TOTAL CURD 500GM,7,50,50,0,1
16-02-2025,Snacks & Ready-to-Eat,urban murmura,14,50,45,5,1
16-02-2025,Oils & Ghee,Sesame oil 1 L,9,590,560,30,1
16-02-2025,"Grains, Flours & Dals",Wheat Flour 1 kg,4,70,60,10,1
16-02-2025,Oils & Ghee,Safflower oil 500 ml,9,220,200,20,1
16-02-2025,"Grains, Flours & Dals",RICE FLOUR 1KG,4,70,55,15,1
16-02-2025,"Grains, Flours & Dals",RAGI FLOUR 500GRMS,4,40,35,5,1
16-02-2025,"Grains, Flours & Dals",Em jowar idly R 500G,4,75,75,0,1
16-02-2025,"Grains, Flours & Dals",Em Multimillet idli r 500g,4,129,129,0,1
16-02-2025,"Dry Fruits, Nuts & Seeds",WALNUT ROUND 250GM,2,320,280,40,1
16-02-2025,"Grains, Flours & Dals",Hs yellow jowar r 500g,4,99,99,0,1
16-02-2025,Milk & Dairy,BROWN EGGS TRAY 30P,7,360,330,30,1
16-02-2025,Sweeteners,SD PALM JAGGERY 500GM,16,200,200,0,1
16-02-2025,Pooja & Spiritual Items,GB Bharatha Woods 75GM,12,60,60,0,1
16-02-2025,Spices & Seasonings,RED COPRA 250GMS,15,85,74,11,1
16-02-2025,"Grains, Flours & Dals",White jowar.F 1 kg,4,100,80,20,1
16-02-2025,Pooja & Spiritual Items,GD TULASI 75GM,12,60,60,0,1
16-02-2025,Snacks & Ready-to-Eat,VD PALLI LADDU,14,160,160,0,2
16-02-2025,Snacks & Ready-to-Eat,VD PALLI CHIKKI,14,80,80,0,1
16-02-2025,Snacks & Ready-to-Eat,SALTED PHALLI,14,195,195,0,3
16-02-2025,"Grains, Flours & Dals",SA Sprouted Ragi Flour 500GM,4,138,138,0,2
16-02-2025,"Dry Fruits, Nuts & Seeds",YB GRANMA NUTS,2,90,90,0,1
16-02-2025,Oils & Ghee,Groundnut oil 1 L,9,720,660,60,2
16-02-2025,"Grains, Flours & Dals",Red uluvalu 500 gms,4,70,70,0,1
16-02-2025,"Grains, Flours & Dals",WHITE BATANI 500GM,4,80,60,20,1
16-02-2025,"Grains, Flours & Dals",MELMEKER 250GMS,4,60,45,15,1
16-02-2025,"Grains, Flours & Dals",POORI ATTA 1KG,4,70,60,10,1
16-02-2025,Oils & Ghee,Safflower oil 1 L,9,440,400,40,1
16-02-2025,"Grains, Flours & Dals",Red Bobarlu 500 gms,4,95,85,10,1
16-02-2025,Spices & Seasonings,Chilli powder 500 gms,15,290,210,80,1
16-02-2025,"Grains, Flours & Dals",Wheat Flour 1 kg,4,70,60,10,1
16-02-2025,Oils & Ghee,Groundnut oil 1 L,9,360,330,30,1
16-02-2025,Snacks & Ready-to-Eat,SH PUFFED RICE 500GM,14,112,112,0,1
16-02-2025,Snacks & Ready-to-Eat,VD PALLI CHIKKI,14,160,160,0,2
16-02-2025,"Grains, Flours & Dals",MAAGAANI SP RICE 5KGS,4,1298,"1,120.00",178,2
16-02-2025,"Dry Fruits, Nuts & Seeds",WALLNUTS 250GM,2,380,360,20,1
16-02-2025,"Grains, Flours & Dals",Multigrain 1 kg,4,200,170,30,2
16-02-2025,"Dry Fruits, Nuts & Seeds",WATERMELON SEEDS 250GRM,2,320,280,40,1
16-02-2025,"Grains, Flours & Dals",RAGI FLOUR 1KG,4,80,70,10,1
16-02-2025,Spices & Seasonings,Masala Karam 250 gms,15,130,120,10,1
16-02-2025,Oils & Ghee,Sesame oil 1 L,9,590,560,30,1
16-02-2025,"Grains, Flours & Dals",Multigrain 1 kg,4,100,85,15,1
16-02-2025,Oils & Ghee,Mustard oil 500 ml,9,220,195,25,1
16-02-2025,Oils & Ghee,Sesame oil 1 L,9,590,560,30,1
16-02-2025,Snacks & Ready-to-Eat,VD PANIPURI 100GM,14,30,30,0,1
16-02-2025,"Grains, Flours & Dals",WHITE BATANI 500GM,4,80,60,20,1
16-02-2025,Snacks & Ready-to-Eat,NGT CHATPATTA CHANA 90GM,14,25,25,0,1
16-02-2025,Spices & Seasonings,NUVVULU 250GM,15,80,65,15,1
16-02-2025,"Grains, Flours & Dals",RAGULU 1 KG,4,70,60,10,1
16-02-2025,Oils & Ghee,Groundnut oil 1 L,9,360,330,30,1
16-02-2025,Snacks & Ready-to-Eat,SALTED PHALLI,14,25,25,0,1
16-02-2025,"Dry Fruits, Nuts & Seeds",FLAX SEEDS 250GM,2,60,50,10,1
16-02-2025,Snacks & Ready-to-Eat,BATANA NGT 70GMS,14,20,20,0,1
16-02-2025,Snacks & Ready-to-Eat,VD MANGO JELLY 250GRMS,14,80,80,0,1
16-02-2025,"Grains, Flours & Dals",RAGI FLOUR 500GRMS,4,40,35,5,1
16-02-2025,Oils & Ghee,Safflower oil 1 L,9,440,400,40,1
16-02-2025,Milk & Dairy,HRITAGE TOTAL CURD 130GM,7,20,20,0,2
16-02-2025,"Grains, Flours & Dals",DESI CHANA,4,25,25,0,1
16-02-2025,Snacks & Ready-to-Eat,RINGS 200GM,14,30,30,0,1
16-02-2025,Personal Care & Cosmetics,KHADI ALMOND SOAP 125GM,10,80,80,0,1
16-02-2025,Personal Care & Cosmetics,MADDI BATH POWDER 400GM,10,150,150,0,1
16-02-2025,Personal Care & Cosmetics,KHADI LEMONGRASS SOAP 125GM,10,80,80,0,1
16-02-2025,Personal Care & Cosmetics,KHADI MIX FRUIT SOAP 125GM,10,80,80,0,1
16-02-2025,Oils & Ghee,Groundnut oil 1 L,9,720,660,60,2
16-02-2025,"Health, Wellness & Ayurvedic Products",MD Kasturi Pasupu Choornam 50GM,5,80,80,0,1
16-02-2025,Oils & Ghee,Groundnut oil 500ml,9,180,165,15,1
16-02-2025,"Grains, Flours & Dals",White jowar.F 1 kg,4,100,80,20,1
16-02-2025,"Grains, Flours & Dals",Multigrain 1 kg,4,100,85,15,1
16-02-2025,"Grains, Flours & Dals",Wheat Rava S 1KG,4,65,55,10,1
16-02-2025,Snacks & Ready-to-Eat,NGT CHATPATTA CHANA 90GM,14,25,25,0,1
16-02-2025,Household & Cleaning,VIM EXTRA 110GM,6,15,15,0,1
16-02-2025,Snacks & Ready-to-Eat,BATANA NGT 70GMS,14,20,20,0,1
16-02-2025,"Grains, Flours & Dals",RAGI FLOUR 1KG,4,80,70,10,1
16-02-2025,Beverages,BRU GREEN LABEL 1.2G,1,48,48,0,24
16-02-2025,"Grains, Flours & Dals",SA YELLOW JOWAR RAVA 500GM,4,95,95,0,1
16-02-2025,"Grains, Flours & Dals",MELMEKER 250GMS,4,60,45,15,1
16-02-2025,Snacks & Ready-to-Eat,Popcorn Seeds 250GM,14,45,40,5,1
16-02-2025,Snacks & Ready-to-Eat,SD Groundnut with palm jaggery 250gm,14,135,135,0,1
16-02-2025,Spices & Seasonings,Jeera 100GM,15,50,45,5,1
16-02-2025,Snacks & Ready-to-Eat,VD MANGO JELLY 250GRMS,14,80,80,0,1
16-02-2025,Snacks & Ready-to-Eat,SD Thati thandra 200gm,14,150,150,0,1
16-02-2025,"Grains, Flours & Dals",MELMEKER 250GMS,4,60,45,15,1
16-02-2025,"Grains, Flours & Dals",Wheat Flour 1 kg,4,140,120,20,2
16-02-2025,"Grains, Flours & Dals",Em kodo idli R 500G,4,129,129,0,1
16-02-2025,"Grains, Flours & Dals",Sathya Javva Wheat Rava 500GM,4,95,95,0,1
16-02-2025,"Grains, Flours & Dals",RAGI FLOUR 1KG,4,80,70,10,1
16-02-2025,"Grains, Flours & Dals",Hs yellow jowar r 500g,4,99,99,0,1
16-02-2025,"Grains, Flours & Dals",Em Little idli R 500g,4,129,129,0,1
16-02-2025,"Grains, Flours & Dals",EM Foxtail idli r 500 g,4,109,109,0,1
16-02-2025,"Grains, Flours & Dals",Em Multimillet idli r 500g,4,129,129,0,1
16-02-2025,Sweeteners,MISHRI 250 GM,16,35,30,5,1
16-02-2025,Pooja & Spiritual Items,SWASTIK CAMPHORE,12,90,90,0,1
16-02-2025,Snacks & Ready-to-Eat,VD SAGOPAPAD 150GM,14,55,55,0,1
16-02-2025,Snacks & Ready-to-Eat,NGT CHATPATTA CHANA 90GM,14,25,25,0,1
16-02-2025,Pooja & Spiritual Items,GD Aiswarya Deepam 700ML,12,195,195,0,1
16-02-2025,Sweeteners,MISHRI D,16,40,30,10,1
16-02-2025,"Dry Fruits, Nuts & Seeds",FLAX SEEDS 250GM,2,60,50,10,1
16-02-2025,"Grains, Flours & Dals",Bombay Rava 500GM,4,35,30,5,1
16-02-2025,Spices & Seasonings,NUVVULU 250GM,15,100,85,15,1
16-02-2025,"Grains, Flours & Dals",Green gram 500 gms,4,75,70,5,1
16-02-2025,Milk & Dairy,BROWN EGGS 1P,7,112,96,16,8
16-02-2025,"Grains, Flours & Dals",SRILATHA RICE RAVVA 500GM,4,35,35,0,1
16-02-2025,Oils & Ghee,Sesame oil 500ml,9,295,280,15,1
16-02-2025,"Dry Fruits, Nuts & Seeds",SD Mango cubes 100gm,2,45,45,0,1
16-02-2025,Snacks & Ready-to-Eat,SD Thati thandra 200gm,14,150,150,0,1
16-02-2025,"Grains, Flours & Dals",SAMALU (Little millet) 1 kg,4,170,130,40,1
16-02-2025,"Grains, Flours & Dals",UDALU (Barnyard millet) 1 kg,4,140,115,25,1
16-02-2025,Sweeteners,MISHRI D,16,40,30,10,1
16-02-2025,"Grains, Flours & Dals",KORRALU (FOXTAIL M) 1KG,4,150,110,40,1
16-02-2025,"Grains, Flours & Dals",Arikadu ( kodo),4,140,130,10,1
16-02-2025,Oils & Ghee,Safflower oil 1 L,9,440,400,40,1
16-02-2025,"Grains, Flours & Dals",RAGI FLOUR 500GRMS,4,40,35,5,1
16-02-2025,Personal Care & Cosmetics,GAYATHRI KUMKUDUKAYA,10,150,150,0,1
16-02-2025,Oils & Ghee,Sesame oil 1 L,9,590,560,30,1
16-02-2025,"Grains, Flours & Dals",Quinova 500 gms,4,110,100,10,1
16-02-2025,"Dry Fruits, Nuts & Seeds",PULMAKHANA 100 GM,2,180,170,10,1
16-02-2025,Spices & Seasonings,DRY MIECHI 200GM,15,80,60,20,1
16-02-2025,Snacks & Ready-to-Eat,urban murmura,14,45,45,0,1
16-02-2025,"Grains, Flours & Dals",SRILATHA RICE RAVVA 500GM,4,35,35,0,1
16-02-2025,Spices & Seasonings,Tamarind 250GMS,15,80,65,15,1
16-02-2025,Snacks & Ready-to-Eat,NGT CHATPATTA CHANA 90GM,14,50,50,0,2
16-02-2025,Snacks & Ready-to-Eat,VD Pappu Chekkalu 190gm,14,60,60,0,1
16-02-2025,Sweeteners,Mishri 500GM,16,70,60,10,1
16-02-2025,"Grains, Flours & Dals",FLOUR CHARGE,4,21.6,21.6,0,1.8
16-02-2025,Pooja & Spiritual Items,GD Sambrani Cup Dhoop 10 PC,12,96,96,0,1
16-02-2025,Oils & Ghee,Coconut oil 1 L,9,440,400,40,1
16-02-2025,"Grains, Flours & Dals",FLOUR CHARGE,4,38.4,38.4,0,3.2
16-02-2025,"Grains, Flours & Dals",Green gram 1 kg,4,150,130,20,1
16-02-2025,"Grains, Flours & Dals",SOYA BEANS 1KG,4,50,45,5,0.25
16-02-2025,Pooja & Spiritual Items,BALAJI GArden dhop sticks,12,0,0,0,1
16-02-2025,Snacks & Ready-to-Eat,ANNAPURNA APPALAM,14,35,35,0,1
16-02-2025,Pooja & Spiritual Items,JAVADHU POWDER 2G,12,34,34,0,1
16-02-2025,Snacks & Ready-to-Eat,RINGS 200GM,14,30,30,0,1
16-02-2025,Pooja & Spiritual Items,GD Dhoop Sticks 26GM,12,80,80,0,4
16-02-2025,Pooja & Spiritual Items,BALAJI SANDAL DHOOP STICKS 10STK,12,125,125,0,1
16-02-2025,Snacks & Ready-to-Eat,VD NUVULU PAPAD 200GM,14,100,100,0,1
16-02-2025,"Dry Fruits, Nuts & Seeds",PUTNALU 500GMS,2,90,76,14,1
16-02-2025,"Grains, Flours & Dals",Chittimuthaylu rice 1 kg,4,320,280,40,2
16-02-2025,Oils & Ghee,Safflower oil 1 L,9,1320,"1,200.00",120,3
16-02-2025,"Grains, Flours & Dals",BOMBAY RAVA,4,70,55,15,1
16-02-2025,"Grains, Flours & Dals",Wheat Flour 1 kg,4,140,120,20,2
16-02-2025,"Grains, Flours & Dals",Em kodo idli R 500G,4,129,129,0,1
16-02-2025,Beverages,REFRESH SHARBATH SUGAR FREE,1,299,285,14,1
16-02-2025,"Health, Wellness & Ayurvedic Products",RB Max Protein Fruit &amp;Nut 50g,5,225,225,0,3
16-02-2025,Oils & Ghee,Safflower oil 1 L,9,440,400,40,1
16-02-2025,Spices & Seasonings,Masala Karam 500 gms,15,260,240,20,1
16-02-2025,Snacks & Ready-to-Eat,VD KOBARI LADDU,14,80,80,0,1
16-02-2025,Spices & Seasonings,Chilli powder 500 gms,15,290,210,80,1
16-02-2025,Snacks & Ready-to-Eat,VD BELLAM GAVVALU 200GM,14,120,120,0,2
16-02-2025,"Grains, Flours & Dals",CHANA DAL 500GM,4,140,120,20,2
16-02-2025,Snacks & Ready-to-Eat,VD PALLI CHIKKI,14,80,80,0,1
16-02-2025,Snacks & Ready-to-Eat,VD BOONDI 175GM,14,60,60,0,1
16-02-2025,"Grains, Flours & Dals",Wheat Rava M 1KG,4,65,55,10,1
16-02-2025,"Grains, Flours & Dals",KORRALU (FOXTAIL M) 500GM,4,65,55,10,1
16-02-2025,"Grains, Flours & Dals",Yellow jowar .F1 kg,4,110,100,10,1
16-02-2025,"Health, Wellness & Ayurvedic Products",AMLAKI CHOORNAM,5,100,100,0,1
16-02-2025,Oils & Ghee,Sesame oil 1 L,9,590,560,30,1
16-02-2025,"Health, Wellness & Ayurvedic Products",MD Bringaraj Choornam 100GM,5,80,80,0,1
16-02-2025,Spices & Seasonings,MD Sonti Powder 50GM,15,80,80,0,1
16-02-2025,"Health, Wellness & Ayurvedic Products",MD Neem Leaf Choornam 100GM,5,220,220,0,2
16-02-2025,Pooja & Spiritual Items,SWATHI POOJA VATHULU,12,90,90,0,3
16-02-2025,Pooja & Spiritual Items,GOW DURBAR GEETHA CAMPHOR,12,60,60,0,1
16-02-2025,Pooja & Spiritual Items,GD Bhagavatha Mallika 75GM,12,60,60,0,1
16-02-2025,Pooja & Spiritual Items,BALAJI KASTURI DHOOP STICKS,12,140,140,0,2
16-02-2025,Milk & Dairy,HERITAGE TOTAL CURD 500GM,7,50,50,0,1
16-02-2025,Pooja & Spiritual Items,GD KASTHURI,12,60,60,0,1
16-02-2025,Pooja & Spiritual Items,GD Dhoop Sticks 26GM,12,40,40,0,2
16-02-2025,Pooja & Spiritual Items,GB Bharatha Woods 75GM,12,60,60,0,1
16-02-2025,"Dry Fruits, Nuts & Seeds",CASHEW 250GM,2,340,310,30,1
16-02-2025,Oils & Ghee,Groundnut oil 1 L,9,360,330,30,1
16-02-2025,"Grains, Flours & Dals",Wheat Flour 1 kg,4,140,120,20,2
16-02-2025,Spices & Seasonings,Telaga Pindi 250 GM,15,40,35,5,1
16-02-2025,Oils & Ghee,Safflower oil 1 L,9,440,400,40,1
16-02-2025,Oils & Ghee,Sesame oil 500ml,9,295,280,15,1
16-02-2025,Oils & Ghee,Groundnut oil 1 L,9,360,330,30,1
16-02-2025,Oils & Ghee,Black Sesame oil 500 ml,9,220,190,30,1
16-02-2025,Snacks & Ready-to-Eat,ZEEDI,14,70,70,0,1
16-02-2025,"Dry Fruits, Nuts & Seeds",PUMPKIN SEEDS 250GM,2,200,160,40,1
16-02-2025,General Household & Kitchenware,BLADE,3,12,12,0,1
16-02-2025,"Grains, Flours & Dals",RED TURDAL 500GM,4,75,70,5,1
16-02-2025,"Grains, Flours & Dals",Green Batani 500GM,4,110,90,20,1
16-02-2025,"Grains, Flours & Dals",white Bobarlu 500 gms,4,80,75,5,1
16-02-2025,"Dry Fruits, Nuts & Seeds",KAJU HALF 250GM,2,310,290,20,1
16-02-2025,"Dry Fruits, Nuts & Seeds",PULMAKHANA 100 GM,2,180,170,10,1
16-02-2025,"Grains, Flours & Dals",DH URAD GOTA 1KG,4,215,190,25,1
16-02-2025,"Grains, Flours & Dals",PESARA PAPPU 500GMS,4,85,75,10,1
16-02-2025,"Grains, Flours & Dals",Wheat Rava S 500GM,4,33,30,3,1
16-02-2025,Sweeteners,MISHRI D,16,40,30,10,1
16-02-2025,Spices & Seasonings,DRY MIECHI 200GM,15,80,60,20,1
16-02-2025,Snacks & Ready-to-Eat,DOSA BATTER 1KG,14,60,60,0,1
16-02-2025,Snacks & Ready-to-Eat,Pani Poori Chips 250GM,14,50,40,10,1
16-02-2025,Snacks & Ready-to-Eat,VD MANGO JELLY 250GRMS,14,80,80,0,1
16-02-2025,Oils & Ghee,Sesame oil 1 L,9,590,560,30,1
16-02-2025,"Grains, Flours & Dals",THICK POHA 1KG,4,80,70,10,1
16-02-2025,Spices & Seasonings,LG 50GM,15,92,92,0,1
16-02-2025,"Grains, Flours & Dals",SL Idly Rava 1KG,4,65,55,10,1
16-02-2025,"Health, Wellness & Ayurvedic Products",MD Kasturi Pasupu Choornam 50GM,5,80,80,0,1
16-02-2025,Snacks & Ready-to-Eat,SD Little Millet WITH PLAM JAGGERY,14,135,135,0,1
16-02-2025,"Grains, Flours & Dals",RAGI FLOUR 1KG,4,80,70,10,1
16-02-2025,Snacks & Ready-to-Eat,SD Little Millet WITH PLAM JAGGERY,14,135,135,0,1
16-02-2025,Oils & Ghee,Sesame oil 500ml,9,295,280,15,1
16-02-2025,"Grains, Flours & Dals",RAGI FLOUR 500GRMS,4,40,35,5,1
16-02-2025,"Grains, Flours & Dals",Wheat Flour 1 kg,4,70,60,10,1
16-02-2025,"Grains, Flours & Dals",split urad dall 500 gms,4,90,80,10,1
16-02-2025,Snacks & Ready-to-Eat,VD MINAPA VADIYAM,14,65,65,0,1
16-02-2025,"Grains, Flours & Dals",SL Idly Rava 1KG,4,65,55,10,1
16-02-2025,Snacks & Ready-to-Eat,SD Ginger Candy 100g,14,60,60,0,1
16-02-2025,Oils & Ghee,Groundnut oil 1 L,9,360,330,30,1
16-02-2025,"Dry Fruits, Nuts & Seeds",Groundnuts 500 gms,2,95,85,10,1
16-02-2025,Personal Care & Cosmetics,UVIS LACTO TAN SOAP 100GM,10,99,99,0,1
16-02-2025,Personal Care & Cosmetics,UVIS COW GHEE SOAP 100GM,10,85,85,0,1
16-02-2025,"Dry Fruits, Nuts & Seeds",ALMONDS 250GM,2,280,260,20,1
16-02-2025,"Dry Fruits, Nuts & Seeds",CASHEW 250GM,2,340,310,30,1
16-02-2025,"Dry Fruits, Nuts & Seeds",YELLOW KISHMISH 250GM,2,130,110,20,1
16-02-2025,"Dry Fruits, Nuts & Seeds",YELLOW KISHMISH 250GM,2,130,110,20,1
16-02-2025,"Dry Fruits, Nuts & Seeds",WALLNUTS 250GM,2,380,360,20,1
16-02-2025,"Grains, Flours & Dals",Red Chana 250GM,4,35,30,5,1
16-02-2025,"Dry Fruits, Nuts & Seeds",ALMONDS 250GM,2,280,260,20,1
16-02-2025,"Dry Fruits, Nuts & Seeds",ALMONDS 250GM,2,280,260,20,1
16-02-2025,"Dry Fruits, Nuts & Seeds",CASHEW 250GM,2,340,310,30,1
16-02-2025,"Dry Fruits, Nuts & Seeds",YELLOW KISHMISH 250GM,2,130,110,20,1
16-02-2025,"Grains, Flours & Dals",white Bobarlu 500 gms,4,80,75,5,1
16-02-2025,"Grains, Flours & Dals",RAJMA 250GM,4,55,45,10,1
16-02-2025,Snacks & Ready-to-Eat,BATANA NGT 70GMS,14,20,20,0,1
16-02-2025,Pooja & Spiritual Items,VRP APOORVA JAVADHU POW,12,70,70,0,2
16-02-2025,Spices & Seasonings,LG 50GM,15,92,92,0,1
16-02-2025,Oils & Ghee,cow ghee 500 ml,9,430,390,40,1
16-02-2025,"Grains, Flours & Dals",FLOUR CHARGE,4,36,36,0,3
16-02-2025,Snacks & Ready-to-Eat,KURNOOL MARMURA,14,140,110,30,2
16-02-2025,Snacks & Ready-to-Eat,GB SALT COOKIES,14,120,110,10,2
16-02-2025,Beverages,BRU GREEN LABEL 1.2G,1,48,48,0,24
16-02-2025,Pooja & Spiritual Items,JVK SAMBRANI STICK 20PCS,12,80,80,0,2
16-02-2025,Snacks & Ready-to-Eat,PEANUT CHILLI,14,10,10,0,2
16-02-2025,"Grains, Flours & Dals",Chana Flour 500 gms,4,70,65,5,1
16-02-2025,Snacks & Ready-to-Eat,RSC ORANGE 100GMS,14,40,40,0,2
16-02-2025,Pooja & Spiritual Items,GB Bharatha Woods 75GM,12,60,60,0,1
16-02-2025,Personal Care & Cosmetics,MD Henna Choornam 100GM,10,80,80,0,1
16-02-2025,Spices & Seasonings,ROYAL SAFFRON 400GRMS,15,65,65,0,1
16-02-2025,Spices & Seasonings,Turmeric powder 250 gms,15,100,75,25,1
16-02-2025,Snacks & Ready-to-Eat,VD PALLI LADDU,14,80,80,0,1
16-02-2025,Snacks & Ready-to-Eat,RSC ORANGE 100GMS,14,20,20,0,1
16-02-2025,Snacks & Ready-to-Eat,VD NUVVULU LADDU,14,80,80,0,1
16-02-2025,"Grains, Flours & Dals",RICE FLOUR 1KG,4,70,55,15,1
16-02-2025,"Grains, Flours & Dals",Wheat Flour 1 kg,4,140,120,20,2
16-02-2025,Spices & Seasonings,Telaga Pindi 250 GM,15,40,35,5,1
16-02-2025,Oils & Ghee,Sesame oil 500ml,9,295,280,15,1
16-02-2025,Snacks & Ready-to-Eat,RINGS 200GM,14,30,30,0,1
16-02-2025,Oils & Ghee,Coconut oil 1 L,9,440,400,40,1
16-02-2025,Spices & Seasonings,SH CASSIA STICKS 50GM,15,75,75,0,1
16-02-2025,Spices & Seasonings,Chilli powder 500 gms,15,290,210,80,1
16-02-2025,"Grains, Flours & Dals",turdal 1kg,4,220,195,25,1
16-02-2025,Oils & Ghee,Groundnut oil 1 L,9,720,660,60,2
16-02-2025,Oils & Ghee,Sesame oil 1 L,9,590,560,30,1
16-02-2025,Oils & Ghee,Safflower oil 1 L,9,1320,"1,200.00",120,3
16-02-2025,Snacks & Ready-to-Eat,VD RIBBON PAKODI 175GM,14,60,60,0,1
16-02-2025,Spices & Seasonings,Jeera 100GM,15,50,45,5,1
16-02-2025,"Dry Fruits, Nuts & Seeds",CASHEW 250GM,2,340,310,30,1
16-02-2025,Snacks & Ready-to-Eat,VD MIXTURE 175 GM,14,60,60,0,1
16-02-2025,"Grains, Flours & Dals",Wheat Rava S 500GM,4,33,30,3,1
16-02-2025,Milk & Dairy,SANGAM CURD 450GM,7,38,38,0,1
16-02-2025,Milk & Dairy,SANGAM TONED MILK 500ML,7,30,30,0,1
16-02-2025,Oils & Ghee,Groundnut oil 1 L,9,720,660,60,2
16-02-2025,"Dry Fruits, Nuts & Seeds",FLAX SEEDS 250GM,2,60,50,10,1
16-02-2025,Oils & Ghee,Sesame oil 1 L,9,590,560,30,1
16-02-2025,"Grains, Flours & Dals",RAJMA 500GM,4,90,90,0,1
16-02-2025,"Grains, Flours & Dals",Wheat Flour 1 kg,4,70,60,10,1
16-02-2025,Spices & Seasonings,NUVVULU 250GM,15,80,65,15,1
16-02-2025,Pooja & Spiritual Items,GD TULASI 75GM,12,60,60,0,1
16-02-2025,"Grains, Flours & Dals",split green gram 500 gms,4,75,70,5,1
16-02-2025,Pooja & Spiritual Items,GD Sambrani Cup Dhoop 10 PC,12,96,96,0,1
16-02-2025,Milk & Dairy,HERITAGE TONED MILK 500ML,7,31,31,0,1
16-02-2025,Spices & Seasonings,Lavangam 50GM,15,60,50,10,1
16-02-2025,Pooja & Spiritual Items,GD WOODS 150GM,12,110,110,0,1
16-02-2025,"Grains, Flours & Dals",Wheat Rava M 500GM,4,33,30,3,1
16-02-2025,"Grains, Flours & Dals",Bombay Rava 500GM,4,35,30,5,1
16-02-2025,Oils & Ghee,Coconut oil 500 ml,9,220,200,20,1
16-02-2025,Oils & Ghee,Safflower oil 1 L,9,440,400,40,1
16-02-2025,"Grains, Flours & Dals",HS Ragi upma rava 500 gms,4,70,70,0,1
16-02-2025,Spices & Seasonings,Tamarind 250GMS,15,160,130,30,2
16-02-2025,"Grains, Flours & Dals",JOWAR UPMA RAVA,4,65,65,0,1
16-02-2025,Milk & Dairy,HERITAGE TONED MILK 500ML,7,31,31,0,1
16-02-2025,Oils & Ghee,Safflower oil 1 L,9,440,400,40,1
16-02-2025,"Grains, Flours & Dals",HS jowar idly rava 500 gms,4,65,65,0,1
16-02-2025,Oils & Ghee,Safflower oil 1 L,9,440,400,40,1
16-02-2025,Oils & Ghee,Groundnut oil 1 L,9,360,330,30,1
16-02-2025,"Dry Fruits, Nuts & Seeds",PULMAKHANA 100 GM,2,180,170,10,1
16-02-2025,"Health, Wellness & Ayurvedic Products",RB Max Protein Choco Berry bar 50g,5,75,75,0,1
16-02-2025,"Dry Fruits, Nuts & Seeds",FLAX SEEDS 1KG,2,48,40,8,0.2
16-02-2025,"Grains, Flours & Dals",FLOUR CHARGE,4,64.8,64.8,0,5.4
16-02-2025,"Grains, Flours & Dals",BAJRA 1 KG,4,12,10,2,0.2
16-02-2025,"Grains, Flours & Dals",JOWAR WHITE 1 KG,4,16,14,2,0.2
16-02-2025,"Grains, Flours & Dals",RAGULU 1 KG,4,14,12,2,0.2
16-02-2025,Pickles & Cooking Pastes,SD AMALA PICKLE,11,110,110,0,1
16-02-2025,"Grains, Flours & Dals",SOYA BEANS 1KG,4,40,36,4,0.2
16-02-2025,"Grains, Flours & Dals",WHEAT 1 KG,4,12,10,2,0.2
16-02-2025,"Grains, Flours & Dals",BARLEY SEEDS 1KG,4,32,28,4,0.2
16-02-2025,"Grains, Flours & Dals",RAGI FLOUR 1KG,4,80,70,10,1
16-02-2025,"Grains, Flours & Dals",DISANO OATS 1KG,4,57,57,0,0.2
16-02-2025,"Grains, Flours & Dals",VYS.SP.RICE BAG 1,4,1800,"1,650.00",150,1
16-02-2025,"Grains, Flours & Dals",FLOUR CHARGE,4,12,12,0,1
16-02-2025,"Grains, Flours & Dals",BARLEY SEEDS 1KG,4,160,140,20,1
16-02-2025,"Dry Fruits, Nuts & Seeds",PUMPKIN SEEDS 250GM,2,200,160,40,1
16-02-2025,"Dry Fruits, Nuts & Seeds",WATERMELON SEEDS 250GRM,2,320,280,40,1
16-02-2025,"Dry Fruits, Nuts & Seeds",FLAX SEEDS 250GM,2,60,50,10,1
16-02-2025,"Dry Fruits, Nuts & Seeds",Groundnuts 500 gms,2,95,85,10,1
16-02-2025,"Grains, Flours & Dals",JOWAR WHITE 1 KG,4,240,210,30,3
16-02-2025,"Grains, Flours & Dals",FLOUR CHARGE,4,120,120,0,10
16-02-2025,Spices & Seasonings,KALONJI SEEDS,15,90,80,10,1
16-02-2025,"Grains, Flours & Dals",WHEAT 1 KG,4,180,150,30,3
16-02-2025,"Grains, Flours & Dals",SOYA BEANS 1KG,4,50,45,5,0.25
16-02-2025,"Grains, Flours & Dals",BARLEY SEEDS 1KG,4,160,140,20,1
16-02-2025,"Grains, Flours & Dals",FLOUR CHARGE,4,12,12,0,1
16-02-2025,Snacks & Ready-to-Eat,RAJGIRA PEANUT CHIKKI 450GM,14,125,125,0,1
16-02-2025,"Health, Wellness & Ayurvedic Products",BHRINGARAJA,5,280,280,0,1
16-02-2025,General Household & Kitchenware,SABEENA,3,15,15,0,1
16-02-2025,"Grains, Flours & Dals",Wheat Flour 1 kg,4,140,120,20,2
16-02-2025,"Grains, Flours & Dals",HS jowar idly rava 500 gms,4,130,130,0,2
16-02-2025,"Grains, Flours & Dals",RAGI FLOUR 500GRMS,4,40,35,5,1
16-02-2025,Snacks & Ready-to-Eat,JUNNU POWDER 100GM,14,70,70,0,1
16-02-2025,Pooja & Spiritual Items,GD Aiswarya Deepam 700ML,12,195,195,0,1
16-02-2025,Spices & Seasonings,RED COPRA 500GM,15,170,148,22,1
16-02-2025,Sweeteners,GS JAGGERY NUGGETS 500GM,16,120,120,0,1
16-02-2025,Oils & Ghee,Groundnut oil 1 L,9,360,330,30,1
16-02-2025,"Grains, Flours & Dals",Idly Rava L 1KG,4,60,50,10,1
16-02-2025,"Grains, Flours & Dals",ANDU KORRALU (Browntop.m) 1 kg,4,260,220,40,1
16-02-2025,Spices & Seasonings,Coriander seeds 200 gms,15,48,40,8,1
16-02-2025,"Grains, Flours & Dals",CHANA DAL 500GM,4,70,60,10,1
16-02-2025,"Grains, Flours & Dals",JOWAR YELLOW 1 K,4,100,90,10,1
16-02-2025,Personal Care & Cosmetics,DETTOL 50ML,10,154,154,0,1
16-02-2025,Spices & Seasonings,Black Till 250GM,15,90,75,15,1
16-02-2025,Snacks & Ready-to-Eat,FUN TIME CRUNCH,14,45,45,0,1
16-02-2025,Sweeteners,YB JAGGERY POWDER 1KG,16,140,140,0,1
16-02-2025,Snacks & Ready-to-Eat,BB VERMICELLI 1KG,14,95,90,5,1
16-02-2025,"Grains, Flours & Dals",Urad dall 1 Kg,4,185,170,15,1
16-02-2025,"Health, Wellness & Ayurvedic Products",MH Millets Malt 500GM,5,200,190,10,1
16-02-2025,Spices & Seasonings,GS Pink Rock Salt 1KG,15,120,120,0,1
16-02-2025,Snacks & Ready-to-Eat,BLACK SESAME CHIKKI,14,45,45,0,1
16-02-2025,"Dry Fruits, Nuts & Seeds",SALTED PISTA 250GM,2,400,350,50,1
16-02-2025,Sweeteners,YB JAGGERY POWDER 500GMS,16,75,75,0,1
16-02-2025,"Grains, Flours & Dals",BOMBAY RAVA,4,70,55,15,1
16-02-2025,Oils & Ghee,Sesame oil 1 L,9,590,560,30,1
16-02-2025,Spices & Seasonings,NUVVULU 500GM,15,160,130,30,1
16-02-2025,"Grains, Flours & Dals",THICK POHA 1KG,4,80,70,10,1
16-02-2025,Spices & Seasonings,PURO Healthy Salt Crystal 1KG,15,135,135,0,1
16-02-2025,"Grains, Flours & Dals",RAJMA 500GM,4,180,180,0,2
16-02-2025,"Grains, Flours & Dals",Arikadu ( kodo),4,140,130,10,1
16-02-2025,"Dry Fruits, Nuts & Seeds",SABJA SEEDS 100GM,2,80,70,10,1
16-02-2025,Spices & Seasonings,SREE MARUTHI IDLY KARAM 200GM,15,60,60,0,1
16-02-2025,Beverages,REFRESH SHARBATH SUGAR FREE,1,299,285,14,1
16-02-2025,"Grains, Flours & Dals",DH URAD GOTA 1KG,4,645,570,75,3
16-02-2025,Spices & Seasonings,ROYAL SAFFRON,15,125,125,0,1
16-02-2025,"Grains, Flours & Dals",SINGLE POLISH 1KG,4,650,650,0,10
16-02-2025,Pooja & Spiritual Items,BALAJI BEL PHOOL DHOOP STICKS 10STK,12,70,70,0,1
16-02-2025,"Grains, Flours & Dals",turdal 1kg,4,220,195,25,1
16-02-2025,"Dry Fruits, Nuts & Seeds",PUMPKIN SEEDS 250GM,2,200,160,40,1
16-02-2025,"Grains, Flours & Dals",VGR RICE 5 KGS,4,350,325,25,1
16-02-2025,Snacks & Ready-to-Eat,VD MULTI CHAKKA,14,110,110,0,1
16-02-2025,Pooja & Spiritual Items,GD Aiswarya Deepam 700ML,12,195,195,0,1
16-02-2025,Household & Cleaning,UJALA LIQUID DETERGENT 250ML,6,80,80,0,1
16-02-2025,Spices & Seasonings,Tamalapaku Karam Powder 100GM,15,80,80,0,1
16-02-2025,Beverages,BRU GREEN LABEL 1.2G,1,96,96,0,48
16-02-2025,"Grains, Flours & Dals",Arikalu (kodo),4,70,65,5,1
16-02-2025,Snacks & Ready-to-Eat,SATHVI MIXED CHIKKI 200GM,14,120,100,20,1
16-02-2025,"Dry Fruits, Nuts & Seeds",PULMAKHANA 100 GM,2,180,170,10,1
16-02-2025,Snacks & Ready-to-Eat,FOXTAIL BIS,14,135,135,0,1
16-02-2025,"Grains, Flours & Dals",JOWAR YELLOW 1 K,4,25,22.5,2.5,0.25
16-02-2025,"Grains, Flours & Dals",KORRALU (FOXTAIL M) 500GM,4,65,55,10,1
16-02-2025,"Grains, Flours & Dals",RAGULU 1 KG,4,35,30,5,0.5
16-02-2025,"Grains, Flours & Dals",Multigrain 1 kg,4,400,340,60,4
16-02-2025,Spices & Seasonings,GS Pink Rock Salt 1KG,15,120,120,0,1
16-02-2025,Oils & Ghee,Safflower oil 1 L,9,440,400,40,1
16-02-2025,Oils & Ghee,Groundnut oil 1 L,9,360,330,30,1
16-02-2025,"Grains, Flours & Dals",Em Foxtail upma r 500 g,4,109,109,0,1
16-02-2025,"Grains, Flours & Dals",Yellow jowar.F 500 gms,4,55,50,5,1
16-02-2025,Oils & Ghee,Coconut oil 500 ml,9,220,200,20,1
16-02-2025,Sweeteners,NATURAL HONEY 250GM,16,150,130,20,1
16-02-2025,Spices & Seasonings,KALONJI SEEDS,15,90,80,10,1
16-02-2025,Snacks & Ready-to-Eat,VD DASA DINUSULU,14,199,199,0,1
16-02-2025,Oils & Ghee,Mustard oil 500 ml,9,220,195,25,1
16-02-2025,Personal Care & Cosmetics,UVIS ALOEVERA &amp;NEEM,10,175,175,0,1
16-02-2025,Oils & Ghee,Groundnut oil 1 L,9,360,330,30,1
16-02-2025,General Household & Kitchenware,NIPPO,3,36,36,0,2
16-02-2025,Personal Care & Cosmetics,DWI ALOEVERA 100GM,10,360,360,0,4
16-02-2025,Oils & Ghee,Groundnut oil 1 L,9,360,330,30,1
16-02-2025,Household & Cleaning,PITAMBARI,6,28,28,0,1
16-02-2025,Oils & Ghee,Groundnut oil 1 L,9,720,660,60,2
16-02-2025,Oils & Ghee,Groundnut oil 1 L,9,1080,990,90,3
16-02-2025,Oils & Ghee,Groundnut oil 1 L,9,360,330,30,1
16-02-2025,Oils & Ghee,Sesame oil 1 L,9,590,560,30,1
16-02-2025,Spices & Seasonings,ROYAL SAFFRON 400GRMS,15,65,65,0,1
16-02-2025,Personal Care & Cosmetics,SEV TULASI SOAP 100GM,10,90,90,0,1
16-02-2025,Spices & Seasonings,SAMBAR POWDER 200GM,15,130,110,20,1
16-02-2025,"Dry Fruits, Nuts & Seeds",Groundnuts 500 gms,2,95,85,10,1
16-02-2025,Beverages,BRU GREEN LABEL 1.2G,1,48,48,0,24
16-02-2025,Snacks & Ready-to-Eat,BB VERMICELLY 500GM,14,53,53,0,1
16-02-2025,Snacks & Ready-to-Eat,VD NUVULU CHEGODI 175GM,14,60,60,0,1
16-02-2025,Spices & Seasonings,MAMTA BLACK PEPPER POWDER,15,90,90,0,1
16-02-2025,"Grains, Flours & Dals",SB Javva Wheat Ravva 500GM,4,95,95,0,1
16-02-2025,Snacks & Ready-to-Eat,VD MULTI CHAKKA,14,110,110,0,1
16-02-2025,"Grains, Flours & Dals",RAGI FLOUR 1KG,4,400,350,50,5
16-02-2025,Personal Care & Cosmetics,SVE SHIKAKAI SOAP 100GM,10,100,100,0,1
16-02-2025,Oils & Ghee,Groundnut oil 1 L,9,360,330,30,1
16-02-2025,Spices & Seasonings,Gasagasalu 50GM,15,130,110,20,1
16-02-2025,Sweeteners,GS Organic Jaggery Powder 600GM,16,99,99,0,1
16-02-2025,Spices & Seasonings,LG 50GM,15,184,184,0,2
16-02-2025,Spices & Seasonings,NUVVULU 250GM,15,80,65,15,1
16-02-2025,Snacks & Ready-to-Eat,NGT CHATPATTA CHANA 90GM,14,25,25,0,1
16-02-2025,Spices & Seasonings,EVEREST PANI PURI MASALA 50GM,15,40,40,0,1
16-02-2025,Spices & Seasonings,Masala Karam 500 gms,15,260,240,20,1
16-02-2025,Spices & Seasonings,SD Garlic Karam Powder 100GM,15,130,130,0,2
16-02-2025,"Grains, Flours & Dals",RAGULU 1 KG,4,70,60,10,1
16-02-2025,"Grains, Flours & Dals",HS jowar idly rava 500 gms,4,195,195,0,3
16-02-2025,Oils & Ghee,Sesame oil 1 L,9,590,560,30,1
16-02-2025,Oils & Ghee,Safflower oil 5 L,9,2200,"1,950.00",250,1
16-02-2025,"Grains, Flours & Dals",White jowar.F 1 kg,4,100,80,20,1
16-02-2025,"Grains, Flours & Dals",POORI ATTA 500GM,4,35,30,5,1
16-02-2025,Spices & Seasonings,LG 50GM,15,92,92,0,1
16-02-2025,"Grains, Flours & Dals",Multigrain 1 kg,4,100,85,15,1
16-02-2025,"Grains, Flours & Dals",RAGI FLOUR 500GRMS,4,40,35,5,1
16-02-2025,"Grains, Flours & Dals",Wheat Flour 1 kg,4,140,120,20,2
16-02-2025,Oils & Ghee,Groundnut oil 1 L,9,720,660,60,2
16-02-2025,Sweeteners,Natural Honey 500 gms,16,280,240,40,1
16-02-2025,Oils & Ghee,Groundnut oil 1 L,9,720,660,60,2
16-02-2025,Snacks & Ready-to-Eat,RAJGIRA PEANUT CHIKKI,14,5,5,0,1
16-02-2025,Snacks & Ready-to-Eat,PEANUT CHILLI,14,5,5,0,1
16-02-2025,"Dry Fruits, Nuts & Seeds",FLAX SEEDS 250GM,2,60,50,10,1
16-02-2025,"Grains, Flours & Dals",turdal 1kg,4,220,195,25,1
16-02-2025,"Dry Fruits, Nuts & Seeds",SATHVI CHIA SEEDS 100GM,2,100,80,20,1
16-02-2025,Personal Care & Cosmetics,MD Bath Powder 100GM,10,40,40,0,1
16-02-2025,Spices & Seasonings,SD Curry Leaves Karam Powder 100GM,15,65,65,0,1
16-02-2025,"Health, Wellness & Ayurvedic Products",MD Bringaraj Choornam 100GM,5,80,80,0,1
16-02-2025,"Grains, Flours & Dals",turdal 1kg,4,220,195,25,1
16-02-2025,Sweeteners,ACHUBELLAM 500GM,16,50,40,10,1
16-02-2025,Spices & Seasonings,Coriander seeds 200 gms,15,48,40,8,1
16-02-2025,"Grains, Flours & Dals",DESI CHANA,4,100,100,0,4
16-02-2025,"Grains, Flours & Dals",URAD DALL,4,95,85,10,1
16-02-2025,Spices & Seasonings,Chilli powder 500 gms,15,290,210,80,1
16-02-2025,"Grains, Flours & Dals",Wheat Flour 1 kg,4,280,240,40,4
16-02-2025,Spices & Seasonings,Chilli powder 500 gms,15,290,210,80,1
16-02-2025,Oils & Ghee,Groundnut oil 1 L,9,360,330,30,1
16-02-2025,Sweeteners,YB JAGGERY POWDER 1KG,16,140,140,0,1
16-02-2025,"Health, Wellness & Ayurvedic Products",MAX PROTEIN ALMOND BAR,5,80,80,0,1
16-02-2025,Milk & Dairy,BROWN EGGS 1P,7,70,60,10,5
16-02-2025,"Grains, Flours & Dals",MAATEJA rice 5 kg,4,360,345,15,1
16-02-2025,"Grains, Flours & Dals",turdal 1kg,4,220,195,25,1
16-02-2025,"Health, Wellness & Ayurvedic Products",RB Max Protein Spanish Tomato,5,45,45,0,1
16-02-2025,Snacks & Ready-to-Eat,MAAGAANI JOWAR M COOKIES 120GM,14,149,149,0,1
16-02-2025,"Health, Wellness & Ayurvedic Products",RB Max Protein Soft &Chewy 55gm,5,50,50,0,1
16-02-2025,"Health, Wellness & Ayurvedic Products",MXP CREAM ONION,5,45,45,0,1
16-02-2025,Oils & Ghee,Safflower oil 500 ml,9,220,200,20,1
16-02-2025,"Health, Wellness & Ayurvedic Products",RB Max Protein Choco chips 55gm,5,50,50,0,1
16-02-2025,Milk & Dairy,BROWN EGGS 1P,7,112,96,16,8
16-02-2025,"Health, Wellness & Ayurvedic Products",RB Max Protein Choco Almond bar 50g,5,80,80,0,1
16-02-2025,"Health, Wellness & Ayurvedic Products",RB Max Protein Fruit &amp;Nut 50g,5,75,75,0,1
16-02-2025,Oils & Ghee,Safflower oil 1 L,9,880,800,80,2
16-02-2025,Oils & Ghee,Sesame oil 1 L,9,590,560,30,1
16-02-2025,"Health, Wellness & Ayurvedic Products",RB Max Protein Cheese&amp;,5,45,45,0,1
16-02-2025,"Health, Wellness & Ayurvedic Products",RB Max Protein Chinese Manchurian,5,45,45,0,1
16-02-2025,"Grains, Flours & Dals",VYS.SP.RICE 5 KGS,4,350,325,25,1
16-02-2025,Spices & Seasonings,NUVVULU 250GM,15,200,170,30,2
16-02-2025,Pooja & Spiritual Items,GD Aiswarya Deepam 700ML,12,390,390,0,2
16-02-2025,Oils & Ghee,Groundnut oil 1 L,9,720,660,60,2
16-02-2025,Oils & Ghee,Groundnut oil 1 L,9,360,330,30,1
16-02-2025,Snacks & Ready-to-Eat,SD Thati thandra 200gm,14,150,150,0,1
16-02-2025,"Grains, Flours & Dals",RAJMA 250GM,4,55,45,10,1
16-02-2025,"Health, Wellness & Ayurvedic Products",RB Max Protein Chinese Manchurian,5,45,45,0,1
16-02-2025,Milk & Dairy,SANGAM CURD 450GM,7,38,38,0,1
16-02-2025,Oils & Ghee,Sesame oil 1 L,9,590,560,30,1
16-02-2025,"Grains, Flours & Dals",White Chana 250 GM,4,60,50,10,1
16-02-2025,"Health, Wellness & Ayurvedic Products",MXP CREAM ONION,5,45,45,0,1
16-02-2025,"Grains, Flours & Dals",Urad dall 1 Kg,4,185,170,15,1
16-02-2025,Snacks & Ready-to-Eat,VD PALLI LADDU,14,80,80,0,1
16-02-2025,"Grains, Flours & Dals",WHITE BATANI,4,40,30,10,1
16-02-2025,"Grains, Flours & Dals",Green Batani 250GM,4,55,45,10,1
16-02-2025,"Grains, Flours & Dals",JOWAR YELLOW 1 K,4,200,180,20,2
16-02-2025,Oils & Ghee,Safflower oil 1 L,9,880,800,80,2
16-02-2025,Milk & Dairy,SANGAM TONED MILK 500ML,7,30,30,0,1
16-02-2025,Oils & Ghee,BUFFALLO GHEE 500ML,9,410,370,40,1
16-02-2025,"Grains, Flours & Dals",BASMATHI RICE 1KG,4,150,135,15,1
16-02-2025,Personal Care & Cosmetics,Soapnut 250GM,10,60,45,15,1
16-02-2025,Pooja & Spiritual Items,SWASTIK CAMPHOR 10GM,12,20,20,0,1
16-02-2025,Snacks & Ready-to-Eat,VD SAGOPAPAD 150GM,14,55,55,0,1
16-02-2025,Personal Care & Cosmetics,DWI NEEM TULSI SOAP 100GM,10,75,75,0,1
16-02-2025,"Grains, Flours & Dals",Bombay Rava 500GM,4,35,30,5,1
16-02-2025,"Grains, Flours & Dals",Yellow jowar .F1 kg,4,110,100,10,1
16-02-2025,"Dry Fruits, Nuts & Seeds",PUTNALU 500GMS,2,90,76,14,1
16-02-2025,"Grains, Flours & Dals",Idly Rava L 1KG,4,120,100,20,2
16-02-2025,Sweeteners,YB JAGGERY POWDER 1KG,16,280,280,0,2
16-02-2025,"Grains, Flours & Dals",DESI CHANA,4,25,25,0,1
16-02-2025,Personal Care & Cosmetics,DWI ROSE WATER 120ML,10,90,90,0,1
16-02-2025,"Health, Wellness & Ayurvedic Products",RB Max Protein Salt & Caramel Bar 50g,5,75,75,0,1
16-02-2025,"Grains, Flours & Dals",Wheat Flour 1 kg,4,280,240,40,4
16-02-2025,Snacks & Ready-to-Eat,NGT CHATPATTA CHANA 90GM,14,25,25,0,1
16-02-2025,Personal Care & Cosmetics,MULTANI MITTI CHOORNAM,10,40,40,0,1
16-02-2025,"Health, Wellness & Ayurvedic Products",RB Max Protein Fruit &amp;Nut 50g,5,75,75,0,1
16-02-2025,Spices & Seasonings,Gasagasalu 50GM,15,130,110,20,1
16-02-2025,Oils & Ghee,Sesame oil 1 L,9,1180,"1,120.00",60,2
16-02-2025,Oils & Ghee,Coconut oil 1 L,9,440,400,40,1
16-02-2025,Spices & Seasonings,Menthulu 250 gms,15,50,45,5,1
16-02-2025,"Dry Fruits, Nuts & Seeds",Groundnuts 1 kg,2,190,170,20,1
16-02-2025,Oils & Ghee,Sesame oil 500ml,9,295,280,15,1
16-02-2025,Pooja & Spiritual Items,SWASTIK CAMPHORE,12,90,90,0,1
16-02-2025,Spices & Seasonings,Turmeric powder 250 gms,15,100,75,25,1
16-02-2025,Personal Care & Cosmetics,UVIS HENNA 100GM,10,75,75,0,1
16-02-2025,Oils & Ghee,Coconut oil 500 ml,9,220,200,20,1
16-02-2025,"Health, Wellness & Ayurvedic Products",MD Aamlaki Choornam 100GM,5,80,80,0,1
16-02-2025,Pooja & Spiritual Items,SWAATHI SAMBRANI POW 10G,12,20,20,0,1
16-02-2025,Personal Care & Cosmetics,HERBAL BATH POWDER 200GM,10,80,80,0,1
16-02-2025,"Grains, Flours & Dals",VGR RICE bag 1,4,1899,"1,650.00",249,1
16-02-2025,"Grains, Flours & Dals",HS Multimillet idly R 500 gms,4,65,65,0,1
16-02-2025,"Grains, Flours & Dals",VGR rice 1 kg,4,350,325,25,5
16-02-2025,"Grains, Flours & Dals",EM Ragi idli R 500G,4,75,75,0,1
16-02-2025,"Grains, Flours & Dals",Wheat Flour 1 kg,4,70,60,10,1
16-02-2025,"Grains, Flours & Dals",HS jowar idly rava 500 gms,4,65,65,0,1
16-02-2025,"Grains, Flours & Dals",PESARA PAPPU 500GMS,4,85,75,10,1
16-02-2025,General Household & Kitchenware,MATCH BOX,3,20,20,0,1
16-02-2025,"Grains, Flours & Dals",Wheat Rava M 500GM,4,66,60,6,2
16-02-2025,Oils & Ghee,Groundnut oil 1 L,9,720,660,60,2
16-02-2025,"Grains, Flours & Dals",RAGI FLOUR 1KG,4,80,70,10,1
16-02-2025,"Grains, Flours & Dals",Wheat Flour 1 kg,4,70,60,10,1
16-02-2025,"Grains, Flours & Dals",VGR rice 1 kg,4,700,650,50,10
16-02-2025,Spices & Seasonings,SWEET SOUNF,15,20,20,0,1
16-02-2025,Spices & Seasonings,Biryani Leaf 25GM,15,20,20,0,1
16-02-2025,"Grains, Flours & Dals",DESI CHANA,4,25,25,0,1
16-02-2025,Oils & Ghee,Sesame oil 500ml,9,295,280,15,1
16-02-2025,Spices & Seasonings,Dalchin Rolls 50GM,15,70,70,0,1
16-02-2025,Spices & Seasonings,SD Curry Leaves Karam Powder 100GM,15,65,65,0,1
16-02-2025,"Grains, Flours & Dals",RAGI FLOUR 1KG,4,160,140,20,2
16-02-2025,"Grains, Flours & Dals",JOWAR UPMA RAVA,4,0,0,0,1
16-02-2025,Oils & Ghee,GANTASALA A2 COW GHEE 250ML,9,299,299,0,1
16-02-2025,Spices & Seasonings,Chilli powder 500 gms,15,290,210,80,1
16-02-2025,Spices & Seasonings,Turmeric powder 250 gms,15,100,75,25,1
16-02-2025,Spices & Seasonings,Miriyalu 50GM,15,100,80,20,1
16-02-2025,"Grains, Flours & Dals",Green gram 1 kg,4,150,130,20,1
16-02-2025,Snacks & Ready-to-Eat,SUNNUNDALU,14,120,120,0,1
16-02-2025,"Grains, Flours & Dals",VYS.SP RICE 1 KG,4,700,650,50,10
16-02-2025,Oils & Ghee,Sesame oil 500ml,9,295,280,15,1
16-02-2025,Oils & Ghee,Groundnut oil 1 L,9,360,330,30,1
16-02-2025,Snacks & Ready-to-Eat,VD RICE SAGO PAPAD 150GM,14,55,55,0,1
16-02-2025,Snacks & Ready-to-Eat,VD RED CHILLI RICEPAPAD 150GM,14,50,50,0,1
16-02-2025,Snacks & Ready-to-Eat,SD black sesme laddu with dates 175gm,14,135,135,0,1
16-02-2025,Snacks & Ready-to-Eat,VD Minapa papad 200gm,14,60,60,0,1
16-02-2025,Snacks & Ready-to-Eat,RINGS 200GM,14,30,30,0,1
16-02-2025,Snacks & Ready-to-Eat,SD Sesame laddu with dates250gm,14,135,135,0,1
16-02-2025,Snacks & Ready-to-Eat,GROUNDNUT LADDU WITH DATES,14,135,135,0,1
16-02-2025,Snacks & Ready-to-Eat,SUNNUNDALU,14,120,120,0,1
16-02-2025,Spices & Seasonings,DRY MIECHI 200GM,15,80,60,20,1
16-02-2025,"Dry Fruits, Nuts & Seeds",Groundnuts 1 kg,2,190,170,20,1
16-02-2025,"Dry Fruits, Nuts & Seeds",Groundnuts 500 gms,2,95,85,10,1
16-02-2025,Oils & Ghee,Sesame oil 500ml,9,590,560,30,2
16-02-2025,Spices & Seasonings,Tamarind 500GM,15,160,130,30,1
16-02-2025,"Grains, Flours & Dals",BARLEY SEEDS 250GMS,4,40,35,5,1
16-02-2025,"Grains, Flours & Dals",Chana Flour 500 gms,4,140,130,10,2
16-02-2025,"Grains, Flours & Dals",VGR RICE 5 KGS,4,350,325,25,1
16-02-2025,Spices & Seasonings,SREE MARUTHI IDLY KARAM 200GM,15,60,60,0,1
16-02-2025,Oils & Ghee,Safflower oil 1 L,9,880,800,80,2
16-02-2025,Spices & Seasonings,NUVVULU 250GM,15,80,65,15,1
16-02-2025,"Grains, Flours & Dals",VYS.SP.RICE 5 KGS,4,350,325,25,1
16-02-2025,"Grains, Flours & Dals",VGR RICE 10 KGS,4,700,650,50,1
16-02-2025,"Grains, Flours & Dals",JOWAR WHITE 1 KG,4,80,70,10,1
16-02-2025,"Grains, Flours & Dals",Chittimuthaylu rice 1 kg,4,160,140,20,1
16-02-2025,Snacks & Ready-to-Eat,BD RED RICE NOODLES 200G,14,70,70,0,1
16-02-2025,"Grains, Flours & Dals",Yellow jowar .F1 kg,4,110,100,10,1
16-02-2025,Beverages,REFRESH SHARBATH NORMAL,1,199,190,9,1
16-02-2025,"Grains, Flours & Dals",SOYA BEANS 1KG,4,50,45,5,0.25
16-02-2025,"Grains, Flours & Dals",RAJMA 250GM,4,55,45,10,1
16-02-2025,Snacks & Ready-to-Eat,SD Ginger Candy 100g,14,60,60,0,1
16-02-2025,"Health, Wellness & Ayurvedic Products",MD Kasturi Pasupu Choornam 50GM,5,80,80,0,1
16-02-2025,"Grains, Flours & Dals",Bajra Flour 500 gms,4,35,30,5,1
16-02-2025,Household & Cleaning,VIM 300GM,6,15,15,0,1
16-02-2025,Oils & Ghee,Sesame oil 1 L,9,590,560,30,1
16-02-2025,Oils & Ghee,Safflower oil 1 L,9,440,400,40,1
16-02-2025,Oils & Ghee,Groundnut oil 1 L,9,360,330,30,1
16-02-2025,Oils & Ghee,Freedom Rice Bran Oil 1L,9,194,180,14,1
16-02-2025,Spices & Seasonings,Telaga Pindi 250 GM,15,40,35,5,1
16-02-2025,Oils & Ghee,Sesame oil 500ml,9,295,280,15,1
16-02-2025,Snacks & Ready-to-Eat,VD RICE MURUKU 150GM,14,50,50,0,1
16-02-2025,Milk & Dairy,BROWN EGGS 1P,7,224,192,32,16
16-02-2025,Snacks & Ready-to-Eat,RI Yogurt Berry Oats 35g,14,45,45,0,1
16-02-2025,Personal Care & Cosmetics,COLGATE KIDS 2 PLUS,10,30,30,0,1
16-02-2025,Snacks & Ready-to-Eat,SD FINGER Millet with palm Jaggery 250gm,14,270,270,0,2
16-02-2025,Oils & Ghee,Groundnut oil 1 L,9,720,660,60,2
16-02-2025,Oils & Ghee,Groundnut oil 1 L,9,360,330,30,1
16-02-2025,Snacks & Ready-to-Eat,SD Atreyapuram DRY Fruit ghee,14,150,150,0,1
16-02-2025,Snacks & Ready-to-Eat,VD PALLI LADDU,14,80,80,0,1
16-02-2025,Spices & Seasonings,Coriander seeds 200 gms,15,48,40,8,1
16-02-2025,"Dry Fruits, Nuts & Seeds",PUTNALU 500GMS,2,90,76,14,1
16-02-2025,Snacks & Ready-to-Eat,SH PUFFED RICE 500GM,14,112,112,0,1
16-02-2025,"Dry Fruits, Nuts & Seeds",KAJU HALF 250GM,2,310,290,20,1
16-02-2025,Spices & Seasonings,ROYAL SAFFRON 400GRMS,15,130,130,0,2
16-02-2025,"Grains, Flours & Dals",RED TUDAL 1KG,4,150,140,10,1
16-02-2025,"Grains, Flours & Dals",MELMEKER 250GMS,4,60,45,15,1
16-02-2025,"Dry Fruits, Nuts & Seeds",SALTED PISTA 250GM,2,400,350,50,1
16-02-2025,"Grains, Flours & Dals",turdal 1kg,4,220,195,25,1
16-02-2025,Snacks & Ready-to-Eat,urban murmura,14,45,45,0,1
16-02-2025,"Grains, Flours & Dals",VGR RICE bag 1,4,1899,"1,650.00",249,1
16-02-2025,Oils & Ghee,DWI VATADATEL 100ML,9,310,310,0,1
16-02-2025,"Grains, Flours & Dals",Red Chana 500 GM,4,75,60,15,1
16-02-2025,Snacks & Ready-to-Eat,SH PUFFED RICE 500GM,14,112,112,0,1
16-02-2025,Snacks & Ready-to-Eat,VD Pappu Chekkalu 190gm,14,60,60,0,1
16-02-2025,"Grains, Flours & Dals",Urad dall 1 Kg,4,185,170,15,1
16-02-2025,"Grains, Flours & Dals",DOCTOR RICE DIABETIC SFR 1KG,4,120,120,0,1
16-02-2025,"Grains, Flours & Dals",Wheat Rava M 1KG,4,65,55,10,1
16-02-2025,"Grains, Flours & Dals",Multigrain 1 kg,4,200,170,30,2
16-02-2025,"Dry Fruits, Nuts & Seeds",SABJA SEEDS 100GM,2,80,70,10,1
16-02-2025,"Grains, Flours & Dals",Red Bobarlu 1 kg,4,190,170,20,1
16-02-2025,"Grains, Flours & Dals",HS Multimillet idly R 500 gms,4,65,65,0,1
16-02-2025,"Grains, Flours & Dals",DOCTOR RICE DIABETIC SFR 1KG,4,120,120,0,1
16-02-2025,Snacks & Ready-to-Eat,BATANA NGT 70GMS,14,20,20,0,1
16-02-2025,"Grains, Flours & Dals",RAGI FLOUR 1KG,4,80,70,10,1
16-02-2025,"Health, Wellness & Ayurvedic Products",MD Neem Leaf Choornam 100GM,5,110,110,0,1
16-02-2025,"Health, Wellness & Ayurvedic Products",MD Bringaraj Choornam 100GM,5,80,80,0,1
16-02-2025,Personal Care & Cosmetics,MD Henna Choornam 100GM,10,80,80,0,1
16-02-2025,Oils & Ghee,Sesame oil 1 L,9,590,560,30,1
16-02-2025,Spices & Seasonings,Elaichi 25GM,15,145,120,25,1
16-02-2025,"Dry Fruits, Nuts & Seeds",SALTED PISTA 250GM,2,400,350,50,1
16-02-2025,Oils & Ghee,Groundnut oil 1 L,9,360,330,30,1
16-02-2025,"Dry Fruits, Nuts & Seeds",YELLOW KISHMISH 250GM,2,130,110,20,1
16-02-2025,"Grains, Flours & Dals",MELMEKER 250GMS,4,60,45,15,1
16-02-2025,Sweeteners,YB JAGGERY POWDER 1KG,16,140,140,0,1
16-02-2025,"Dry Fruits, Nuts & Seeds",PUTNALU 500GMS,2,90,76,14,1
15-02-2025,"Grains, Flours & Dals",VGR rice 1 kg,4,140,130,10,2
15-02-2025,Snacks & Ready-to-Eat,VD PALLI CHIKKI,14,160,160,0,2
15-02-2025,Snacks & Ready-to-Eat,VD Pappu Chekkalu 190gm,14,60,60,0,1
15-02-2025,Snacks & Ready-to-Eat,VD MURUKU 175GM,14,60,60,0,1
15-02-2025,"Grains, Flours & Dals",SINGLE POLISH 1KG,4,325,325,0,5
15-02-2025,Snacks & Ready-to-Eat,BATANA NGT 70GMS,14,20,20,0,1
15-02-2025,Snacks & Ready-to-Eat,PEANUT CHIKKI,14,110,110,0,5
15-02-2025,Snacks & Ready-to-Eat,SD FINGER Millet with palm Jaggery 250gm,14,135,135,0,1
15-02-2025,"Grains, Flours & Dals",SOYA BEANS 1KG,4,50,45,5,0.25
15-02-2025,Snacks & Ready-to-Eat,BATANA NGT 70GMS,14,60,60,0,3
15-02-2025,General Household & Kitchenware,MATCH BOX,3,20,20,0,1
15-02-2025,Snacks & Ready-to-Eat,VD Pappu Chekkalu 190gm,14,60,60,0,1
15-02-2025,Snacks & Ready-to-Eat,FUN TIME CRUNCH,14,45,45,0,1
15-02-2025,"Health, Wellness & Ayurvedic Products",JAMBU SEED CHOORNAM 100GM,5,80,80,0,1
15-02-2025,Snacks & Ready-to-Eat,NGT CHATPATTA CHANA 90GM,14,25,25,0,1
15-02-2025,Milk & Dairy,BROWN EGGS 1P,7,168,144,24,12
15-02-2025,"Grains, Flours & Dals",Em jowar idly R 500G,4,150,150,0,2
15-02-2025,"Dry Fruits, Nuts & Seeds",SUNFLOWER SEEDS 250GRM,2,150,130,20,1
15-02-2025,"Health, Wellness & Ayurvedic Products",MXP CHOCO CLASSIC BAR,5,80,80,0,1
15-02-2025,"Dry Fruits, Nuts & Seeds",PUMPKIN SEEDS 250GM,2,200,160,40,1
15-02-2025,"Grains, Flours & Dals",Idly Rava L 1KG,4,60,50,10,1
15-02-2025,"Grains, Flours & Dals",AISHWARYA SP 1KG,4,800,700,100,10
15-02-2025,"Grains, Flours & Dals",Em Multimillet idli r 500g,4,129,129,0,1
15-02-2025,"Grains, Flours & Dals",White jowar.F 1 kg,4,100,80,20,1
15-02-2025,Snacks & Ready-to-Eat,PEANUT CHIKKI 450GM,14,125,125,0,1
15-02-2025,"Grains, Flours & Dals",Multigrain 1 kg,4,300,255,45,3
15-02-2025,"Health, Wellness & Ayurvedic Products",MH Millets Malt 1KG,5,400,380,20,1
15-02-2025,"Grains, Flours & Dals",RAGI FLOUR 1KG,4,80,70,10,1
15-02-2025,"Grains, Flours & Dals",Wheat Rava M 1KG,4,65,55,10,1
15-02-2025,"Dry Fruits, Nuts & Seeds",Groundnuts 1 kg,2,190,170,20,1
15-02-2025,"Dry Fruits, Nuts & Seeds",CASHEW 250GM,2,340,310,30,1
15-02-2025,Personal Care & Cosmetics,BAMBOO TOOTH BRUSH,10,50,50,0,1
15-02-2025,"Dry Fruits, Nuts & Seeds",PLAIN PISTA 250GM,2,660,550,110,1
15-02-2025,Milk & Dairy,BROWN EGGS 1P,7,56,48,8,4
15-02-2025,Spices & Seasonings,EV Chicken Masala 50GM,15,5,5,0,1
15-02-2025,"Grains, Flours & Dals",JOWAR WHITE 1 KG,4,120,105,15,1.5
15-02-2025,"Grains, Flours & Dals",white Bobarlu 500 gms,4,80,75,5,1
15-02-2025,"Grains, Flours & Dals",BAJRA 1 KG,4,90,75,15,1.5
15-02-2025,"Grains, Flours & Dals",WHITE BATANI,4,40,30,10,1
15-02-2025,Snacks & Ready-to-Eat,Corn Chips 250GM,14,40,35,5,1
15-02-2025,"Grains, Flours & Dals",Multigrain 1 kg,4,200,170,30,2
15-02-2025,Snacks & Ready-to-Eat,JUNNU POWDER 100GM,14,210,210,0,3
15-02-2025,"Grains, Flours & Dals",KORRALU (FOXTAIL M) 1KG,4,150,110,40,1
15-02-2025,Snacks & Ready-to-Eat,urban murmura,14,50,45,5,1
15-02-2025,Beverages,GANTASALA GREEN TEA 100GM,1,149,149,0,1
15-02-2025,"Grains, Flours & Dals",SA Multi Grain Mix 500GM,4,159,159,0,1
15-02-2025,Sweeteners,NATURAL HONEY 1KG,16,560,480,80,1
15-02-2025,Snacks & Ready-to-Eat,SD Little Millet WITH PLAM JAGGERY,14,135,135,0,1
15-02-2025,Snacks & Ready-to-Eat,FOXTAIL BIS,14,135,135,0,1
15-02-2025,"Health, Wellness & Ayurvedic Products",RB Max Protein PERI PERI 60gm,5,45,45,0,1
15-02-2025,"Grains, Flours & Dals",Sathya Javva Wheat Rava 500GM,4,95,95,0,1
15-02-2025,"Dry Fruits, Nuts & Seeds",ANJEER 250GM,2,400,360,40,1
15-02-2025,"Dry Fruits, Nuts & Seeds",SATHVI CHIA SEEDS 100GM,2,100,80,20,1
15-02-2025,"Dry Fruits, Nuts & Seeds",ALMONDS 250GM,2,280,260,20,1
15-02-2025,"Dry Fruits, Nuts & Seeds",KAJU HALF 250GM,2,310,290,20,1
15-02-2025,"Dry Fruits, Nuts & Seeds",WALLNUTS 250GM,2,380,360,20,1
15-02-2025,"Dry Fruits, Nuts & Seeds",BLACK KISMIS 250GM,2,175,140,35,1
15-02-2025,"Dry Fruits, Nuts & Seeds",CASHEW 250GM,2,340,310,30,1
15-02-2025,Personal Care & Cosmetics,DWI ALOEVERA 100GM,10,270,270,0,3
15-02-2025,Snacks & Ready-to-Eat,SD Bajra with palm Jaggery 250gm,14,135,135,0,1
15-02-2025,Spices & Seasonings,Masala Karam 500 gms,15,260,240,20,1
15-02-2025,"Grains, Flours & Dals",RAGI FLOUR 500GRMS,4,40,35,5,1
15-02-2025,Household & Cleaning,HERBAL LIQ DISH WASH 500ML,6,340,340,0,2
15-02-2025,"Grains, Flours & Dals",PESARA PAPPU 500GMS,4,85,75,10,1
15-02-2025,"Grains, Flours & Dals",Quinova 1 kg,4,220,195,25,1
15-02-2025,"Grains, Flours & Dals",SINGLE POLISH 1KG,4,130,130,0,2
15-02-2025,"Dry Fruits, Nuts & Seeds",Groundnuts 1 kg,2,190,170,20,1
15-02-2025,"Grains, Flours & Dals",split green gram 500 gms,4,75,70,5,1
15-02-2025,Milk & Dairy,SANGAM TONED MILK 500ML,7,60,60,0,2
15-02-2025,"Grains, Flours & Dals",Arikadu ( kodo),4,140,130,10,1
15-02-2025,Milk & Dairy,BROWN EGGS TRAY 30P,7,360,330,30,1
15-02-2025,"Grains, Flours & Dals",Hs yellow jowar r 500g,4,99,99,0,1
15-02-2025,"Health, Wellness & Ayurvedic Products",MORINGA LEAF POWDER M,5,80,75,5,1
15-02-2025,Snacks & Ready-to-Eat,BLACK SESAME CHIKKI,14,5,5,0,1
15-02-2025,Snacks & Ready-to-Eat,SH PUFFED RICE 500GM,14,112,112,0,1
15-02-2025,Snacks & Ready-to-Eat,GROUNDNUT LADDU WITH DATES,14,135,135,0,1
15-02-2025,"Health, Wellness & Ayurvedic Products",MORINGA LEAF POWDER M,5,80,80,0,1
15-02-2025,Snacks & Ready-to-Eat,FUN TIME CRUNCH,14,45,45,0,1
15-02-2025,"Dry Fruits, Nuts & Seeds",PULMAKHANA 100 GM,2,180,170,10,1
15-02-2025,"Dry Fruits, Nuts & Seeds",CASHEW,2,680,590,90,1
15-02-2025,"Dry Fruits, Nuts & Seeds",SATHVI CHIA SEEDS 100GM,2,100,80,20,1
15-02-2025,Sweeteners,GS Palm Jaggery Powder 400GM,16,180,180,0,1
15-02-2025,Spices & Seasonings,GS Pink Rock Salt 1KG,15,120,120,0,1
15-02-2025,Snacks & Ready-to-Eat,Corn Chips 250GM,14,40,35,5,1
15-02-2025,Spices & Seasonings,NUVVULU 500GM,15,160,130,30,1
15-02-2025,Pooja & Spiritual Items,GOMATHA AGARBATHI,12,75,75,0,1
15-02-2025,"Grains, Flours & Dals",DH URAD GOTA 1KG,4,215,190,25,1
15-02-2025,Oils & Ghee,Coconut oil 1 L,9,440,400,40,1
15-02-2025,Pooja & Spiritual Items,SIVA JOOTHI 365 DEEPAPU,12,50,50,0,2
15-02-2025,Pooja & Spiritual Items,JAGI KAYA 25GM,12,80,60,20,1
15-02-2025,Snacks & Ready-to-Eat,MAAGAANI JOWAR M COOKIES 120GM,14,149,149,0,1
15-02-2025,Snacks & Ready-to-Eat,BD RAGI NOODLES,14,75,75,0,1
15-02-2025,"Grains, Flours & Dals",SINGLE POLISH 1KG,4,325,325,0,5
15-02-2025,"Grains, Flours & Dals",HS JOWAR FLAKES 250GM 1+1,4,119,119,0,1
15-02-2025,Snacks & Ready-to-Eat,urban murmura,14,50,45,5,1
15-02-2025,Pooja & Spiritual Items,GD Dhoop Cones 40GM,12,30,30,0,1
15-02-2025,"Dry Fruits, Nuts & Seeds",WATERMELON SEEDS 250GRM,2,320,280,40,1
15-02-2025,"Dry Fruits, Nuts & Seeds",FLAX SEEDS 250GM,2,60,50,10,1
15-02-2025,"Dry Fruits, Nuts & Seeds",PUMPKIN SEEDS 250GM,2,200,160,40,1
15-02-2025,Snacks & Ready-to-Eat,VD NUVULU CHEGODI 175GM,14,60,60,0,1
15-02-2025,"Grains, Flours & Dals",MELMEKER 250GMS,4,60,45,15,1
15-02-2025,Snacks & Ready-to-Eat,VD PALLI CHIKKI,14,80,80,0,1
15-02-2025,Snacks & Ready-to-Eat,VD Pappu Chekkalu 190gm,14,60,60,0,1
15-02-2025,Household & Cleaning,VANISH 10X OXI POWER 400ML,6,69,69,0,1
15-02-2025,"Grains, Flours & Dals",split urad dall 250 gms,4,45,40,5,1
15-02-2025,Milk & Dairy,SANGAM TONED MILK 500ML,7,30,30,0,1
15-02-2025,"Grains, Flours & Dals",Red Bobarlu 500 gms,4,95,85,10,1
15-02-2025,"Dry Fruits, Nuts & Seeds",SATHVI CHIA SEEDS 100GM,2,100,80,20,1
15-02-2025,Snacks & Ready-to-Eat,PUMPKIN CHIKKI 200GM,14,140,120,20,1
15-02-2025,Snacks & Ready-to-Eat,ELITE ELAICHI RUSK 200GM,14,35,35,0,1
15-02-2025,"Grains, Flours & Dals",HS Jowar upma rava 500 gms,4,65,65,0,1
15-02-2025,Oils & Ghee,Coconut oil 500 ml,9,220,200,20,1
15-02-2025,Snacks & Ready-to-Eat,Corn Chips 250GM,14,40,35,5,1
15-02-2025,Snacks & Ready-to-Eat,SD Vamu with palm jaggery 250gm,14,135,135,0,1
15-02-2025,Snacks & Ready-to-Eat,SD Moringa with plam jaggery 250gm,14,135,135,0,1
15-02-2025,Snacks & Ready-to-Eat,SD FINGER Millet with palm Jaggery 250gm,14,135,135,0,1
15-02-2025,Snacks & Ready-to-Eat,SD JOWAR WITH PALM JAGGERY 250GM,14,135,135,0,1
15-02-2025,"Dry Fruits, Nuts & Seeds",YELLOW KISHMISH 250GM,2,130,110,20,1
15-02-2025,"Dry Fruits, Nuts & Seeds",BLACK KISMIS 250GM,2,175,140,35,1
15-02-2025,"Grains, Flours & Dals",white Bobarlu 500 gms,4,80,75,5,1
15-02-2025,"Grains, Flours & Dals",SABDANA,4,80,70,10,2
15-02-2025,Snacks & Ready-to-Eat,VD PALLI LADDU,14,80,80,0,1
15-02-2025,Sweeteners,YB JAGGERY POWDER 500GMS,16,75,75,0,1
15-02-2025,Snacks & Ready-to-Eat,PUMPKIN CHIKKI 200GM,14,140,120,20,1
15-02-2025,"Grains, Flours & Dals",PRO SOYA CHUNKS 200G,4,79,79,0,1
15-02-2025,"Dry Fruits, Nuts & Seeds",ALMONDS 250GM,2,280,260,20,1
15-02-2025,Sweeteners,Natural Honey 500 gms,16,280,240,40,1
15-02-2025,"Grains, Flours & Dals",Green gram 1 kg,4,150,130,20,1
15-02-2025,"Grains, Flours & Dals",VGR rice 1 kg,4,140,130,10,2
15-02-2025,"Dry Fruits, Nuts & Seeds",Groundnuts 1 kg,2,190,170,20,1
15-02-2025,"Grains, Flours & Dals",URAD DALL,4,95,85,10,1
15-02-2025,"Grains, Flours & Dals",DH URAD GOTA 1KG,4,430,380,50,2
15-02-2025,"Dry Fruits, Nuts & Seeds",SUNFLOWER SEEDS 250GRM,2,150,130,20,1
15-02-2025,Milk & Dairy,BROWN EGGS 1P,7,56,48,8,4
15-02-2025,"Dry Fruits, Nuts & Seeds",ALMONDS 250GM,2,280,260,20,1
15-02-2025,"Dry Fruits, Nuts & Seeds",PUMPKIN SEEDS 250GM,2,200,160,40,1
15-02-2025,"Dry Fruits, Nuts & Seeds",WATERMELON SEEDS 250GRM,2,320,280,40,1
15-02-2025,Snacks & Ready-to-Eat,Popcorn Seeds 500GM,14,90,80,10,1
15-02-2025,"Grains, Flours & Dals",RAGULU 1 KG,4,70,60,10,1
15-02-2025,Snacks & Ready-to-Eat,Popcorn Seeds 250GM,14,45,40,5,1
15-02-2025,"Grains, Flours & Dals",JOWAR WHITE 1 KG,4,80,70,10,1
15-02-2025,Spices & Seasonings,Menthulu 250 gms,15,50,45,5,1
15-02-2025,"Grains, Flours & Dals",Green gram 1 kg,4,150,130,20,1
15-02-2025,"Grains, Flours & Dals",Black RICE 1 KG,4,340,310,30,1
15-02-2025,Sweeteners,YB JAGGERY POWDER 500GMS,16,75,75,0,1
15-02-2025,Spices & Seasonings,Avalu small 250 gms,15,60,40,20,1
15-02-2025,Snacks & Ready-to-Eat,VD PAPPU CHEGODI 200GM,14,60,60,0,1
15-02-2025,Snacks & Ready-to-Eat,VD RIBBON PAKODI 175GM,14,60,60,0,1
15-02-2025,Oils & Ghee,Coconut oil 500 ml,9,220,200,20,1
15-02-2025,Snacks & Ready-to-Eat,VD GUMMADI VADIYAM,14,75,75,0,1
15-02-2025,Oils & Ghee,Safflower oil 500 ml,9,220,200,20,1
15-02-2025,"Grains, Flours & Dals",BARLEY SEEDS 250GMS,4,40,35,5,1
15-02-2025,"Health, Wellness & Ayurvedic Products",RB Peanut butter Peanuts Dark 40g,5,45,45,0,1
15-02-2025,Snacks & Ready-to-Eat,Corn Chips 250GM,14,40,35,5,1
15-02-2025,"Grains, Flours & Dals",Wheat Flour 1 kg,4,70,60,10,1
15-02-2025,"Dry Fruits, Nuts & Seeds",SATHVI CHIA SEEDS 100GM,2,100,80,20,1
15-02-2025,"Dry Fruits, Nuts & Seeds",SABJA SEEDS 100GM,2,80,70,10,1
15-02-2025,"Grains, Flours & Dals",DISANO OATS 1KG,4,71.25,71.25,0,0.25
15-02-2025,Snacks & Ready-to-Eat,PEANUT CHIKKI,14,66,66,0,3
15-02-2025,"Grains, Flours & Dals",Multigrain 1 kg,4,100,85,15,1
15-02-2025,Oils & Ghee,BUFFALLO GHEE 500ML,9,820,740,80,2
15-02-2025,Oils & Ghee,Groundnut oil 5 L,9,1800,"1,600.00",200,1
15-02-2025,"Grains, Flours & Dals",VGR RICE 5 KGS,4,350,325,25,1
15-02-2025,"Grains, Flours & Dals",Brown rice 5 kgs,4,350,325,25,1
15-02-2025,"Health, Wellness & Ayurvedic Products",RB Max Protein Choco Berry bar 50g,5,75,75,0,1
15-02-2025,Spices & Seasonings,ROYAL SAFFRON 400GRMS,15,65,65,0,1
15-02-2025,Snacks & Ready-to-Eat,ANNAPURNA APPALAM,14,70,70,0,2
15-02-2025,"Health, Wellness & Ayurvedic Products",RB Max Protein Choco Berry bar 50g,5,75,75,0,1
15-02-2025,Snacks & Ready-to-Eat,VD PALLI LADDU,14,80,80,0,1
15-02-2025,"Grains, Flours & Dals",POORI ATTA 500GM,4,70,60,10,2
15-02-2025,"Grains, Flours & Dals",Wheat Flour 1 kg,4,140,120,20,2
15-02-2025,"Grains, Flours & Dals",White Chana 250 GM,4,60,50,10,1
15-02-2025,Snacks & Ready-to-Eat,NGT CHATPATTA CHANA 90GM,14,25,25,0,1
15-02-2025,Oils & Ghee,Coconut oil 500 ml,9,220,200,20,1
15-02-2025,Snacks & Ready-to-Eat,BATANA NGT 70GMS,14,20,20,0,1
15-02-2025,"Grains, Flours & Dals",UDALU (Barnyard millet) 1 kg,4,140,115,25,1
15-02-2025,Personal Care & Cosmetics,NIVEA MEN SHOWER GEL 250ML,10,250,250,0,1
15-02-2025,"Grains, Flours & Dals",KORRALU (FOXTAIL M) 1KG,4,150,110,40,1
15-02-2025,"Grains, Flours & Dals",Yellow jowar .F1 kg,4,110,100,10,1
15-02-2025,Snacks & Ready-to-Eat,VD PALLI CHIKKI,14,80,80,0,1
15-02-2025,Oils & Ghee,Castor oil 200 ml,9,800,600,200,8
15-02-2025,"Grains, Flours & Dals",turdal 1kg,4,220,195,25,1
15-02-2025,"Dry Fruits, Nuts & Seeds",PULMAKHANA 100 GM,2,180,170,10,1
15-02-2025,"Grains, Flours & Dals",Idly Rava L 1KG,4,60,50,10,1
15-02-2025,"Grains, Flours & Dals",MELMEKER 250GMS,4,120,90,30,2
15-02-2025,Spices & Seasonings,RED COPRA 250GMS,15,85,74,11,1
15-02-2025,"Grains, Flours & Dals",THICK POHA 1KG,4,80,70,10,1
15-02-2025,Spices & Seasonings,GS Pink Rock Salt 1KG,15,120,120,0,1
15-02-2025,"Dry Fruits, Nuts & Seeds",Putnalu 250GM,2,45,38,7,1
15-02-2025,"Dry Fruits, Nuts & Seeds",SALTED PISTA 250GM,2,400,350,50,1
15-02-2025,Spices & Seasonings,SONTI 50GM,15,30,20,10,1
15-02-2025,Personal Care & Cosmetics,OVAL BODY LOOFAH,10,55,55,0,1
15-02-2025,Spices & Seasonings,Black Till 250GM,15,90,75,15,1
15-02-2025,Spices & Seasonings,ROYAL SAFFRON 400GRMS,15,65,65,0,1
15-02-2025,"Grains, Flours & Dals",White jowar.F 500 Gms,4,50,40,10,1
15-02-2025,"Grains, Flours & Dals",JOWAR UPMA RAVA,4,65,65,0,1
15-02-2025,"Grains, Flours & Dals",THIN POHA 500GM,4,40,35,5,1
15-02-2025,Sweeteners,Mishri 500GM,16,70,60,10,1
15-02-2025,"Dry Fruits, Nuts & Seeds",Putnalu 250GM,2,45,38,7,1
15-02-2025,"Health, Wellness & Ayurvedic Products",MD Kasturi Pasupu Choornam 50GM,5,80,80,0,1
15-02-2025,Sweeteners,ACHUBELLAM 500GM,16,50,40,10,1
15-02-2025,"Grains, Flours & Dals",Chana Flour 1 kg,4,140,130,10,1
15-02-2025,"Grains, Flours & Dals",RAGI FLOUR 500GRMS,4,40,35,5,1
15-02-2025,"Dry Fruits, Nuts & Seeds",ANJEER 250GM,2,400,360,40,1
15-02-2025,"Grains, Flours & Dals",Wheat Flour 1 kg,4,70,60,10,1
15-02-2025,Personal Care & Cosmetics,PAPAYA GEL,10,140,140,0,1
15-02-2025,"Dry Fruits, Nuts & Seeds",PUMPKIN SEEDS 250GM,2,200,160,40,1
15-02-2025,Spices & Seasonings,Lavangam 50GM,15,60,50,10,1
15-02-2025,Sweeteners,MISHRI D,16,40,30,10,1
15-02-2025,Spices & Seasonings,Elaichi 25GM,15,145,120,25,1
15-02-2025,Spices & Seasonings,YB PINK ROCK SALT 1KG,15,120,120,0,1
15-02-2025,"Grains, Flours & Dals",White Chana 250 GM,4,60,50,10,1
15-02-2025,"Dry Fruits, Nuts & Seeds",SABJA SEEDS 100GM,2,80,70,10,1
15-02-2025,"Grains, Flours & Dals",THICK POHA 1KG,4,80,70,10,1
15-02-2025,"Grains, Flours & Dals",white Bobarlu 500 gms,4,80,75,5,1
15-02-2025,"Grains, Flours & Dals",FLOUR CHARGE,4,36,36,0,3
15-02-2025,"Grains, Flours & Dals",Sathya Javva Wheat Rava 500GM,4,95,95,0,1
15-02-2025,"Health, Wellness & Ayurvedic Products",RB Max Protein Fruit &amp;Nut 50g,5,75,75,0,1
15-02-2025,"Dry Fruits, Nuts & Seeds",Putnalu 250GM,2,45,38,7,1
15-02-2025,"Grains, Flours & Dals",Wheat Flour 1 kg,4,280,240,40,4
15-02-2025,Pooja & Spiritual Items,GD Kumkum 50GM,12,40,40,0,1
15-02-2025,"Health, Wellness & Ayurvedic Products",RB Max Protein Cheese&amp;,5,45,45,0,1
15-02-2025,"Grains, Flours & Dals",BOMBAY RAVA,4,70,55,15,1
15-02-2025,"Dry Fruits, Nuts & Seeds",ANJEER 250GM,2,400,360,40,1
15-02-2025,"Grains, Flours & Dals",ANDU KORRALU (Brown top .mlt) 500,4,130,110,20,1
15-02-2025,"Grains, Flours & Dals",Chana Flour 1 kg,4,140,130,10,1
15-02-2025,Snacks & Ready-to-Eat,urban murmura,14,45,45,0,1
15-02-2025,Personal Care & Cosmetics,COLGATE ACTIVE SALT,10,20,20,0,1
15-02-2025,"Grains, Flours & Dals",BARLEY FLOUR 250GM,4,45,40,5,1
15-02-2025,"Dry Fruits, Nuts & Seeds",Groundnuts 1 kg,2,190,170,20,1
15-02-2025,"Grains, Flours & Dals",White jowar.F 1 kg,4,200,160,40,2
15-02-2025,"Grains, Flours & Dals",FLOUR CHARGE,4,24,24,0,2
15-02-2025,General Household & Kitchenware,CANDLE,3,120,120,0,4
15-02-2025,"Grains, Flours & Dals",PESARA PAPPU 1 KG,4,340,290,50,2
15-02-2025,Sweeteners,MISHRI 250 GM,16,35,30,5,1
15-02-2025,"Grains, Flours & Dals",Wheat Flour 1 kg,4,70,60,10,1
15-02-2025,"Grains, Flours & Dals",Red uluvalu 500 gms,4,70,70,0,1
15-02-2025,Snacks & Ready-to-Eat,RITEBITE BLUEBERRY BLAST,14,50,50,0,1
15-02-2025,Oils & Ghee,Groundnut oil 1 L,9,360,330,30,1
15-02-2025,"Grains, Flours & Dals",COW B RICE BAG 1,4,2099,"1,750.00",349,1
15-02-2025,Sweeteners,SH JAGGERY POWDER 500GM,16,80,68,12,1
15-02-2025,"Grains, Flours & Dals",Red Wheat Flour 1 kg,4,140,130,10,1
15-02-2025,"Grains, Flours & Dals",Chana Flour 500 gms,4,70,65,5,1
15-02-2025,Pooja & Spiritual Items,SWASTIK CAMPHORE,12,90,90,0,1
15-02-2025,"Health, Wellness & Ayurvedic Products",RB Max Protein Choco chips 55gm,5,50,50,0,1
15-02-2025,"Grains, Flours & Dals",Wheat Flour 1 kg,4,70,60,10,1
15-02-2025,Pooja & Spiritual Items,GOMATHA AGARBATHI,12,75,75,0,1
15-02-2025,Snacks & Ready-to-Eat,SD black sesme laddu with dates 175gm,14,135,135,0,1
15-02-2025,"Grains, Flours & Dals",ANDU KORRALU (Brown top .mlt) 500,4,130,110,20,1
15-02-2025,Sweeteners,NATURAL HONEY 250GM,16,150,130,20,1
15-02-2025,Snacks & Ready-to-Eat,BATANA NGT 70GMS,14,20,20,0,1
15-02-2025,Snacks & Ready-to-Eat,SD Atreyapuram DRY Fruit ghee,14,150,150,0,1
15-02-2025,"Grains, Flours & Dals",JOWAR WHITE 1 KG,4,40,35,5,0.5
15-02-2025,Sweeteners,MISHRI 250 GM,16,35,30,5,1
15-02-2025,"Dry Fruits, Nuts & Seeds",Groundnuts 1 kg,2,190,170,20,1
15-02-2025,Spices & Seasonings,SWEET SOUNF,15,20,20,0,1
15-02-2025,"Dry Fruits, Nuts & Seeds",Groundnuts 1 kg,2,190,170,20,1
15-02-2025,"Grains, Flours & Dals",Multigrain 1 kg,4,300,255,45,3
15-02-2025,Oils & Ghee,Sesame oil 1 L,9,590,560,30,1
15-02-2025,"Grains, Flours & Dals",SL Idly Rava 1KG,4,65,55,10,1
15-02-2025,Oils & Ghee,Groundnut oil 1 L,9,720,660,60,2
15-02-2025,Oils & Ghee,Groundnut oil 1 L,9,360,330,30,1
15-02-2025,Spices & Seasonings,Biryani Leaf 25GM,15,20,20,0,1
15-02-2025,Spices & Seasonings,Japatri 25GM,15,100,80,20,1
15-02-2025,Spices & Seasonings,THOKA MIRYALU 50GM,15,210,180,30,1
15-02-2025,Spices & Seasonings,SATHVI ANASAPUVUU 25GM,15,90,65,25,1
15-02-2025,Spices & Seasonings,Dalchin Rolls 50GM,15,70,70,0,1
15-02-2025,Snacks & Ready-to-Eat,BLACK SESAME CHIKKI,14,45,45,0,1
15-02-2025,Spices & Seasonings,Marati Magga 50GM,15,130,110,20,1
15-02-2025,Spices & Seasonings,Tamarind 250GMS,15,160,130,30,2
15-02-2025,Spices & Seasonings,LG 50GM,15,92,92,0,1
15-02-2025,Oils & Ghee,Sesame oil 1 L,9,590,560,30,1
15-02-2025,"Grains, Flours & Dals",BAJRA 1 KG,4,180,150,30,3
15-02-2025,"Grains, Flours & Dals",JOWAR WHITE 1 KG,4,240,210,30,3
15-02-2025,"Grains, Flours & Dals",FLOUR CHARGE,4,72,72,0,6
15-02-2025,"Dry Fruits, Nuts & Seeds",YELLOW KISHMISH 250GM,2,130,110,20,1
15-02-2025,"Grains, Flours & Dals",RICE FLOUR 1KG,4,140,110,30,2
15-02-2025,"Grains, Flours & Dals",Chana Flour 1 kg,4,700,650,50,5
15-02-2025,Oils & Ghee,Castor oil 500 ml,9,250,200,50,1
15-02-2025,"Grains, Flours & Dals",Wheat Flour 1 kg,4,280,240,40,4
15-02-2025,"Health, Wellness & Ayurvedic Products",RB Max Protein Cheese&amp;,5,45,45,0,1
15-02-2025,"Grains, Flours & Dals",THICK POHA 500GM,4,40,35,5,1
15-02-2025,"Grains, Flours & Dals",Bajra Flour 500 gms,4,35,30,5,1
15-02-2025,Snacks & Ready-to-Eat,VD SAGOPAPAD 150GM,14,110,110,0,2
15-02-2025,Snacks & Ready-to-Eat,VD MULTI CHAKKA,14,110,110,0,1
15-02-2025,"Grains, Flours & Dals",RAGI FLOUR 1KG,4,80,70,10,1
15-02-2025,Snacks & Ready-to-Eat,urban murmura,14,45,45,0,1
15-02-2025,"Grains, Flours & Dals",Wheat Flour 1 kg,4,140,120,20,2
15-02-2025,"Grains, Flours & Dals",Multigrain 1 kg,4,100,85,15,1
15-02-2025,Milk & Dairy,BROWN EGGS 1P,7,280,240,40,20
15-02-2025,"Grains, Flours & Dals",RAGI FLOUR 500GRMS,4,40,35,5,1
15-02-2025,Snacks & Ready-to-Eat,VD PALLI CHIKKI,14,80,80,0,1
15-02-2025,Snacks & Ready-to-Eat,Pani Poori Chips 250GM,14,50,40,10,1
15-02-2025,Snacks & Ready-to-Eat,SD JOWAR WITH PALM JAGGERY 250GM,14,135,135,0,1
15-02-2025,"Grains, Flours & Dals",Brown RICE 1KG,4,210,195,15,3
15-02-2025,"Grains, Flours & Dals",Green Batani 250GM,4,55,45,10,1
15-02-2025,"Grains, Flours & Dals",Yellow jowar .F1 kg,4,110,100,10,1
15-02-2025,Snacks & Ready-to-Eat,VD RICE PAPAD 150GM,14,50,50,0,1
15-02-2025,Snacks & Ready-to-Eat,BATANA NGT 70GMS,14,20,20,0,1
15-02-2025,Snacks & Ready-to-Eat,VD RIBBON PAKODI 175GM,14,60,60,0,1
15-02-2025,Oils & Ghee,Coconut oil 1 L,9,440,400,40,1
15-02-2025,Oils & Ghee,Coconut oil 500 ml,9,220,200,20,1
15-02-2025,Oils & Ghee,Safflower oil 1 L,9,440,400,40,1
15-02-2025,Snacks & Ready-to-Eat,NGT CHATPATTA CHANA 90GM,14,25,25,0,1
15-02-2025,Oils & Ghee,Flaxseed oil 1 L,9,520,480,40,1
15-02-2025,General Household & Kitchenware,SIRIDHANYALU BOOK,3,200,180,20,1
15-02-2025,"Grains, Flours & Dals",JOWAR YELLOW 1 K,4,100,90,10,1
15-02-2025,"Grains, Flours & Dals",Quinova 500 gms,4,110,100,10,1
15-02-2025,Snacks & Ready-to-Eat,RSC ORANGE 100GMS,14,20,20,0,1
15-02-2025,Beverages,BRU GREEN LABEL 1.2G,1,96,96,0,48
15-02-2025,Spices & Seasonings,DRY MIECHI 200GM,15,80,60,20,1
15-02-2025,"Health, Wellness & Ayurvedic Products",MH Millets Malt 500GM,5,200,190,10,1
15-02-2025,Personal Care & Cosmetics,GAYATHRI KUMKUDUKAYA,10,150,150,0,1
15-02-2025,"Health, Wellness & Ayurvedic Products",HARITHAKI CHOORNAM,5,60,60,0,1
15-02-2025,"Dry Fruits, Nuts & Seeds",DIANUTS 500GM,2,120,120,0,1
15-02-2025,"Health, Wellness & Ayurvedic Products",MD Vasa Choornam 30GM,5,80,80,0,1
15-02-2025,"Dry Fruits, Nuts & Seeds",YB GRANMA NUTS,2,90,90,0,1
15-02-2025,Snacks & Ready-to-Eat,BELLAM MINAPA SUNADULLU,14,180,180,0,1
15-02-2025,Snacks & Ready-to-Eat,VD DRY FRUIT PUTHAREKULU,14,120,120,0,1
15-02-2025,Snacks & Ready-to-Eat,SD Atreyapuram DRY Fruit ghee,14,150,150,0,1
15-02-2025,Snacks & Ready-to-Eat,VD PALLI LADDU,14,80,80,0,1
15-02-2025,Snacks & Ready-to-Eat,FOXTAIL BIS,14,135,135,0,1
15-02-2025,Snacks & Ready-to-Eat,VD Pappu Chekkalu 190gm,14,60,60,0,1
15-02-2025,Snacks & Ready-to-Eat,SD Aswagandha with palm Jaggery250Gm,14,135,135,0,1
15-02-2025,Snacks & Ready-to-Eat,RAGI LADDU,14,120,120,0,1
15-02-2025,Snacks & Ready-to-Eat,GANTASALA GINGER SNACKS 150GM,14,60,60,0,1
15-02-2025,Oils & Ghee,Safflower oil 1 L,9,440,400,40,1
15-02-2025,Snacks & Ready-to-Eat,NGT CHATPATTA CHANA 90GM,14,25,25,0,1
15-02-2025,Snacks & Ready-to-Eat,VD PAPPU CHEGODI 200GM,14,60,60,0,1
15-02-2025,Snacks & Ready-to-Eat,VD MANGO JELLY 250GRMS,14,80,80,0,1
15-02-2025,Snacks & Ready-to-Eat,VD ATUKULU MIXTURE 175GM,14,60,60,0,1
15-02-2025,Milk & Dairy,BROWN EGGS 1P,7,210,180,30,15
15-02-2025,Oils & Ghee,Freedom Rice Bran Oil 1L,9,194,180,14,1
15-02-2025,"Grains, Flours & Dals",turdal 500 gms,4,220,200,20,2
15-02-2025,Pooja & Spiritual Items,BALAJI ROSE DHOOP STIKS 10STK,12,125,125,0,1
15-02-2025,Oils & Ghee,Groundnut oil 1 L,9,360,330,30,1
15-02-2025,Pooja & Spiritual Items,GD JASMINE,12,120,120,0,2
15-02-2025,Pooja & Spiritual Items,GD Dhoop Sticks 26GM,12,20,20,0,1
15-02-2025,Pooja & Spiritual Items,GD JASMINE 75GM,12,120,120,0,2
15-02-2025,Milk & Dairy,BROWN EGGS 1P,7,210,180,30,15
15-02-2025,"Grains, Flours & Dals",turdal 500 gms,4,220,200,20,2
15-02-2025,Oils & Ghee,Groundnut oil 1 L,9,360,330,30,1
15-02-2025,Oils & Ghee,Freedom Rice Bran Oil 1L,9,194,180,14,1
15-02-2025,Snacks & Ready-to-Eat,VD SANNAPUSA 175GM,14,60,60,0,1
15-02-2025,"Dry Fruits, Nuts & Seeds",Groundnuts 500 gms,2,95,85,10,1
15-02-2025,Snacks & Ready-to-Eat,VD Pappu Chekkalu 190gm,14,60,60,0,1
15-02-2025,Beverages,BRU GREEN LABEL 1.2G,1,144,144,0,72
15-02-2025,Spices & Seasonings,Chilli powder 500 gms,15,290,210,80,1
15-02-2025,Spices & Seasonings,SREE MARUTHI IDLY KARAM 200GM,15,60,60,0,1
15-02-2025,Snacks & Ready-to-Eat,VD RED CHILLI RICEPAPAD 150GM,14,300,300,0,6
15-02-2025,Snacks & Ready-to-Eat,VD RICE SAGO PAPAD 150GM,14,110,110,0,2
15-02-2025,Snacks & Ready-to-Eat,3D PAPAD,14,120,120,0,3
15-02-2025,Snacks & Ready-to-Eat,VD RICE PAPAD 150GM,14,50,50,0,1
15-02-2025,Snacks & Ready-to-Eat,VD SAGOPAPAD 150GM,14,165,165,0,3
15-02-2025,Snacks & Ready-to-Eat,SD Groundnut with palm jaggery 250gm,14,135,135,0,1
15-02-2025,"Dry Fruits, Nuts & Seeds",CASHEW 250GM,2,340,310,30,1
15-02-2025,Spices & Seasonings,RED COPRA 250GMS,15,85,74,11,1
15-02-2025,"Grains, Flours & Dals",JOWAR WHITE 1 KG,4,80,70,10,1
15-02-2025,"Dry Fruits, Nuts & Seeds",SUNFLOWER SEEDS 250GRM,2,150,130,20,1
15-02-2025,"Grains, Flours & Dals",RED RICE 1KG,4,150,120,30,1
15-02-2025,"Grains, Flours & Dals",Bajra Flour 1 kg,4,70,60,10,1
15-02-2025,"Dry Fruits, Nuts & Seeds",PUMPKIN SEEDS 250GM,2,200,160,40,1
15-02-2025,"Dry Fruits, Nuts & Seeds",WATERMELON SEEDS 250GRM,2,320,280,40,1
15-02-2025,Sweeteners,YB Brown Sugar 500GM,16,75,75,0,1
15-02-2025,Snacks & Ready-to-Eat,SD Aswagandha with palm Jaggery250Gm,14,135,135,0,1
15-02-2025,Snacks & Ready-to-Eat,VD MURUKU 175GM,14,60,60,0,1
15-02-2025,"Grains, Flours & Dals",EM Ragi idli R 500G,4,150,150,0,2
15-02-2025,"Grains, Flours & Dals",RAGI FLOUR 1KG,4,160,140,20,2
15-02-2025,"Grains, Flours & Dals",MAAGAANI LOW GI SP L 1KG,4,240,210,30,2
15-02-2025,Pooja & Spiritual Items,VRP APOORVA JAVADHU POW,12,35,35,0,1
15-02-2025,"Health, Wellness & Ayurvedic Products",RB Max Protein Choco Almond bar 50g,5,75,75,0,1
15-02-2025,Personal Care & Cosmetics,OVAL BODY LOOFAH,10,110,110,0,2
15-02-2025,"Health, Wellness & Ayurvedic Products",MD Neem Leaf Choornam 100GM,5,80,80,0,1
15-02-2025,"Health, Wellness & Ayurvedic Products",MD Ashwagandha Choornam 100GM,5,170,170,0,1
15-02-2025,"Health, Wellness & Ayurvedic Products",MD Triphala Chorrnam 100GM,5,80,80,0,1
15-02-2025,Snacks & Ready-to-Eat,VD MULTI CHAKKA,14,110,110,0,1
15-02-2025,"Grains, Flours & Dals",Wheat Rava M 1KG,4,65,55,10,1
15-02-2025,Milk & Dairy,BROWN EGGS TRAY 30P,7,360,330,30,1
15-02-2025,Oils & Ghee,Groundnut oil 1 L,9,720,660,60,2
15-02-2025,Spices & Seasonings,SATHVI ANASAPUVUU 25GM,15,90,65,25,1
15-02-2025,Spices & Seasonings,Masala Karam 250 gms,15,130,120,10,1
15-02-2025,"Grains, Flours & Dals",MELMEKER 250GMS,4,60,45,15,1
15-02-2025,Snacks & Ready-to-Eat,VD PALLI LADDU,14,80,80,0,1
15-02-2025,"Grains, Flours & Dals",BOMBAY RAVA,4,70,55,15,1
15-02-2025,Snacks & Ready-to-Eat,NGT CHATPATTA CHANA 90GM,14,25,25,0,1
15-02-2025,Oils & Ghee,Coconut oil 1 L,9,440,400,40,1
15-02-2025,"Dry Fruits, Nuts & Seeds",SABJA SEEDS 100GM,2,80,70,10,1
15-02-2025,Spices & Seasonings,Telaga Pindi 250 GM,15,40,35,5,1
15-02-2025,"Grains, Flours & Dals",SRILATHA RICE RAVVA 500GM,4,128,128,0,4
15-02-2025,Household & Cleaning,VIM TROPICAL LEMON FRESHNESS 250ML,6,55,55,0,1
15-02-2025,Snacks & Ready-to-Eat,VD MURUKU 175GM,14,60,60,0,1
15-02-2025,"Dry Fruits, Nuts & Seeds",PUMPKIN SEEDS 250GM,2,200,160,40,1
15-02-2025,"Grains, Flours & Dals",RAGI FLOUR 1KG,4,80,70,10,1
15-02-2025,Household & Cleaning,VIM EXTRA 110GM,6,15,15,0,1
15-02-2025,"Dry Fruits, Nuts & Seeds",WATERMELON SEEDS 250GRM,2,320,280,40,1
15-02-2025,"Dry Fruits, Nuts & Seeds",FLAX SEEDS 250GM,2,60,50,10,1
15-02-2025,"Grains, Flours & Dals",PRO ORG MEDIUM POHA 500G,4,78,78,0,1
15-02-2025,Sweeteners,YB JAGGERY POWDER 1KG,16,140,140,0,1
15-02-2025,"Grains, Flours & Dals",RED TURDAL 500GM,4,75,70,5,1
15-02-2025,"Grains, Flours & Dals",SAMALU (Little millet) 1 kg,4,170,130,40,1
15-02-2025,Oils & Ghee,Cow ghee 500 ml,9,430,390,40,1
15-02-2025,"Grains, Flours & Dals",KORRALU (FOXTAIL M) 1KG,4,150,110,40,1
15-02-2025,Oils & Ghee,Groundnut oil 1 L,9,360,330,30,1
15-02-2025,"Grains, Flours & Dals",SAMALU (Little millet) 500 gms,4,85,65,20,1
15-02-2025,Snacks & Ready-to-Eat,VD KOBARI LADDU,14,80,80,0,1
15-02-2025,Snacks & Ready-to-Eat,VD MINAPA SUNNUNDALU 12P,14,180,180,0,1
15-02-2025,Snacks & Ready-to-Eat,SALTED PHALLI,14,65,65,0,1
15-02-2025,Snacks & Ready-to-Eat,SD JOWAR WITH PALM JAGGERY 250GM,14,135,135,0,1
15-02-2025,"Dry Fruits, Nuts & Seeds",BLACK KISMIS 250GM,2,175,140,35,1
15-02-2025,"Dry Fruits, Nuts & Seeds",PUMPKIN SEEDS 250GM,2,200,160,40,1
15-02-2025,"Dry Fruits, Nuts & Seeds",WATERMELON SEEDS 250GRM,2,320,280,40,1
15-02-2025,"Grains, Flours & Dals",SH RED POHA 500GM,4,255,255,0,3
15-02-2025,"Grains, Flours & Dals",RAGI FLOUR 1KG,4,160,140,20,2
15-02-2025,Sweeteners,MADHUR SUGAR 1KG,16,65,55,10,1
15-02-2025,"Grains, Flours & Dals",Wheat Flour 1 kg,4,140,120,20,2
15-02-2025,Personal Care & Cosmetics,Soapnut 250GM,10,45,45,0,1
15-02-2025,Sweeteners,GS Palm Jaggery Powder 400GM,16,360,360,0,2
15-02-2025,Snacks & Ready-to-Eat,NGT CHATPATTA CHANA 90GM,14,50,50,0,2
15-02-2025,Spices & Seasonings,SREE MARUTHI IDLY KARAM 200GM,15,60,60,0,1
15-02-2025,Spices & Seasonings,SAMBAR POWDER 200GM,15,130,110,20,1
15-02-2025,Spices & Seasonings,DHANIYA POWDER 200GM,15,100,85,15,1
15-02-2025,Spices & Seasonings,GARAM MASALA 200GM,15,120,95,25,1
15-02-2025,Snacks & Ready-to-Eat,BATANA NGT 70GMS,14,40,40,0,2
15-02-2025,Pooja & Spiritual Items,SOSR SWATHHI 365,12,120,120,0,4
15-02-2025,Oils & Ghee,Castor oil 200 ml,9,100,80,20,1
15-02-2025,Pooja & Spiritual Items,GD Aiswarya Deepam 700ML,12,195,195,0,1
15-02-2025,Household & Cleaning,ROOPERI PITAMBARI SILVER 50ML,6,110,110,0,1
15-02-2025,Misc,JOKER,8,20,20,0,10
15-02-2025,Oils & Ghee,Safflower oil 1 L,9,440,400,40,1
15-02-2025,"Grains, Flours & Dals",PRO ORG TUR DAL UNPOLISHED 500GM,4,176,176,0,1
15-02-2025,Oils & Ghee,Groundnut oil 1 L,9,720,660,60,2
15-02-2025,Snacks & Ready-to-Eat,VD Pappu Chekkalu 190gm,14,60,60,0,1
15-02-2025,"Grains, Flours & Dals",VYS.SP RICE 1 KG,4,700,650,50,10
15-02-2025,Snacks & Ready-to-Eat,VD RIBBON PAKODI 175GM,14,60,60,0,1
15-02-2025,Spices & Seasonings,Tamarind 250GMS,15,80,65,15,1
15-02-2025,Snacks & Ready-to-Eat,VD MURUKU 175GM,14,60,60,0,1
15-02-2025,Spices & Seasonings,Jeera 100GM,15,50,45,5,1
15-02-2025,Spices & Seasonings,AVALU 100GM,15,25,20,5,1
15-02-2025,Milk & Dairy,HERITAGE TONED MILK 500ML,7,62,62,0,2
15-02-2025,Snacks & Ready-to-Eat,BB VERMICELLI 1KG,14,95,90,5,1
15-02-2025,"Health, Wellness & Ayurvedic Products",MH Millets Malt 500GM,5,200,190,10,1
15-02-2025,"Grains, Flours & Dals",Multigrain 500 gms,4,50,43,7,1
15-02-2025,Snacks & Ready-to-Eat,VD JAGGERY GHEE 250GM,14,120,120,0,1
15-02-2025,Oils & Ghee,Groundnut oil 1 L,9,360,330,30,1
15-02-2025,Snacks & Ready-to-Eat,VD KOBARI LADDU,14,80,80,0,1
14-02-2025,Spices & Seasonings,SREE MARUTHI IDLY KARAM 200GM,15,60,60,0,1
14-02-2025,Snacks & Ready-to-Eat,BLACK SESAME CHIKKI,14,10,10,0,1
14-02-2025,Snacks & Ready-to-Eat,ELITE MILK RUSK 200GM,14,35,35,0,1
14-02-2025,"Grains, Flours & Dals",THIN POHA 500GM,4,40,35,5,1
14-02-2025,Snacks & Ready-to-Eat,BLACK SESAME CHIKKI,14,5,5,0,1
14-02-2025,Snacks & Ready-to-Eat,TILLI CHIKKI,14,125,125,0,1
14-02-2025,Sweeteners,MISHRI D,16,40,30,10,1
14-02-2025,Snacks & Ready-to-Eat,BATANA NGT 70GMS,14,20,20,0,1
14-02-2025,Beverages,ASSAM MASALA TEA,1,199,199,0,1
14-02-2025,Personal Care & Cosmetics,REVIVE ANTI BACTERIA 50GM,10,20,20,0,1
14-02-2025,Milk & Dairy,BROWN EGGS 1P,7,56,48,8,4
14-02-2025,"Grains, Flours & Dals",RAGI FLOUR 500GRMS,4,40,35,5,1
14-02-2025,"Grains, Flours & Dals",Green gram 500 gms,4,75,70,5,1
14-02-2025,"Grains, Flours & Dals",UDALU (Barnyard millet) 500 gms,4,70,60,10,1
14-02-2025,Household & Cleaning,VIM SOAP,6,20,20,0,4
14-02-2025,"Grains, Flours & Dals",Quinova 500 gms,4,110,100,10,1
14-02-2025,"Grains, Flours & Dals",Arikalu (kodo),4,70,65,5,1
14-02-2025,"Grains, Flours & Dals",KORRALU (FOXTAIL M) 500GM,4,65,55,10,1
14-02-2025,Snacks & Ready-to-Eat,SF NOODLES CLKASSIC MASALA,14,129,129,0,1
14-02-2025,Spices & Seasonings,SD IDLY KARAM,15,65,65,0,1
14-02-2025,Snacks & Ready-to-Eat,VD MURMURA LADDU,14,50,50,0,1
14-02-2025,Snacks & Ready-to-Eat,VD MANGO JELLY 250GRMS,14,80,80,0,1
14-02-2025,Sweeteners,YB JAGGERY POWDER 500GMS,16,225,225,0,3
14-02-2025,"Dry Fruits, Nuts & Seeds",Putnalu 250GM,2,45,38,7,1
14-02-2025,"Grains, Flours & Dals",SABDANA 500GM,4,90,70,20,1
14-02-2025,"Grains, Flours & Dals",Wheat Flour 1 kg,4,420,360,60,6
14-02-2025,Spices & Seasonings,Avalu small 250 gms,15,60,40,20,1
14-02-2025,"Grains, Flours & Dals",Chana Flour 500 gms,4,70,65,5,1
14-02-2025,"Grains, Flours & Dals",Idly Rava L 1KG,4,60,50,10,1
14-02-2025,Sweeteners,YB JAGGERY POWDER 1KG,16,140,140,0,1
14-02-2025,"Grains, Flours & Dals",UDALU (Barnyard millet) 1 kg,4,140,115,25,1
14-02-2025,"Grains, Flours & Dals",RAGI FLOUR 1KG,4,160,140,20,2
14-02-2025,Milk & Dairy,BROWN EGGS TRAY 30P,7,720,660,60,2
14-02-2025,Milk & Dairy,BROWN EGGS 1P,7,84,72,12,6
14-02-2025,Pooja & Spiritual Items,BALAJI BEL PHOOL STICKS 90GM,12,60,60,0,1
14-02-2025,Pooja & Spiritual Items,VRP APOORVA JAVADHU POW,12,35,35,0,1
14-02-2025,"Grains, Flours & Dals",KORRALU (FOXTAIL M) 1KG,4,300,220,80,2
14-02-2025,"Grains, Flours & Dals",Red Wheat Flour 1 kg,4,140,130,10,1
14-02-2025,"Grains, Flours & Dals",BASMATHI RICE 1KG,4,150,135,15,1
14-02-2025,"Grains, Flours & Dals",MELMEKER 250GMS,4,60,45,15,1
14-02-2025,Sweeteners,YB JAGGERY POWDER 1KG,16,140,140,0,1
14-02-2025,"Dry Fruits, Nuts & Seeds",Groundnuts 500 gms,2,95,85,10,1
14-02-2025,Oils & Ghee,Coconut oil 1 L,9,440,400,40,1
14-02-2025,Snacks & Ready-to-Eat,NGT CHATPATTA CHANA 90GM,14,50,40,10,2
14-02-2025,Spices & Seasonings,Tamarind 250GMS,15,80,65,15,1
14-02-2025,Personal Care & Cosmetics,Soapnut 250GM,10,60,45,15,1
14-02-2025,Household & Cleaning,PITAMBARI,6,28,28,0,1
14-02-2025,Pooja & Spiritual Items,VRP APOORVA JAVADHU POW,12,35,35,0,1
14-02-2025,"Dry Fruits, Nuts & Seeds",FLAX SEEDS 250GM,2,60,50,10,1
14-02-2025,"Dry Fruits, Nuts & Seeds",PUMPKIN SEEDS 250GM,2,400,320,80,2
14-02-2025,"Dry Fruits, Nuts & Seeds",WATERMELON SEEDS 250GRM,2,640,560,80,2
14-02-2025,Household & Cleaning,VIM MAHA BAR,6,30,30,0,3
14-02-2025,"Dry Fruits, Nuts & Seeds",ALMONDS 250GM,2,280,260,20,1
14-02-2025,Spices & Seasonings,JEERA 250 gms,15,125,105,20,1
14-02-2025,"Dry Fruits, Nuts & Seeds",CASHEW 250GM,2,340,310,30,1
14-02-2025,Spices & Seasonings,DRY MIECHI 200GM,15,160,120,40,2
14-02-2025,"Dry Fruits, Nuts & Seeds",SUNFLOWER SEEDS 250GRM,2,300,260,40,2
14-02-2025,Snacks & Ready-to-Eat,VD NUVVULU LADDU,14,80,80,0,1
14-02-2025,Snacks & Ready-to-Eat,GB SALT COOKIES,14,60,55,5,1
14-02-2025,"Grains, Flours & Dals",Idly Rava L 1KG,4,60,50,10,1
14-02-2025,Spices & Seasonings,Masala Karam 250 gms,15,260,240,20,2
14-02-2025,Milk & Dairy,BROWN EGGS 1P,7,168,144,24,12
14-02-2025,Sweeteners,YB JAGGERY POWDER 500GMS,16,75,75,0,1
14-02-2025,Oils & Ghee,Groundnut oil 1 L,9,720,660,60,2
14-02-2025,Pooja & Spiritual Items,GD Dhoop Cones 40GM,12,30,30,0,1
14-02-2025,Pooja & Spiritual Items,GD JASMINE 75GM,12,60,60,0,1
14-02-2025,Pooja & Spiritual Items,GD Dhoop Sticks 26GM,12,20,20,0,1
14-02-2025,Pooja & Spiritual Items,BALAJI SANDAL DHOOP STICKS 10STK,12,125,125,0,1
14-02-2025,"Grains, Flours & Dals",Red Wheat Flour 1 kg,4,140,130,10,1
14-02-2025,"Grains, Flours & Dals",White jowar.F 1 kg,4,100,80,20,1
14-02-2025,Snacks & Ready-to-Eat,VD PALLI LADDU,14,80,80,0,1
14-02-2025,Snacks & Ready-to-Eat,RSC ORANGE 100GMS,14,20,20,0,1
14-02-2025,"Grains, Flours & Dals",Hs yellow jowar r 500g,4,99,99,0,1
14-02-2025,Snacks & Ready-to-Eat,BATANA NGT 70GMS,14,40,40,0,2
14-02-2025,Oils & Ghee,Groundnut oil 1 L,9,720,660,60,2
14-02-2025,Snacks & Ready-to-Eat,NGT CHATPATTA CHANA 90GM,14,25,25,0,1
14-02-2025,Snacks & Ready-to-Eat,VD MANGO JELLY 250GRMS,14,80,80,0,1
14-02-2025,"Grains, Flours & Dals",VL Sabdana 500GM,4,77,77,0,1
14-02-2025,Oils & Ghee,Safflower oil 1 L,9,440,400,40,1
14-02-2025,Oils & Ghee,Sesame oil 1 L,9,590,560,30,1
14-02-2025,Snacks & Ready-to-Eat,VD PAPPU CHEGODI 200GM,14,60,60,0,1
14-02-2025,Snacks & Ready-to-Eat,VD KOBARI LADDU,14,80,80,0,1
14-02-2025,Sweeteners,YB JAGGERY POWDER 1KG,16,140,140,0,1
14-02-2025,Snacks & Ready-to-Eat,VD Pappu Chekkalu 190gm,14,60,60,0,1
14-02-2025,Snacks & Ready-to-Eat,DOSA BATTER 1KG,14,60,60,0,1
14-02-2025,Snacks & Ready-to-Eat,VD ATUKULU MIXTURE 175GM,14,60,60,0,1
14-02-2025,Snacks & Ready-to-Eat,BATANA NGT 70GMS,14,20,20,0,1
14-02-2025,"Grains, Flours & Dals",AISHWARYA SP 5KG,4,400,375,25,1
14-02-2025,"Grains, Flours & Dals",Wheat Flour 3 kgs,4,210,180,30,1
14-02-2025,"Grains, Flours & Dals",Arikalu (kodo),4,70,65,5,1
14-02-2025,"Grains, Flours & Dals",KORRALU (FOXTAIL M) 500GM,4,65,55,10,1
14-02-2025,"Dry Fruits, Nuts & Seeds",BLACK KISMIS 250GM,2,175,140,35,1
14-02-2025,"Dry Fruits, Nuts & Seeds",CASHEW 250GM,2,340,310,30,1
14-02-2025,"Grains, Flours & Dals",Wheat Rava M 500GM,4,33,30,3,1
14-02-2025,"Grains, Flours & Dals",RAJMA 250GM,4,55,45,10,1
14-02-2025,"Grains, Flours & Dals",RAGI FLOUR 500GRMS,4,40,35,5,1
14-02-2025,"Grains, Flours & Dals",SA Sprouted Ragi Flour 500GM,4,69,69,0,1
14-02-2025,"Grains, Flours & Dals",KORRALU (FOXTAIL M) 1KG,4,150,110,40,1
14-02-2025,Snacks & Ready-to-Eat,VD SANNAPUSA 175GM,14,60,60,0,1
14-02-2025,"Grains, Flours & Dals",Bajra Flour 500 gms,4,35,30,5,1
14-02-2025,Snacks & Ready-to-Eat,VD NUVULLU CHIKKI,14,80,80,0,1
14-02-2025,Oils & Ghee,Groundnut oil 5 L,9,1800,"1,600.00",200,1
14-02-2025,Snacks & Ready-to-Eat,BATANA NGT 70GMS,14,20,20,0,1
14-02-2025,Snacks & Ready-to-Eat,VD NUVVULU LADDU,14,80,80,0,1
14-02-2025,"Health, Wellness & Ayurvedic Products",MD Triphala Chorrnam 100GM,5,160,160,0,2
14-02-2025,"Grains, Flours & Dals",WHEAT 1 KG,4,120,100,20,2
14-02-2025,"Grains, Flours & Dals",SAMALU (Little millet) 500 gms,4,85,65,20,1
14-02-2025,"Dry Fruits, Nuts & Seeds",SATHVI CHIA SEEDS 100GM,2,100,80,20,1
14-02-2025,"Grains, Flours & Dals",RAGULU 1 KG,4,70,60,10,1
14-02-2025,"Grains, Flours & Dals",UDALU (Barnyard millet) 500 gms,4,70,60,10,1
14-02-2025,"Grains, Flours & Dals",Arikalu (kodo),4,70,65,5,1
14-02-2025,"Grains, Flours & Dals",BARLEY SEEDS 250GMS,4,40,35,5,1
14-02-2025,Snacks & Ready-to-Eat,GB SALT COOKIES,14,60,55,5,1
14-02-2025,"Grains, Flours & Dals",KORRALU (FOXTAIL M) 500GM,4,65,55,10,1
14-02-2025,"Grains, Flours & Dals",BAJRA 1 KG,4,30,25,5,0.5
14-02-2025,Snacks & Ready-to-Eat,RAJGIRA PEANUT CHIKKI 450GM,14,250,250,0,2
14-02-2025,"Grains, Flours & Dals",White jowar.F 1 kg,4,300,240,60,3
14-02-2025,"Grains, Flours & Dals",FLOUR CHARGE,4,22.8,22.8,0,1.9
14-02-2025,Snacks & Ready-to-Eat,VD RICE PAPAD 150GM,14,50,50,0,1
14-02-2025,Snacks & Ready-to-Eat,VD SAGOPAPAD 150GM,14,55,55,0,1
14-02-2025,Personal Care & Cosmetics,HERBAL BATH POWDER 200GM,10,80,80,0,1
14-02-2025,"Grains, Flours & Dals",Wheat Flour 1 kg,4,70,60,10,1
14-02-2025,Snacks & Ready-to-Eat,VD KOBARI LADDU,14,80,80,0,1
14-02-2025,Milk & Dairy,HRITAGE TOTAL CURD 130GM,7,10,10,0,1
14-02-2025,"Dry Fruits, Nuts & Seeds",SALTED PISTA 250GM,2,400,350,50,1
14-02-2025,Snacks & Ready-to-Eat,NGT CHATPATTA CHANA 90GM,14,25,25,0,1
14-02-2025,Snacks & Ready-to-Eat,VD PALLI CHIKKI,14,80,80,0,1
14-02-2025,Snacks & Ready-to-Eat,SD Atreyapuram DRY Fruit ghee,14,150,150,0,1
14-02-2025,Snacks & Ready-to-Eat,SESAME CHIKKI,14,120,100,20,1
14-02-2025,Snacks & Ready-to-Eat,VD MULTI CHAKKA,14,110,110,0,1
14-02-2025,"Grains, Flours & Dals",RICE FLOUR 1KG,4,70,55,15,1
14-02-2025,Snacks & Ready-to-Eat,SD FINGER Millet with palm Jaggery 250gm,14,135,135,0,1
14-02-2025,"Grains, Flours & Dals",SINGLE POLISH 1KG,4,325,325,0,5
14-02-2025,"Grains, Flours & Dals",DH URAD GOTA 1KG,4,215,190,25,1
14-02-2025,"Grains, Flours & Dals",BOMBAY RAVA,4,70,55,15,1
14-02-2025,Spices & Seasonings,Tamarind 500GM,15,160,130,30,1
14-02-2025,Snacks & Ready-to-Eat,VD MINAPA SUNNUNDALU 12P,14,180,180,0,1
14-02-2025,Snacks & Ready-to-Eat,TILLI CHIKKI,14,20,20,0,4
14-02-2025,"Grains, Flours & Dals",Wheat Flour 1 kg,4,70,60,10,1
14-02-2025,Spices & Seasonings,KALONJI SEEDS,15,90,80,10,1
14-02-2025,Snacks & Ready-to-Eat,RI Yogurt Berry Oats 35g,14,45,45,0,1
14-02-2025,Snacks & Ready-to-Eat,SD Atreyapuram DRY Fruit ghee,14,150,150,0,1
14-02-2025,"Grains, Flours & Dals",JOWAR WHITE 1 KG,4,80,70,10,1
14-02-2025,Snacks & Ready-to-Eat,TILLI CHIKKI,14,5,5,0,1
14-02-2025,"Grains, Flours & Dals",Arikadu ( kodo),4,140,130,10,1
14-02-2025,Snacks & Ready-to-Eat,SD black sesme laddu with dates 175gm,14,135,135,0,1
14-02-2025,Spices & Seasonings,Tamarind 250GMS,15,80,65,15,1
14-02-2025,Milk & Dairy,HRITAGE TOTAL CURD 130GM,7,10,10,0,1
14-02-2025,"Dry Fruits, Nuts & Seeds",SABJA SEEDS 100GM,2,80,70,10,1
14-02-2025,Spices & Seasonings,Elaichi 25GM,15,145,120,25,1
14-02-2025,"Grains, Flours & Dals",ROXY POORI ATTA 1KG,4,30,30,0,1
14-02-2025,"Grains, Flours & Dals",RAGI FLOUR 1KG,4,80,70,10,1
14-02-2025,"Grains, Flours & Dals",HS RAGI Idly rava 500 gms,4,70,70,0,1
14-02-2025,Snacks & Ready-to-Eat,PEANUT CANDY,14,45,45,0,1
14-02-2025,Snacks & Ready-to-Eat,PEANUT CHIKKI,14,22,22,0,1
14-02-2025,"Grains, Flours & Dals",Hs yellow jowar r 500g,4,99,99,0,1
14-02-2025,Oils & Ghee,Groundnut oil 5 L,9,1800,"1,600.00",200,1
14-02-2025,Snacks & Ready-to-Eat,VD MULTI CHAKKA,14,110,110,0,1
14-02-2025,"Grains, Flours & Dals",Red Chana 500 GM,4,75,60,15,1
14-02-2025,"Grains, Flours & Dals",Green gram 1 kg,4,150,130,20,1
14-02-2025,Snacks & Ready-to-Eat,SD GINGER CANDY 200GM,14,120,120,0,1
14-02-2025,"Grains, Flours & Dals",white Bobarlu 500 gms,4,80,75,5,1
14-02-2025,"Grains, Flours & Dals",Idly Rava L 1KG,4,60,50,10,1
14-02-2025,"Grains, Flours & Dals",RICE FLOUR 500 GM,4,35,28,7,1
14-02-2025,Oils & Ghee,Groundnut oil 1 L,9,360,330,30,1
14-02-2025,"Grains, Flours & Dals",Chana Flour 1 kg,4,140,130,10,1
14-02-2025,"Grains, Flours & Dals",Em jowar idly R 500G,4,75,75,0,1
14-02-2025,"Grains, Flours & Dals",Wheat Flour 1 kg,4,70,60,10,1
14-02-2025,Milk & Dairy,HERITAGE TONED MILK 500ML,7,31,31,0,1
14-02-2025,Sweeteners,SUGAR 1KG,16,60,50,10,1
14-02-2025,Pooja & Spiritual Items,SWASTIK CAMPHOR 10GM,12,20,20,0,1
14-02-2025,General Household & Kitchenware,MATCH BOX,3,20,20,0,1
14-02-2025,Pooja & Spiritual Items,HERBAL SANDALWOOD STICK,12,45,45,0,1
14-02-2025,"Grains, Flours & Dals",CHANA DAL 1KG,4,140,120,20,1
14-02-2025,Spices & Seasonings,AV Iodized Salt 1KG,15,28,25,3,1
14-02-2025,Oils & Ghee,Freedom Rice Bran Oil 1L,9,194,180,14,1
14-02-2025,Spices & Seasonings,Turmeric powder 250 gms,15,100,75,25,1
14-02-2025,"Grains, Flours & Dals",EM jowar upma R 500G,4,75,75,0,1
14-02-2025,Milk & Dairy,BROWN EGGS TRAY 30P,7,360,330,30,1
14-02-2025,Sweeteners,SH JAGGERY POWDER 500GM,16,80,68,12,1
14-02-2025,Oils & Ghee,Groundnut oil 500ml,9,180,165,15,1
14-02-2025,Snacks & Ready-to-Eat,VD MINAPA VADIYAM,14,65,65,0,1
14-02-2025,Sweeteners,YB Brown Sugar 500GM,16,150,150,0,2
14-02-2025,Pooja & Spiritual Items,SREEJA R.B.OIL POOJA 80ML,12,38,38,0,1
14-02-2025,Snacks & Ready-to-Eat,VD NUVULLU CHIKKI,14,80,80,0,1
14-02-2025,"Grains, Flours & Dals",URAD DALL,4,95,85,10,1
14-02-2025,Oils & Ghee,Groundnut oil 500ml,9,180,165,15,1
14-02-2025,"Grains, Flours & Dals",turdal 500 gms,4,110,100,10,1
14-02-2025,Snacks & Ready-to-Eat,VD MINAPA VADIYAM,14,65,65,0,1
14-02-2025,"Grains, Flours & Dals",EM Foxtail idli r 500 g,4,109,109,0,1
14-02-2025,Snacks & Ready-to-Eat,SD Sesame laddu with dates250gm,14,135,135,0,1
14-02-2025,"Grains, Flours & Dals",split green gram 500 gms,4,75,70,5,1
14-02-2025,Personal Care & Cosmetics,DWI ALOEVERA 100GM,10,100,100,0,1
14-02-2025,Pooja & Spiritual Items,GB Bharatha Woods 75GM,12,60,60,0,1
14-02-2025,Sweeteners,GS Organic Jaggery Powder 600GM,16,99,99,0,1
14-02-2025,"Grains, Flours & Dals",PESARA PAPPU 500GMS,4,85,75,10,1
14-02-2025,"Grains, Flours & Dals",SB Javva Wheat Ravva 500GM,4,95,95,0,1
14-02-2025,Pooja & Spiritual Items,GD Ramayana Sandal 75GM,12,60,60,0,1
14-02-2025,Sweeteners,Natural Honey 500 gms,16,280,240,40,1
14-02-2025,"Grains, Flours & Dals",Bajra Flour 1 kg,4,70,60,10,1
14-02-2025,Sweeteners,ACHU BELLAM 1KG,16,100,80,20,1
14-02-2025,Oils & Ghee,Cow ghee 500 ml,9,430,390,40,1
14-02-2025,Snacks & Ready-to-Eat,PEANUT CHIKKI 450GM,14,125,125,0,1
14-02-2025,Spices & Seasonings,DRY MIECHI 200GM,15,80,60,20,1
14-02-2025,Snacks & Ready-to-Eat,VD SAGOPAPAD 150GM,14,55,55,0,1
14-02-2025,Oils & Ghee,BUFFALLO GHEE 500ML,9,1640,"1,480.00",160,4
14-02-2025,Snacks & Ready-to-Eat,PN ORGANIC PUFFED RICE 200GM,14,55,55,0,1
14-02-2025,Sweeteners,SUGAR 1KG,16,120,100,20,2
14-02-2025,"Grains, Flours & Dals",Chana Flour 500 gms,4,70,65,5,1
14-02-2025,Spices & Seasonings,Chilli powder 500 gms,15,290,210,80,1
14-02-2025,Snacks & Ready-to-Eat,Corn Chips 250GM,14,160,140,20,4
14-02-2025,Oils & Ghee,Safflower oil 1 L,9,880,800,80,2
14-02-2025,"Grains, Flours & Dals",BOMBAY RAVA,4,140,110,30,2
14-02-2025,Personal Care & Cosmetics,GOW DURBAR 75G,10,60,60,0,1
14-02-2025,Pooja & Spiritual Items,SOSR SWATHHI 365,12,30,30,0,1
14-02-2025,Beverages,BRU GREEN LABEL 1.2G,1,14,14,0,7
14-02-2025,"Grains, Flours & Dals",SH WHITE POHA 500GM,4,75,75,0,1
14-02-2025,Snacks & Ready-to-Eat,RAJGIRA PEANUT CHIKKI 450GM,14,125,125,0,1
14-02-2025,Snacks & Ready-to-Eat,VD MINAPA SUNNUNDALU 12P,14,180,180,0,1
14-02-2025,"Dry Fruits, Nuts & Seeds",PULMAKHANA 100 GM,2,180,170,10,1
14-02-2025,"Grains, Flours & Dals",Wheat Flour 1 kg,4,70,60,10,1
14-02-2025,Sweeteners,NATURAL HONEY 250GM,16,150,130,20,1
14-02-2025,Snacks & Ready-to-Eat,VD RED CHILLI RICEPAPAD 150GM,14,50,50,0,1
14-02-2025,"Grains, Flours & Dals",turdal 500 gms,4,110,100,10,1
14-02-2025,Sweeteners,ACHU BELLAM 1KG,16,100,80,20,1
14-02-2025,Sweeteners,Natural Honey 500 gms,16,280,240,40,1
14-02-2025,"Grains, Flours & Dals",Red Wheat Flour 1 kg,4,140,130,10,1
14-02-2025,Milk & Dairy,BROWN EGGS 1P,7,140,120,20,10
14-02-2025,Snacks & Ready-to-Eat,VD ATUKULU MIXTURE 175GM,14,60,60,0,1
14-02-2025,Milk & Dairy,BROWN EGGS 1P,7,168,144,24,12
14-02-2025,Snacks & Ready-to-Eat,VD MURMURA LADDU,14,50,50,0,1
14-02-2025,Snacks & Ready-to-Eat,VD Pappu Chekkalu 190gm,14,60,60,0,1
14-02-2025,Snacks & Ready-to-Eat,VD BOONDI 175GM,14,60,60,0,1
14-02-2025,Snacks & Ready-to-Eat,VD Pappu Chekkalu 190gm,14,60,60,0,1
14-02-2025,Snacks & Ready-to-Eat,PUMPKIN CHIKKI 200GM,14,140,120,20,1
14-02-2025,Snacks & Ready-to-Eat,VD KOBARI LADDU,14,160,160,0,2
14-02-2025,"Grains, Flours & Dals",BASMATHI RICE 1KG,4,150,135,15,1
14-02-2025,Spices & Seasonings,SWEET SOUNF,15,20,20,0,1
14-02-2025,Snacks & Ready-to-Eat,ANNAPURNA APPALAM,14,35,35,0,1
14-02-2025,Snacks & Ready-to-Eat,PEANUT CHIKKI,14,22,22,0,1
14-02-2025,Oils & Ghee,Groundnut oil 1 L,9,360,330,30,1
14-02-2025,Snacks & Ready-to-Eat,BATANA NGT 70GMS,14,20,20,0,1
14-02-2025,"Grains, Flours & Dals",BOBBARA PAPPU 500GM,4,85,80,5,1
14-02-2025,"Grains, Flours & Dals",RICE FLOUR 500 GM,4,35,28,7,1
14-02-2025,"Dry Fruits, Nuts & Seeds",FLAX SEEDS 250GM,2,60,50,10,1
14-02-2025,"Grains, Flours & Dals",RAGI FLOUR 1KG,4,80,70,10,1
14-02-2025,Oils & Ghee,Groundnut oil 1 L,9,360,330,30,1
14-02-2025,Snacks & Ready-to-Eat,VD MULTI CHAKKA,14,110,110,0,1
14-02-2025,"Dry Fruits, Nuts & Seeds",SATHVI CHIA SEEDS 100GM,2,100,80,20,1
14-02-2025,"Grains, Flours & Dals",Wheat Flour 1 kg,4,70,60,10,1
14-02-2025,Oils & Ghee,Safflower oil 1 L,9,880,800,80,2
14-02-2025,"Grains, Flours & Dals",RAGI FLOUR 500GRMS,4,40,35,5,1
14-02-2025,"Dry Fruits, Nuts & Seeds",PULMAKHANA 100 GM,2,180,170,10,1
14-02-2025,Snacks & Ready-to-Eat,GB SALT COOKIES,14,60,55,5,1
14-02-2025,Snacks & Ready-to-Eat,VD PALLI LADDU,14,80,80,0,1
14-02-2025,Snacks & Ready-to-Eat,SD Thati thandra 200gm,14,300,300,0,2
14-02-2025,"Grains, Flours & Dals",SRILATHA RICE RAVVA 500GM,4,70,70,0,2
14-02-2025,Snacks & Ready-to-Eat,NGT CHATPATTA CHANA 90GM,14,25,25,0,1
14-02-2025,"Grains, Flours & Dals",Wheat Flour 1 kg,4,140,120,20,2
14-02-2025,"Grains, Flours & Dals",BOMBAY RAVA,4,70,55,15,1
14-02-2025,Snacks & Ready-to-Eat,VD RIBBON PAKODI 175GM,14,60,60,0,1
14-02-2025,"Grains, Flours & Dals",Green gram 500 gms,4,75,70,5,1
14-02-2025,"Grains, Flours & Dals",Sathya Javva Wheat Rava 500GM,4,95,95,0,1
14-02-2025,Snacks & Ready-to-Eat,VD SANNAPUSA 175GM,14,60,60,0,1
14-02-2025,Snacks & Ready-to-Eat,VD Pappu Chekkalu 190gm,14,60,60,0,1
14-02-2025,"Grains, Flours & Dals",Chana Flour 500 gms,4,70,65,5,1
14-02-2025,"Grains, Flours & Dals",Idly Rava L 1KG,4,120,100,20,2
14-02-2025,"Dry Fruits, Nuts & Seeds",Groundnuts 500 gms,2,95,85,10,1
14-02-2025,Snacks & Ready-to-Eat,BB VERMICELLI 1KG,14,95,90,5,1
14-02-2025,"Grains, Flours & Dals",UDALU (Barnyard millet) 1 kg,4,280,230,50,2
14-02-2025,"Grains, Flours & Dals",turdal 500 gms,4,220,200,20,2
14-02-2025,Spices & Seasonings,Coconut Powder 250GM,15,90,90,0,1
14-02-2025,Spices & Seasonings,Tamarind 250GMS,15,80,65,15,1
14-02-2025,"Grains, Flours & Dals",Sathya Javva Wheat Rava 500GM,4,95,95,0,1
14-02-2025,Snacks & Ready-to-Eat,Corn Chips 250GM,14,40,35,5,1
14-02-2025,"Grains, Flours & Dals",FLOUR CHARGE,4,20.88,20.88,0,1.74
14-02-2025,Spices & Seasonings,RED COPRA 250GMS,15,85,74,11,1
14-02-2025,"Grains, Flours & Dals",CHANA DAL 500GM,4,70,60,10,1
14-02-2025,Spices & Seasonings,DURGA SALT CRYSTAL 1KG,15,25,25,0,1
14-02-2025,"Dry Fruits, Nuts & Seeds",Groundnuts 1 kg,2,190,170,20,1
14-02-2025,"Grains, Flours & Dals",split urad dall 250 gms,4,45,40,5,1
14-02-2025,Spices & Seasonings,Vamu 100GM,15,60,50,10,1
14-02-2025,"Dry Fruits, Nuts & Seeds",PLAIN PISTA 250GM,2,660,550,110,1
14-02-2025,Oils & Ghee,Sesame oil 1 L,9,590,560,30,1
14-02-2025,Oils & Ghee,Coconut oil 500 ml,9,220,200,20,1
14-02-2025,Oils & Ghee,Groundnut oil 1 L,9,360,330,30,1
14-02-2025,"Health, Wellness & Ayurvedic Products",MXP CHOCO CLASSIC BAR,5,70,70,0,1
14-02-2025,"Health, Wellness & Ayurvedic Products",RB Max Protein Choco Almond bar 50g,5,75,75,0,1
14-02-2025,Snacks & Ready-to-Eat,GS INSTANT RAGI DOSA MIX,14,99,99,0,1
14-02-2025,"Dry Fruits, Nuts & Seeds",Groundnuts 500 gms,2,95,85,10,1
14-02-2025,Oils & Ghee,Groundnut oil 1 L,9,360,330,30,1
14-02-2025,"Health, Wellness & Ayurvedic Products",RB Max Protein DESI MASALA 60gm,5,45,45,0,1
14-02-2025,"Grains, Flours & Dals",Wheat Flour 1 kg,4,70,60,10,1
14-02-2025,"Grains, Flours & Dals",Quinova 1 kg,4,220,195,25,1
14-02-2025,Spices & Seasonings,Karakaya,15,30,30,0,1
14-02-2025,"Grains, Flours & Dals",Red Chana 500 GM,4,75,60,15,1
14-02-2025,Pooja & Spiritual Items,SWASTIK CAMPHORE,12,90,90,0,1
14-02-2025,"Grains, Flours & Dals",DESI CHANA,4,75,75,0,3
14-02-2025,"Grains, Flours & Dals",VGR rice 1 kg,4,70,65,5,1
14-02-2025,"Grains, Flours & Dals",Brown RICE 1KG,4,70,65,5,1
14-02-2025,Sweeteners,SD PALM JAGGERY 500GM,16,200,200,0,1
14-02-2025,Pooja & Spiritual Items,GOW DURBAR GEETHA CAMPHOR,12,60,60,0,1
14-02-2025,Pooja & Spiritual Items,GD Ramayana Sandal 75GM,12,60,60,0,1
14-02-2025,Personal Care & Cosmetics,GOW DURBAR 75G,10,60,60,0,1
14-02-2025,"Grains, Flours & Dals",SINGLE POLISH 1KG,4,325,325,0,5
14-02-2025,"Grains, Flours & Dals",Multigrain 1 kg,4,300,255,45,3
14-02-2025,Oils & Ghee,cow ghee 500 ml,9,430,390,40,1
14-02-2025,Pooja & Spiritual Items,GOW DURBAR GEETHA CAMPHOR,12,60,60,0,1
14-02-2025,Pooja & Spiritual Items,GD Aiswarya Deepam 700ML,12,195,195,0,1
14-02-2025,Oils & Ghee,Mustard oil 1 L,9,440,400,40,1
14-02-2025,"Grains, Flours & Dals",RAGI FLOUR 500GRMS,4,80,70,10,2
14-02-2025,"Grains, Flours & Dals",Wheat Flour 2 kgs,4,140,120,20,1
14-02-2025,Spices & Seasonings,LG 50GM,15,92,92,0,1
14-02-2025,Oils & Ghee,Safflower oil 500 ml,9,220,200,20,1
14-02-2025,"Dry Fruits, Nuts & Seeds",Groundnuts 1 kg,2,190,170,20,1
14-02-2025,Pooja & Spiritual Items,GD Aiswarya Deepam 700ML,12,195,195,0,1
14-02-2025,Oils & Ghee,Coconut oil 500 ml,9,220,200,20,1
14-02-2025,Sweeteners,GS Organic Jaggery Powder 600GM,16,198,198,0,2
14-02-2025,Pooja & Spiritual Items,AMRUTHA SURABHI,12,80,80,0,1
14-02-2025,Spices & Seasonings,ROYAL SAFFRON 400GRMS,15,65,65,0,1
14-02-2025,Sweeteners,SUGAR 1KG,16,60,50,10,1
14-02-2025,"Grains, Flours & Dals",turdal 1kg,4,440,390,50,2
14-02-2025,Spices & Seasonings,NUVVULU 250GM,15,100,85,15,1
14-02-2025,"Dry Fruits, Nuts & Seeds",DRYDATES YELLOW 250GM,2,135,120,15,1
14-02-2025,Spices & Seasonings,SV Sambar Powder 100GM,15,80,80,0,1
14-02-2025,Sweeteners,Natural Honey 500 gms,16,280,240,40,1
14-02-2025,Pooja & Spiritual Items,PACHA KARPURAM 10GM,12,60,60,0,1
14-02-2025,"Grains, Flours & Dals",Wheat Rava S 500GM,4,33,30,3,1
14-02-2025,"Grains, Flours & Dals",RAGULU 1 KG,4,35,30,5,0.5
14-02-2025,"Grains, Flours & Dals",White jowar.F 1 kg,4,100,80,20,1
14-02-2025,Oils & Ghee,Safflower oil 500 ml,9,220,200,20,1
14-02-2025,"Grains, Flours & Dals",White jowar.F 1 kg,4,100,80,20,1
14-02-2025,Spices & Seasonings,Dalchin Chekka 50GM,15,50,40,10,1
14-02-2025,Spices & Seasonings,Elaichi 25GM,15,145,120,25,1
14-02-2025,Snacks & Ready-to-Eat,NGT CHATPATTA CHANA 90GM,14,50,50,0,2
14-02-2025,"Dry Fruits, Nuts & Seeds",SATHVI CHIA SEEDS 100GM,2,100,80,20,1
14-02-2025,Sweeteners,DATE POWDER,16,599,569,30,1
14-02-2025,"Grains, Flours & Dals",JOWAR YELLOW 1 K,4,100,90,10,1
14-02-2025,Snacks & Ready-to-Eat,VD MURMURA LADDU,14,50,50,0,1
14-02-2025,Snacks & Ready-to-Eat,VD MANGO JELLY 250GRMS,14,80,80,0,1
14-02-2025,Snacks & Ready-to-Eat,MUTLGRAIN BREAD,14,70,70,0,1
14-02-2025,Snacks & Ready-to-Eat,TILLI CHIKKI,14,5,5,0,1
14-02-2025,Spices & Seasonings,EV Chicken Masala 50GM,15,48,48,0,1
14-02-2025,"Health, Wellness & Ayurvedic Products",MXP CREAM ONION,5,45,45,0,1
14-02-2025,Oils & Ghee,Groundnut oil 1 L,9,360,330,30,1
14-02-2025,"Grains, Flours & Dals",VL Sabdana 500GM,4,77,77,0,1
14-02-2025,Oils & Ghee,Safflower oil 1 L,9,440,400,40,1
14-02-2025,Oils & Ghee,Mustard oil 500 ml,9,220,195,25,1
14-02-2025,Oils & Ghee,Sesame oil 1 L,9,1180,"1,120.00",60,2
14-02-2025,"Grains, Flours & Dals",SINGLE POLISH 1KG,4,130,130,0,2
14-02-2025,"Grains, Flours & Dals",WHEAT 1 KG,4,120,100,20,2
14-02-2025,Spices & Seasonings,Coriander seeds 200 gms,15,48,40,8,1
14-02-2025,"Dry Fruits, Nuts & Seeds",SABJA SEEDS 100GM,2,80,70,10,1
14-02-2025,"Grains, Flours & Dals",SAMALU (Little millet) 1 kg,4,170,130,40,1
14-02-2025,"Grains, Flours & Dals",UDALU (Barnyard millet) 1 kg,4,140,115,25,1
14-02-2025,"Grains, Flours & Dals",DOCTOR RICE DIABETIC SFR 1KG,4,120,120,0,1
14-02-2025,"Grains, Flours & Dals",JOWAR WHITE 1 KG,4,40,35,5,0.5
14-02-2025,"Grains, Flours & Dals",White jowar.F 1 kg,4,100,80,20,1
14-02-2025,Beverages,BRU GREEN LABEL 1.2G,1,72,72,0,36
14-02-2025,Pooja & Spiritual Items,BALAJI BEL PHOOL DHOOP STICKS 10STK,12,210,210,0,3
14-02-2025,Oils & Ghee,Castor oil 200 ml,9,75,75,0,1
14-02-2025,Oils & Ghee,Groundnut oil 5 L,9,1800,"1,600.00",200,1
14-02-2025,"Dry Fruits, Nuts & Seeds",FLAX SEEDS 250GM,2,60,50,10,1
14-02-2025,"Grains, Flours & Dals",HS RAGI Idly rava 500 gms,4,70,70,0,1
14-02-2025,"Grains, Flours & Dals",HS Multimillet idly R 500 gms,4,65,65,0,1
14-02-2025,"Grains, Flours & Dals",Multigrain 1 kg,4,500,425,75,5
14-02-2025,"Grains, Flours & Dals",HS jowar idly rava 500 gms,4,65,65,0,1
14-02-2025,"Grains, Flours & Dals",Multigrain 1 kg,4,200,170,30,2
14-02-2025,"Grains, Flours & Dals",Wheat Flour 1 kg,4,140,120,20,2
14-02-2025,Oils & Ghee,Safflower oil 1 L,9,440,400,40,1
14-02-2025,Oils & Ghee,Mustard oil 1 L,9,440,400,40,1
14-02-2025,Spices & Seasonings,SWEET SOUNF,15,20,20,0,1
14-02-2025,Snacks & Ready-to-Eat,BD PEARL MILLET NOODLES 200G,14,140,140,0,2
14-02-2025,"Grains, Flours & Dals",White jowar.F 1 kg,4,100,80,20,1
14-02-2025,"Dry Fruits, Nuts & Seeds",PULMAKHANA 100 GM,2,180,170,10,1
14-02-2025,"Grains, Flours & Dals",Yellow jowar.F 500 gms,4,55,50,5,1
14-02-2025,"Grains, Flours & Dals",Urad dall 500 gms,4,95,85,10,1
14-02-2025,"Grains, Flours & Dals",KORRALU (FOXTAIL M) 500GM,4,65,55,10,1
14-02-2025,"Grains, Flours & Dals",Arikadu ( kodo),4,70,65,5,0.5
14-02-2025,Oils & Ghee,Coconut oil 1 L,9,440,400,40,1
14-02-2025,Oils & Ghee,Mustard oil 500 ml,9,220,195,25,1
14-02-2025,Snacks & Ready-to-Eat,VD JAGGERY GHEE 250GM,14,120,120,0,1
14-02-2025,Milk & Dairy,HERITAGE TONED MILK 500ML,7,31,31,0,1
14-02-2025,Milk & Dairy,HERITAGE TOTAL CURD 500GM,7,50,50,0,1
14-02-2025,"Grains, Flours & Dals",COW B rice 1 kg,4,360,345,15,5
14-02-2025,Oils & Ghee,Safflower oil 500 ml,9,220,200,20,1
14-02-2025,Oils & Ghee,Sesame oil 500ml,9,295,280,15,1
14-02-2025,"Grains, Flours & Dals",SINGLE POLISH 1KG,4,975,975,0,15
14-02-2025,Milk & Dairy,BROWN EGGS TRAY 30P,7,360,330,30,1
14-02-2025,"Grains, Flours & Dals",turdal 1kg,4,220,195,25,1
14-02-2025,Oils & Ghee,Groundnut oil 500ml,9,180,165,15,1
14-02-2025,Oils & Ghee,Coconut oil 500 ml,9,220,200,20,1
14-02-2025,"Grains, Flours & Dals",Wheat Flour 1 kg,4,70,60,10,1
14-02-2025,"Grains, Flours & Dals",SL Suji Rava 500GM,4,32,32,0,1
14-02-2025,Spices & Seasonings,AVALU 100GM,15,25,20,5,1
14-02-2025,Snacks & Ready-to-Eat,VD GUMMADI VADIYAM,14,75,75,0,1
14-02-2025,Household & Cleaning,BORIC POWDER 100GM,6,55,55,0,1
14-02-2025,"Grains, Flours & Dals",Chana Flour 500 gms,4,70,65,5,1
14-02-2025,Snacks & Ready-to-Eat,SD FINGER Millet with palm Jaggery 250gm,14,135,135,0,1
14-02-2025,General Household & Kitchenware,MATCH BOX,3,20,20,0,1
14-02-2025,"Health, Wellness & Ayurvedic Products",MD Hibiscus Flower Choornam 30GM,5,100,100,0,1
14-02-2025,Spices & Seasonings,SD IDLY KARAM,15,65,65,0,1
14-02-2025,Spices & Seasonings,SD Garlic Karam Powder 100GM,15,65,65,0,1
14-02-2025,Personal Care & Cosmetics,MD Bath Powder 100GM,10,40,40,0,1
14-02-2025,"Dry Fruits, Nuts & Seeds",ANJEER 250GM,2,400,360,40,1
14-02-2025,"Grains, Flours & Dals",RAGI FLOUR 500GRMS,4,40,35,5,1
14-02-2025,"Grains, Flours & Dals",VYS.SP.RICE BAG 1,4,1800,"1,650.00",150,1
14-02-2025,"Grains, Flours & Dals",Green gram 500 gms,4,75,70,5,1
14-02-2025,"Grains, Flours & Dals",Red Bobarlu 500 gms,4,95,85,10,1
14-02-2025,"Grains, Flours & Dals",Red Chana 500 GM,4,75,60,15,1
14-02-2025,Beverages,BRU GREEN LABEL 1.2G,1,72,72,0,36
14-02-2025,Milk & Dairy,BROWN EGGS TRAY 30P,7,360,330,30,1
14-02-2025,"Grains, Flours & Dals",turdal 1kg,4,660,585,75,3
14-02-2025,"Grains, Flours & Dals",COW B rice 5 kgs,4,360,345,15,1
14-02-2025,"Grains, Flours & Dals",RAJMA 500GM,4,90,90,0,1
14-02-2025,"Grains, Flours & Dals",Wheat Rava S 1KG,4,65,55,10,1
14-02-2025,Milk & Dairy,BROWN EGGS 1P,7,84,72,12,6
14-02-2025,"Grains, Flours & Dals",Multigrain 1 kg,4,100,85,15,1
14-02-2025,Snacks & Ready-to-Eat,VD MURMURA LADDU,14,50,50,0,1
14-02-2025,Snacks & Ready-to-Eat,VD DAHI MIRCHI(SALTED) 100GM,14,45,45,0,1
14-02-2025,"Dry Fruits, Nuts & Seeds",Groundnuts 500 gms,2,95,85,10,1
14-02-2025,Sweeteners,MISHRI 250 GM,16,35,30,5,1
14-02-2025,Spices & Seasonings,YB Rock Salt 1KG,15,120,120,0,1
14-02-2025,"Grains, Flours & Dals",navara rice,4,200,180,20,1
14-02-2025,Spices & Seasonings,ROYAL SAFFRON,15,125,125,0,1
14-02-2025,Oils & Ghee,Groundnut oil 1 L,9,360,330,30,1
13-02-2025,Oils & Ghee,Groundnut oil 500ml,9,180,165,15,1
13-02-2025,Snacks & Ready-to-Eat,BATANA NGT 70GMS,14,40,40,0,2
13-02-2025,"Grains, Flours & Dals",Chana Flour 500 gms,4,70,65,5,1
13-02-2025,"Grains, Flours & Dals",JOWAR YELLOW 1 K,4,100,90,10,1
13-02-2025,Snacks & Ready-to-Eat,NGT CHATPATTA CHANA 90GM,14,25,25,0,1
13-02-2025,Spices & Seasonings,SD Garlic Karam Powder 100GM,15,65,65,0,1
13-02-2025,Baking & Cooking Aids,GONDH 50GRMS,0,78,78,0,1
13-02-2025,Personal Care & Cosmetics,YB Bath Powder 200GM,10,100,100,0,1
13-02-2025,"Dry Fruits, Nuts & Seeds",FLAX SEEDS 250GM,2,60,50,10,1
13-02-2025,"Grains, Flours & Dals",Quinova 500 gms,4,110,100,10,1
13-02-2025,"Grains, Flours & Dals",KORRALU (FOXTAIL M) 1KG,4,150,110,40,1
13-02-2025,Pooja & Spiritual Items,SIVA JOOTHI 365 DEEPAPU,12,25,25,0,1
13-02-2025,"Grains, Flours & Dals",UDALU (Barnyard millet) 1 kg,4,140,115,25,1
13-02-2025,"Dry Fruits, Nuts & Seeds",FLAX SEEDS 250GM,2,60,50,10,1
13-02-2025,"Dry Fruits, Nuts & Seeds",PUMPKIN SEEDS 250GM,2,200,160,40,1
13-02-2025,Snacks & Ready-to-Eat,VD MURMURA LADDU,14,100,100,0,2
13-02-2025,"Grains, Flours & Dals",RAGI FLOUR 1KG,4,80,70,10,1
13-02-2025,Snacks & Ready-to-Eat,BATANA NGT 70GMS,14,20,20,0,1
13-02-2025,Snacks & Ready-to-Eat,VD RED CHILLI RICEPAPAD 150GM,14,50,50,0,1
13-02-2025,Pooja & Spiritual Items,GD Aiswarya Deepam 700ML,12,195,195,0,1
13-02-2025,Spices & Seasonings,Tamalapaku Karam Powder 100GM,15,80,80,0,1
13-02-2025,Pooja & Spiritual Items,BALAJI BEL PHOOL DHOOP STICKS 10STK,12,70,70,0,1
13-02-2025,"Grains, Flours & Dals",JOWAR UPMA RAVA,4,0,0,0,1
13-02-2025,"Grains, Flours & Dals",Em jowar idly R 500G,4,75,75,0,1
13-02-2025,"Dry Fruits, Nuts & Seeds",SUNFLOWER SEEDS 250GRM,2,150,130,20,1
13-02-2025,"Dry Fruits, Nuts & Seeds",SATHVI CHIA SEEDS 100GM,2,100,80,20,1
13-02-2025,"Grains, Flours & Dals",EM Ragi idli R 500G,4,75,75,0,1
13-02-2025,Pooja & Spiritual Items,BALAJI BEL PHOOL STICKS 90GM,12,60,60,0,1
13-02-2025,"Grains, Flours & Dals",White jowar.F 1 kg,4,100,80,20,1
13-02-2025,"Grains, Flours & Dals",THIN POHA 500GM,4,40,35,5,1
13-02-2025,Spices & Seasonings,Miriyalu 50GM,15,100,80,20,1
13-02-2025,Snacks & Ready-to-Eat,DOSA BATTER 1KG,14,60,60,0,1
13-02-2025,"Grains, Flours & Dals",SH WHEAT DALIYA 500GM,4,60,60,0,1
13-02-2025,"Dry Fruits, Nuts & Seeds",SH GROUNDNUT 250GM,2,85,85,0,1
13-02-2025,Spices & Seasonings,sf jeera,15,120,120,0,1
13-02-2025,Spices & Seasonings,SARVA CHAAT MASALA 100GM,15,85,85,0,1
13-02-2025,"Grains, Flours & Dals",Em Foxtail upma r 500 g,4,109,109,0,1
13-02-2025,"Grains, Flours & Dals",Wheat Flour 1 kg,4,70,60,10,1
13-02-2025,"Grains, Flours & Dals",SA Multi Grain Mix 500GM,4,159,159,0,1
13-02-2025,Snacks & Ready-to-Eat,VD NUVVULU LADDU,14,80,80,0,1
13-02-2025,Sweeteners,SUGAR 1KG,16,60,50,10,1
13-02-2025,Snacks & Ready-to-Eat,VD Pappu Chekkalu 190gm,14,60,60,0,1
13-02-2025,Snacks & Ready-to-Eat,VD PALLI LADDU,14,160,160,0,2
13-02-2025,Snacks & Ready-to-Eat,MILK BREAD,14,55,55,0,1
13-02-2025,Personal Care & Cosmetics,MD Bath Powder 100GM,10,40,40,0,1
13-02-2025,Snacks & Ready-to-Eat,ELITE MILK RUSK 200GM,14,35,35,0,1
13-02-2025,"Grains, Flours & Dals",HS Ragi upma rava 500 gms,4,70,70,0,1
13-02-2025,"Grains, Flours & Dals",JOWAR UPMA RAVA,4,130,130,0,2
13-02-2025,"Grains, Flours & Dals",Em Foxtail upma r 500 g,4,109,109,0,1
13-02-2025,"Grains, Flours & Dals",Em little upma R 500g,4,129,129,0,1
13-02-2025,"Grains, Flours & Dals",HS Multimillet upma r 500g,4,130,130,0,2
13-02-2025,Snacks & Ready-to-Eat,VD MURMURA LADDU,14,100,100,0,2
13-02-2025,Snacks & Ready-to-Eat,BATANA NGT 70GMS,14,20,20,0,1
13-02-2025,Snacks & Ready-to-Eat,VD BELLAM GAVVALU 200GM,14,60,60,0,1
13-02-2025,Snacks & Ready-to-Eat,VD KOBARI LADDU,14,80,80,0,1
13-02-2025,Snacks & Ready-to-Eat,VD SANNAPUSA 175GM,14,60,60,0,1
13-02-2025,Snacks & Ready-to-Eat,VD PALLI LADDU,14,160,160,0,2
13-02-2025,Snacks & Ready-to-Eat,VD Pappu Chekkalu 190gm,14,60,60,0,1
13-02-2025,Snacks & Ready-to-Eat,VD PALLI LADDU,14,80,80,0,1
13-02-2025,Snacks & Ready-to-Eat,FOXTAIL BIS,14,135,135,0,1
13-02-2025,"Health, Wellness & Ayurvedic Products",AMLA PACHAK,5,100,100,0,1
13-02-2025,Snacks & Ready-to-Eat,GANTASALA TOMATO SNACKS 150GM,14,60,60,0,1
13-02-2025,Snacks & Ready-to-Eat,VD MULTI CHAKKA,14,110,110,0,1
13-02-2025,Snacks & Ready-to-Eat,VD MURUKU 175GM,14,60,60,0,1
13-02-2025,Snacks & Ready-to-Eat,VD PAPPU CHEGODI 200GM,14,60,60,0,1
13-02-2025,Snacks & Ready-to-Eat,VD DASA DINUSULU,14,199,199,0,1
13-02-2025,Milk & Dairy,BROWN EGGS 1P,7,168,144,24,12
13-02-2025,Spices & Seasonings,DURGA SALT CRYSTAL 1KG,15,25,25,0,1
13-02-2025,"Grains, Flours & Dals",Idly Rava L 1KG,4,60,50,10,1
13-02-2025,Oils & Ghee,Safflower oil 500 ml,9,220,200,20,1
13-02-2025,Oils & Ghee,Groundnut oil 1 L,9,360,330,30,1
13-02-2025,Spices & Seasonings,Dalchin Chekka 50GM,15,50,40,10,1
13-02-2025,Snacks & Ready-to-Eat,BATANA NGT 70GMS,14,20,20,0,1
13-02-2025,"Dry Fruits, Nuts & Seeds",PUMPKIN SEEDS 250GM,2,200,160,40,1
13-02-2025,"Dry Fruits, Nuts & Seeds",FLAX SEEDS 250GM,2,60,50,10,1
13-02-2025,"Grains, Flours & Dals",RAGI FLOUR 1KG,4,80,70,10,1
13-02-2025,"Grains, Flours & Dals",DISANO OATS 1KG,4,285,142.5,142.5,1
13-02-2025,"Grains, Flours & Dals",Red Bobarlu 500 gms,4,95,85,10,1
13-02-2025,"Grains, Flours & Dals",White Chana 250 GM,4,60,50,10,1
13-02-2025,"Grains, Flours & Dals",Green gram 500 gms,4,75,70,5,1
13-02-2025,"Grains, Flours & Dals",Wheat Flour 2 kgs,4,140,120,20,1
13-02-2025,"Dry Fruits, Nuts & Seeds",SUNFLOWER SEEDS 250GRM,2,150,130,20,1
13-02-2025,"Dry Fruits, Nuts & Seeds",BLACK KISMIS 250GM,2,175,140,35,1
13-02-2025,"Dry Fruits, Nuts & Seeds",Groundnuts 500 gms,2,95,85,10,1
13-02-2025,"Grains, Flours & Dals",Black gram 500 gms,4,75,70,5,1
13-02-2025,"Grains, Flours & Dals",Red Chana 250GM,4,35,30,5,1
13-02-2025,"Grains, Flours & Dals",SA YELLOW JOWAR RAVA 500GM,4,95,95,0,1
13-02-2025,"Grains, Flours & Dals",white Bobarlu 500 gms,4,80,75,5,1
13-02-2025,Snacks & Ready-to-Eat,VD NUVULU LADDU 9PIC,14,100,100,0,1
13-02-2025,"Grains, Flours & Dals",Wheat Flour 1 kg,4,140,120,20,2
13-02-2025,Snacks & Ready-to-Eat,VD BELLAM GAVVALU 200GM,14,60,60,0,1
13-02-2025,"Grains, Flours & Dals",SAMALU (Little millet) 500 gms,4,85,65,20,1
13-02-2025,Oils & Ghee,Safflower oil 1 L,9,440,400,40,1
13-02-2025,"Grains, Flours & Dals",KORRALU (FOXTAIL M) 1KG,4,150,110,40,1
13-02-2025,Snacks & Ready-to-Eat,VD JAGGERY GHEE 250GM,14,180,180,0,1
13-02-2025,"Grains, Flours & Dals",DISANO OATS 1KG,4,285,142.5,142.5,1
13-02-2025,Snacks & Ready-to-Eat,SD FINGER Millet with palm Jaggery 250gm,14,135,135,0,1
13-02-2025,"Grains, Flours & Dals",Arikalu (kodo),4,70,65,5,1
13-02-2025,Spices & Seasonings,SWEET SOUNF,15,20,20,0,1
13-02-2025,Spices & Seasonings,SATHVI KARAKAYA 25 GM,15,50,30,20,1
13-02-2025,Snacks & Ready-to-Eat,RINGS 200GM,14,30,30,0,1
13-02-2025,"Dry Fruits, Nuts & Seeds",Putnalu 250GM,2,45,38,7,1
13-02-2025,"Grains, Flours & Dals",Wheat Flour 1 kg,4,105,90,15,1.5
13-02-2025,Oils & Ghee,Coconut oil 1 L,9,440,400,40,1
13-02-2025,Snacks & Ready-to-Eat,RAJGIRA PEANUT CHIKKI,14,40,40,0,8
13-02-2025,Sweeteners,SD PALM JAGGERY 500GM,16,200,200,0,1
13-02-2025,"Grains, Flours & Dals",SINGLE POLISH 1KG,4,650,650,0,10
13-02-2025,Snacks & Ready-to-Eat,SD Aswagandha with palm Jaggery250Gm,14,135,135,0,1
13-02-2025,Snacks & Ready-to-Eat,VD BELLAM GAVVALU 200GM,14,60,60,0,1
13-02-2025,"Grains, Flours & Dals",Multigrain 1 kg,4,100,85,15,1
13-02-2025,"Grains, Flours & Dals",Wheat Flour 1 kg,4,70,60,10,1
13-02-2025,Spices & Seasonings,Masala Karam 250 gms,15,260,240,20,2
13-02-2025,"Grains, Flours & Dals",FLOUR CHARGE,4,33.6,33.6,0,2.8
13-02-2025,"Grains, Flours & Dals",SRILATHA RICE RAVVA 500GM,4,35,35,0,1
13-02-2025,Oils & Ghee,Groundnut oil 1 L,9,360,330,30,1
13-02-2025,Snacks & Ready-to-Eat,SD JOWAR WITH PALM JAGGERY 250GM,14,135,135,0,1
13-02-2025,Snacks & Ready-to-Eat,RINGS 200GM,14,30,30,0,1
13-02-2025,Spices & Seasonings,DRY MIECHI 200GM,15,80,60,20,1
13-02-2025,"Grains, Flours & Dals",idly/Dosa rice 1 kg,4,70,60,10,1
13-02-2025,Spices & Seasonings,Coriander seeds 200 gms,15,48,40,8,1
13-02-2025,"Grains, Flours & Dals",Em jowar idly R 500G,4,75,75,0,1
13-02-2025,Spices & Seasonings,YB PINK ROCK SALT 1KG,15,120,120,0,1
13-02-2025,"Grains, Flours & Dals",VL Sabdana 500GM,4,77,77,0,1
13-02-2025,"Grains, Flours & Dals",EM Ragi idli R 500G,4,75,75,0,1
13-02-2025,"Grains, Flours & Dals",Wheat Flour 2 kgs,4,140,120,20,1
13-02-2025,Spices & Seasonings,Elaichi 25GM,15,145,120,25,1
13-02-2025,"Grains, Flours & Dals",Multigrain 1 kg,4,100,85,15,1
13-02-2025,Spices & Seasonings,Turmeric powder 250 gms,15,100,75,25,1
13-02-2025,Oils & Ghee,Freedom Rice Bran Oil 1L,9,194,180,14,1
13-02-2025,"Grains, Flours & Dals",turdal 1kg,4,220,195,25,1
13-02-2025,Spices & Seasonings,Dalchin Chekka 50GM,15,50,40,10,1
13-02-2025,"Grains, Flours & Dals",RAGI FLOUR 1KG,4,80,70,10,1
13-02-2025,"Grains, Flours & Dals",Brown RICE 1KG,4,350,325,25,5
13-02-2025,Spices & Seasonings,ROYAL SAFFRON,15,125,125,0,1
13-02-2025,Oils & Ghee,Groundnut oil 500ml,9,360,330,30,2
13-02-2025,Beverages,RED LABEL 100GM,1,20,20,0,2
13-02-2025,"Grains, Flours & Dals",RAGI FLOUR 500GRMS,4,40,35,5,1
13-02-2025,"Grains, Flours & Dals",White jowar.F 1 kg,4,100,80,20,1
13-02-2025,Snacks & Ready-to-Eat,VD MURMURA LADDU,14,50,50,0,1
13-02-2025,Snacks & Ready-to-Eat,VD MANGO JELLY 250GRMS,14,80,80,0,1
13-02-2025,Household & Cleaning,GOOD KNIGHT GOLD FLASH,6,160,160,0,2
13-02-2025,Personal Care & Cosmetics,MYSORE SANDAL SOAP 75G,10,42,42,0,1
13-02-2025,Snacks & Ready-to-Eat,TILLI CHIKKI,14,125,125,0,1
13-02-2025,"Grains, Flours & Dals",THICK POHA 500GM,4,40,35,5,1
13-02-2025,"Grains, Flours & Dals",Wheat Flour 1 kg,4,350,300,50,5
13-02-2025,Personal Care & Cosmetics,YB Bath Powder 200GM,10,100,100,0,1
13-02-2025,"Grains, Flours & Dals",Wheat Rava M 1KG,4,65,55,10,1
13-02-2025,"Health, Wellness & Ayurvedic Products",MH Millets Milk Powder 250GM,5,250,250,0,1
13-02-2025,"Health, Wellness & Ayurvedic Products",MH Millets Malt 500GM,5,200,190,10,1
13-02-2025,"Dry Fruits, Nuts & Seeds",SATHVI CHIA SEEDS 100GM,2,100,80,20,1
13-02-2025,"Grains, Flours & Dals",SL Idly Rava 1KG,4,65,55,10,1
13-02-2025,Snacks & Ready-to-Eat,VD PALLI LADDU,14,80,80,0,1
13-02-2025,"Grains, Flours & Dals",White jowar.F 1 kg,4,100,80,20,1
13-02-2025,Spices & Seasonings,Masala Karam 250 gms,15,130,120,10,1
13-02-2025,"Grains, Flours & Dals",JOWAR UPMA RAVA,4,0,0,0,1
13-02-2025,"Grains, Flours & Dals",PRO ORG RED POHA 500GM,4,89,89,0,1
13-02-2025,"Grains, Flours & Dals",Quinova 1 kg,4,220,195,25,1
13-02-2025,"Grains, Flours & Dals",JOWAR YELLOW 1 K,4,100,90,10,1
13-02-2025,"Grains, Flours & Dals",split black gram 1 kg,4,180,170,10,1
13-02-2025,Personal Care & Cosmetics,MYSORE SANDAL,10,82,82,0,1
13-02-2025,"Grains, Flours & Dals",UDALU (Barnyard millet) 1 kg,4,140,115,25,1
13-02-2025,"Grains, Flours & Dals",SAMALU (Little millet) 1 kg,4,170,130,40,1
13-02-2025,"Grains, Flours & Dals",RAGI FLOUR 1KG,4,80,70,10,1
13-02-2025,"Grains, Flours & Dals",Multigrain 1 kg,4,100,85,15,1
13-02-2025,"Grains, Flours & Dals",POORI ATTA 1KG,4,70,60,10,1
13-02-2025,Personal Care & Cosmetics,Soapnut 500GM,10,90,90,0,1
13-02-2025,Spices & Seasonings,Menthulu 250 gms,15,50,45,5,1
13-02-2025,Snacks & Ready-to-Eat,SD FINGER Millet with palm Jaggery 250gm,14,135,135,0,1
13-02-2025,Oils & Ghee,Safflower oil 1 L,9,440,400,40,1
13-02-2025,"Grains, Flours & Dals",Sathya Javva Wheat Rava 500GM,4,95,95,0,1
13-02-2025,"Grains, Flours & Dals",PRO ORG RED POHA 500GM,4,89,89,0,1
13-02-2025,Snacks & Ready-to-Eat,VD PAPPU CHEGODI 200GM,14,60,60,0,1
13-02-2025,Snacks & Ready-to-Eat,VD RIBBON PAKODI 175GM,14,60,60,0,1
13-02-2025,Snacks & Ready-to-Eat,VD ATUKULU MIXTURE 175GM,14,60,60,0,1
13-02-2025,Snacks & Ready-to-Eat,VD PALLI LADDU,14,80,80,0,1
13-02-2025,Snacks & Ready-to-Eat,VD NUVVULU LADDU,14,80,80,0,1
13-02-2025,"Grains, Flours & Dals",UDALU (Barnyard millet) 1 kg,4,140,115,25,1
13-02-2025,"Dry Fruits, Nuts & Seeds",ALMONDS 250GM,2,280,260,20,1
13-02-2025,"Dry Fruits, Nuts & Seeds",PUMPKIN SEEDS 250GM,2,200,160,40,1
13-02-2025,"Dry Fruits, Nuts & Seeds",WATERMELON SEEDS 250GRM,2,320,280,40,1
13-02-2025,"Dry Fruits, Nuts & Seeds",DRIED KIWI 200GM,2,145,130,15,1
13-02-2025,"Dry Fruits, Nuts & Seeds",PLAIN PISTA 250GM,2,660,550,110,1
13-02-2025,Oils & Ghee,Safflower oil 1 L,9,440,400,40,1
13-02-2025,"Grains, Flours & Dals",SAMALU (Little millet) 500 gms,4,85,65,20,1
13-02-2025,"Dry Fruits, Nuts & Seeds",SUNFLOWER SEEDS 250GRM,2,150,130,20,1
13-02-2025,"Grains, Flours & Dals",Arikalu (kodo),4,70,65,5,1
13-02-2025,"Grains, Flours & Dals",Yellow jowar .F1 kg,4,110,100,10,1
13-02-2025,"Grains, Flours & Dals",ANDU KORRALU (Browntop.m) 1 kg,4,260,220,40,1
13-02-2025,"Grains, Flours & Dals",SA YELLOW JOWAR RAVA 500GM,4,95,95,0,1
13-02-2025,"Grains, Flours & Dals",KORRALU (FOXTAIL M) 500GM,4,65,55,10,1
13-02-2025,Spices & Seasonings,Turmeric powder 250 gms,15,100,75,25,1
13-02-2025,"Dry Fruits, Nuts & Seeds",KAJU HALF 250GM,2,310,290,20,1
13-02-2025,Pooja & Spiritual Items,GD Dhoop Sticks 26GM,12,20,20,0,1
13-02-2025,Spices & Seasonings,SATHVI KARAKAYA 25 GM,15,50,30,20,1
13-02-2025,"Grains, Flours & Dals",RAGI FLOUR 1KG,4,80,70,10,1
13-02-2025,Milk & Dairy,ID PANEER,7,135,135,0,1
13-02-2025,Spices & Seasonings,SATHVI KARAKAYA 25 GM,15,50,30,20,1
13-02-2025,Personal Care & Cosmetics,NEEM SOAP 100GM,10,100,100,0,1
13-02-2025,"Grains, Flours & Dals",Multigrain 1 kg,4,100,85,15,1
13-02-2025,Sweeteners,NATURAL HONEY 250GM,16,150,130,20,1
13-02-2025,"Grains, Flours & Dals",RAGI FLOUR 500GRMS,4,40,35,5,1
13-02-2025,Snacks & Ready-to-Eat,BD BARELY NOODLES 200G,14,70,70,0,1
13-02-2025,Oils & Ghee,Sesame oil 1 L,9,590,560,30,1
13-02-2025,"Grains, Flours & Dals",RAGI FLOUR 500GRMS,4,40,35,5,1
13-02-2025,Spices & Seasonings,Telaga Pindi 250 GM,15,40,35,5,1
13-02-2025,Oils & Ghee,Coconut oil 1 L,9,440,400,40,1
13-02-2025,Oils & Ghee,Safflower oil 1 L,9,440,400,40,1
13-02-2025,Personal Care & Cosmetics,MADDI ALOEVERA SHAMPOO 500ML,10,600,600,0,2
13-02-2025,Snacks & Ready-to-Eat,BATANA NGT 70GMS,14,60,60,0,3
13-02-2025,Snacks & Ready-to-Eat,NGT CHATPATTA CHANA 90GM,14,50,50,0,2
13-02-2025,"Dry Fruits, Nuts & Seeds",Groundnuts 1 kg,2,1140,"1,020.00",120,6
13-02-2025,"Grains, Flours & Dals",RAJMA 250GM,4,55,45,10,1
13-02-2025,"Grains, Flours & Dals",Sathya Javva Wheat Rava 500GM,4,95,95,0,1
13-02-2025,Spices & Seasonings,Chilli powder 500 gms,15,290,210,80,1
13-02-2025,"Grains, Flours & Dals",White Chana 250 GM,4,60,50,10,1
13-02-2025,Oils & Ghee,Safflower oil 1 L,9,440,400,40,1
13-02-2025,"Grains, Flours & Dals",MAAGAANI SP RICE 5KGS,4,649,560,89,1
13-02-2025,"Grains, Flours & Dals",KORRALU (FOXTAIL M) 1KG,4,150,110,40,1
13-02-2025,Oils & Ghee,Safflower oil 5 L,9,2200,"1,950.00",250,1
13-02-2025,Spices & Seasonings,ELACHI 25 GM,15,145,120,25,1
13-02-2025,Oils & Ghee,Safflower oil 500 ml,9,220,200,20,1
13-02-2025,Spices & Seasonings,Miriyalu 50GM,15,100,80,20,1
13-02-2025,Pickles & Cooking Pastes,SD AMALA PICKLE,11,110,110,0,1
13-02-2025,Spices & Seasonings,Jeera 100GM,15,50,45,5,1
13-02-2025,"Grains, Flours & Dals",UDALU (Barnyard millet) 500 gms,4,70,60,10,1
13-02-2025,"Grains, Flours & Dals",SAMALU (Little millet) 500 gms,4,85,65,20,1
13-02-2025,"Grains, Flours & Dals",JOWAR YELLOW 1 K,4,200,180,20,2
13-02-2025,"Grains, Flours & Dals",AISHWARYA SP 1KG,4,160,140,20,2
13-02-2025,"Grains, Flours & Dals",Multigrain 1 kg,4,100,85,15,1
13-02-2025,Oils & Ghee,Safflower oil 1 L,9,880,800,80,2
13-02-2025,Snacks & Ready-to-Eat,MILK BREAD,14,55,55,0,1
13-02-2025,Milk & Dairy,BROWN EGGS TRAY 30P,7,360,330,30,1
13-02-2025,"Dry Fruits, Nuts & Seeds",PUMPKIN SEEDS 250GM,2,200,160,40,1
13-02-2025,Oils & Ghee,Groundnut oil 500ml,9,360,330,30,2
13-02-2025,"Dry Fruits, Nuts & Seeds",YELLOW KISHMISH 250GM,2,130,110,20,1
13-02-2025,"Grains, Flours & Dals",Chana Flour 500 gms,4,70,65,5,1
13-02-2025,"Health, Wellness & Ayurvedic Products",PULIPIRI WARTS REMOVER 9GM,5,125,125,0,1
13-02-2025,"Grains, Flours & Dals",RICE FLOUR 1KG,4,70,55,15,1
13-02-2025,Snacks & Ready-to-Eat,RITEBITE BLUEBERRY BLAST,14,50,50,0,1
13-02-2025,Oils & Ghee,Groundnut oil 1 L,9,360,330,30,1
13-02-2025,"Grains, Flours & Dals",RAGI FLOUR 1KG,4,80,70,10,1
13-02-2025,"Grains, Flours & Dals",SINGLE POLISH 1KG,4,650,650,0,10
13-02-2025,"Grains, Flours & Dals",turdal 1kg,4,440,390,50,2
13-02-2025,"Dry Fruits, Nuts & Seeds",Groundnuts 1 kg,2,380,340,40,2
13-02-2025,Sweeteners,GS A2 Buffalo Ghee 500ML,16,550,550,0,1
13-02-2025,"Grains, Flours & Dals",AISHWARYA SP 1KG,4,800,700,100,10
13-02-2025,Oils & Ghee,Sesame oil 1 L,9,590,560,30,1
13-02-2025,Personal Care & Cosmetics,MD Bath Powder 100GM,10,40,40,0,1
13-02-2025,"Health, Wellness & Ayurvedic Products",RB Peanut butter Peanuts Dark 40g,5,45,45,0,1
13-02-2025,Snacks & Ready-to-Eat,SD Atreyapuram DRY Fruit ghee,14,150,150,0,1
13-02-2025,Personal Care & Cosmetics,HERBAL BATH POWDER 200GM,10,80,80,0,1
13-02-2025,Snacks & Ready-to-Eat,Popcorn Seeds 250GM,14,45,40,5,1
13-02-2025,Snacks & Ready-to-Eat,SD SESAME PAPAD,14,80,80,0,1
13-02-2025,Snacks & Ready-to-Eat,SD Bajra with palm Jaggery 250gm,14,135,135,0,1
13-02-2025,Spices & Seasonings,ELACHI 25 GM,15,145,120,25,1
13-02-2025,"Dry Fruits, Nuts & Seeds",Groundnuts 1 kg,2,190,170,20,1
13-02-2025,Oils & Ghee,Safflower oil 1 L,9,440,400,40,1
13-02-2025,Oils & Ghee,Groundnut oil 1 L,9,1080,990,90,3
13-02-2025,"Grains, Flours & Dals",COW B RICE BAG 1,4,2099,"1,750.00",349,1
13-02-2025,Snacks & Ready-to-Eat,ragi elachi cookies,14,75,75,0,1
13-02-2025,Beverages,ASSAM MASALA TEA,1,199,199,0,1
13-02-2025,Snacks & Ready-to-Eat,MAAGAANI JOWAR M COOKIES 120GM,14,596,596,0,4
13-02-2025,Spices & Seasonings,Turmeric powder 250 gms,15,100,75,25,1
13-02-2025,Snacks & Ready-to-Eat,SD Sesame laddu with dates250gm,14,135,135,0,1
13-02-2025,"Grains, Flours & Dals",POORI ATTA 500GM,4,0,0,0,1
13-02-2025,Snacks & Ready-to-Eat,SUNNUNDALU 200GM,14,120,120,0,1
13-02-2025,Milk & Dairy,SANGAM CURD 450GM,7,38,38,0,1
13-02-2025,"Grains, Flours & Dals",PESARA PAPPU 500GMS,4,85,75,10,1
13-02-2025,"Dry Fruits, Nuts & Seeds",Putnalu 250GM,2,45,38,7,1
13-02-2025,"Grains, Flours & Dals",COW B rice 1 kg,4,360,345,15,5
13-02-2025,"Grains, Flours & Dals",RAGI FLOUR 1KG,4,80,70,10,1
13-02-2025,"Grains, Flours & Dals",Wheat Flour 1 kg,4,70,60,10,1
13-02-2025,"Dry Fruits, Nuts & Seeds",Groundnuts 1 kg,2,190,170,20,1
13-02-2025,"Dry Fruits, Nuts & Seeds",PUTNALU 500GMS,2,90,76,14,1
13-02-2025,"Dry Fruits, Nuts & Seeds",Groundnuts 500 gms,2,190,170,20,2
13-02-2025,"Grains, Flours & Dals",maida 500grms,4,120,120,0,2
13-02-2025,Beverages,BRU GREEN LABEL 1.2G,1,24,24,0,12
13-02-2025,"Grains, Flours & Dals",Idly Rava L 1KG,4,60,50,10,1
13-02-2025,"Grains, Flours & Dals",Urad dall 1 Kg,4,370,340,30,2
13-02-2025,Sweeteners,SUGAR 1KG,16,60,50,10,1
13-02-2025,Pooja & Spiritual Items,VRP APOORVA JAVADHU POW,12,35,35,0,1
13-02-2025,Beverages,REFRESH SHARBATH NORMAL,1,199,190,9,1
13-02-2025,Spices & Seasonings,GARAM MASALA 200GM,15,120,110,10,1
13-02-2025,Spices & Seasonings,GREEN SOUNF,15,60,40,20,1
13-02-2025,Milk & Dairy,BROWN EGGS 1P,7,168,144,24,12
13-02-2025,Oils & Ghee,Groundnut oil 1 L,9,720,660,60,2
13-02-2025,Snacks & Ready-to-Eat,SD GINGER CANDY 200GM,14,120,120,0,1
13-02-2025,Milk & Dairy,HERITAGE TONED MILK 500ML,7,62,62,0,2
13-02-2025,Snacks & Ready-to-Eat,SD Vamu with palm jaggery 250gm,14,135,135,0,1
13-02-2025,"Grains, Flours & Dals",Em Multimillet upma 500g,4,129,129,0,1
13-02-2025,"Grains, Flours & Dals",SL Idly Rava 1KG,4,65,55,10,1
13-02-2025,General Household & Kitchenware,RED LINE 20GM,3,75,75,0,1
13-02-2025,"Dry Fruits, Nuts & Seeds",SABJA SEEDS 100GM,2,80,70,10,1
13-02-2025,"Grains, Flours & Dals",Multigrain 1 kg,4,200,170,30,2
13-02-2025,"Grains, Flours & Dals",Chana Flour 500 gms,4,140,130,10,2
13-02-2025,"Grains, Flours & Dals",PESARA PAPPU 1 KG,4,170,145,25,1
13-02-2025,"Grains, Flours & Dals",Wheat Flour 1 kg,4,140,120,20,2
13-02-2025,"Grains, Flours & Dals",Wheat Flour 1 kg,4,70,60,10,1
13-02-2025,"Grains, Flours & Dals",WHITE BATANI 500GM,4,80,60,20,1
13-02-2025,"Grains, Flours & Dals",Red Chana 250GM,4,35,30,5,1
13-02-2025,"Dry Fruits, Nuts & Seeds",Groundnuts 1 kg,2,190,170,20,1
13-02-2025,Sweeteners,Natural Honey 500 gms,16,280,240,40,1
13-02-2025,"Grains, Flours & Dals",White Chana 250 GM,4,60,50,10,1
13-02-2025,Oils & Ghee,Sesame oil 1 L,9,590,560,30,1
13-02-2025,Sweeteners,GS A2 Buffalo Ghee 500ML,16,550,550,0,1
13-02-2025,Personal Care & Cosmetics,MYSORE SANDAL,10,69,69,0,1
13-02-2025,"Grains, Flours & Dals",VGR rice 1 kg,4,70,65,5,1
13-02-2025,"Grains, Flours & Dals",Wheat Flour 1 kg,4,210,180,30,3
13-02-2025,"Grains, Flours & Dals",JOWAR WHITE 1 KG,4,80,70,10,1
13-02-2025,"Grains, Flours & Dals",BOBBARA PAPPU 500GM,4,85,80,5,1
12-02-2025,"Dry Fruits, Nuts & Seeds",PUMPKIN SEEDS 250GM,2,200,160,40,1
12-02-2025,"Dry Fruits, Nuts & Seeds",WATERMELON SEEDS 250GRM,2,320,280,40,1
12-02-2025,"Dry Fruits, Nuts & Seeds",FLAX SEEDS 250GM,2,60,50,10,1
12-02-2025,Snacks & Ready-to-Eat,RAJGIRA PEANUT CHIKKI,14,10,10,0,2
12-02-2025,Spices & Seasonings,NUVVULU 250GM,15,80,65,15,1
12-02-2025,"Dry Fruits, Nuts & Seeds",SABJA SEEDS 100GM,2,80,70,10,1
12-02-2025,"Dry Fruits, Nuts & Seeds",SUNFLOWER SEEDS 250GRM,2,150,130,20,1
12-02-2025,"Dry Fruits, Nuts & Seeds",DRIED KIWI 200GM,2,145,130,15,1
12-02-2025,Snacks & Ready-to-Eat,GB SALT COOKIES,14,60,55,5,1
12-02-2025,Oils & Ghee,Safflower oil 500 ml,9,220,200,20,1
12-02-2025,"Grains, Flours & Dals",MELMEKER 250GMS,4,60,45,15,1
12-02-2025,"Grains, Flours & Dals",MAATEJA rice 1 kg,4,72,69,3,1
12-02-2025,Snacks & Ready-to-Eat,SD Ginger Candy 100g,14,60,60,0,1
12-02-2025,Snacks & Ready-to-Eat,SD FINGER Millet with palm Jaggery 250gm,14,135,135,0,1
12-02-2025,Snacks & Ready-to-Eat,RSC ORANGE 100GMS,14,20,20,0,1
12-02-2025,"Dry Fruits, Nuts & Seeds",DRIED KIWI 200GM,2,145,130,15,1
12-02-2025,"Dry Fruits, Nuts & Seeds",DRIED KIWI 200GM,2,145,130,15,1
12-02-2025,"Grains, Flours & Dals",SA Sprouted Ragi Flour 500GM,4,69,69,0,1
12-02-2025,Snacks & Ready-to-Eat,SD FINGER Millet with palm Jaggery 250gm,14,135,135,0,1
12-02-2025,Sweeteners,MISHRI 250 GM,16,35,30,5,1
12-02-2025,"Dry Fruits, Nuts & Seeds",Groundnuts 1 kg,2,190,170,20,1
12-02-2025,"Grains, Flours & Dals",Wheat Flour 1 kg,4,140,120,20,2
12-02-2025,"Dry Fruits, Nuts & Seeds",DRIED KIWI 200GM,2,290,260,30,2
12-02-2025,Sweeteners,NATURAL HONEY 1KG,16,560,480,80,1
12-02-2025,Snacks & Ready-to-Eat,SS IDLY BATTER 1KG,14,60,60,0,1
12-02-2025,"Grains, Flours & Dals",turdal 1kg,4,220,195,25,1
12-02-2025,"Dry Fruits, Nuts & Seeds",PUMPKIN SEEDS 250GM,2,200,160,40,1
12-02-2025,"Dry Fruits, Nuts & Seeds",ALMONDS 250GM,2,280,260,20,1
12-02-2025,"Dry Fruits, Nuts & Seeds",BLACK KISMIS 250GM,2,175,140,35,1
12-02-2025,"Grains, Flours & Dals",AISHWARYA SP 5KG,4,400,375,25,1
12-02-2025,"Dry Fruits, Nuts & Seeds",SUNFLOWER SEEDS 250GRM,2,150,130,20,1
12-02-2025,"Grains, Flours & Dals",SAMALU (Little millet) 500 gms,4,85,65,20,1
12-02-2025,Oils & Ghee,GANTASALA A2 COW GHEE 500ML,9,550,550,0,1
12-02-2025,Snacks & Ready-to-Eat,VD RIBBON PAKODI 175GM,14,60,60,0,1
12-02-2025,Personal Care & Cosmetics,STAYFREE DRY-MAX 8UNITS,10,90,90,0,1
12-02-2025,Spices & Seasonings,Telaga Pindi 250 GM,15,40,35,5,1
12-02-2025,Snacks & Ready-to-Eat,GANTASALA KARIVEPAKU SNACKS,14,60,60,0,1
12-02-2025,Snacks & Ready-to-Eat,VD MIXTURE 175 GM,14,60,60,0,1
12-02-2025,Snacks & Ready-to-Eat,SS IDLY BATTER 1KG,14,60,60,0,1
12-02-2025,"Grains, Flours & Dals",UDALU (Barnyard millet) 1 kg,4,140,115,25,1
12-02-2025,"Health, Wellness & Ayurvedic Products",RB Max Protein Oats &Raisins 55gm,5,80,80,0,1
12-02-2025,Sweeteners,SD PALM JAGGERY 500GM,16,200,200,0,1
12-02-2025,"Grains, Flours & Dals",Arikalu (kodo),4,70,65,5,1
12-02-2025,"Grains, Flours & Dals",KORRALU (FOXTAIL M) 500GM,4,65,55,10,1
12-02-2025,"Grains, Flours & Dals",BLACK GRAM 1KG,4,300,280,20,2
12-02-2025,"Grains, Flours & Dals",split green gram 500 gms,4,75,70,5,1
12-02-2025,"Grains, Flours & Dals",JOWAR YELLOW 1 K,4,100,90,10,1
12-02-2025,"Dry Fruits, Nuts & Seeds",PULMAKHANA 100 GM,2,180,170,10,1
12-02-2025,"Grains, Flours & Dals",Multigrain 1 kg,4,200,170,30,2
12-02-2025,Milk & Dairy,SANGAM CURD 450GM,7,38,38,0,1
12-02-2025,Milk & Dairy,SANGAM TONED MILK 500ML,7,60,60,0,2
12-02-2025,"Grains, Flours & Dals",Brown RICE 1KG,4,140,130,10,2
12-02-2025,Snacks & Ready-to-Eat,GROUNDNUT LADDU WITH DATES,14,135,135,0,1
12-02-2025,Snacks & Ready-to-Eat,SD Flax seeds with dates 250gm,14,135,135,0,1
12-02-2025,"Grains, Flours & Dals",MAAGAANI LOW GI SP 1KG,4,745,745,0,5
12-02-2025,"Grains, Flours & Dals",Bombay Rava 500GM,4,35,30,5,1
12-02-2025,"Grains, Flours & Dals",Wheat Rava M 500GM,4,33,30,3,1
12-02-2025,"Grains, Flours & Dals",SINGLE POLISH 1KG,4,65,65,0,1
12-02-2025,"Grains, Flours & Dals",White jowar.F 1 kg,4,100,80,20,1
12-02-2025,"Dry Fruits, Nuts & Seeds",Groundnuts 500 gms,2,95,85,10,1
12-02-2025,Oils & Ghee,Sesame oil 500ml,9,295,280,15,1
12-02-2025,"Grains, Flours & Dals",POORI ATTA 500GM,4,0,0,0,1
12-02-2025,"Grains, Flours & Dals",Wheat Flour 1 kg,4,70,60,10,1
12-02-2025,Snacks & Ready-to-Eat,VD CORNFLAKES MIXTURE 175GM,14,60,60,0,1
12-02-2025,Oils & Ghee,Safflower oil 1 L,9,440,400,40,1
12-02-2025,"Dry Fruits, Nuts & Seeds",SUNFLOWER SEEDS 250GRM,2,150,130,20,1
12-02-2025,"Grains, Flours & Dals",white Bobarlu 1 KG,4,170,150,20,1
12-02-2025,"Dry Fruits, Nuts & Seeds",PUMPKIN SEEDS 250GM,2,200,160,40,1
12-02-2025,Snacks & Ready-to-Eat,SD FINGER Millet with palm Jaggery 250gm,14,135,135,0,1
12-02-2025,Snacks & Ready-to-Eat,VD NUVULU CHEGODI 175GM,14,60,60,0,1
12-02-2025,"Dry Fruits, Nuts & Seeds",FLAX SEEDS 250GM,2,60,50,10,1
12-02-2025,"Grains, Flours & Dals",POORI ATTA 1KG,4,70,60,10,1
12-02-2025,Snacks & Ready-to-Eat,SD JOWAR WITH PALM JAGGERY 250GM,14,135,135,0,1
12-02-2025,"Dry Fruits, Nuts & Seeds",Groundnuts 1 kg,2,190,170,20,1
12-02-2025,Snacks & Ready-to-Eat,SD RED CHILLY PAPADS,14,80,80,0,1
12-02-2025,Personal Care & Cosmetics,BAMBOO TOOTH BRUSH,10,120,120,0,1
12-02-2025,Snacks & Ready-to-Eat,VD NUVULU LADDU 9PIC,14,100,100,0,1
12-02-2025,General Household & Kitchenware,SIRIDHANYALU BOOK,3,200,180,20,1
12-02-2025,Oils & Ghee,Sesame oil 1 L,9,590,560,30,1
12-02-2025,Pooja & Spiritual Items,GOMATHA AGARBATHI,12,75,75,0,1
12-02-2025,"Grains, Flours & Dals",MAAGAANI LOW GI SP 1KG,4,249,249,0,1
12-02-2025,"Grains, Flours & Dals",Chana Flour 500 gms,4,140,130,10,2
12-02-2025,"Grains, Flours & Dals",Red Wheat Flour 1 kg,4,140,130,10,1
12-02-2025,"Dry Fruits, Nuts & Seeds",SABJA SEEDS 100GM,2,80,70,10,1
12-02-2025,"Grains, Flours & Dals",SINGLE POLISH 1KG,4,32.5,32.5,0,0.5
12-02-2025,"Grains, Flours & Dals",YB CHITTIMUTYALU RICE 1KG,4,200,200,0,1
12-02-2025,Snacks & Ready-to-Eat,GB SALT COOKIES,14,60,55,5,1
12-02-2025,"Grains, Flours & Dals",RAGULU 1 KG,4,70,60,10,1
12-02-2025,"Grains, Flours & Dals",SINGLE POLISH 1KG,4,325,325,0,5
12-02-2025,Oils & Ghee,Sesame oil 500ml,9,295,280,15,1
12-02-2025,Spices & Seasonings,ROYAL SAFFRON 400GRMS,15,65,65,0,1
12-02-2025,"Grains, Flours & Dals",White jowar.F 1 kg,4,100,80,20,1
12-02-2025,"Grains, Flours & Dals",POORI ATTA 500GM,4,30,30,0,1
12-02-2025,"Grains, Flours & Dals",PESARA PAPPU 1 KG,4,170,145,25,1
12-02-2025,"Dry Fruits, Nuts & Seeds",Groundnuts 500 gms,2,95,85,10,1
12-02-2025,"Grains, Flours & Dals",Wheat Flour 1 kg,4,70,60,10,1
12-02-2025,Snacks & Ready-to-Eat,NGT CHATPATTA CHANA 90GM,14,25,25,0,1
12-02-2025,Spices & Seasonings,Jeera 100GM,15,50,45,5,1
12-02-2025,"Grains, Flours & Dals",turdal 500 gms,4,110,100,10,1
12-02-2025,"Grains, Flours & Dals",UDALU (Barnyard millet) 1 kg,4,140,115,25,1
12-02-2025,"Grains, Flours & Dals",SL Idly Rava 1KG,4,65,55,10,1
12-02-2025,Oils & Ghee,Castor oil 500 ml,9,250,200,50,1
12-02-2025,"Grains, Flours & Dals",DH URAD GOTA 1KG,4,430,380,50,2
12-02-2025,"Dry Fruits, Nuts & Seeds",PUTNALU 500GMS,2,90,76,14,1
12-02-2025,"Dry Fruits, Nuts & Seeds",Groundnuts 1 kg,2,190,170,20,1
12-02-2025,Milk & Dairy,BROWN EGGS TRAY 30P,7,360,330,30,1
12-02-2025,Snacks & Ready-to-Eat,PEANUT CANDY,14,45,45,0,1
12-02-2025,"Grains, Flours & Dals",Wheat Flour 1 kg,4,70,60,10,1
12-02-2025,Spices & Seasonings,TATA SALT 1KG,15,30,30,0,1
12-02-2025,Snacks & Ready-to-Eat,FUN TIME CRUNCH,14,45,45,0,1
12-02-2025,"Grains, Flours & Dals",SINGHAM 26KG BAG,4,1650,"1,650.00",0,1
12-02-2025,Snacks & Ready-to-Eat,SD FINGER Millet with palm Jaggery 250gm,14,135,135,0,1
12-02-2025,Oils & Ghee,Mustard oil 1 L,9,440,400,40,1
12-02-2025,Oils & Ghee,Safflower oil 1 L,9,440,400,40,1
12-02-2025,"Health, Wellness & Ayurvedic Products",MADDI NEEM OIL 100ML,5,110,110,0,1
12-02-2025,Personal Care & Cosmetics,VICCO TURMERIC SKIN CREAM 15G,10,77,77,0,1
12-02-2025,Snacks & Ready-to-Eat,Corn Chips 250GM,14,80,70,10,2
12-02-2025,Spices & Seasonings,NUVVULU 250GM,15,80,65,15,1
12-02-2025,Spices & Seasonings,Turmeric powder 250 gms,15,100,75,25,1
12-02-2025,"Grains, Flours & Dals",Chana Flour 500 gms,4,280,260,20,4
12-02-2025,"Dry Fruits, Nuts & Seeds",PUMPKIN SEEDS 250GM,2,200,160,40,1
12-02-2025,Spices & Seasonings,ROYAL SAFFRON,15,125,125,0,1
12-02-2025,"Grains, Flours & Dals",Wheat Flour 1 kg,4,210,180,30,3
12-02-2025,"Grains, Flours & Dals",SL Idly Rava 1KG,4,130,110,20,2
12-02-2025,"Grains, Flours & Dals",split green gram 1 kg,4,150,140,10,1
12-02-2025,"Grains, Flours & Dals",SINGLE POLISH 1KG,4,325,325,0,5
12-02-2025,"Grains, Flours & Dals",VGR RICE 5 KGS,4,350,325,25,1
12-02-2025,Spices & Seasonings,SONTI 50GM,15,30,30,0,1
12-02-2025,"Grains, Flours & Dals",RAGI FLOUR 1KG,4,80,70,10,1
12-02-2025,"Grains, Flours & Dals",DISANO OATS 1KG,4,285,142.5,142.5,1
12-02-2025,Snacks & Ready-to-Eat,BB VERMICELLI 250GM,14,30,30,0,1
12-02-2025,"Grains, Flours & Dals",Quinova 1 kg,4,220,195,25,1
12-02-2025,Milk & Dairy,SANGAM TONED MILK 500ML,7,60,60,0,2
12-02-2025,Pooja & Spiritual Items,BALAJI KEWDA STICKS 220GM,12,150,150,0,1
12-02-2025,Snacks & Ready-to-Eat,SALTED PHALLI,14,65,65,0,1
12-02-2025,Spices & Seasonings,SD Redgram Karam Powder 100GM,15,65,65,0,1
12-02-2025,Snacks & Ready-to-Eat,VD ATUKULU MIXTURE 175GM,14,60,60,0,1
12-02-2025,"Grains, Flours & Dals",Wheat Flour 5 kgs,4,350,300,50,1
12-02-2025,Sweeteners,MISHRI 250 GM,16,35,30,5,1
12-02-2025,"Grains, Flours & Dals",HS JOWAR FLAKES 250GM 1+1,4,119,119,0,1
12-02-2025,Snacks & Ready-to-Eat,URBAN MARMURA 450GM,14,70,70,0,1
12-02-2025,Milk & Dairy,BROWN EGGS TRAY 30P,7,360,330,30,1
12-02-2025,"Grains, Flours & Dals",VGR RICE 5 KGS,4,350,325,25,1
12-02-2025,"Grains, Flours & Dals",THICK POHA 500GM,4,40,35,5,1
12-02-2025,"Grains, Flours & Dals",SAMALU (Little millet) 500 gms,4,85,65,20,1
12-02-2025,"Grains, Flours & Dals",Arikalu (kodo),4,70,65,5,1
12-02-2025,Milk & Dairy,HERITAGE TONED MILK 500ML,7,31,31,0,1
12-02-2025,"Grains, Flours & Dals",KORRALU (FOXTAIL M) 500GM,4,65,55,10,1
12-02-2025,"Grains, Flours & Dals",BARLEY SEEDS 250GMS,4,40,35,5,1
12-02-2025,"Grains, Flours & Dals",JOWAR YELLOW 1 K,4,25,22.5,2.5,0.25
12-02-2025,"Dry Fruits, Nuts & Seeds",YELLOW KISHMISH 250GM,2,130,110,20,1
12-02-2025,Sweeteners,GS Organic Jaggery Powder 600GM,16,99,99,0,1
12-02-2025,Oils & Ghee,Safflower oil 1 L,9,440,400,40,1
12-02-2025,Spices & Seasonings,GREEN SOUNF,15,120,80,40,2
12-02-2025,Spices & Seasonings,Tamarind 250GMS,15,80,65,15,1
12-02-2025,"Grains, Flours & Dals",Multigrain 1 kg,4,100,85,15,1
12-02-2025,Personal Care & Cosmetics,Khadi Shikakai With Amla Shampoo 200,10,300,300,0,1
12-02-2025,"Grains, Flours & Dals",SRILATHA RICE RAVVA 500GM,4,35,35,0,1
12-02-2025,"Grains, Flours & Dals",RAGI FLOUR 500GRMS,4,40,35,5,1
12-02-2025,"Grains, Flours & Dals",White jowar.F 1 kg,4,100,80,20,1
12-02-2025,Spices & Seasonings,JEERA 250 gms,15,125,105,20,1
12-02-2025,Spices & Seasonings,DRY MANGO POWDER,15,90,90,0,2
12-02-2025,Spices & Seasonings,NUVVULU 250GM,15,100,85,15,1
12-02-2025,"Grains, Flours & Dals",SB Javva Wheat Ravva 500GM,4,95,95,0,1
12-02-2025,"Grains, Flours & Dals",Wheat Rava M 1KG,4,65,55,10,1
12-02-2025,Snacks & Ready-to-Eat,BATANA NGT 70GMS,14,20,20,0,1
12-02-2025,"Dry Fruits, Nuts & Seeds",FLAX SEEDS 250GM,2,60,50,10,1
12-02-2025,Personal Care & Cosmetics,ROUND LOOFAH,10,65,65,0,1
12-02-2025,Snacks & Ready-to-Eat,MAAGAANI JOWAR M COOKIES 120GM,14,149,149,0,1
12-02-2025,Snacks & Ready-to-Eat,SD Atreyapuram DRY Fruit ghee,14,150,150,0,1
12-02-2025,"Grains, Flours & Dals",SAMALU (Little millet) 1 kg,4,170,130,40,1
12-02-2025,"Grains, Flours & Dals",HS JOWAR FLAKES 250GM 1+1,4,119,119,0,1
12-02-2025,Snacks & Ready-to-Eat,MUTLGRAIN BREAD,14,70,70,0,1
12-02-2025,Milk & Dairy,BROWN EGGS 1P,7,112,96,16,8
12-02-2025,"Health, Wellness & Ayurvedic Products",RB Max Protein Choco chips 55gm,5,50,50,0,1
12-02-2025,Snacks & Ready-to-Eat,SF VERMICELLI,14,139,139,0,1
12-02-2025,"Grains, Flours & Dals",BLACK GRAM 1KG,4,150,140,10,1
12-02-2025,"Grains, Flours & Dals",VGR rice 1 kg,4,140,130,10,2
12-02-2025,"Grains, Flours & Dals",SINGLE POLISH 1KG,4,325,325,0,5
12-02-2025,"Grains, Flours & Dals",SRILATHA RICE RAVVA 500GM,4,35,35,0,1
12-02-2025,"Grains, Flours & Dals",JOWAR UPMA RAVA,4,0,0,0,1
12-02-2025,Snacks & Ready-to-Eat,WHOLE WHEAT BREAD,14,55,55,0,1
12-02-2025,"Grains, Flours & Dals",BASMATHI RICE 1KG,4,150,135,15,1
12-02-2025,"Grains, Flours & Dals",MAAGAANI LOW GI SP L 1KG,4,240,210,30,2
12-02-2025,"Grains, Flours & Dals",MAAGAANI LOW GI SP L 1KG,4,120,105,15,1
12-02-2025,Snacks & Ready-to-Eat,WHOLE WHEAT BREAD,14,55,55,0,1
12-02-2025,"Grains, Flours & Dals",BASMATHI RICE 1KG,4,150,135,15,1
12-02-2025,Household & Cleaning,BORIC POWDER 100GM,6,55,55,0,1
12-02-2025,"Grains, Flours & Dals",FLOUR CHARGE,4,30,30,0,2.5
12-02-2025,Pooja & Spiritual Items,GB Bharatha Woods 75GM,12,60,60,0,1
12-02-2025,Snacks & Ready-to-Eat,BD LITTLE MILLET NOODLES 200G,14,75,75,0,1
12-02-2025,"Grains, Flours & Dals",KORRALU (FOXTAIL M) 500GM,4,65,55,10,1
12-02-2025,"Grains, Flours & Dals",VGR rice 1 kg,4,70,65,5,1
12-02-2025,Snacks & Ready-to-Eat,FOXTAIL NOODLES,14,75,75,0,1
12-02-2025,"Grains, Flours & Dals",RAGI FLOUR 1KG,4,80,70,10,1
12-02-2025,"Grains, Flours & Dals",Wheat Flour 1 kg,4,70,60,10,1
12-02-2025,"Grains, Flours & Dals",Wheat Flour 1 kg,4,70,60,10,1
12-02-2025,"Grains, Flours & Dals",RAGI FLOUR 500GRMS,4,40,35,5,1
12-02-2025,"Grains, Flours & Dals",SPLIT BLACK GRAM 500 GM,4,90,85,5,1
12-02-2025,"Grains, Flours & Dals",split black gram 1 kg,4,180,170,10,1
12-02-2025,"Dry Fruits, Nuts & Seeds",PULMAKHANA 100 GM,2,360,340,20,2
12-02-2025,"Grains, Flours & Dals",Quinova 1 kg,4,220,195,25,1
12-02-2025,"Dry Fruits, Nuts & Seeds",SATHVI CHIA SEEDS 100GM,2,100,80,20,1
12-02-2025,Oils & Ghee,Safflower oil 1 L,9,440,400,40,1
12-02-2025,"Grains, Flours & Dals",PESARA PAPPU 500GMS,4,85,75,10,1
12-02-2025,Spices & Seasonings,Dalchin Chekka 50GM,15,50,40,10,1
12-02-2025,"Dry Fruits, Nuts & Seeds",FLAX SEEDS 250GM,2,60,50,10,1
12-02-2025,"Grains, Flours & Dals",MAAGAANI LOW GI SP L 1KG,4,120,105,15,1
12-02-2025,Snacks & Ready-to-Eat,TILLI CHIKKI,14,25,25,0,5
12-02-2025,"Grains, Flours & Dals",MGSUGAR CONTROL RICE 1KG,4,139,139,0,1
12-02-2025,"Grains, Flours & Dals",White jowar.F 1 kg,4,100,80,20,1
12-02-2025,"Dry Fruits, Nuts & Seeds",Putnalu 250GM,2,45,38,7,1
12-02-2025,Snacks & Ready-to-Eat,VD ATUKULU MIXTURE 175GM,14,60,60,0,1
12-02-2025,Spices & Seasonings,Telaga Pindi 250 GM,15,40,35,5,1
12-02-2025,Oils & Ghee,Sesame oil 1 L,9,590,560,30,1
12-02-2025,Snacks & Ready-to-Eat,Corn Chips 250GM,14,80,70,10,2
12-02-2025,Spices & Seasonings,Jeera 100GM,15,50,45,5,1
12-02-2025,Oils & Ghee,Safflower oil 1 L,9,440,400,40,1
12-02-2025,"Grains, Flours & Dals",SL Idly Rava 1KG,4,130,110,20,2
12-02-2025,Spices & Seasonings,ROYAL SAFFRON,15,125,125,0,1
12-02-2025,"Grains, Flours & Dals",split black gram 1 kg,4,180,170,10,1
12-02-2025,Spices & Seasonings,AVALU 100GM,15,25,20,5,1
12-02-2025,"Grains, Flours & Dals",FLOUR CHARGE,4,18,18,0,1.5
12-02-2025,"Grains, Flours & Dals",JOWAR YELLOW 1 K,4,150,135,15,1.5
12-02-2025,Snacks & Ready-to-Eat,VD MINAPA SUNNUNDALU 12P,14,180,180,0,1
12-02-2025,Oils & Ghee,Sesame oil 500ml,9,295,280,15,1
12-02-2025,Household & Cleaning,SURF EXCEL MATIC TL 500ML,6,130,130,0,1
12-02-2025,Snacks & Ready-to-Eat,SD Moringa with plam jaggery 250gm,14,135,135,0,1
12-02-2025,Household & Cleaning,LIZOL FORAL CLEANER,6,116,116,0,1
12-02-2025,Household & Cleaning,VIM TROPICAL LEMON FRESHNESS 250ML,6,55,55,0,1
12-02-2025,"Grains, Flours & Dals",VL Sabdana 500GM,4,77,77,0,1
12-02-2025,Household & Cleaning,COMFORT EAU DE PARFUM 210ML,6,65,65,0,1
12-02-2025,Snacks & Ready-to-Eat,SD KODO MILLET WITH PALM JAGGERY,14,135,135,0,1
12-02-2025,Spices & Seasonings,THREE MANGO RAI 200G,15,42,42,0,1
12-02-2025,"Grains, Flours & Dals",COW B RICE BAG 1,4,2099,"1,750.00",349,1
12-02-2025,"Grains, Flours & Dals",DR.RICE 5KG,4,3600,"3,600.00",0,6
12-02-2025,Milk & Dairy,BROWN EGGS 1P,7,84,72,12,6
12-02-2025,"Grains, Flours & Dals",Yellow jowar .F1 kg,4,110,100,10,1
12-02-2025,Spices & Seasonings,Menthulu 250 gms,15,100,90,10,2
12-02-2025,Snacks & Ready-to-Eat,VD SAGOPAPAD 150GM,14,55,55,0,1
12-02-2025,"Dry Fruits, Nuts & Seeds",KAJU HALF 250GM,2,310,290,20,1
12-02-2025,Household & Cleaning,VIM SOAP,6,40,40,0,8
12-02-2025,Spices & Seasonings,Coriander seeds 200 gms,15,48,40,8,1
12-02-2025,Spices & Seasonings,ROYAL SAFFRON 400GRMS,15,65,65,0,1
12-02-2025,Snacks & Ready-to-Eat,ANNAPURNA APPALAM,14,70,70,0,2
12-02-2025,Spices & Seasonings,SHAHI BIRYANI MASALA,15,42,42,0,1
12-02-2025,Snacks & Ready-to-Eat,GB SALT COOKIES,14,60,55,5,1
12-02-2025,"Dry Fruits, Nuts & Seeds",Groundnuts 1 kg,2,190,170,20,1
12-02-2025,"Grains, Flours & Dals",CHANA DAL 500GM,4,140,120,20,2
12-02-2025,"Dry Fruits, Nuts & Seeds",WALLNUTS 250GM,2,380,360,20,1
12-02-2025,"Dry Fruits, Nuts & Seeds",PUTNALU 500GMS,2,90,76,14,1
12-02-2025,Oils & Ghee,Sesame oil 1 L,9,1770,"1,680.00",90,3
12-02-2025,Household & Cleaning,SURFEXCEL BAR 80G,6,50,50,0,5
12-02-2025,Spices & Seasonings,GS Pink Rock Salt 1KG,15,120,120,0,1
12-02-2025,Snacks & Ready-to-Eat,ELITE MILK RUSK 200GM,14,35,35,0,1
12-02-2025,"Dry Fruits, Nuts & Seeds",SALTED PISTA 250GM,2,400,350,50,1
12-02-2025,Pooja & Spiritual Items,Banda Puvvu 25GM,12,80,80,0,1
12-02-2025,Household & Cleaning,PITAMBARI,6,56,56,0,2
12-02-2025,Snacks & Ready-to-Eat,PEANUT CANDY,14,90,90,0,2
12-02-2025,Snacks & Ready-to-Eat,SESAME CHIKKI,14,120,100,20,1
12-02-2025,"Grains, Flours & Dals",turdal 1kg,4,220,195,25,1
12-02-2025,"Grains, Flours & Dals",HS Multimillet upma r 500g,4,65,65,0,1
12-02-2025,"Grains, Flours & Dals",White jowar.F 1 kg,4,100,80,20,1
12-02-2025,Spices & Seasonings,Menthulu 250 gms,15,50,45,5,1
12-02-2025,"Grains, Flours & Dals",split black gram 500 gms,4,90,85,5,1
12-02-2025,"Grains, Flours & Dals",Wheat Flour 1 kg,4,210,180,30,3
12-02-2025,Personal Care & Cosmetics,MD Bath Powder 100GM,10,80,80,0,2
12-02-2025,Pooja & Spiritual Items,GD Kumkum 50GM,12,30,30,0,1
12-02-2025,Spices & Seasonings,ROYAL SAFFRON,15,250,250,0,2
12-02-2025,"Grains, Flours & Dals",HS JOWAR FLAKES 250GM 1+1,4,119,59.5,59.5,1
12-02-2025,Snacks & Ready-to-Eat,BATANA NGT 70GMS,14,20,20,0,1
12-02-2025,Spices & Seasonings,Turmeric powder 250 gms,15,100,75,25,1
12-02-2025,"Grains, Flours & Dals",SPLIT BLACK GRAM 500 GM,4,90,85,5,1
12-02-2025,Spices & Seasonings,Coriander seeds 200 gms,15,48,40,8,1
12-02-2025,Spices & Seasonings,Turmeric powder 250 gms,15,100,75,25,1
12-02-2025,"Dry Fruits, Nuts & Seeds",Groundnuts 500 gms,2,95,85,10,1
12-02-2025,"Grains, Flours & Dals",MELMEKER 250GMS,4,60,45,15,1
12-02-2025,"Grains, Flours & Dals",URAD DALL,4,95,85,10,1
12-02-2025,Oils & Ghee,Sesame oil 1 L,9,1770,"1,680.00",90,3
12-02-2025,Pooja & Spiritual Items,GD Aiswarya Deepam 700ML,12,195,195,0,1
12-02-2025,Household & Cleaning,COMFORT EAU DE PARFUM 210ML,6,58,58,0,1
12-02-2025,"Grains, Flours & Dals",turdal 1kg,4,220,195,25,1
12-02-2025,"Grains, Flours & Dals",JOWAR WHITE 1 KG,4,80,70,10,1
12-02-2025,"Grains, Flours & Dals",Wheat Flour 1 kg,4,140,120,20,2
12-02-2025,"Dry Fruits, Nuts & Seeds",SATHVI CHIA SEEDS 100GM,2,100,80,20,1
12-02-2025,"Dry Fruits, Nuts & Seeds",SABJA SEEDS 100GM,2,80,70,10,1
12-02-2025,"Grains, Flours & Dals",ANDU KORRALU (Brown top .mlt) 500,4,130,110,20,1
12-02-2025,Spices & Seasonings,GREEN SOUNF,15,60,40,20,1
12-02-2025,"Grains, Flours & Dals",SAMALU (Little millet) 1 kg,4,170,130,40,1
12-02-2025,"Grains, Flours & Dals",UDALU (Barnyard millet) 1 kg,4,140,115,25,1
12-02-2025,Sweeteners,SD PALM JAGGERY 500GM,16,200,200,0,1
12-02-2025,"Grains, Flours & Dals",RAJMA 250GM,4,55,45,10,1
12-02-2025,"Grains, Flours & Dals",KORRALU (FOXTAIL M) 1KG,4,150,110,40,1
12-02-2025,"Dry Fruits, Nuts & Seeds",Groundnuts 1 kg,2,190,170,20,1
12-02-2025,"Grains, Flours & Dals",Black uluvalu 500 gms,4,90,70,20,1
12-02-2025,"Grains, Flours & Dals",Arikalu (kodo),4,140,130,10,2
12-02-2025,"Grains, Flours & Dals",VGR rice 1 kg,4,210,195,15,3
12-02-2025,"Dry Fruits, Nuts & Seeds",Groundnuts 500 gms,2,95,85,10,1
12-02-2025,"Grains, Flours & Dals",WHEAT 1 KG,4,120,100,20,2
12-02-2025,"Grains, Flours & Dals",SINGLE POLISH 1KG,4,650,650,0,10
12-02-2025,"Grains, Flours & Dals",RAJMA 250GM,4,55,45,10,1
12-02-2025,"Grains, Flours & Dals",RAGI FLOUR 1KG,4,80,70,10,1
12-02-2025,"Grains, Flours & Dals",Wheat Rava M 1KG,4,130,110,20,2
12-02-2025,Spices & Seasonings,AV Iodized Salt 1KG,15,140,125,15,5
12-02-2025,"Dry Fruits, Nuts & Seeds",YB GRANMA NUTS,2,90,90,0,1
12-02-2025,"Grains, Flours & Dals",RED WHEAT 1 KG,4,130,120,10,1
12-02-2025,"Dry Fruits, Nuts & Seeds",ANJEER 250GM,2,800,720,80,2
12-02-2025,"Dry Fruits, Nuts & Seeds",SABJA SEEDS 100GM,2,80,70,10,1
12-02-2025,"Grains, Flours & Dals",Red Bobarlu 500 gms,4,95,85,10,1
12-02-2025,Snacks & Ready-to-Eat,JUNNU POWDER 100GM,14,140,140,0,2
12-02-2025,Milk & Dairy,SANGAM FULL CREAM MILK 500ML,7,76,76,0,2
12-02-2025,Spices & Seasonings,LG 50GM,15,92,92,0,1
12-02-2025,Personal Care & Cosmetics,GAYATHRI KUMKUDUKAYA,10,300,300,0,2
12-02-2025,"Grains, Flours & Dals",RAGULU 1 KG,4,35,30,5,0.5
12-02-2025,Snacks & Ready-to-Eat,GB SALT COOKIES,14,60,55,5,1
12-02-2025,"Grains, Flours & Dals",BLACK GRAM 1KG,4,300,280,20,2
12-02-2025,"Grains, Flours & Dals",White jowar.F 1 kg,4,100,80,20,1
12-02-2025,"Grains, Flours & Dals",FLOUR CHARGE,4,26.4,26.4,0,2.2
12-02-2025,"Dry Fruits, Nuts & Seeds",YELLOW KISHMISH 250GM,2,130,110,20,1
12-02-2025,"Grains, Flours & Dals",JOWAR WHITE 1 KG,4,40,35,5,0.5
12-02-2025,"Dry Fruits, Nuts & Seeds",Groundnuts 500 gms,2,95,85,10,1
12-02-2025,Sweeteners,Mishri 500GM,16,210,180,30,3
12-02-2025,Spices & Seasonings,Turmeric powder 250 gms,15,300,225,75,3
12-02-2025,Sweeteners,GS JAGGERY NUGGETS 500GM,16,120,120,0,1
12-02-2025,"Grains, Flours & Dals",Bombay Rava 500GM,4,35,30,5,1
12-02-2025,"Grains, Flours & Dals",turdal 1kg,4,220,195,25,1
12-02-2025,Milk & Dairy,HERITAGE TOTAL CURD 500GM,7,50,50,0,1
12-02-2025,"Dry Fruits, Nuts & Seeds",PUTNALU 500GMS,2,90,76,14,1
12-02-2025,"Dry Fruits, Nuts & Seeds",Groundnuts 500 gms,2,95,85,10,1
12-02-2025,"Grains, Flours & Dals",Idly Rava L 1KG,4,60,50,10,1
12-02-2025,"Grains, Flours & Dals",Wheat Flour 1 kg,4,140,120,20,2
12-02-2025,"Dry Fruits, Nuts & Seeds",SATHVI CHIA SEEDS 100GM,2,100,80,20,1
12-02-2025,"Grains, Flours & Dals",SINGLE POLISH 1KG,4,325,325,0,5
12-02-2025,"Dry Fruits, Nuts & Seeds",YB GRANMA NUTS,2,90,90,0,1
12-02-2025,Milk & Dairy,BROWN EGGS 1P,7,84,72,12,6
12-02-2025,"Health, Wellness & Ayurvedic Products",AMLA PACHAK,5,100,100,0,1
12-02-2025,Milk & Dairy,BROWN EGGS TRAY 30P,7,720,660,60,2
12-02-2025,"Grains, Flours & Dals",Bombay Rava 500GM,4,35,30,5,1
12-02-2025,"Grains, Flours & Dals",SINGLE POLISH 1KG,4,65,65,0,1
12-02-2025,Sweeteners,GS JAGGERY NUGGETS 500GM,16,120,120,0,1
12-02-2025,"Grains, Flours & Dals",MAAGAANI LOW GI SP L 1KG,4,360,315,45,3
12-02-2025,"Grains, Flours & Dals",turdal 1kg,4,440,390,50,2
12-02-2025,"Grains, Flours & Dals",White jowar.F 1 kg,4,300,240,60,3
12-02-2025,Oils & Ghee,Sesame oil 1 L,9,1180,"1,120.00",60,2
12-02-2025,Milk & Dairy,BROWN EGGS 1P,7,84,72,12,6
12-02-2025,Snacks & Ready-to-Eat,SD FINGER Millet with palm Jaggery 250gm,14,135,135,0,1
12-02-2025,"Grains, Flours & Dals",JOWAR YELLOW 1 K,4,50,45,5,0.5
12-02-2025,"Grains, Flours & Dals",BAJRA 1 KG,4,30,25,5,0.5
12-02-2025,Spices & Seasonings,DRY MIECHI 200GM,15,80,60,20,1
12-02-2025,Spices & Seasonings,JEERA 250 gms,15,125,105,20,1
12-02-2025,Spices & Seasonings,SATHVI ANASAPUVUU 25GM,15,90,65,25,1
12-02-2025,Spices & Seasonings,Coriander seeds 200 gms,15,48,40,8,1
12-02-2025,"Dry Fruits, Nuts & Seeds",Groundnuts 1 kg,2,380,340,40,2
12-02-2025,Sweeteners,SUGAR 1KG,16,240,200,40,4
12-02-2025,Spices & Seasonings,Japatri 25GM,15,100,80,20,1
12-02-2025,Spices & Seasonings,TATA SALT 1KG,15,30,30,0,1
12-02-2025,Spices & Seasonings,Gasagasalu 50GM,15,130,110,20,1
12-02-2025,Oils & Ghee,Safflower oil 1 L,9,880,800,80,2
12-02-2025,Spices & Seasonings,Elaichi 25GM,15,145,120,25,1
12-02-2025,Oils & Ghee,Sesame oil 1 L,9,590,560,30,1
12-02-2025,"Grains, Flours & Dals",URAD DALL,4,95,85,10,1
12-02-2025,"Grains, Flours & Dals",RED TURDAL 500GM,4,75,70,5,1
12-02-2025,"Grains, Flours & Dals",Urad dall 1 Kg,4,185,170,15,1
12-02-2025,"Grains, Flours & Dals",turdal 1kg,4,220,195,25,1
12-02-2025,Oils & Ghee,Safflower oil 1 L,9,440,400,40,1
12-02-2025,"Dry Fruits, Nuts & Seeds",Putnalu 250GM,2,45,38,7,1
12-02-2025,"Grains, Flours & Dals",CHANA DAL 1KG,4,35,30,5,0.25
12-02-2025,"Grains, Flours & Dals",SL Idly Rava 1KG,4,65,55,10,1
12-02-2025,Household & Cleaning,VIM EXTRA 110GM,6,10,10,0,1
12-02-2025,Personal Care & Cosmetics,lux,10,36,36,0,1
12-02-2025,Sweeteners,SUGAR 500 GM,16,30,25,5,1
12-02-2025,"Dry Fruits, Nuts & Seeds",Groundnuts 500 gms,2,95,85,10,1
12-02-2025,"Grains, Flours & Dals",Red Wheat Flour 1 kg,4,140,130,10,1
12-02-2025,Milk & Dairy,BROWN EGGS TRAY 30P,7,360,330,30,1
12-02-2025,Milk & Dairy,BROWN EGGS TRAY 30P,7,360,330,30,1
12-02-2025,Spices & Seasonings,Jeera 100GM,15,50,45,5,1
12-02-2025,"Grains, Flours & Dals",Multigrain 1 kg,4,100,85,15,1
12-02-2025,Snacks & Ready-to-Eat,VD Minapa papad 200gm,14,60,60,0,1
12-02-2025,"Grains, Flours & Dals",SL Suji Rava 500GM,4,32,32,0,1
12-02-2025,"Grains, Flours & Dals",Green gram 1 kg,4,150,130,20,1
12-02-2025,"Dry Fruits, Nuts & Seeds",Groundnuts 1 kg,2,380,340,40,2
12-02-2025,"Grains, Flours & Dals",PESARA PAPPU 1 KG,4,170,145,25,1
12-02-2025,Snacks & Ready-to-Eat,SD JOWAR WITH PALM JAGGERY 250GM,14,135,135,0,1
12-02-2025,Snacks & Ready-to-Eat,SD Aswagandha with palm Jaggery250Gm,14,135,135,0,1
12-02-2025,"Dry Fruits, Nuts & Seeds",PUMPKIN SEEDS 250GM,2,200,160,40,1
12-02-2025,"Grains, Flours & Dals",DISANO OATS 1KG,4,285,142.5,142.5,1
12-02-2025,Pooja & Spiritual Items,SWASTIK CAMPHORE,12,90,90,0,1
12-02-2025,"Grains, Flours & Dals",Multigrain 1 kg,4,100,85,15,1
12-02-2025,Milk & Dairy,BROWN EGGS 1P,7,140,120,20,10
12-02-2025,"Grains, Flours & Dals",Brown RICE 1KG,4,140,130,10,2
12-02-2025,"Grains, Flours & Dals",VGR rice 1 kg,4,140,130,10,2
12-02-2025,Beverages,REFRESH SHARBATH NORMAL,1,199,190,9,1
12-02-2025,"Grains, Flours & Dals",SINGLE POLISH 1KG,4,130,130,0,2
12-02-2025,"Health, Wellness & Ayurvedic Products",MH Millets Malt 500GM,5,200,190,10,1
12-02-2025,"Grains, Flours & Dals",Green gram 500 gms,4,75,70,5,1
11-02-2025,Milk & Dairy,BROWN EGGS 1P,7,168,144,24,12
11-02-2025,Milk & Dairy,SANGAM CURD 450GM,7,38,38,0,1
11-02-2025,Snacks & Ready-to-Eat,SS IDLY BATTER 1KG,14,60,60,0,1
11-02-2025,Snacks & Ready-to-Eat,BATANA NGT 70GMS,14,20,20,0,1
11-02-2025,Spices & Seasonings,ROYAL SAFFRON,15,125,125,0,1
11-02-2025,"Dry Fruits, Nuts & Seeds",Groundnuts 1 kg,2,190,170,20,1
11-02-2025,Pooja & Spiritual Items,SWASTIK CAMPHORE,12,90,90,0,1
11-02-2025,Spices & Seasonings,DRY MIECHI 200GM,15,80,60,20,1
11-02-2025,"Grains, Flours & Dals",Urad dall 1 Kg,4,370,340,30,2
11-02-2025,Household & Cleaning,PITAMBARI SHINING POWDER 200G,6,240,240,0,4
11-02-2025,Sweeteners,SUGAR 1KG,16,120,100,20,2
11-02-2025,Snacks & Ready-to-Eat,BB VERMICELLY 500GM,14,106,106,0,2
11-02-2025,General Household & Kitchenware,SABEENA,3,90,90,0,3
11-02-2025,"Dry Fruits, Nuts & Seeds",Groundnuts 500 gms,2,190,170,20,2
11-02-2025,Spices & Seasonings,JEERA 250 gms,15,125,105,20,1
11-02-2025,"Dry Fruits, Nuts & Seeds",CASHEW 250GM,2,340,310,30,1
11-02-2025,"Grains, Flours & Dals",Wheat Flour 1 kg,4,210,180,30,3
11-02-2025,Oils & Ghee,Sesame oil 1 L,9,1180,"1,120.00",60,2
11-02-2025,Spices & Seasonings,Chilli powder 500 gms,15,580,420,160,2
11-02-2025,Household & Cleaning,LIZOL FORAL CLEANER,6,348,348,0,3
11-02-2025,Spices & Seasonings,LG 50GM,15,276,276,0,3
11-02-2025,"Grains, Flours & Dals",BOMBAY RAVA,4,70,55,15,1
11-02-2025,Spices & Seasonings,Tamarind 250GMS,15,80,65,15,1
11-02-2025,"Dry Fruits, Nuts & Seeds",Putnalu 250GM,2,90,76,14,2
11-02-2025,"Grains, Flours & Dals",turdal 1kg,4,660,585,75,3
11-02-2025,Pooja & Spiritual Items,GD Aiswarya Deepam 700ML,12,390,390,0,2
11-02-2025,Household & Cleaning,TIDE DOUBLE POWER LEMON &amp;MINT,6,146,146,0,1
11-02-2025,"Grains, Flours & Dals",SINGLE POLISH 1KG,4,325,325,0,5
11-02-2025,Spices & Seasonings,SONTI 50GM,15,30,30,0,1
11-02-2025,"Grains, Flours & Dals",MAIDA 1KG,4,0,0,0,1
11-02-2025,"Grains, Flours & Dals",Chana Flour 500 gms,4,70,65,5,1
11-02-2025,Snacks & Ready-to-Eat,GB SALT COOKIES,14,60,55,5,1
11-02-2025,"Grains, Flours & Dals",Multigrain 1 kg,4,500,425,75,5
11-02-2025,Milk & Dairy,BROWN EGGS 1P,7,56,48,8,4
11-02-2025,"Grains, Flours & Dals",Wheat Flour 1 kg,4,140,120,20,2
11-02-2025,Oils & Ghee,Sesame oil 1 L,9,590,560,30,1
11-02-2025,Snacks & Ready-to-Eat,NGT CHATPATTA CHANA 90GM,14,25,25,0,1
11-02-2025,Sweeteners,SD PALM JAGGERY 500GM,16,200,200,0,1
11-02-2025,Snacks & Ready-to-Eat,BATANA NGT 70GMS,14,20,20,0,1
11-02-2025,Snacks & Ready-to-Eat,SD High Protein Laddu 175gm,14,190,190,0,1
11-02-2025,Snacks & Ready-to-Eat,SESAME CHIKKI,14,120,100,20,1
11-02-2025,Milk & Dairy,BROWN EGGS TRAY 30P,7,360,330,30,1
11-02-2025,"Grains, Flours & Dals",DESI CHANA,4,25,25,0,1
11-02-2025,Snacks & Ready-to-Eat,GANTASALA GINGER CANDY 200GM,14,105,105,0,1
11-02-2025,Snacks & Ready-to-Eat,VD SANNAPUSA 175GM,14,60,60,0,1
11-02-2025,"Grains, Flours & Dals",KORRALU (FOXTAIL M) 500GM,4,65,55,10,1
11-02-2025,"Grains, Flours & Dals",SAMALU (Little millet) 500 gms,4,85,65,20,1
11-02-2025,"Grains, Flours & Dals",MAAGAANI LOW GI SP 1KG,4,149,149,0,1
11-02-2025,"Grains, Flours & Dals",MAATEJA rice 1 kg,4,72,69,3,1
11-02-2025,"Grains, Flours & Dals",split green gram 1 kg,4,150,140,10,1
11-02-2025,General Household & Kitchenware,MATCH BOX,3,20,20,0,1
11-02-2025,Spices & Seasonings,Menthulu 250 gms,15,50,45,5,1
11-02-2025,"Health, Wellness & Ayurvedic Products",MXP CREAM ONION,5,90,90,0,2
11-02-2025,Snacks & Ready-to-Eat,RSC ORANGE 100GMS,14,20,20,0,1
11-02-2025,Snacks & Ready-to-Eat,GB SALT COOKIES,14,120,110,10,2
11-02-2025,Snacks & Ready-to-Eat,RITEBITE MELTING CHOCOLATE,14,100,100,0,2
11-02-2025,Spices & Seasonings,JEERA 250 gms,15,125,105,20,1
11-02-2025,"Grains, Flours & Dals",Green gram 500 gms,4,75,70,5,1
11-02-2025,Spices & Seasonings,Tamarind 250GMS,15,80,65,15,1
11-02-2025,Spices & Seasonings,Avalu small 250 gms,15,60,40,20,1
11-02-2025,Snacks & Ready-to-Eat,Corn Chips 250GM,14,40,35,5,1
11-02-2025,"Dry Fruits, Nuts & Seeds",SATHVI CHIA SEEDS 100GM,2,100,80,20,1
11-02-2025,"Grains, Flours & Dals",DH URAD GOTA 1KG,4,215,190,25,1
11-02-2025,"Grains, Flours & Dals",SL Idly Rava 1KG,4,65,55,10,1
11-02-2025,Snacks & Ready-to-Eat,RITEBITE BLUEBERRY BLAST,14,50,50,0,1
11-02-2025,Snacks & Ready-to-Eat,VD NUVULU LADDU 9PIC,14,100,100,0,1
11-02-2025,Spices & Seasonings,DRY MIECHI 200GM,15,80,60,20,1
11-02-2025,"Dry Fruits, Nuts & Seeds",PUTNALU 500GMS,2,90,76,14,1
11-02-2025,Snacks & Ready-to-Eat,TILLI CHIKKI,14,125,125,0,1
11-02-2025,Spices & Seasonings,AVALU 100GM,15,25,20,5,1
11-02-2025,Snacks & Ready-to-Eat,RINGS 200GM,14,30,30,0,1
11-02-2025,"Grains, Flours & Dals",CHANA DAL 500GM,4,70,60,10,1
11-02-2025,Spices & Seasonings,JEERA 250 gms,15,125,105,20,1
11-02-2025,Oils & Ghee,Sesame oil 500ml,9,295,280,15,1
11-02-2025,"Dry Fruits, Nuts & Seeds",PULMAKHANA 100 GM,2,180,170,10,1
11-02-2025,Pooja & Spiritual Items,BALAJI LAVENDER DOOP STICK 10STK,12,125,125,0,1
11-02-2025,Pooja & Spiritual Items,BALAJI KASTURI DHOOP STICKS,12,70,70,0,1
11-02-2025,Personal Care & Cosmetics,EYETEX,10,15,15,0,1
11-02-2025,Pooja & Spiritual Items,SREE REAL KASTURI STICKS 90GM,12,72,72,0,1
11-02-2025,Spices & Seasonings,NUVVULU 250GM,15,100,85,15,1
11-02-2025,"Grains, Flours & Dals",CHANA DAL 500GM,4,70,60,10,1
11-02-2025,Oils & Ghee,Castor oil 200 ml,9,100,80,20,1
11-02-2025,Snacks & Ready-to-Eat,VD MYSOREPAK 6PIC,14,100,100,0,1
11-02-2025,"Grains, Flours & Dals",SINGLE POLISH 1KG,4,260,260,0,4
11-02-2025,"Grains, Flours & Dals",SL Idly Rava 1KG,4,65,55,10,1
11-02-2025,"Grains, Flours & Dals",RAGI FLOUR 1KG,4,80,70,10,1
11-02-2025,"Grains, Flours & Dals",BAJRA 1 KG,4,30,25,5,0.5
11-02-2025,"Grains, Flours & Dals",JOWAR YELLOW 1 K,4,100,90,10,1
11-02-2025,"Grains, Flours & Dals",RAGULU 1 KG,4,70,60,10,1
11-02-2025,"Grains, Flours & Dals",Urad dall 1 Kg,4,185,170,15,1
11-02-2025,"Grains, Flours & Dals",JOWAR YELLOW 1 K,4,100,90,10,1
11-02-2025,"Grains, Flours & Dals",Em Multimillet idli r 500g,4,129,129,0,1
11-02-2025,"Grains, Flours & Dals",Urad dall 1 Kg,4,370,340,30,2
11-02-2025,"Dry Fruits, Nuts & Seeds",Groundnuts 1 kg,2,380,340,40,2
11-02-2025,Spices & Seasonings,RED COPRA 250GMS,15,85,74,11,1
11-02-2025,"Grains, Flours & Dals",DESI CHANA,4,25,25,0,1
11-02-2025,Spices & Seasonings,WHITE SESAME,15,150,150,0,2
11-02-2025,"Grains, Flours & Dals",Chana Flour 500 gms,4,70,65,5,1
11-02-2025,"Grains, Flours & Dals",SL Idly Rava 1KG,4,65,55,10,1
11-02-2025,"Dry Fruits, Nuts & Seeds",SATHVI CHIA SEEDS 100GM,2,100,80,20,1
11-02-2025,"Grains, Flours & Dals",Wheat Flour 1 kg,4,140,120,20,2
11-02-2025,Snacks & Ready-to-Eat,VD CORNFLAKES MIXTURE 175GM,14,60,60,0,1
11-02-2025,Milk & Dairy,BROWN EGGS 1P,7,168,144,24,12
11-02-2025,Snacks & Ready-to-Eat,MILK BREAD,14,55,55,0,1
11-02-2025,Milk & Dairy,BROWN EGGS TRAY 30P,7,360,330,30,1
11-02-2025,"Grains, Flours & Dals",Wheat Rava M 500GM,4,33,30,3,1
11-02-2025,Spices & Seasonings,Dalchin Chekka 50GM,15,50,40,10,1
11-02-2025,Personal Care & Cosmetics,LISTERINE MILD TASTE 250ML,10,210,210,0,1
11-02-2025,Spices & Seasonings,SREE MARUTHI IDLY KARAM 200GM,15,60,60,0,1
11-02-2025,Beverages,BRU GREEN LABEL 1.2G,1,10,10,0,5
11-02-2025,"Grains, Flours & Dals",Red Chana 500 GM,4,75,60,15,1
11-02-2025,General Household & Kitchenware,clay water bottle 1,3,263,249.85,13.15,1
11-02-2025,"Dry Fruits, Nuts & Seeds",Groundnuts 500 gms,2,95,85,10,1
11-02-2025,Snacks & Ready-to-Eat,COPRA LADDU 200GM,14,100,80,20,1
11-02-2025,"Dry Fruits, Nuts & Seeds",Putnalu 250GM,2,45,38,7,1
11-02-2025,Snacks & Ready-to-Eat,VD MURUKU 175GM,14,60,60,0,1
11-02-2025,Sweeteners,GS Organic Jaggery Powder 600GM,16,99,99,0,1
11-02-2025,Oils & Ghee,Sesame oil 1 L,9,590,560,30,1
11-02-2025,Snacks & Ready-to-Eat,ID PAROTA,14,105,105,0,1
11-02-2025,"Grains, Flours & Dals",Chana Flour 500 gms,4,70,65,5,1
11-02-2025,Beverages,REFRESH SHARBATH NORMAL,1,199,190,9,1
11-02-2025,Beverages,BISLERI SODA 750ML,1,20,20,0,1
11-02-2025,"Grains, Flours & Dals",MAIDA 1KG,4,0,0,0,1
11-02-2025,Oils & Ghee,DB CASTOR OIL 100ML,9,130,130,0,1
11-02-2025,Spices & Seasonings,Lavangam 50GM,15,60,50,10,1
11-02-2025,"Grains, Flours & Dals",turdal 1kg,4,220,195,25,1
11-02-2025,"Grains, Flours & Dals",RAGI FLOUR 500GRMS,4,40,35,5,1
11-02-2025,"Grains, Flours & Dals",Multigrain 1 kg,4,100,85,15,1
11-02-2025,"Dry Fruits, Nuts & Seeds",MAHA BEERA SEEDS 100GM,2,60,60,0,1
11-02-2025,"Grains, Flours & Dals",Idly Rava L 1KG,4,120,100,20,2
11-02-2025,"Dry Fruits, Nuts & Seeds",PULMAKHANA 100 GM,2,180,170,10,1
11-02-2025,Spices & Seasonings,SATHVI ANASAPUVUU 25GM,15,90,65,25,1
11-02-2025,"Grains, Flours & Dals",idly/Dosa rice 1 kg,4,70,60,10,1
11-02-2025,"Grains, Flours & Dals",split black gram 1 kg,4,180,170,10,1
11-02-2025,Snacks & Ready-to-Eat,GB SALT COOKIES,14,60,55,5,1
11-02-2025,Snacks & Ready-to-Eat,FOXTAIL BIS,14,135,135,0,1
11-02-2025,"Health, Wellness & Ayurvedic Products",MH Millets Malt 500GM,5,200,190,10,1
11-02-2025,Oils & Ghee,Sesame oil 500ml,9,295,280,15,1
11-02-2025,Oils & Ghee,Safflower oil 1 L,9,440,400,40,1
11-02-2025,Milk & Dairy,BROWN EGGS 1P,7,70,60,10,5
11-02-2025,Snacks & Ready-to-Eat,SD FINGER Millet with palm Jaggery 250gm,14,135,135,0,1
11-02-2025,Snacks & Ready-to-Eat,SD Aswagandha with palm Jaggery250Gm,14,135,135,0,1
11-02-2025,Baking & Cooking Aids,MTR GULAB JAMUN MIX 190GM,0,80,80,0,1
11-02-2025,Spices & Seasonings,DB SAFRON,15,180,180,0,1
11-02-2025,Spices & Seasonings,BLACK JEERA 50 GM,15,45,30,15,1
11-02-2025,Spices & Seasonings,Tamarind 500GM,15,160,130,30,1
11-02-2025,"Grains, Flours & Dals",Red Chana 250GM,4,35,30,5,1
11-02-2025,"Grains, Flours & Dals",Idly Rava L 1KG,4,60,50,10,1
11-02-2025,"Grains, Flours & Dals",BARLEY SEEDS 250GMS,4,40,35,5,1
11-02-2025,"Grains, Flours & Dals",BOMBAY RAVA,4,70,55,15,1
11-02-2025,Spices & Seasonings,Elaichi 25GM,15,145,120,25,1
11-02-2025,"Grains, Flours & Dals",SABDANA 500GM,4,90,70,20,1
11-02-2025,Pooja & Spiritual Items,BANDA PUVVU 25GM 25GM,12,80,60,20,1
11-02-2025,Spices & Seasonings,Marati Magga 50GM,15,130,110,20,1
11-02-2025,"Grains, Flours & Dals",THICK POHA 1KG,4,80,70,10,1
11-02-2025,Milk & Dairy,BROWN EGGS 1P,7,84,72,12,6
11-02-2025,"Grains, Flours & Dals",Red Bobarlu 500 gms,4,190,170,20,2
11-02-2025,"Grains, Flours & Dals",White Chana 250 GM,4,60,50,10,1
11-02-2025,"Grains, Flours & Dals",Wheat Rava M 500GM,4,33,30,3,1
11-02-2025,"Grains, Flours & Dals",Wheat Rava M 1KG,4,65,55,10,1
11-02-2025,"Grains, Flours & Dals",MAIDA 1KG,4,60,60,0,1
11-02-2025,Spices & Seasonings,RED COPRA 500GM,15,170,148,22,1
11-02-2025,Spices & Seasonings,ROYAL SAFFRON,15,125,125,0,1
11-02-2025,"Dry Fruits, Nuts & Seeds",PUMPKIN SEEDS 250GM,2,200,160,40,1
11-02-2025,"Dry Fruits, Nuts & Seeds",FLAX SEEDS 250GM,2,60,50,10,1
11-02-2025,"Dry Fruits, Nuts & Seeds",SATHVI CHIA SEEDS 100GM,2,100,80,20,1
11-02-2025,"Dry Fruits, Nuts & Seeds",SUNFLOWER SEEDS 250GRM,2,150,130,20,1
11-02-2025,"Grains, Flours & Dals",Multigrain 1 kg,4,200,170,30,2
11-02-2025,"Grains, Flours & Dals",Yellow jowar .F1 kg,4,330,300,30,3
11-02-2025,"Grains, Flours & Dals",BARLEY SEEDS 250GMS,4,40,35,5,1
11-02-2025,"Grains, Flours & Dals",BAJRA 1 KG,4,60,50,10,1
11-02-2025,"Grains, Flours & Dals",split black gram 1 kg,4,180,170,10,1
11-02-2025,"Grains, Flours & Dals",KORRALU (FOXTAIL M) 500GM,4,65,55,10,1
11-02-2025,Snacks & Ready-to-Eat,BD PEARL MILLET NOODLES 200G,14,70,70,0,1
11-02-2025,"Grains, Flours & Dals",JOWAR YELLOW 1 K,4,50,45,5,0.5
11-02-2025,Snacks & Ready-to-Eat,VD Minapa papad 200gm,14,60,60,0,1
11-02-2025,"Grains, Flours & Dals",DESI CHANA,4,25,25,0,1
11-02-2025,"Grains, Flours & Dals",Sathya Javva Wheat Rava 500GM,4,95,95,0,1
11-02-2025,"Grains, Flours & Dals",SAMALU (Little millet) 500 gms,4,85,65,20,1
11-02-2025,"Grains, Flours & Dals",SL Idly Rava 1KG,4,65,55,10,1
11-02-2025,Snacks & Ready-to-Eat,BATANA NGT 70GMS,14,20,20,0,1
11-02-2025,Snacks & Ready-to-Eat,ZEEDI,14,70,70,0,1
11-02-2025,Household & Cleaning,EXO SOAP,6,32,32,0,1
11-02-2025,Pooja & Spiritual Items,GD Aiswarya Deepam 700ML,12,195,195,0,1
11-02-2025,"Grains, Flours & Dals",Wheat Rava M 1KG,4,65,55,10,1
11-02-2025,Snacks & Ready-to-Eat,BATANA NGT 70GMS,14,20,20,0,1
11-02-2025,Spices & Seasonings,Masala Karam 250 gms,15,130,120,10,1
11-02-2025,Spices & Seasonings,DRY MIECHI 200GM,15,80,60,20,1
11-02-2025,"Grains, Flours & Dals",Green gram 1 kg,4,150,130,20,1
11-02-2025,"Grains, Flours & Dals",Urad dall 1 Kg,4,185,170,15,1
11-02-2025,Snacks & Ready-to-Eat,Popcorn Seeds 250GM,14,45,40,5,1
11-02-2025,"Grains, Flours & Dals",Chana Flour 500 gms,4,70,65,5,1
11-02-2025,"Dry Fruits, Nuts & Seeds",Putnalu 250GM,2,45,38,7,1
11-02-2025,"Grains, Flours & Dals",Wheat Flour 1 kg,4,70,60,10,1
11-02-2025,"Grains, Flours & Dals",SRILATHA RICE RAVVA 500GM,4,35,35,0,1
11-02-2025,Snacks & Ready-to-Eat,RAJGIRA PEANUT CHIKKI,14,10,10,0,2
11-02-2025,"Grains, Flours & Dals",EM Ragi upma R 500g,4,75,75,0,1
11-02-2025,Snacks & Ready-to-Eat,GB SALT COOKIES,14,60,55,5,1
11-02-2025,Snacks & Ready-to-Eat,ONION RINGS,14,200,200,0,4
11-02-2025,Spices & Seasonings,Chilli powder 500 gms,15,290,210,80,1
11-02-2025,Spices & Seasonings,Chilli powder 1 kg,15,580,420,160,1
11-02-2025,Pickles & Cooking Pastes,SD MESTA PICKLE,11,110,110,0,1
11-02-2025,"Grains, Flours & Dals",RAGI FLOUR 500GRMS,4,40,35,5,1
11-02-2025,Pickles & Cooking Pastes,SD MANGO TOKKU,11,110,110,0,1
11-02-2025,"Dry Fruits, Nuts & Seeds",GF DATES 500GM,2,156,149,7,1
11-02-2025,"Grains, Flours & Dals",KORRALU (FOXTAIL M) 1KG,4,300,220,80,2
11-02-2025,"Grains, Flours & Dals",Wheat Rava M 1KG,4,65,55,10,1
11-02-2025,Oils & Ghee,Safflower oil 1 L,9,880,800,80,2
11-02-2025,Spices & Seasonings,NUVVULU 500GM,15,160,130,30,1
11-02-2025,"Dry Fruits, Nuts & Seeds",SUNFLOWER SEEDS 250GRM,2,150,130,20,1
11-02-2025,General Household & Kitchenware,CANDLE,3,120,120,0,4
11-02-2025,"Dry Fruits, Nuts & Seeds",BLACK KISMIS 250GM,2,175,140,35,1
11-02-2025,"Dry Fruits, Nuts & Seeds",WATERMELON SEEDS 250GRM,2,640,560,80,2
11-02-2025,Snacks & Ready-to-Eat,BD RAGI NOODLES,14,75,75,0,1
11-02-2025,"Dry Fruits, Nuts & Seeds",FLAX SEEDS 250GM,2,60,50,10,1
11-02-2025,"Dry Fruits, Nuts & Seeds",PUMPKIN SEEDS 250GM,2,200,160,40,1
11-02-2025,Snacks & Ready-to-Eat,MAAGAANI M JOWAR PASTA 200GM,14,199,199,0,1
11-02-2025,"Grains, Flours & Dals",Wheat Flour 1 kg,4,140,120,20,2
11-02-2025,"Dry Fruits, Nuts & Seeds",SUNFLOWER SEEDS 250GRM,2,150,130,20,1
11-02-2025,Snacks & Ready-to-Eat,RAJGIRA PEANUT CHIKKI,14,10,10,0,2
11-02-2025,"Dry Fruits, Nuts & Seeds",PUMPKIN SEEDS 250GM,2,200,160,40,1
11-02-2025,"Health, Wellness & Ayurvedic Products",VEMANA PULIPIRI 10GM,5,120,120,0,1
11-02-2025,"Dry Fruits, Nuts & Seeds",WATERMELON SEEDS 250GRM,2,320,280,40,1
11-02-2025,Snacks & Ready-to-Eat,FOXTAIL BIS,14,135,135,0,1
11-02-2025,"Dry Fruits, Nuts & Seeds",MAHA BEERA SEEDS 100GM,2,60,60,0,1
11-02-2025,"Grains, Flours & Dals",SPLIT BLACK GRAM 500 GM,4,90,85,5,1
11-02-2025,Oils & Ghee,A2 BUFFALO GHEE 250ML,9,299,299,0,1
11-02-2025,"Grains, Flours & Dals",RAGI FLOUR 1KG,4,160,140,20,2
11-02-2025,"Grains, Flours & Dals",SINGLE POLISH 1KG,4,325,325,0,5
11-02-2025,"Grains, Flours & Dals",AISHWARYA SP 5KG,4,400,375,25,1
11-02-2025,Oils & Ghee,Safflower oil 500 ml,9,220,200,20,1
11-02-2025,Spices & Seasonings,SWEET SOUNF,15,20,20,0,1
11-02-2025,Oils & Ghee,Sesame oil 500ml,9,295,280,15,1
11-02-2025,"Grains, Flours & Dals",White Chana 250 GM,4,60,50,10,1
11-02-2025,Oils & Ghee,cow ghee 500 ml,9,430,390,40,1
11-02-2025,Oils & Ghee,Coconut oil 500 ml,9,220,200,20,1
11-02-2025,"Grains, Flours & Dals",SINGLE POLISH 1KG,4,130,130,0,2
11-02-2025,Sweeteners,ACHUBELLAM 500GM,16,50,40,10,1
11-02-2025,Snacks & Ready-to-Eat,SD Little Millet WITH PLAM JAGGERY,14,135,135,0,1
11-02-2025,"Grains, Flours & Dals",MELMEKER 250GMS,4,120,90,30,2
11-02-2025,"Grains, Flours & Dals",DESI CHANA,4,25,25,0,1
11-02-2025,"Grains, Flours & Dals",Chana Flour 500 gms,4,70,65,5,1
11-02-2025,Snacks & Ready-to-Eat,MB SORGHUM NOODLES 180GM,14,95,95,0,1
11-02-2025,"Grains, Flours & Dals",YB CHITTIMUTYALU RICE 1KG,4,200,200,0,1
11-02-2025,Pooja & Spiritual Items,VRP APOORVA JAVADHU POW,12,35,35,0,1
11-02-2025,Personal Care & Cosmetics,COLGATE KIDS 2 PLUS,10,30,30,0,1
11-02-2025,Personal Care & Cosmetics,KHADI Neem Anti Dandruff Shampoo,10,199,199,0,1
11-02-2025,"Grains, Flours & Dals",RAJMA 500GM,4,90,90,0,1
11-02-2025,Spices & Seasonings,PRO ORG CUMIN 100G,15,176,176,0,1
11-02-2025,Snacks & Ready-to-Eat,NGT CHATPATTA CHANA 90GM,14,25,25,0,1
11-02-2025,"Grains, Flours & Dals",RAGULU 1 KG,4,70,60,10,1
11-02-2025,Snacks & Ready-to-Eat,RAJGIRA PEANUT CHIKKI,14,10,10,0,2
11-02-2025,Snacks & Ready-to-Eat,BD RED RICE NOODLES 200G,14,70,70,0,1
11-02-2025,"Grains, Flours & Dals",JOWAR WHITE 1 KG,4,40,35,5,0.5
11-02-2025,"Grains, Flours & Dals",BAJRA 1 KG,4,30,25,5,0.5
11-02-2025,"Grains, Flours & Dals",JOWAR YELLOW 1 K,4,50,45,5,0.5
11-02-2025,"Grains, Flours & Dals",THIN POHA 500GM,4,40,35,5,1
11-02-2025,Spices & Seasonings,Tamarind 500GM,15,160,130,30,1
11-02-2025,"Dry Fruits, Nuts & Seeds",PUMPKIN SEEDS 250GM,2,200,160,40,1
11-02-2025,"Dry Fruits, Nuts & Seeds",FLAX SEEDS 250GM,2,60,50,10,1
11-02-2025,"Grains, Flours & Dals",RAGI FLOUR 500GRMS,4,40,35,5,1
11-02-2025,"Grains, Flours & Dals",Wheat Flour 1 kg,4,70,60,10,1
11-02-2025,"Dry Fruits, Nuts & Seeds",PUTNALU 500GMS,2,90,76,14,1
11-02-2025,"Grains, Flours & Dals",Chana Flour 500 gms,4,70,65,5,1
11-02-2025,"Grains, Flours & Dals",White jowar.F 1 kg,4,100,80,20,1
11-02-2025,Sweeteners,GS Palm Jaggery Powder 400GM,16,180,180,0,1
11-02-2025,Spices & Seasonings,SD Garlic Karam Powder 100GM,15,65,65,0,1
11-02-2025,Oils & Ghee,Sesame oil 1 L,9,590,560,30,1
11-02-2025,Oils & Ghee,Safflower oil 1 L,9,440,400,40,1
11-02-2025,"Grains, Flours & Dals",BOMBAY RAVA,4,70,55,15,1
11-02-2025,Pooja & Spiritual Items,GD WOODS 150GM,12,110,110,0,1
11-02-2025,Pooja & Spiritual Items,GD TULASI 75GM,12,120,120,0,2
11-02-2025,Pooja & Spiritual Items,GD Dhoop Sticks 26GM,12,20,20,0,1
11-02-2025,"Grains, Flours & Dals",Arikadu ( kodo),4,140,130,10,1
11-02-2025,"Grains, Flours & Dals",SAMALU (Little millet) 1 kg,4,170,130,40,1
11-02-2025,"Grains, Flours & Dals",UDALU (Barnyard millet) 1 kg,4,140,115,25,1
11-02-2025,"Dry Fruits, Nuts & Seeds",FLAX SEEDS 250GM,2,60,50,10,1
11-02-2025,Personal Care & Cosmetics,GOW DURBAR NAVA 100GM SOAP,10,120,120,0,3
11-02-2025,Sweeteners,SUGAR 1KG,16,60,50,10,1
11-02-2025,"Grains, Flours & Dals",maida 500grms,4,60,60,0,1
11-02-2025,Snacks & Ready-to-Eat,VD MINAPA SUNNUNDALU 12P,14,180,180,0,1
11-02-2025,"Grains, Flours & Dals",SABDANA 500GM,4,90,70,20,1
11-02-2025,"Grains, Flours & Dals",Wheat Flour 1 kg,4,70,60,10,1
11-02-2025,"Grains, Flours & Dals",THICK POHA 1KG,4,80,70,10,1
11-02-2025,Snacks & Ready-to-Eat,Corn Chips 250GM,14,40,35,5,1
11-02-2025,"Grains, Flours & Dals",SRILATHA RICE RAVVA 500GM,4,35,35,0,1
11-02-2025,Oils & Ghee,Safflower oil 1 L,9,440,400,40,1
11-02-2025,Oils & Ghee,Sesame oil 1 L,9,590,560,30,1
11-02-2025,Spices & Seasonings,AV Iodized Salt 1KG,15,28,25,3,1
11-02-2025,"Grains, Flours & Dals",SINGLE POLISH 1KG,4,325,325,0,5
11-02-2025,Sweeteners,Natural Honey 500 gms,16,280,240,40,1
11-02-2025,Snacks & Ready-to-Eat,SATHVI MIXED CHIKKI 200GM,14,240,200,40,2
11-02-2025,"Grains, Flours & Dals",SL Idly Rava 1KG,4,65,55,10,1
11-02-2025,"Grains, Flours & Dals",Wheat Rava M 1KG,4,195,165,30,3
11-02-2025,"Grains, Flours & Dals",Wheat Flour 1 kg,4,140,120,20,2
11-02-2025,Spices & Seasonings,Jeera 100GM,15,50,45,5,1
11-02-2025,Oils & Ghee,cow ghee 500 ml,9,430,390,40,1
11-02-2025,Spices & Seasonings,Miriyalu 50GM,15,100,80,20,1
11-02-2025,Spices & Seasonings,ROYAL SAFFRON 400GRMS,15,65,65,0,1
11-02-2025,Sweeteners,SUGAR 1KG,16,60,50,10,1
11-02-2025,"Dry Fruits, Nuts & Seeds",Groundnuts 1 kg,2,190,170,20,1
11-02-2025,"Grains, Flours & Dals",split black gram 1 kg,4,180,170,10,1
11-02-2025,"Grains, Flours & Dals",Idly Rava L 1KG,4,60,50,10,1
11-02-2025,Spices & Seasonings,RED COPRA 250GMS,15,85,74,11,1
11-02-2025,Milk & Dairy,SANGAM TONED MILK 500ML,7,30,30,0,1
11-02-2025,"Grains, Flours & Dals",FLOUR CHARGE,4,14.4,14.4,0,1.2
11-02-2025,"Grains, Flours & Dals",RAGI FLOUR 500GRMS,4,40,35,5,1
11-02-2025,Milk & Dairy,SANGAM CURD 450GM,7,38,38,0,1
11-02-2025,"Health, Wellness & Ayurvedic Products",RB Max Protein Salt & Caramel Bar 50g,5,80,80,0,1
11-02-2025,Snacks & Ready-to-Eat,RSC ORANGE 100GMS,14,20,20,0,1
11-02-2025,"Grains, Flours & Dals",Chana Flour 500 gms,4,70,65,5,1
11-02-2025,Milk & Dairy,HERITAGE TONED MILK 500ML,7,31,31,0,1
11-02-2025,"Grains, Flours & Dals",SINGHAM 26KG BAG,4,1650,"1,650.00",0,1
11-02-2025,Milk & Dairy,SANGAM FULL CREAM MILK 500ML,7,38,38,0,1
11-02-2025,"Grains, Flours & Dals",THICK POHA 500GM,4,40,35,5,1
11-02-2025,Snacks & Ready-to-Eat,VD CORNFLAKES MIXTURE 175GM,14,60,60,0,1
11-02-2025,"Grains, Flours & Dals",MELMEKER 250GMS,4,60,45,15,1
11-02-2025,Personal Care & Cosmetics,DETTOL 50ML,10,154,154,0,1
11-02-2025,Snacks & Ready-to-Eat,KURNOOL MARMURA,14,70,55,15,1
11-02-2025,Sweeteners,ACHU BELLAM 1KG,16,100,80,20,1
11-02-2025,Oils & Ghee,Freedom Rice Bran Oil 1L,9,388,360,28,2
11-02-2025,Snacks & Ready-to-Eat,VD MIXTURE 175 GM,14,60,60,0,1
11-02-2025,"Grains, Flours & Dals",Wheat Rava M 1KG,4,65,55,10,1
11-02-2025,Spices & Seasonings,ROYAL SAFFRON,15,125,125,0,1
11-02-2025,Spices & Seasonings,Jeera 100GM,15,50,45,5,1
11-02-2025,Spices & Seasonings,GREEN SOUNF,15,60,40,20,1
11-02-2025,Sweeteners,SUGAR 1KG,16,60,50,10,1
11-02-2025,Snacks & Ready-to-Eat,KURNOOL MARMURA,14,70,55,15,1
11-02-2025,Sweeteners,GS Organic Jaggery Powder 600GM,16,99,99,0,1
11-02-2025,Spices & Seasonings,NUVVULU 250GM,15,80,65,15,1
11-02-2025,"Grains, Flours & Dals",HS jowar idly rava 500 gms,4,65,65,0,1
11-02-2025,Snacks & Ready-to-Eat,NGT CHATPATTA CHANA 90GM,14,25,25,0,1
11-02-2025,"Grains, Flours & Dals",Red Chana 500 GM,4,30,30,0,1
11-02-2025,"Grains, Flours & Dals",VGR rice 1 kg,4,700,650,50,10
11-02-2025,"Health, Wellness & Ayurvedic Products",RB Max Protein PERI PERI 60gm,5,45,45,0,1
11-02-2025,"Grains, Flours & Dals",SL Suji Rava 500GM,4,32,32,0,1
11-02-2025,"Health, Wellness & Ayurvedic Products",MXP CREAM ONION,5,45,45,0,1
11-02-2025,"Grains, Flours & Dals",CHANA DAL 500GM,4,70,60,10,1
11-02-2025,"Grains, Flours & Dals",RICE FLOUR 1KG,4,70,55,15,1
11-02-2025,Household & Cleaning,VIM EXTRA 110GM,6,30,30,0,2
11-02-2025,"Grains, Flours & Dals",turdal 500 gms,4,110,100,10,1
11-02-2025,"Health, Wellness & Ayurvedic Products",RB Max Protein Cheese&amp;,5,45,45,0,1
11-02-2025,Spices & Seasonings,Tamarind 250GMS,15,80,65,15,1
11-02-2025,"Health, Wellness & Ayurvedic Products",RB Max Protein Chinese Manchurian,5,45,45,0,1
11-02-2025,Oils & Ghee,Coconut oil 500 ml,9,220,200,20,1
11-02-2025,Oils & Ghee,Coconut oil 1 L,9,440,400,40,1
11-02-2025,Household & Cleaning,SURFEXCEL BAR 80G,6,40,40,0,4
11-02-2025,Spices & Seasonings,Chilli powder 500 gms,15,290,210,80,1
11-02-2025,Spices & Seasonings,SD Garlic Karam Powder 100GM,15,65,65,0,1
11-02-2025,"Grains, Flours & Dals",Wheat Flour 1 kg,4,70,60,10,1
11-02-2025,Pooja & Spiritual Items,BALAJI BEL PHOOL STICKS 90GM,12,60,60,0,1
11-02-2025,"Grains, Flours & Dals",MELMEKER 250GMS,4,60,45,15,1
11-02-2025,Snacks & Ready-to-Eat,VD BOONDI 175GM,14,60,60,0,1
11-02-2025,Milk & Dairy,SANGAM TONED MILK 500ML,7,30,30,0,1
11-02-2025,Household & Cleaning,TIDE DOUBLE POWER JASMINE &amp;ROSE,6,66,66,0,1
11-02-2025,Personal Care & Cosmetics,gow durbar sandal,10,40,40,0,1
11-02-2025,"Dry Fruits, Nuts & Seeds",Groundnuts 500 gms,2,95,85,10,1
11-02-2025,"Grains, Flours & Dals",Red Chana 500 GM,4,75,60,15,1
11-02-2025,Sweeteners,SUGAR 1KG,16,60,50,10,1
11-02-2025,Spices & Seasonings,SWEET SOUNF,15,20,20,0,1
11-02-2025,Personal Care & Cosmetics,MARGO,10,45,42,3,1
11-02-2025,Pooja & Spiritual Items,BALAJI BEL PHOOL DHOOP STICKS 10STK,12,70,70,0,1
11-02-2025,Personal Care & Cosmetics,COLGATE STRONG TEETH,10,20,20,0,1
11-02-2025,Pooja & Spiritual Items,GD Aiswarya Deepam 700ML,12,195,195,0,1
11-02-2025,Sweeteners,KAMAL JAGGERY 500GM,16,40,40,0,1
11-02-2025,Spices & Seasonings,AV Iodized Salt 1KG,15,56,50,6,2
11-02-2025,"Grains, Flours & Dals",Bombay Rava 500GM,4,35,30,5,1
11-02-2025,Pooja & Spiritual Items,SREE REAL KASTURI STICKS 90GM,12,72,72,0,1
11-02-2025,Household & Cleaning,EXO SOAP,6,32,32,0,1
11-02-2025,"Grains, Flours & Dals",RAGI FLOUR 1KG,4,80,70,10,1
11-02-2025,"Grains, Flours & Dals",Wheat Rava M 1KG,4,65,55,10,1
11-02-2025,Oils & Ghee,Groundnut oil 1 L,9,360,330,30,1
11-02-2025,"Grains, Flours & Dals",Wheat Flour 1 kg,4,70,60,10,1
11-02-2025,"Grains, Flours & Dals",Green gram 1 kg,4,150,130,20,1
11-02-2025,"Grains, Flours & Dals",Red Chana 500 GM,4,150,120,30,2
11-02-2025,"Dry Fruits, Nuts & Seeds",Groundnuts 1 kg,2,190,170,20,1
11-02-2025,Spices & Seasonings,JEERA 250 gms,15,125,105,20,1
11-02-2025,"Grains, Flours & Dals",White jowar.F 1 kg,4,100,80,20,1
11-02-2025,Oils & Ghee,Sesame oil 500ml,9,590,560,30,2
11-02-2025,Spices & Seasonings,Coriander seeds 200 gms,15,96,80,16,2
11-02-2025,Oils & Ghee,Groundnut oil 1 L,9,720,660,60,2
11-02-2025,"Grains, Flours & Dals",SB Javva Wheat Ravva 500GM,4,190,190,0,2
11-02-2025,Snacks & Ready-to-Eat,SD FINGER Millet with palm Jaggery 250gm,14,135,135,0,1
11-02-2025,"Grains, Flours & Dals",WHEAT 1 KG,4,180,150,30,3
11-02-2025,"Grains, Flours & Dals",FLOUR CHARGE,4,36,36,0,3
11-02-2025,Beverages,BRU GREEN LABEL 1.2G,1,96,96,0,48
11-02-2025,Snacks & Ready-to-Eat,VD SAGOPAPAD 150GM,14,55,55,0,1
11-02-2025,Snacks & Ready-to-Eat,RSC ORANGE 100GMS,14,20,20,0,1
11-02-2025,"Grains, Flours & Dals",White jowar.F 1 kg,4,300,240,60,3
11-02-2025,Oils & Ghee,Groundnut oil 1 L,9,720,660,60,2
11-02-2025,"Grains, Flours & Dals",Wheat Rava M 1KG,4,65,55,10,1
11-02-2025,"Grains, Flours & Dals",Sathya Javva Wheat Rava 500GM,4,190,190,0,2
11-02-2025,Oils & Ghee,Sesame oil 1 L,9,590,560,30,1
11-02-2025,Snacks & Ready-to-Eat,FOXTAIL BIS,14,135,135,0,1
11-02-2025,Sweeteners,ACHUBELLAM 500GM,16,50,40,10,1
11-02-2025,"Grains, Flours & Dals",RICE FLOUR 500 GM,4,70,56,14,2
11-02-2025,Personal Care & Cosmetics,GOHNSONS BABY OIL 100ML,10,140,140,0,1
11-02-2025,Oils & Ghee,Castor oil 200 ml,9,100,80,20,1
11-02-2025,"Grains, Flours & Dals",SL Idly Rava 1KG,4,65,55,10,1
11-02-2025,Sweeteners,MADHUR SUGAR 1KG,16,65,55,10,1
11-02-2025,Oils & Ghee,DWI VATADATEL 100ML,9,310,310,0,1
11-02-2025,Sweeteners,Mishri 500GM,16,70,60,10,1
11-02-2025,Spices & Seasonings,SWEET SOUNF,15,20,20,0,1
11-02-2025,"Health, Wellness & Ayurvedic Products",MADDI NEEM OIL 100ML,5,100,100,0,1
11-02-2025,Pooja & Spiritual Items,NAGA SINDHURAM,12,40,40,0,1
11-02-2025,Spices & Seasonings,SONTI 50GM,15,30,30,0,1
11-02-2025,Personal Care & Cosmetics,HERBAL BATH POWDER 200GM,10,80,80,0,1
11-02-2025,Sweeteners,MISHRI D,16,40,30,10,1
11-02-2025,Personal Care & Cosmetics,KAIPO ACT CHARCOAL TP 100G,10,90,90,0,1
11-02-2025,"Grains, Flours & Dals",MAAGAANI SP RICE 5KGS,4,649,560,89,1
11-02-2025,Personal Care & Cosmetics,MESWAK 100GM,10,70,70,0,1
11-02-2025,Oils & Ghee,Sesame oil 1 L,9,590,560,30,1
11-02-2025,Oils & Ghee,MUSTARD OIL 100ML,9,100,100,0,1
11-02-2025,Snacks & Ready-to-Eat,SATHVI MIXED CHIKKI 200GM,14,120,100,20,1
11-02-2025,Household & Cleaning,VIM SOAP,6,20,20,0,4
11-02-2025,Beverages,BRU GREEN LABEL 1.2G,1,48,48,0,24
11-02-2025,Oils & Ghee,Groundnut oil 5 L,9,1800,"1,600.00",200,1
11-02-2025,Personal Care & Cosmetics,BIOTIQUE FRESH HENNA S&C 120ML,10,99,99,0,1
11-02-2025,Snacks & Ready-to-Eat,BD BARELY NOODLES 200G,14,70,70,0,1
11-02-2025,Oils & Ghee,Coconut oil 1 L,9,440,400,40,1
11-02-2025,Oils & Ghee,Sesame oil 500ml,9,295,280,15,1
11-02-2025,Oils & Ghee,Groundnut oil 1 L,9,360,330,30,1
11-02-2025,Oils & Ghee,A2 BUFFALO GHEE 250ML,9,299,299,0,1
11-02-2025,Spices & Seasonings,SD Garlic Karam Powder 100GM,15,65,65,0,1
11-02-2025,Spices & Seasonings,EV Cumin Powder 50GM,15,61,61,0,1
11-02-2025,"Grains, Flours & Dals",Yellow jowar .F1 kg,4,110,100,10,1
11-02-2025,Snacks & Ready-to-Eat,Popcorn Seeds 250GM,14,45,40,5,1
11-02-2025,Spices & Seasonings,ROYAL SAFFRON 400GRMS,15,65,65,0,1
11-02-2025,"Grains, Flours & Dals",BARLEY SEEDS 250GMS,4,40,35,5,1
11-02-2025,Sweeteners,COCONUT SUGAR,16,299,284,15,1
11-02-2025,"Grains, Flours & Dals",Em Multimillet idli r 500g,4,129,129,0,1
11-02-2025,"Grains, Flours & Dals",White jowar.F 1 kg,4,100,80,20,1
11-02-2025,"Grains, Flours & Dals",MAAGAANI LOW GI SP L 1KG,4,600,525,75,5
11-02-2025,"Grains, Flours & Dals",Em jowar idly R 500G,4,150,150,0,2
11-02-2025,"Dry Fruits, Nuts & Seeds",SATHVI CHIA SEEDS 100GM,2,200,160,40,2
11-02-2025,Sweeteners,NATURAL HONEY 1KG,16,560,480,80,1
11-02-2025,Sweeteners,KAMAL JAGGERY 500GM,16,40,40,0,1
11-02-2025,"Grains, Flours & Dals",THICK POHA 1KG,4,80,70,10,1
11-02-2025,"Grains, Flours & Dals",Multigrain 1 kg,4,500,425,75,5
11-02-2025,"Grains, Flours & Dals",FLOUR CHARGE,4,30,30,0,2.5
11-02-2025,"Grains, Flours & Dals",Green Batani 500GM,4,110,90,20,1
11-02-2025,"Grains, Flours & Dals",white Bobarlu 500 gms,4,80,75,5,1
11-02-2025,"Grains, Flours & Dals",DH URAD GOTA 1KG,4,215,190,25,1
11-02-2025,"Grains, Flours & Dals",Red Bobarlu 500 gms,4,95,85,10,1
11-02-2025,Oils & Ghee,Groundnut oil 1 L,9,360,330,30,1
11-02-2025,"Dry Fruits, Nuts & Seeds",WALLNUTS 250GM,2,380,360,20,1
11-02-2025,Snacks & Ready-to-Eat,RINGS 200GM,14,30,30,0,1
11-02-2025,"Grains, Flours & Dals",RAGI FLOUR 1KG,4,80,70,10,1
11-02-2025,Snacks & Ready-to-Eat,VD RICE SAGO PAPAD 150GM,14,55,55,0,1
11-02-2025,"Grains, Flours & Dals",Wheat Flour 1 kg,4,70,60,10,1
11-02-2025,"Grains, Flours & Dals",Multigrain 1 kg,4,100,85,15,1
11-02-2025,Milk & Dairy,SANGAM FULL CREAM MILK 500ML,7,38,38,0,1
11-02-2025,Spices & Seasonings,Elaichi 25GM,15,145,120,25,1
11-02-2025,"Grains, Flours & Dals",SRILATHA RICE RAVVA 500GM,4,35,35,0,1
11-02-2025,Snacks & Ready-to-Eat,VD DAHI MIRCHI(SALTED) 100GM,14,45,45,0,1
11-02-2025,"Dry Fruits, Nuts & Seeds",PULMAKHANA 100 GM,2,180,170,10,1
11-02-2025,Snacks & Ready-to-Eat,ZEEDI,14,140,140,0,2
11-02-2025,Spices & Seasonings,Tamarind 250GMS,15,160,130,30,2
11-02-2025,"Grains, Flours & Dals",WHEAT 1 KG,4,300,250,50,5
11-02-2025,Spices & Seasonings,Masala Karam 500 gms,15,260,240,20,1
11-02-2025,Oils & Ghee,Sesame oil 1 L,9,590,560,30,1
11-02-2025,"Grains, Flours & Dals",RAGI FLOUR 500GRMS,4,40,35,5,1
11-02-2025,Snacks & Ready-to-Eat,SATHVI MIXED CHIKKI 200GM,14,120,100,20,1
11-02-2025,Milk & Dairy,SANGAM TONED MILK 500ML,7,30,30,0,1
11-02-2025,"Grains, Flours & Dals",Idly Rava L 1KG,4,60,50,10,1
11-02-2025,Oils & Ghee,Safflower oil 500 ml,9,220,200,20,1
11-02-2025,Sweeteners,COCONUT SUGAR,16,0,0,0,1
11-02-2025,"Health, Wellness & Ayurvedic Products",RB Max Protein Classic Creamy,5,169,169,0,1
11-02-2025,Snacks & Ready-to-Eat,VD Minapa papad 200gm,14,60,60,0,1
11-02-2025,"Grains, Flours & Dals",Em Multimillet idli r 500g,4,129,129,0,1
11-02-2025,Snacks & Ready-to-Eat,SATHVI MIXED CHIKKI 200GM,14,240,200,40,2
11-02-2025,Spices & Seasonings,NUVVULU 500GM,15,200,170,30,1
11-02-2025,Snacks & Ready-to-Eat,RAJGIRA PEANUT CHIKKI,14,30,30,0,6
11-02-2025,"Grains, Flours & Dals",SRILATHA RICE RAVVA 500GM,4,35,35,0,1
11-02-2025,"Grains, Flours & Dals",KORRALU (FOXTAIL M) 500GM,4,65,55,10,1
11-02-2025,"Dry Fruits, Nuts & Seeds",ALBUKARA 250GM,2,145,120,25,1
11-02-2025,Snacks & Ready-to-Eat,BD LITTLE MILLET NOODLES 200G,14,75,75,0,1
11-02-2025,"Grains, Flours & Dals",THICK POHA 500GM,4,40,35,5,1
11-02-2025,Snacks & Ready-to-Eat,SD Vamu with palm jaggery 250gm,14,135,135,0,1
11-02-2025,Spices & Seasonings,Tamarind 250GMS,15,80,65,15,1
11-02-2025,Spices & Seasonings,Chilli powder 1 kg,15,580,420,160,1
11-02-2025,Oils & Ghee,Coconut oil 1 L,9,440,400,40,1
11-02-2025,Spices & Seasonings,AV Iodized Salt 1KG,15,28,25,3,1
11-02-2025,Oils & Ghee,Groundnut oil 1 L,9,1080,990,90,3
11-02-2025,Spices & Seasonings,DRY MIECHI 200GM,15,80,60,20,1
11-02-2025,Spices & Seasonings,Turmeric powder 250 gms,15,100,75,25,1
11-02-2025,Sweeteners,SUGAR 500 GM,16,30,25,5,1
11-02-2025,Oils & Ghee,Safflower oil 1 L,9,440,400,40,1
11-02-2025,"Grains, Flours & Dals",RAGULU 1 KG,4,35,30,5,0.5
11-02-2025,Oils & Ghee,Groundnut oil 1 L,9,360,330,30,1
11-02-2025,"Grains, Flours & Dals",WHEAT 1 KG,4,30,25,5,0.5
11-02-2025,"Grains, Flours & Dals",MAATEJA rice 1 kg,4,144,138,6,2
11-02-2025,Pooja & Spiritual Items,GD Dhoop Sticks 26GM,12,20,20,0,1
11-02-2025,"Grains, Flours & Dals",RAGI FLOUR 500GRMS,4,40,35,5,1
11-02-2025,"Grains, Flours & Dals",SRILATHA RICE RAVVA 500GM,4,35,35,0,1
11-02-2025,Sweeteners,MADHUR SUGAR 1KG,16,65,55,10,1
11-02-2025,"Dry Fruits, Nuts & Seeds",PULMAKHANA 100 GM,2,180,170,10,1
11-02-2025,Oils & Ghee,Groundnut oil 5 L,9,1800,"1,600.00",200,1
11-02-2025,Oils & Ghee,Safflower oil 5 L,9,2200,"1,950.00",250,1
11-02-2025,"Grains, Flours & Dals",WHEAT 1 KG,4,30,25,5,0.5
11-02-2025,Oils & Ghee,Groundnut oil 1 L,9,360,330,30,1
11-02-2025,"Grains, Flours & Dals",RAGULU 1 KG,4,35,30,5,0.5
11-02-2025,Oils & Ghee,Safflower oil 1 L,9,440,400,40,1
11-02-2025,Snacks & Ready-to-Eat,VD PAPPU CHEGODI 200GM,14,60,60,0,1
11-02-2025,Snacks & Ready-to-Eat,VD CORNFLAKES MIXTURE 175GM,14,60,60,0,1
11-02-2025,Snacks & Ready-to-Eat,BATANA NGT 70GMS,14,20,20,0,1
11-02-2025,Snacks & Ready-to-Eat,TILLI CHIKKI,14,30,30,0,6
11-02-2025,Snacks & Ready-to-Eat,MILK BREAD,14,55,55,0,1
11-02-2025,"Dry Fruits, Nuts & Seeds",PUTNALU 500GMS,2,180,152,28,2
11-02-2025,"Dry Fruits, Nuts & Seeds",Groundnuts 500 gms,2,95,85,10,1
11-02-2025,Oils & Ghee,Sesame oil 1 L,9,590,560,30,1
11-02-2025,Sweeteners,GS Organic Jaggery Powder 600GM,16,198,198,0,2
11-02-2025,"Grains, Flours & Dals",SRILATHA RICE RAVVA 500GM,4,35,35,0,1
11-02-2025,Oils & Ghee,Groundnut oil 1 L,9,360,330,30,1
11-02-2025,Spices & Seasonings,Dalchin Chekka 50GM,15,50,40,10,1
11-02-2025,Spices & Seasonings,Lavangam 50GM,15,60,50,10,1
11-02-2025,Spices & Seasonings,ROYAL SAFFRON 400GRMS,15,65,65,0,1
11-02-2025,Spices & Seasonings,NUVVULU 250GM,15,80,65,15,1
11-02-2025,"Grains, Flours & Dals",Wheat Flour 1 kg,4,140,120,20,2
11-02-2025,"Grains, Flours & Dals",MELMEKER 250GMS,4,60,45,15,1
11-02-2025,"Grains, Flours & Dals",MAAGAANI LOW GI SP L 1KG,4,600,525,75,5
10-02-2025,"Grains, Flours & Dals",Red uluvalu 500 gms,4,90,75,15,1
10-02-2025,"Grains, Flours & Dals",AISHWARYA SP 25KG,4,1999,"1,690.00",309,1
10-02-2025,"Dry Fruits, Nuts & Seeds",PLAIN PISTA 250GM,2,660,550,110,1
10-02-2025,Snacks & Ready-to-Eat,NGT CHATPATTA CHANA 90GM,14,25,25,0,1
10-02-2025,"Grains, Flours & Dals",Multigrain 1 kg,4,100,85,15,1
10-02-2025,Snacks & Ready-to-Eat,SESAME LADDU 200GM,14,100,80,20,1
10-02-2025,Oils & Ghee,cow ghee 500 ml,9,430,390,40,1
10-02-2025,Snacks & Ready-to-Eat,VD RED CHILLI RICEPAPAD 150GM,14,50,50,0,1
10-02-2025,Snacks & Ready-to-Eat,BATANA NGT 70GMS,14,40,40,0,2
10-02-2025,"Grains, Flours & Dals",Red Wheat Flour 1 kg,4,140,130,10,1
10-02-2025,Milk & Dairy,SANGAM TONED MILK 500ML,7,30,30,0,1
10-02-2025,Milk & Dairy,HRITAGE TOTAL CURD 130GM,7,20,20,0,2
10-02-2025,Pooja & Spiritual Items,SWAATHI SAMBRANI POW 10G,12,20,20,0,1
10-02-2025,"Grains, Flours & Dals",Bajra Flour 500 gms,4,35,30,5,1
10-02-2025,"Dry Fruits, Nuts & Seeds",PULMAKHANA 100 GM,2,180,170,10,1
10-02-2025,Spices & Seasonings,RED COPRA 500GM,15,170,148,22,1
10-02-2025,General Household & Kitchenware,RED LINE 20GM,3,75,75,0,1
10-02-2025,Snacks & Ready-to-Eat,SD FINGER Millet with palm Jaggery 250gm,14,135,135,0,1
10-02-2025,"Health, Wellness & Ayurvedic Products",EUCALYPTUS OIL,5,199,199,0,1
10-02-2025,Snacks & Ready-to-Eat,SUNNUNDALU,14,120,120,0,1
10-02-2025,"Health, Wellness & Ayurvedic Products",DWI MANDARA TAILAM 100ML,5,160,160,0,1
10-02-2025,Spices & Seasonings,DRY MIECHI 200GM,15,80,60,20,1
10-02-2025,Snacks & Ready-to-Eat,RAGI LADDU,14,120,120,0,1
10-02-2025,Snacks & Ready-to-Eat,MB PEARL MILLET NOODLES 180GM,14,95,95,0,1
10-02-2025,Snacks & Ready-to-Eat,VD NUVULU LADDU 9PIC,14,100,100,0,1
10-02-2025,Snacks & Ready-to-Eat,MB SORGHUM NOODLES 180GM,14,95,95,0,1
10-02-2025,Oils & Ghee,Groundnut oil 1 L,9,360,330,30,1
10-02-2025,Pooja & Spiritual Items,GD Aiswarya Deepam 700ML,12,195,195,0,1
10-02-2025,Personal Care & Cosmetics,COCONUT BATH SCRUBBER,10,40,40,0,1
10-02-2025,"Grains, Flours & Dals",Red uluvalu 250 gms,4,45,40,5,1
10-02-2025,"Dry Fruits, Nuts & Seeds",PULMAKHANA 100 GM,2,180,170,10,1
10-02-2025,Spices & Seasonings,DRY MIECHI 200GM,15,80,60,20,1
10-02-2025,Beverages,RED LABEL 500,1,270,270,0,1
10-02-2025,Snacks & Ready-to-Eat,Popcorn Seeds 250GM,14,45,40,5,1
10-02-2025,"Grains, Flours & Dals",SABDANA 500GM,4,90,70,20,1
10-02-2025,"Grains, Flours & Dals",Multigrain 1 kg,4,100,85,15,1
10-02-2025,"Dry Fruits, Nuts & Seeds",ANJEER 250GM,2,400,360,40,1
10-02-2025,"Grains, Flours & Dals",Wheat Flour 1 kg,4,70,60,10,1
10-02-2025,"Dry Fruits, Nuts & Seeds",SUNFLOWER SEEDS 250GRM,2,150,130,20,1
10-02-2025,Oils & Ghee,Groundnut oil 1 L,9,360,330,30,1
10-02-2025,Snacks & Ready-to-Eat,VD RICE SAGO PAPAD 150GM,14,55,55,0,1
10-02-2025,"Dry Fruits, Nuts & Seeds",PUMPKIN SEEDS 250GM,2,200,160,40,1
10-02-2025,"Dry Fruits, Nuts & Seeds",FLAX SEEDS 250GM,2,60,50,10,1
10-02-2025,"Grains, Flours & Dals",SINGLE POLISH 1KG,4,325,325,0,5
10-02-2025,Snacks & Ready-to-Eat,RSC ORANGE 100GMS,14,20,20,0,1
10-02-2025,Snacks & Ready-to-Eat,TILLI CHIKKI,14,20,20,0,4
10-02-2025,Beverages,BRU GREEN LABEL 1.2G,1,24,24,0,12
10-02-2025,"Grains, Flours & Dals",CORN FOUR 250GM,4,40,35,5,1
10-02-2025,Snacks & Ready-to-Eat,PEANUT CHILLI,14,15,15,0,3
10-02-2025,"Grains, Flours & Dals",Chana Flour 500 gms,4,70,65,5,1
10-02-2025,"Health, Wellness & Ayurvedic Products",MADDI NEEM OIL 100ML,5,70,70,0,1
10-02-2025,"Health, Wellness & Ayurvedic Products",RB Max Protein Fruit &amp;Nut 50g,5,75,75,0,1
10-02-2025,"Grains, Flours & Dals",SL Idly Rava 1KG,4,130,110,20,2
10-02-2025,Pooja & Spiritual Items,GD Aiswarya Deepam 700ML,12,195,195,0,1
10-02-2025,"Grains, Flours & Dals",RICE FLOUR 500 GM,4,35,28,7,1
10-02-2025,Spices & Seasonings,JEERA 250 gms,15,125,105,20,1
10-02-2025,"Grains, Flours & Dals",Multigrain 1 kg,4,200,170,30,2
10-02-2025,Personal Care & Cosmetics,PARACHUTE 45ML,10,20,20,0,1
10-02-2025,"Grains, Flours & Dals",VGR rice 1 kg,4,210,195,15,3
10-02-2025,"Grains, Flours & Dals",AISHWARYA SP 1KG,4,80,70,10,1
10-02-2025,Spices & Seasonings,Turmeric powder 250 gms,15,200,150,50,2
10-02-2025,"Grains, Flours & Dals",Chana Flour 500 gms,4,70,65,5,1
10-02-2025,"Grains, Flours & Dals",Quinova 500 gms,4,110,100,10,1
10-02-2025,"Grains, Flours & Dals",Red Wheat Flour 1 kg,4,140,130,10,1
10-02-2025,"Dry Fruits, Nuts & Seeds",DRYDATES YELLOW 250GM,2,135,120,15,1
10-02-2025,"Grains, Flours & Dals",SL Idly Rava 1KG,4,65,55,10,1
10-02-2025,"Grains, Flours & Dals",Wheat Rava M 1KG,4,65,55,10,1
10-02-2025,"Grains, Flours & Dals",RAGI FLOUR 1KG,4,80,70,10,1
10-02-2025,Oils & Ghee,Coconut oil 500 ml,9,220,200,20,1
10-02-2025,"Grains, Flours & Dals",DH URAD GOTA 1KG,4,215,190,25,1
10-02-2025,"Grains, Flours & Dals",ANDU KORRALU (Browntop.m) 1 kg,4,260,220,40,1
10-02-2025,"Grains, Flours & Dals",KORRALU (FOXTAIL M) 1KG,4,150,110,40,1
10-02-2025,Sweeteners,ACHUBELLAM 500GM,16,50,40,10,1
10-02-2025,Snacks & Ready-to-Eat,NGT CHATPATTA CHANA 90GM,14,25,25,0,1
10-02-2025,Sweeteners,YB JAGGERY POWDER 500GMS,16,75,75,0,1
10-02-2025,Snacks & Ready-to-Eat,ANNAPURNA APPALAM,14,70,70,0,2
10-02-2025,Snacks & Ready-to-Eat,SD Sesame laddu with dates250gm,14,135,135,0,1
10-02-2025,"Grains, Flours & Dals",maida 500grms,4,60,60,0,1
10-02-2025,Snacks & Ready-to-Eat,PEANUT CHILLI,14,60,60,0,12
10-02-2025,"Grains, Flours & Dals",White jowar.F 1 kg,4,100,80,20,1
10-02-2025,"Grains, Flours & Dals",Bombay Rava 500GM,4,35,30,5,1
10-02-2025,Snacks & Ready-to-Eat,SS IDLY BATTER 1KG,14,60,60,0,1
10-02-2025,Pooja & Spiritual Items,GD Aiswarya Deepam 700ML,12,195,195,0,1
10-02-2025,Snacks & Ready-to-Eat,BB VERMICELLI 250GM,14,30,30,0,1
10-02-2025,"Dry Fruits, Nuts & Seeds",DIANUTS 500GM,2,120,120,0,1
10-02-2025,"Grains, Flours & Dals",RAGI FLOUR 500GRMS,4,40,35,5,1
10-02-2025,Pickles & Cooking Pastes,SD RED CHILLI PICKLE,11,110,110,0,1
10-02-2025,Pickles & Cooking Pastes,SD AMALA PICKLE,11,110,110,0,1
10-02-2025,Snacks & Ready-to-Eat,VD SAGOPAPAD 150GM,14,55,55,0,1
10-02-2025,"Grains, Flours & Dals",Wheat Flour 1 kg,4,280,240,40,4
10-02-2025,"Dry Fruits, Nuts & Seeds",FLAX SEEDS 250GM,2,60,50,10,1
10-02-2025,"Grains, Flours & Dals",Wheat Rava M 500GM,4,33,30,3,1
10-02-2025,"Grains, Flours & Dals",BASMATHI RICE 1KG,4,150,135,15,1
10-02-2025,Personal Care & Cosmetics,SVE RED SANDAL SOAP 100GM,10,90,90,0,1
10-02-2025,"Dry Fruits, Nuts & Seeds",PULMAKHANA 100 GM,2,180,170,10,1
10-02-2025,"Grains, Flours & Dals",Red Chana 500 GM,4,75,60,15,1
10-02-2025,Snacks & Ready-to-Eat,ANNAPURNA APPALAM,14,35,35,0,1
10-02-2025,"Grains, Flours & Dals",Red uluvalu 250 gms,4,45,40,5,1
10-02-2025,"Grains, Flours & Dals",Green gram 500 gms,4,75,70,5,1
10-02-2025,Personal Care & Cosmetics,SVE MULTANI MITTI SOAP 100GM,10,90,90,0,1
10-02-2025,"Grains, Flours & Dals",Red Bobarlu 500 gms,4,95,85,10,1
10-02-2025,"Grains, Flours & Dals",THICK POHA 1KG,4,80,70,10,1
10-02-2025,"Grains, Flours & Dals",SL Idly Rava 1KG,4,130,110,20,2
10-02-2025,"Grains, Flours & Dals",SAMALU (Little millet) 500 gms,4,85,65,20,1
10-02-2025,Spices & Seasonings,Jeera 100GM,15,50,45,5,1
10-02-2025,"Grains, Flours & Dals",PRO ORG RED POHA 500GM,4,89,89,0,1
10-02-2025,"Grains, Flours & Dals",UDALU (Barnyard millet) 500 gms,4,70,60,10,1
10-02-2025,"Grains, Flours & Dals",Arikalu (kodo),4,70,65,5,1
10-02-2025,"Grains, Flours & Dals",JOWAR WHITE 1 KG,4,40,35,5,0.5
10-02-2025,"Grains, Flours & Dals",Chittimuthaylu rice 1 kg,4,160,140,20,1
10-02-2025,Oils & Ghee,Sesame oil 500ml,9,295,280,15,1
10-02-2025,Snacks & Ready-to-Eat,BATANA NGT 70GMS,14,20,20,0,1
10-02-2025,Snacks & Ready-to-Eat,NGT CHATPATTA CHANA 90GM,14,25,25,0,1
10-02-2025,Sweeteners,GS Palm Jaggery Powder 400GM,16,180,180,0,1
10-02-2025,Oils & Ghee,Castor oil 200 ml,9,100,80,20,1
10-02-2025,"Dry Fruits, Nuts & Seeds",FLAX SEEDS 250GM,2,60,50,10,1
10-02-2025,"Grains, Flours & Dals",Wheat Flour 1 kg,4,70,60,10,1
10-02-2025,"Grains, Flours & Dals",RAGI FLOUR 500GRMS,4,40,35,5,1
10-02-2025,"Grains, Flours & Dals",Multigrain 1 kg,4,100,85,15,1
10-02-2025,"Dry Fruits, Nuts & Seeds",PLAIN PISTA 250GM,2,660,550,110,1
10-02-2025,"Grains, Flours & Dals",Urad dall 1 Kg,4,185,170,15,1
10-02-2025,"Grains, Flours & Dals",Idly Rava L 1KG,4,60,50,10,1
10-02-2025,"Dry Fruits, Nuts & Seeds",PUMPKIN SEEDS 250GM,2,200,160,40,1
10-02-2025,"Dry Fruits, Nuts & Seeds",SATHVI CHIA SEEDS 100GM,2,100,80,20,1
10-02-2025,"Grains, Flours & Dals",split green gram 500 gms,4,75,70,5,1
10-02-2025,"Grains, Flours & Dals",split black gram 1 kg,4,180,170,10,1
10-02-2025,Spices & Seasonings,DRY MIECHI 200GM,15,80,60,20,1
10-02-2025,Spices & Seasonings,Tamarind 500GM,15,160,130,30,1
10-02-2025,Spices & Seasonings,JEERA 250 gms,15,125,105,20,1
10-02-2025,Spices & Seasonings,Miriyalu 50GM,15,100,80,20,1
10-02-2025,Spices & Seasonings,Lavangam 50GM,15,60,50,10,1
10-02-2025,"Grains, Flours & Dals",THICK POHA 500GM,4,40,35,5,1
10-02-2025,Pooja & Spiritual Items,BANDA PUVVU 25GM 25GM,12,80,60,20,1
10-02-2025,Snacks & Ready-to-Eat,DISANO PASTA,14,175,175,0,1
10-02-2025,"Grains, Flours & Dals",Sathya Javva Wheat Rava 500GM,4,95,95,0,1
10-02-2025,"Grains, Flours & Dals",Multigrain 1 kg,4,100,85,15,1
10-02-2025,Beverages,BRU GREEN LABEL 1.2G,1,18,18,0,9
10-02-2025,Snacks & Ready-to-Eat,RSC ORANGE 100GMS,14,20,20,0,1
10-02-2025,Snacks & Ready-to-Eat,BATANA NGT 70GMS,14,60,60,0,3
10-02-2025,Sweeteners,ACHUBELLAM 500GM,16,50,40,10,1
10-02-2025,Snacks & Ready-to-Eat,SALTED PHALLI,14,25,25,0,1
10-02-2025,Snacks & Ready-to-Eat,BATANA NGT 70GMS,14,20,20,0,1
10-02-2025,Personal Care & Cosmetics,GOW DURBAR 75G,10,60,60,0,1
10-02-2025,Pooja & Spiritual Items,SREE REAL KASTURI STICKS 90GM,12,72,72,0,1
10-02-2025,Snacks & Ready-to-Eat,SESAME LADDU 200GM,14,100,80,20,1
10-02-2025,"Grains, Flours & Dals",Yellow jowar .F1 kg,4,110,100,10,1
10-02-2025,Pooja & Spiritual Items,GD Dhoop Sticks 26GM,12,40,40,0,2
10-02-2025,"Grains, Flours & Dals",Em Little idli R 500g,4,129,129,0,1
10-02-2025,"Grains, Flours & Dals",SAMALU (Little millet) 500 gms,4,85,65,20,1
10-02-2025,"Grains, Flours & Dals",HS jowar idly rava 500 gms,4,65,65,0,1
10-02-2025,"Grains, Flours & Dals",UDALU (Barnyard millet) 500 gms,4,70,60,10,1
10-02-2025,Personal Care & Cosmetics,MD Bath Powder 100GM,10,40,40,0,1
10-02-2025,"Grains, Flours & Dals",SRILATHA RICE RAVVA 500GM,4,35,35,0,1
10-02-2025,Snacks & Ready-to-Eat,VD RICE MURUKU 150GM,14,50,50,0,1
10-02-2025,"Grains, Flours & Dals",RED WHEAT 1 KG,4,260,240,20,2
10-02-2025,"Grains, Flours & Dals",FLOUR CHARGE,4,24,24,0,2
10-02-2025,Personal Care & Cosmetics,HERBAL BATH POWDER 200GM,10,80,80,0,1
10-02-2025,"Grains, Flours & Dals",RAGI FLOUR 1KG,4,80,70,10,1
10-02-2025,Sweeteners,NATURAL HONEY 250GM,16,150,130,20,1
10-02-2025,"Grains, Flours & Dals",Wheat Flour 1 kg,4,70,60,10,1
10-02-2025,"Grains, Flours & Dals",Wheat Flour 2 kgs,4,280,240,40,2
10-02-2025,"Grains, Flours & Dals",RAGI FLOUR 1KG,4,80,70,10,1
10-02-2025,Oils & Ghee,Groundnut oil 1 L,9,360,330,30,1
10-02-2025,"Grains, Flours & Dals",Chana Flour 500 gms,4,70,65,5,1
10-02-2025,"Grains, Flours & Dals",White jowar.F 1 kg,4,200,160,40,2
10-02-2025,Sweeteners,SUGAR 1KG,16,60,50,10,1
10-02-2025,Sweeteners,MISHRI 250 GM,16,70,60,10,2
10-02-2025,"Dry Fruits, Nuts & Seeds",Groundnuts 1 kg,2,190,170,20,1
10-02-2025,Sweeteners,YB Brown Sugar 500GM,16,75,75,0,1
10-02-2025,Snacks & Ready-to-Eat,RB Choco Delite Almonds Raisins 40g,14,135,135,0,3
10-02-2025,"Dry Fruits, Nuts & Seeds",SUNFLOWER SEEDS 250GRM,2,150,130,20,1
10-02-2025,Sweeteners,GS Palm Jaggery Powder 400GM,16,360,360,0,2
10-02-2025,"Dry Fruits, Nuts & Seeds",PUMPKIN SEEDS 250GM,2,200,160,40,1
10-02-2025,"Dry Fruits, Nuts & Seeds",WATERMELON SEEDS 250GRM,2,320,280,40,1
10-02-2025,"Dry Fruits, Nuts & Seeds",FLAX SEEDS 250GM,2,60,50,10,1
10-02-2025,"Grains, Flours & Dals",VYS.SP.RICE BAG 1,4,1800,"1,650.00",150,1
10-02-2025,"Grains, Flours & Dals",RAGULU 1 KG,4,35,30,5,0.5
10-02-2025,"Grains, Flours & Dals",BAJRA 1 KG,4,30,25,5,0.5
10-02-2025,"Grains, Flours & Dals",Urad dall 500 gms,4,95,85,10,1
10-02-2025,Personal Care & Cosmetics,KAIPO ACT CHARCOAL TP 100G,10,90,90,0,1
10-02-2025,"Grains, Flours & Dals",FLOUR CHARGE,4,30,30,0,2.5
10-02-2025,"Grains, Flours & Dals",JOWAR WHITE 1 KG,4,40,35,5,0.5
10-02-2025,"Grains, Flours & Dals",KORRALU (FOXTAIL M) 1KG,4,150,110,40,1
10-02-2025,"Dry Fruits, Nuts & Seeds",ALMONDS 250GM,2,280,260,20,1
10-02-2025,"Grains, Flours & Dals",HS RAGI Idly rava 500 gms,4,70,70,0,1
10-02-2025,Snacks & Ready-to-Eat,HS Ragi biscuits,14,50,50,0,1
10-02-2025,"Grains, Flours & Dals",turdal 500 gms,4,110,100,10,1
10-02-2025,Personal Care & Cosmetics,GOW DURBAR NAVA 100GM SOAP,10,40,40,0,1
10-02-2025,Spices & Seasonings,Lavangam 50GM,15,60,50,10,1
10-02-2025,Spices & Seasonings,SONTI 50GM,15,30,20,10,1
10-02-2025,Spices & Seasonings,FLAXSEED KARAM,15,75,75,0,1
10-02-2025,"Grains, Flours & Dals",Wheat Rava M 500GM,4,33,30,3,1
10-02-2025,Oils & Ghee,Groundnut oil 500ml,9,180,165,15,1
10-02-2025,Spices & Seasonings,Tamarind 250GMS,15,80,65,15,1
10-02-2025,Spices & Seasonings,SD Redgram Karam Powder 100GM,15,130,130,0,2
10-02-2025,Snacks & Ready-to-Eat,RAJGIRA PEANUT CHIKKI,14,30,30,0,6
10-02-2025,"Dry Fruits, Nuts & Seeds",Putnalu 250GM,2,45,38,7,1
10-02-2025,Spices & Seasonings,Jeera 100GM,15,50,45,5,1
10-02-2025,"Grains, Flours & Dals",JOWAR UPMA RAVA,4,0,0,0,1
10-02-2025,"Grains, Flours & Dals",URAD DALL,4,95,85,10,1
10-02-2025,Spices & Seasonings,SH CASSIA STICKS 50GM,15,75,75,0,1
10-02-2025,"Grains, Flours & Dals",Green gram 500 gms,4,75,70,5,1
10-02-2025,"Grains, Flours & Dals",Wheat Flour 1 kg,4,70,60,10,1
10-02-2025,Spices & Seasonings,Vamu 100GM,15,60,50,10,1
10-02-2025,Snacks & Ready-to-Eat,MH Sprouted Ragi Dosa 400GM,14,80,80,0,1
10-02-2025,"Grains, Flours & Dals",SRILATHA RICE RAVVA 500GM,4,35,35,0,1
10-02-2025,Spices & Seasonings,AVALU 100GM,15,25,20,5,1
10-02-2025,Snacks & Ready-to-Eat,BD RED RICE NOODLES 200G,14,70,70,0,1
10-02-2025,Spices & Seasonings,Menthulu 250 gms,15,50,45,5,1
10-02-2025,Personal Care & Cosmetics,SVE SUNNI PINDI SCRUBSOAP 100GM,10,200,200,0,2
10-02-2025,Snacks & Ready-to-Eat,PEANUT CHILLI,14,50,50,0,10
10-02-2025,"Dry Fruits, Nuts & Seeds",Groundnuts 500 gms,2,95,85,10,1
10-02-2025,Snacks & Ready-to-Eat,SATHVI MIXED CHIKKI 200GM,14,120,100,20,1
10-02-2025,Snacks & Ready-to-Eat,Sprouted Ragi Biscuits 450GM,14,150,150,0,1
10-02-2025,Sweeteners,SD PALM JAGGERY 500GM,16,400,400,0,2
10-02-2025,"Grains, Flours & Dals",MAAGAANI LOW GI SP L 1KG,4,240,210,30,2
10-02-2025,Oils & Ghee,Groundnut oil 1 L,9,360,330,30,1
10-02-2025,Spices & Seasonings,TM MIRCH POWDER 200GM,15,326,326,0,2
10-02-2025,Spices & Seasonings,THREE MANGO RAI 200G,15,84,84,0,2
10-02-2025,Spices & Seasonings,PRO ORG AJWAIN 100G,15,105,105,0,1
10-02-2025,"Grains, Flours & Dals",Wheat Flour 1 kg,4,70,60,10,1
10-02-2025,Beverages,BRU GREEN LABEL 200G,1,140,140,0,1
10-02-2025,"Grains, Flours & Dals",Black gram 500 gms,4,75,70,5,1
10-02-2025,Snacks & Ready-to-Eat,SD GINGER CANDY 200GM,14,120,120,0,1
10-02-2025,Snacks & Ready-to-Eat,SESAME CHIKKI,14,240,200,40,2
10-02-2025,Spices & Seasonings,LG 50GM,15,92,92,0,1
10-02-2025,Oils & Ghee,Sesame oil 1 L,9,590,560,30,1
10-02-2025,"Grains, Flours & Dals",FLOUR CHARGE,4,48,48,0,4
10-02-2025,Pooja & Spiritual Items,GD Sambrani Cup Dhoop 10 PC,12,96,96,0,1
10-02-2025,"Grains, Flours & Dals",WHEAT 1 KG,4,120,100,20,2
10-02-2025,Oils & Ghee,Coconut oil 1 L,9,880,800,80,2
10-02-2025,Milk & Dairy,SANGAM FULL CREAM MILK 500ML,7,38,38,0,1
10-02-2025,Household & Cleaning,PITAMBARI,6,112,112,0,4
10-02-2025,Snacks & Ready-to-Eat,RSC ORANGE 100GMS,14,20,20,0,1
10-02-2025,Household & Cleaning,VIM SOAP,6,100,100,0,20
10-02-2025,Snacks & Ready-to-Eat,KURNOOL MARMURA,14,70,55,15,1
10-02-2025,Milk & Dairy,SANGAM TONED MILK 500ML,7,30,30,0,1
10-02-2025,Snacks & Ready-to-Eat,VD SAGOPAPAD 150GM,14,55,55,0,1
10-02-2025,Snacks & Ready-to-Eat,VD CORNFLAKES MIXTURE 175GM,14,60,60,0,1
10-02-2025,Snacks & Ready-to-Eat,VD PAPPU CHEGODI 200GM,14,60,60,0,1
10-02-2025,"Grains, Flours & Dals",SINGLE POLISH 1KG,4,325,325,0,5
10-02-2025,"Dry Fruits, Nuts & Seeds",ALMONDS 250GM,2,280,260,20,1
10-02-2025,Snacks & Ready-to-Eat,VD SAGOPAPAD 150GM,14,55,55,0,1
10-02-2025,Snacks & Ready-to-Eat,SUNNUNDALU,14,120,120,0,1
10-02-2025,Snacks & Ready-to-Eat,RAJGIRA PEANUT CHIKKI,14,45,45,0,9
10-02-2025,"Grains, Flours & Dals",Wheat Flour 1 kg,4,70,60,10,1
10-02-2025,Spices & Seasonings,AV Iodized Salt 1KG,15,28,25,3,1
10-02-2025,"Grains, Flours & Dals",SL Idly Rava 1KG,4,260,220,40,4
10-02-2025,Oils & Ghee,Groundnut oil 1 L,9,360,330,30,1
10-02-2025,Pooja & Spiritual Items,SREE REAL KASTURI STICKS 90GM,12,72,72,0,1
10-02-2025,Snacks & Ready-to-Eat,VD VAMUPUSA 175GM,14,60,60,0,1
10-02-2025,Snacks & Ready-to-Eat,VD MYSOREPAK 6PIC,14,100,100,0,1
10-02-2025,Spices & Seasonings,NUVVULU 500GM,15,160,130,30,1
10-02-2025,Oils & Ghee,Sesame oil 500ml,9,295,280,15,1
10-02-2025,General Household & Kitchenware,IRN STL HDL KADAI 12,3,365,365,0,1
10-02-2025,General Household & Kitchenware,IRN WDN HDI KADAIA 10,3,275,275,0,1
10-02-2025,"Grains, Flours & Dals",RAGULU 1 KG,4,350,300,50,5
10-02-2025,General Household & Kitchenware,IRN STL HDL KADAI 12,3,365,365,0,1
10-02-2025,"Grains, Flours & Dals",FLOUR CHARGE,4,60,60,0,5
10-02-2025,"Dry Fruits, Nuts & Seeds",FLAX SEEDS 1KG,2,24,20,4,0.1
10-02-2025,"Grains, Flours & Dals",turdal 500 gms,4,110,100,10,1
10-02-2025,Oils & Ghee,Mustard oil 1 L,9,440,400,40,1
10-02-2025,"Grains, Flours & Dals",KORRALU (FOXTAIL M) 1KG,4,150,110,40,1
10-02-2025,"Grains, Flours & Dals",BAJRA 1 KG,4,30,25,5,0.5
10-02-2025,"Grains, Flours & Dals",ANDU KORRALU (Browntop.m) 1 kg,4,260,220,40,1
10-02-2025,"Grains, Flours & Dals",Yellow jowar .F1 kg,4,110,100,10,1
10-02-2025,"Grains, Flours & Dals",White jowar.F 1 kg,4,100,80,20,1
10-02-2025,"Grains, Flours & Dals",SAMALU (Little millet) 500 gms,4,85,65,20,1
10-02-2025,Spices & Seasonings,Gasagasalu 50GM,15,130,110,20,1
10-02-2025,Oils & Ghee,Groundnut oil 1 L,9,1080,990,90,3
10-02-2025,Oils & Ghee,Castor oil 200 ml,9,100,80,20,1
10-02-2025,Oils & Ghee,Coconut oil 500 ml,9,220,200,20,1
10-02-2025,"Grains, Flours & Dals",RAGULU 1 KG,4,140,120,20,2
10-02-2025,"Grains, Flours & Dals",RICE FLOUR 1KG,4,140,110,30,2
10-02-2025,"Grains, Flours & Dals",FLOUR CHARGE,4,13.2,13.2,0,1.1
10-02-2025,"Grains, Flours & Dals",FLOUR CHARGE,4,24,24,0,2
10-02-2025,"Grains, Flours & Dals",BAJRA 1 KG,4,6,5,1,0.1
10-02-2025,"Grains, Flours & Dals",JOWAR WHITE 1 KG,4,12,10.5,1.5,0.15
10-02-2025,"Grains, Flours & Dals",RAGULU 1 KG,4,7,6,1,0.1
10-02-2025,"Grains, Flours & Dals",WHEAT 1 KG,4,90,75,15,1.5
10-02-2025,"Grains, Flours & Dals",BARLEY SEEDS 1KG,4,16,14,2,0.1
10-02-2025,Sweeteners,SD PALM JAGGERY 500GM,16,200,200,0,1
10-02-2025,Oils & Ghee,Safflower oil 500 ml,9,220,200,20,1
10-02-2025,Oils & Ghee,Coconut oil 500 ml,9,220,200,20,1
10-02-2025,Oils & Ghee,Groundnut oil 5 L,9,1800,"1,600.00",200,1
10-02-2025,Pooja & Spiritual Items,GD Aiswarya Deepam 700ML,12,195,195,0,1
10-02-2025,"Grains, Flours & Dals",Multigrain 1 kg,4,200,170,30,2
10-02-2025,"Grains, Flours & Dals",Multigrain 1 kg,4,200,170,30,2
10-02-2025,Snacks & Ready-to-Eat,VD GUMMADI VADIYAM,14,75,75,0,1
10-02-2025,"Grains, Flours & Dals",VGR rice 1 kg,4,210,195,15,3
10-02-2025,Snacks & Ready-to-Eat,MB FOXTAIL MILLET NOODLES 180GM,14,95,95,0,1
10-02-2025,Pickles & Cooking Pastes,SD MANGO PICKLE,11,110,110,0,1
10-02-2025,Oils & Ghee,Safflower oil 1 L,9,440,400,40,1
10-02-2025,Spices & Seasonings,ROYAL SAFFRON,15,125,125,0,1
10-02-2025,"Dry Fruits, Nuts & Seeds",FLAX SEEDS 250GM,2,60,50,10,1
10-02-2025,"Dry Fruits, Nuts & Seeds",PULMAKHANA 100 GM,2,180,170,10,1
10-02-2025,Snacks & Ready-to-Eat,VD Minapa papad 200gm,14,60,60,0,1
10-02-2025,"Grains, Flours & Dals",SPLIT BLACK GRAM 500 GM,4,90,85,5,1
10-02-2025,"Dry Fruits, Nuts & Seeds",SATHVI CHIA SEEDS 100GM,2,100,80,20,1
10-02-2025,Spices & Seasonings,Tamarind 250GMS,15,80,65,15,1
10-02-2025,"Grains, Flours & Dals",Multigrain 1 kg,4,100,85,15,1
10-02-2025,"Grains, Flours & Dals",THICK POHA 500GM,4,40,35,5,1
10-02-2025,"Grains, Flours & Dals",Multigrain 1 kg,4,100,85,15,1
10-02-2025,"Grains, Flours & Dals",MELMEKER 250GMS,4,60,45,15,1
10-02-2025,Milk & Dairy,SANGAM TONED MILK 500ML,7,30,30,0,1
10-02-2025,Sweeteners,NATURAL HONEY 250GM,16,150,130,20,1
10-02-2025,Milk & Dairy,SANGAM CURD 450GM,7,38,38,0,1
10-02-2025,"Grains, Flours & Dals",SABDANA 500GM,4,90,70,20,1
10-02-2025,"Grains, Flours & Dals",RAGI FLOUR 1KG,4,80,70,10,1
10-02-2025,"Dry Fruits, Nuts & Seeds",Groundnuts 1 kg,2,190,170,20,1
10-02-2025,"Grains, Flours & Dals",SA WHITE JOWAR RAVA 500GM,4,138,138,0,2
10-02-2025,Sweeteners,GS Organic Jaggery Powder 600GM,16,99,99,0,1
10-02-2025,Snacks & Ready-to-Eat,MB MULTIMILLET NOODLES 180GM,14,95,95,0,1
10-02-2025,Sweeteners,GS Palm Jaggery Powder 400GM,16,180,180,0,1
10-02-2025,Snacks & Ready-to-Eat,NGT CHATPATTA CHANA 90GM,14,50,50,0,2
10-02-2025,"Grains, Flours & Dals",maida 500grms,4,60,60,0,1
10-02-2025,"Grains, Flours & Dals",Chana Flour 500 gms,4,70,65,5,1
10-02-2025,"Grains, Flours & Dals",HS Multimillet idly R 500 gms,4,65,65,0,1
10-02-2025,"Grains, Flours & Dals",RICE FLOUR 500 GM,4,35,28,7,1
10-02-2025,Oils & Ghee,Groundnut oil 1 L,9,720,660,60,2
09-02-2025,Pooja & Spiritual Items,BALAJI KASTURI DHOOP STICKS,12,70,70,0,1
09-02-2025,"Grains, Flours & Dals",SINGLE POLISH 1KG,4,650,650,0,10
09-02-2025,"Grains, Flours & Dals",SL Idly Rava 1KG,4,65,55,10,1
09-02-2025,"Grains, Flours & Dals",Wheat Rava M 500GM,4,33,30,3,1
09-02-2025,"Grains, Flours & Dals",turdal 500 gms,4,110,100,10,1
09-02-2025,"Dry Fruits, Nuts & Seeds",Groundnuts 500 gms,2,95,85,10,1
09-02-2025,"Grains, Flours & Dals",RED TURDAL 500GM,4,75,70,5,1
09-02-2025,"Health, Wellness & Ayurvedic Products",DWI BHRINGARAJA TAILAM 100ML,5,150,150,0,1
09-02-2025,"Health, Wellness & Ayurvedic Products",DWI MANDARA TAILAM 100ML,5,160,160,0,1
09-02-2025,"Grains, Flours & Dals",Green gram 500 gms,4,75,70,5,1
09-02-2025,"Grains, Flours & Dals",Wheat Flour 2 kgs,4,140,120,20,1
09-02-2025,Oils & Ghee,Freedom Rice Bran Oil 1L,9,388,360,28,2
09-02-2025,Oils & Ghee,Groundnut oil 1 L,9,360,330,30,1
09-02-2025,"Grains, Flours & Dals",RAGI FLOUR 500GRMS,4,40,35,5,1
09-02-2025,Snacks & Ready-to-Eat,VD RIBBON PAKODI 175GM,14,60,60,0,1
09-02-2025,Snacks & Ready-to-Eat,SD black sesme laddu with dates 175gm,14,135,135,0,1
09-02-2025,Snacks & Ready-to-Eat,GS SORGHUM SNACKS 150GM,14,60,60,0,1
09-02-2025,Snacks & Ready-to-Eat,RAGI LADDU,14,120,120,0,1
09-02-2025,"Dry Fruits, Nuts & Seeds",SD SUNFLOWER SEEDS WITH DATES,2,135,135,0,1
09-02-2025,Snacks & Ready-to-Eat,VD NUVULU CHEGODI 175GM,14,60,60,0,1
09-02-2025,"Grains, Flours & Dals",KORRALU (FOXTAIL M) 1KG,4,150,110,40,1
09-02-2025,"Grains, Flours & Dals",UDALU (Barnyard millet) 1 kg,4,140,115,25,1
09-02-2025,"Grains, Flours & Dals",BARLEY SEEDS 1KG,4,80,70,10,0.5
09-02-2025,"Grains, Flours & Dals",Wheat Rava M 1KG,4,130,110,20,2
09-02-2025,"Grains, Flours & Dals",SAMALU (Little millet) 1 kg,4,340,260,80,2
09-02-2025,"Grains, Flours & Dals",RAGI FLOUR 500GRMS,4,40,35,5,1
09-02-2025,"Grains, Flours & Dals",Quinova 1 kg,4,440,390,50,2
09-02-2025,Snacks & Ready-to-Eat,PALLI LADDU 200GMS,14,180,140,40,2
09-02-2025,Oils & Ghee,GANTASALA A2 COW GHEE 500ML,9,550,550,0,1
09-02-2025,Snacks & Ready-to-Eat,VD VAMUPUSA 175GM,14,60,60,0,1
09-02-2025,Snacks & Ready-to-Eat,VD CORNFLAKES MIXTURE 175GM,14,60,60,0,1
09-02-2025,Snacks & Ready-to-Eat,VD PAPPU CHEGODI 200GM,14,60,60,0,1
09-02-2025,Snacks & Ready-to-Eat,VD ATUKULU MIXTURE 175GM,14,60,60,0,1
09-02-2025,Snacks & Ready-to-Eat,NGT CHATPATTA CHANA 90GM,14,25,25,0,1
09-02-2025,Snacks & Ready-to-Eat,VD MURUKU 175GM,14,120,120,0,2
09-02-2025,Pooja & Spiritual Items,GD Camphor 50GM,12,115,115,0,1
09-02-2025,Snacks & Ready-to-Eat,VD MIXTURE 175 GM,14,60,60,0,1
09-02-2025,Oils & Ghee,Groundnut oil 1 L,9,720,660,60,2
09-02-2025,Snacks & Ready-to-Eat,SALTED PHALLI,14,75,75,0,3
09-02-2025,Snacks & Ready-to-Eat,VD NUVULU CHEGODI 175GM,14,60,60,0,1
09-02-2025,Pooja & Spiritual Items,SWASTIK CAMPHORE,12,90,90,0,1
09-02-2025,"Health, Wellness & Ayurvedic Products",ORGANIC MORINGA POWER 100GM,5,249,249,0,1
09-02-2025,Snacks & Ready-to-Eat,VD BOONDI 175GM,14,180,180,0,3
09-02-2025,Snacks & Ready-to-Eat,VD Pappu Chekkalu 190gm,14,60,60,0,1
09-02-2025,Snacks & Ready-to-Eat,VD NUVULU LADDU 9PIC,14,200,200,0,2
09-02-2025,"Grains, Flours & Dals",Idly Rava L 1KG,4,60,50,10,1
09-02-2025,"Grains, Flours & Dals",BASMATHI RICE 1KG,4,150,135,15,1
09-02-2025,"Grains, Flours & Dals",split black gram 1 kg,4,180,170,10,1
09-02-2025,Spices & Seasonings,JEERA 250 gms,15,125,105,20,1
09-02-2025,"Grains, Flours & Dals",Urad dall 1 Kg,4,185,170,15,1
09-02-2025,"Dry Fruits, Nuts & Seeds",YELLOW KISHMISH 250GM,2,130,110,20,1
09-02-2025,"Dry Fruits, Nuts & Seeds",Groundnuts 1 kg,2,190,170,20,1
09-02-2025,Snacks & Ready-to-Eat,RAGI LADDU,14,120,120,0,1
09-02-2025,"Dry Fruits, Nuts & Seeds",PULMAKHANA 100 GM,2,180,170,10,1
09-02-2025,Snacks & Ready-to-Eat,VD PAPPU CHEGODI 200GM,14,60,60,0,1
09-02-2025,"Grains, Flours & Dals",SAMALU (Little millet) 500 gms,4,85,65,20,1
09-02-2025,Snacks & Ready-to-Eat,PALLI LADDU 200GMS,14,90,70,20,1
09-02-2025,"Dry Fruits, Nuts & Seeds",SALTED PISTA 250GM,2,400,350,50,1
09-02-2025,"Grains, Flours & Dals",Yellow jowar .F1 kg,4,110,100,10,1
09-02-2025,"Grains, Flours & Dals",White jowar.F 1 kg,4,100,80,20,1
09-02-2025,"Grains, Flours & Dals",KORRALU (FOXTAIL M) 500GM,4,65,55,10,1
09-02-2025,"Grains, Flours & Dals",CHANA DAL 500GM,4,35,30,5,0.5
09-02-2025,"Grains, Flours & Dals",Green gram 1 kg,4,150,130,20,1
09-02-2025,Snacks & Ready-to-Eat,VD MINAPA VADIYAM,14,65,65,0,1
09-02-2025,"Grains, Flours & Dals",BARLEY FLOUR 250GM,4,45,40,5,1
09-02-2025,Snacks & Ready-to-Eat,PALLI LADDU 200GMS,14,90,70,20,1
09-02-2025,"Grains, Flours & Dals",Sathya Javva Wheat Rava 500GM,4,95,95,0,1
09-02-2025,"Grains, Flours & Dals",RAGI FLOUR 500GRMS,4,40,35,5,1
09-02-2025,Snacks & Ready-to-Eat,NGT CHATPATTA CHANA 90GM,14,25,25,0,1
09-02-2025,"Grains, Flours & Dals",turdal 500 gms,4,110,100,10,1
09-02-2025,"Grains, Flours & Dals",DOCTOR RICE DIABETIC SFR 1KG,4,120,120,0,1
09-02-2025,"Grains, Flours & Dals",PRO ORG KABULI CHANNA 500GM,4,196,196,0,1
09-02-2025,"Dry Fruits, Nuts & Seeds",YB GRANMA NUTS,2,90,90,0,1
09-02-2025,Spices & Seasonings,MG Dasa dinasalu 250gm,15,220,220,0,1
09-02-2025,"Grains, Flours & Dals",UDALU (Barnyard millet) 1 kg,4,140,115,25,1
09-02-2025,"Grains, Flours & Dals",Multigrain 1 kg,4,200,170,30,2
09-02-2025,Sweeteners,YB Palm Jaggery 250GM,16,200,200,0,1
09-02-2025,"Grains, Flours & Dals",Arikadu ( kodo),4,140,130,10,1
09-02-2025,Snacks & Ready-to-Eat,BLACK SESAME CHIKKI BOX,14,200,200,0,1
09-02-2025,"Dry Fruits, Nuts & Seeds",Groundnuts 1 kg,2,190,170,20,1
09-02-2025,Oils & Ghee,Groundnut oil 1 L,9,360,330,30,1
09-02-2025,"Grains, Flours & Dals",Wheat Flour 1 kg,4,70,60,10,1
09-02-2025,"Grains, Flours & Dals",Idly Rava L 1KG,4,120,100,20,2
09-02-2025,"Grains, Flours & Dals",split black gram 1 kg,4,360,340,20,2
09-02-2025,"Grains, Flours & Dals",DISANO OATS 1KG,4,285,142.5,142.5,1
09-02-2025,"Grains, Flours & Dals",SL Idly Rava 1KG,4,65,55,10,1
09-02-2025,Spices & Seasonings,ROYAL SAFFRON,15,125,125,0,1
09-02-2025,"Dry Fruits, Nuts & Seeds",Groundnuts 1 kg,2,190,170,20,1
09-02-2025,"Grains, Flours & Dals",Green gram 1 kg,4,300,260,40,2
09-02-2025,"Grains, Flours & Dals",split black gram 1 kg,4,360,340,20,2
09-02-2025,"Grains, Flours & Dals",Quinova 500 gms,4,110,100,10,1
09-02-2025,Sweeteners,Mishri 500GM,16,70,60,10,1
09-02-2025,Snacks & Ready-to-Eat,VD MINAPA VADIYAM,14,65,65,0,1
09-02-2025,"Grains, Flours & Dals",Idly Rava L 1KG,4,60,50,10,1
09-02-2025,"Grains, Flours & Dals",KORRALU (FOXTAIL M) 500GM,4,130,110,20,2
09-02-2025,"Grains, Flours & Dals",WHEAT 1 KG,4,30,25,5,0.5
09-02-2025,Oils & Ghee,Groundnut oil 1 L,9,360,330,30,1
09-02-2025,"Grains, Flours & Dals",UDALU (Barnyard millet) 1 kg,4,280,230,50,2
09-02-2025,Pooja & Spiritual Items,SOSR SWATHHI 365,12,30,30,0,1
09-02-2025,Household & Cleaning,VIM COOLING FRESHNESS MINT,6,20,15,5,1
09-02-2025,"Grains, Flours & Dals",SAMALU (Little millet) 500 gms,4,170,130,40,2
09-02-2025,"Dry Fruits, Nuts & Seeds",SATHVI CHIA SEEDS 100GM,2,100,80,20,1
09-02-2025,Snacks & Ready-to-Eat,FOXTAIL BIS,14,135,135,0,1
09-02-2025,Spices & Seasonings,SD Curry Leaves Karam Powder 100GM,15,65,65,0,1
09-02-2025,"Grains, Flours & Dals",DISANO OATS 1KG,4,285,142.5,142.5,1
09-02-2025,"Grains, Flours & Dals",HS jowar idly rava 500 gms,4,65,65,0,1
09-02-2025,Milk & Dairy,SANGAM CURD 450GM,7,38,38,0,1
09-02-2025,"Grains, Flours & Dals",Red uluvalu 250 gms,4,45,40,5,1
09-02-2025,"Grains, Flours & Dals",SA YELLOW JOWAR RAVA 500GM,4,95,95,0,1
09-02-2025,Personal Care & Cosmetics,ORGANIC SPONGE LOOFAH,10,70,70,0,1
09-02-2025,Spices & Seasonings,DURGA SALT CRYSTAL 1KG,15,25,25,0,1
09-02-2025,"Health, Wellness & Ayurvedic Products",MH Millets Malt 500GM,5,200,190,10,1
09-02-2025,"Dry Fruits, Nuts & Seeds",PUTNALU 500GMS,2,180,152,28,2
09-02-2025,"Grains, Flours & Dals",Green gram 1 kg,4,150,130,20,1
09-02-2025,Spices & Seasonings,ELACHI 25 GM,15,145,120,25,1
09-02-2025,"Grains, Flours & Dals",Yellow jowar .F1 kg,4,110,100,10,1
09-02-2025,"Grains, Flours & Dals",split green gram 500 gms,4,75,70,5,1
09-02-2025,"Grains, Flours & Dals",turdal 1kg,4,660,585,75,3
09-02-2025,Oils & Ghee,Groundnut oil 1 L,9,360,330,30,1
09-02-2025,"Grains, Flours & Dals",Bajra Flour 1 kg,4,70,60,10,1
09-02-2025,Spices & Seasonings,Gasagasalu 50GM,15,130,110,20,1
09-02-2025,Oils & Ghee,Sesame oil 1 L,9,590,560,30,1
09-02-2025,"Grains, Flours & Dals",Sathya Javva Wheat Rava 500GM,4,95,95,0,1
09-02-2025,"Grains, Flours & Dals",RAGI FLOUR 500GRMS,4,40,35,5,1
09-02-2025,"Grains, Flours & Dals",MAAGAANI SP RICE 20 KGS,4,2300,"1,960.00",340,1
09-02-2025,"Grains, Flours & Dals",Yellow jowar .F1 kg,4,110,100,10,1
09-02-2025,"Grains, Flours & Dals",RICE FLOUR 1KG,4,70,55,15,1
09-02-2025,Oils & Ghee,Safflower oil 1 L,9,440,400,40,1
09-02-2025,Snacks & Ready-to-Eat,SATHVI MIXED CHIKKI 200GM,14,120,100,20,1
09-02-2025,Snacks & Ready-to-Eat,VD NUVULU LADDU 9PIC,14,100,100,0,1
09-02-2025,Snacks & Ready-to-Eat,SD Sesame laddu with dates250gm,14,135,135,0,1
09-02-2025,Spices & Seasonings,ROYAL SAFFRON,15,125,125,0,1
09-02-2025,Oils & Ghee,Groundnut oil 500ml,9,720,660,60,4
09-02-2025,Sweeteners,GS Organic Jaggery Powder 600GM,16,99,99,0,1
09-02-2025,Spices & Seasonings,Chilli powder 1 kg,15,580,420,160,1
09-02-2025,"Grains, Flours & Dals",PESARA PAPPU 1 KG,4,170,145,25,1
09-02-2025,"Grains, Flours & Dals",KORRALU (FOXTAIL M) 500GM,4,65,55,10,1
09-02-2025,"Grains, Flours & Dals",FLOUR CHARGE,4,36,36,0,3
09-02-2025,"Grains, Flours & Dals",Arikalu (kodo),4,70,65,5,1
09-02-2025,"Grains, Flours & Dals",UDALU (Barnyard millet) 500 gms,4,70,60,10,1
09-02-2025,"Grains, Flours & Dals",ANDU KORRALU (Brown top .mlt) 500,4,130,110,20,1
09-02-2025,"Grains, Flours & Dals",RAGULU 1 KG,4,35,30,5,0.5
09-02-2025,"Grains, Flours & Dals",SAMALU (Little millet) 500 gms,4,85,65,20,1
09-02-2025,Snacks & Ready-to-Eat,NGT CHATPATTA CHANA 90GM,14,25,25,0,1
09-02-2025,Snacks & Ready-to-Eat,PALLI LADDU 200GMS,14,90,70,20,1
09-02-2025,Snacks & Ready-to-Eat,GB SALT COOKIES,14,60,55,5,1
09-02-2025,Snacks & Ready-to-Eat,Popcorn Seeds 500GM,14,90,80,10,1
09-02-2025,"Grains, Flours & Dals",UDALU (Barnyard millet) 1 kg,4,140,115,25,1
09-02-2025,"Grains, Flours & Dals",RED WHEAT 1 KG,4,520,480,40,4
09-02-2025,"Grains, Flours & Dals",Urad dall 1 Kg,4,370,340,30,2
09-02-2025,"Grains, Flours & Dals",FLOUR CHARGE,4,48,48,0,4
09-02-2025,Milk & Dairy,HERITAGE TOTAL CURD 500GM,7,50,50,0,1
09-02-2025,Oils & Ghee,Black Sesame oil 500 ml,9,220,190,30,1
09-02-2025,"Grains, Flours & Dals",Bombay Rava 500GM,4,35,30,5,1
09-02-2025,Oils & Ghee,cow ghee 500 ml,9,430,390,40,1
09-02-2025,Pooja & Spiritual Items,NAGA SINDHURAM,12,40,40,0,1
09-02-2025,Pooja & Spiritual Items,VRP APOORVA JAVADHU POW,12,35,35,0,1
09-02-2025,Pooja & Spiritual Items,GD Aiswarya Deepam 700ML,12,195,195,0,1
09-02-2025,"Grains, Flours & Dals",SINGLE POLISH 1KG,4,130,130,0,2
09-02-2025,General Household & Kitchenware,IRN WDN HDL IDCTN KADAI 10,3,280,280,0,1
09-02-2025,"Grains, Flours & Dals",SA YELLOW JOWAR RAVA 500GM,4,95,95,0,1
09-02-2025,Snacks & Ready-to-Eat,HS JOWAR BISCUITS,14,50,50,0,1
09-02-2025,"Grains, Flours & Dals",Brown RICE 1KG,4,35,32.5,2.5,0.5
09-02-2025,Oils & Ghee,Sesame oil 1 L,9,1180,"1,120.00",60,2
09-02-2025,"Grains, Flours & Dals",RAGULU 1 KG,4,70,60,10,1
09-02-2025,"Grains, Flours & Dals",BARLEY SEEDS 1KG,4,80,70,10,0.5
09-02-2025,Sweeteners,ACHUBELLAM 500GM,16,50,40,10,1
09-02-2025,Spices & Seasonings,Chilli powder 500 gms,15,290,210,80,1
09-02-2025,Snacks & Ready-to-Eat,PUMPKIN CHIKKI 200GM,14,140,120,20,1
09-02-2025,Snacks & Ready-to-Eat,PALLI LADDU 200GMS,14,90,70,20,1
09-02-2025,Snacks & Ready-to-Eat,VD ATUKULU MIXTURE 175GM,14,60,60,0,1
09-02-2025,"Grains, Flours & Dals",Green gram 500 gms,4,75,70,5,1
09-02-2025,Oils & Ghee,Coconut oil 1 L,9,440,400,40,1
09-02-2025,"Grains, Flours & Dals",RAGI FLOUR 500GRMS,4,40,35,5,1
09-02-2025,Spices & Seasonings,SWEET SOUNF,15,20,20,0,1
09-02-2025,"Health, Wellness & Ayurvedic Products",RB Max Protein Choco Berry bar 50g,5,75,75,0,1
09-02-2025,"Grains, Flours & Dals",Brown RICE 1KG,4,140,130,10,2
09-02-2025,"Grains, Flours & Dals",VGR rice 1 kg,4,140,130,10,2
09-02-2025,Spices & Seasonings,DURGA SALT CRYSTAL 1KG,15,25,25,0,1
09-02-2025,General Household & Kitchenware,IRN WDN HDL DOSA TAWA 11,3,245,245,0,1
09-02-2025,"Grains, Flours & Dals",Wheat Rava M 500GM,4,33,30,3,1
09-02-2025,Spices & Seasonings,Turmeric powder 250 gms,15,100,75,25,1
09-02-2025,"Grains, Flours & Dals",VGR rice 1 kg,4,350,325,25,5
09-02-2025,Oils & Ghee,Safflower oil 1 L,9,1320,"1,200.00",120,3
09-02-2025,Spices & Seasonings,THREE MANGO RAI POWDER500GM,15,103,103,0,1
09-02-2025,Spices & Seasonings,SONTI 50GM,15,30,20,10,1
09-02-2025,"Grains, Flours & Dals",Bajra Flour 1 kg,4,140,120,20,2
09-02-2025,"Grains, Flours & Dals",turdal 1kg,4,220,195,25,1
09-02-2025,"Dry Fruits, Nuts & Seeds",Groundnuts 1 kg,2,190,170,20,1
09-02-2025,"Grains, Flours & Dals",Urad dall 1 Kg,4,185,170,15,1
09-02-2025,"Dry Fruits, Nuts & Seeds",Putnalu 250GM,2,90,76,14,2
09-02-2025,Sweeteners,GS Organic Jaggery Powder 600GM,16,99,99,0,1
09-02-2025,"Grains, Flours & Dals",Wheat Flour 1 kg,4,280,240,40,4
09-02-2025,"Grains, Flours & Dals",RAGI FLOUR 500GRMS,4,40,35,5,1
09-02-2025,"Grains, Flours & Dals",RAGI FLOUR 500GRMS,4,40,35,5,1
09-02-2025,"Grains, Flours & Dals",Bajra Flour 500 gms,4,35,30,5,1
09-02-2025,"Grains, Flours & Dals",Yellow jowar.F 500 gms,4,55,50,5,1
09-02-2025,Sweeteners,MISHRI 250 GM,16,35,30,5,1
09-02-2025,"Grains, Flours & Dals",split green gram 500 gms,4,75,70,5,1
09-02-2025,"Grains, Flours & Dals",UDALU (Barnyard millet) 1 kg,4,280,230,50,2
09-02-2025,"Grains, Flours & Dals",SAMALU (Little millet) 1 kg,4,340,260,80,2
09-02-2025,"Grains, Flours & Dals",Em Little idli R 500g,4,129,129,0,1
09-02-2025,Oils & Ghee,Groundnut oil 1 L,9,720,660,60,2
09-02-2025,"Grains, Flours & Dals",Wheat Flour 1 kg,4,140,120,20,2
09-02-2025,"Grains, Flours & Dals",THICK POHA 1KG,4,80,70,10,1
09-02-2025,Snacks & Ready-to-Eat,Sprouted Ragi Biscuits 450GM,14,150,150,0,1
09-02-2025,"Health, Wellness & Ayurvedic Products",MAHAVEDA NANNARI SHARBATH 750ML,5,220,220,0,1
09-02-2025,Snacks & Ready-to-Eat,urban murmura,14,70,70,0,1
09-02-2025,Spices & Seasonings,kasturi methi,15,60,60,0,1
09-02-2025,"Grains, Flours & Dals",White jowar.F 1 kg,4,100,80,20,1
09-02-2025,Snacks & Ready-to-Eat,ELITE MILK RUSK 200GM,14,35,35,0,1
09-02-2025,"Grains, Flours & Dals",Wheat Flour 1 kg,4,70,60,10,1
09-02-2025,"Grains, Flours & Dals",Multigrain 1 kg,4,100,85,15,1
09-02-2025,Oils & Ghee,Safflower oil 1 L,9,440,400,40,1
09-02-2025,Spices & Seasonings,Chilli powder 500 gms,15,290,210,80,1
09-02-2025,"Grains, Flours & Dals",Em kodo idli R 500G,4,129,129,0,1
09-02-2025,"Grains, Flours & Dals",Em little upma R 500g,4,129,129,0,1
09-02-2025,Spices & Seasonings,Masala Karam 250 gms,15,130,120,10,1
09-02-2025,"Dry Fruits, Nuts & Seeds",Groundnuts 500 gms,2,95,85,10,1
09-02-2025,Oils & Ghee,Sesame oil 1 L,9,1180,"1,120.00",60,2
09-02-2025,"Grains, Flours & Dals",White jowar.F 1 kg,4,100,80,20,1
09-02-2025,"Grains, Flours & Dals",PESARA PAPPU 1 KG,4,170,145,25,1
09-02-2025,"Grains, Flours & Dals",Chana Flour 1 kg,4,140,130,10,1
09-02-2025,Pooja & Spiritual Items,GD Aiswarya Deepam 700ML,12,195,195,0,1
09-02-2025,Oils & Ghee,Sesame oil 1 L,9,590,560,30,1
09-02-2025,Snacks & Ready-to-Eat,VD NUVULU LADDU 9PIC,14,100,100,0,1
09-02-2025,"Dry Fruits, Nuts & Seeds",KAJU HALF 250GM,2,310,290,20,1
09-02-2025,"Grains, Flours & Dals",MELMEKER 250GMS,4,60,45,15,1
09-02-2025,Oils & Ghee,Groundnut oil 1 L,9,720,660,60,2
09-02-2025,"Grains, Flours & Dals",RED RICE 1KG,4,150,120,30,1
09-02-2025,"Grains, Flours & Dals",Wheat Flour 1 kg,4,70,60,10,1
09-02-2025,"Grains, Flours & Dals",MELMEKER 250GMS,4,60,45,15,1
09-02-2025,"Grains, Flours & Dals",White jowar.F 1 kg,4,100,80,20,1
09-02-2025,"Dry Fruits, Nuts & Seeds",Groundnuts 1 kg,2,190,170,20,1
09-02-2025,Pooja & Spiritual Items,NAGA SINDHURAM,12,40,40,0,1
09-02-2025,Spices & Seasonings,ROYAL SAFFRON,15,125,125,0,1
09-02-2025,Sweeteners,GS JAGGERY NUGGETS 500GM,16,120,120,0,1
09-02-2025,Sweeteners,KAMAL JAGGERY 500GM,16,40,40,0,1
09-02-2025,Snacks & Ready-to-Eat,SD FINGER Millet with palm Jaggery 250gm,14,135,135,0,1
09-02-2025,Snacks & Ready-to-Eat,Pani Poori Chips 500GM,14,100,80,20,1
09-02-2025,Snacks & Ready-to-Eat,SALTED PHALLI,14,25,25,0,1
09-02-2025,"Grains, Flours & Dals",Bombay Rava 500GM,4,35,30,5,1
09-02-2025,"Grains, Flours & Dals",Wheat Rava M 500GM,4,33,30,3,1
09-02-2025,"Grains, Flours & Dals",AS Maize Rava 500GM,4,42,38,4,1
09-02-2025,Spices & Seasonings,EVEREST PANI PURI MASALA 50GM,15,40,40,0,1
09-02-2025,Snacks & Ready-to-Eat,VD MYSOREPAK 6PIC,14,100,100,0,1
09-02-2025,"Dry Fruits, Nuts & Seeds",GF DATES 500GM,2,156,149,7,1
09-02-2025,"Health, Wellness & Ayurvedic Products",RB Max Protein Choco Almond bar 50g,5,75,75,0,1
09-02-2025,"Grains, Flours & Dals",Wheat Rava M 1KG,4,65,55,10,1
09-02-2025,"Grains, Flours & Dals",BASMATHI RICE 1KG,4,150,135,15,1
09-02-2025,Snacks & Ready-to-Eat,SATHVI MIXED CHIKKI 200GM,14,240,200,40,2
09-02-2025,Sweeteners,MISHRI 250 GM,16,35,30,5,1
09-02-2025,"Grains, Flours & Dals",SL Suji Rava 500GM,4,32,32,0,1
09-02-2025,Personal Care & Cosmetics,MD Bath Powder 100GM,10,40,40,0,1
09-02-2025,"Grains, Flours & Dals",HS jowar idly rava 500 gms,4,65,65,0,1
09-02-2025,"Grains, Flours & Dals",RICE FLOUR 500 GM,4,35,28,7,1
09-02-2025,"Grains, Flours & Dals",MELMEKER 250GMS,4,60,45,15,1
09-02-2025,"Grains, Flours & Dals",HS jowar idly rava 500 gms,4,130,130,0,2
09-02-2025,Personal Care & Cosmetics,MD Bath Powder 100GM,10,40,40,0,1
09-02-2025,Oils & Ghee,Sesame oil 1 L,9,1180,"1,120.00",60,2
09-02-2025,Oils & Ghee,Groundnut oil 1 L,9,720,660,60,2
09-02-2025,"Grains, Flours & Dals",DISANO OATS 1KG,4,285,142.5,142.5,1
09-02-2025,Oils & Ghee,Groundnut oil 1 L,9,360,330,30,1
09-02-2025,"Grains, Flours & Dals",Wheat Flour 1 kg,4,70,60,10,1
09-02-2025,Snacks & Ready-to-Eat,SD KODO MILLET WITH PALM JAGGERY,14,135,135,0,1
09-02-2025,Snacks & Ready-to-Eat,SUNNUNDALU,14,120,120,0,1
09-02-2025,"Grains, Flours & Dals",Urad dall 1 Kg,4,185,170,15,1
09-02-2025,"Grains, Flours & Dals",Chana Flour 500 gms,4,70,65,5,1
09-02-2025,"Grains, Flours & Dals",YB NAVARA RICE 500GM,4,100,100,0,1
09-02-2025,"Grains, Flours & Dals",Multigrain 1 kg,4,100,85,15,1
09-02-2025,Spices & Seasonings,Elaichi 25GM,15,145,120,25,1
09-02-2025,Oils & Ghee,Safflower oil 1 L,9,440,400,40,1
09-02-2025,Oils & Ghee,Sesame oil 1 L,9,590,560,30,1
09-02-2025,"Grains, Flours & Dals",Em jowar idly R 500G,4,75,75,0,1
09-02-2025,Snacks & Ready-to-Eat,VD RICE SAGO PAPAD 150GM,14,55,55,0,1
09-02-2025,Oils & Ghee,Groundnut oil 1 L,9,360,330,30,1
09-02-2025,"Grains, Flours & Dals",SAMALU (Little millet) 1 kg,4,170,130,40,1
09-02-2025,Oils & Ghee,Groundnut oil 5 L,9,1800,"1,600.00",200,1
09-02-2025,"Grains, Flours & Dals",RICE FLOUR 500 GM,4,35,28,7,1
09-02-2025,"Grains, Flours & Dals",SB Javva Wheat Ravva 500GM,4,190,190,0,2
09-02-2025,Sweeteners,MISHRI D,16,40,30,10,1
09-02-2025,"Grains, Flours & Dals",Green gram 1 kg,4,300,260,40,2
09-02-2025,"Grains, Flours & Dals",Wheat Flour 1 kg,4,140,120,20,2
09-02-2025,"Grains, Flours & Dals",BOMBAY RAVA,4,70,55,15,1
09-02-2025,Oils & Ghee,Coconut oil 1 L,9,440,400,40,1
09-02-2025,Spices & Seasonings,Masala Karam 500 gms,15,260,240,20,1
09-02-2025,"Grains, Flours & Dals",RAGI FLOUR 1KG,4,80,70,10,1
09-02-2025,"Grains, Flours & Dals",Quinova 1 kg,4,220,195,25,1
09-02-2025,Oils & Ghee,Sesame oil 1 L,9,590,560,30,1
09-02-2025,Oils & Ghee,Coconut oil 500 ml,9,220,200,20,1
09-02-2025,Snacks & Ready-to-Eat,urban murmura,14,70,70,0,1
09-02-2025,Oils & Ghee,Sesame oil 500ml,9,295,280,15,1
09-02-2025,Snacks & Ready-to-Eat,VD MINAPA VADIYAM,14,65,65,0,1
09-02-2025,Snacks & Ready-to-Eat,VD MINAPA MIRCHI PAPAD 195GM,14,70,70,0,1
09-02-2025,Snacks & Ready-to-Eat,VD DAHI MIRCHI(SALTED) 100GM,14,90,90,0,2
09-02-2025,Snacks & Ready-to-Eat,VD MINAPA VADIYAM,14,65,65,0,1
09-02-2025,"Grains, Flours & Dals",Multigrain 1 kg,4,200,170,30,2
09-02-2025,"Grains, Flours & Dals",DH URAD GOTA 1KG,4,215,190,25,1
09-02-2025,Spices & Seasonings,RED COPRA 500GM,15,170,148,22,1
09-02-2025,"Dry Fruits, Nuts & Seeds",FLAX SEEDS 250GM,2,60,50,10,1
09-02-2025,"Grains, Flours & Dals",SL Idly Rava 1KG,4,65,55,10,1
09-02-2025,"Dry Fruits, Nuts & Seeds",CASHEW 250GM,2,340,310,30,1
09-02-2025,Snacks & Ready-to-Eat,Corn Chips 250GM,14,40,35,5,1
09-02-2025,Spices & Seasonings,Vamu 100GM,15,60,50,10,1
09-02-2025,Snacks & Ready-to-Eat,VD CORNFLAKES MIXTURE 175GM,14,60,60,0,1
09-02-2025,Oils & Ghee,Safflower oil 1 L,9,440,400,40,1
09-02-2025,Oils & Ghee,Sesame oil 1 L,9,590,560,30,1
09-02-2025,"Dry Fruits, Nuts & Seeds",SUNFLOWER SEEDS 250GRM,2,150,130,20,1
09-02-2025,General Household & Kitchenware,MATCH BOX,3,10,10,0,1
09-02-2025,Oils & Ghee,Groundnut oil 1 L,9,360,330,30,1
09-02-2025,Sweeteners,SD PALM JAGGERY 500GM,16,200,200,0,1
09-02-2025,"Dry Fruits, Nuts & Seeds",FLAX SEEDS 250GM,2,60,50,10,1
09-02-2025,Snacks & Ready-to-Eat,SD RED CHILLY PAPADS,14,80,80,0,1
09-02-2025,Snacks & Ready-to-Eat,VD NUVULU PAPAD 200GM,14,100,100,0,1
09-02-2025,"Grains, Flours & Dals",Chana Flour 500 gms,4,70,65,5,1
09-02-2025,Snacks & Ready-to-Eat,NGT CHATPATTA CHANA 90GM,14,25,25,0,1
09-02-2025,Snacks & Ready-to-Eat,PALLI LADDU 200GMS,14,90,70,20,1
09-02-2025,"Grains, Flours & Dals",RAGI FLOUR 500GRMS,4,80,70,10,2
09-02-2025,Snacks & Ready-to-Eat,SESAME LADDU 200GM,14,100,80,20,1
09-02-2025,"Grains, Flours & Dals",Wheat Flour 1 kg,4,70,60,10,1
09-02-2025,Snacks & Ready-to-Eat,VD PAPPU CHEGODI 200GM,14,60,60,0,1
09-02-2025,"Health, Wellness & Ayurvedic Products",RB FRUITS &amp;seeds Cranberries,5,45,45,0,1
09-02-2025,"Grains, Flours & Dals",Multigrain 1 kg,4,200,170,30,2
09-02-2025,"Grains, Flours & Dals",Wheat Rava M 1KG,4,65,55,10,1
09-02-2025,Oils & Ghee,Groundnut oil 1 L,9,360,330,30,1
09-02-2025,Snacks & Ready-to-Eat,SD FINGER Millet with palm Jaggery 250gm,14,135,135,0,1
09-02-2025,Spices & Seasonings,PN ORGANIC PINK SALT 1KG,15,124,124,0,1
09-02-2025,Snacks & Ready-to-Eat,SATHVI PALLI CHIKKI 200GM,14,200,160,40,2
09-02-2025,"Dry Fruits, Nuts & Seeds",Groundnuts 500 gms,2,95,85,10,1
09-02-2025,"Grains, Flours & Dals",Wheat Flour 1 kg,4,70,60,10,1
09-02-2025,"Grains, Flours & Dals",PRO ORGANIC MOONG GREEN,4,148,148,0,1
09-02-2025,Snacks & Ready-to-Eat,ELITE ELAICHI RUSK 200GM,14,35,35,0,1
09-02-2025,"Grains, Flours & Dals",Wheat Rava M 500GM,4,33,30,3,1
09-02-2025,"Grains, Flours & Dals",White jowar.F 1 kg,4,100,80,20,1
09-02-2025,Spices & Seasonings,Telaga Pindi 500GM,15,160,140,20,2
09-02-2025,Snacks & Ready-to-Eat,PUMPKIN CHIKKI 200GM,14,140,120,20,1
09-02-2025,Oils & Ghee,Sesame oil 1 L,9,1180,"1,120.00",60,2
09-02-2025,"Grains, Flours & Dals",Wheat Flour 1 kg,4,70,60,10,1
09-02-2025,"Grains, Flours & Dals",THICK POHA 500GM,4,40,35,5,1
09-02-2025,Oils & Ghee,Safflower oil 1 L,9,880,800,80,2
09-02-2025,Oils & Ghee,Sesame oil 1 L,9,590,560,30,1
09-02-2025,"Grains, Flours & Dals",Multigrain 1 kg,4,100,85,15,1
09-02-2025,Oils & Ghee,Coconut oil 500 ml,9,220,200,20,1
09-02-2025,Snacks & Ready-to-Eat,FOXTAIL NOODLES,14,75,75,0,1
09-02-2025,Oils & Ghee,Groundnut oil 1 L,9,360,330,30,1
09-02-2025,"Grains, Flours & Dals",turdal 1kg,4,220,195,25,1
09-02-2025,Snacks & Ready-to-Eat,PEANUT CANDY,14,45,45,0,1
09-02-2025,Sweeteners,KAMAL JAGGERY 500GM,16,40,40,0,1
09-02-2025,Sweeteners,MISHRI D,16,40,30,10,1
09-02-2025,Sweeteners,SUGAR 1KG,16,60,50,10,1
09-02-2025,Spices & Seasonings,Turmeric powder 250 gms,15,100,75,25,1
09-02-2025,Snacks & Ready-to-Eat,BB VERMICELLY 500GM,14,53,53,0,1
09-02-2025,Snacks & Ready-to-Eat,BLACK SESAME CHIKKI,14,15,15,0,3
09-02-2025,"Grains, Flours & Dals",CHANA DAL 500GM,4,70,60,10,1
09-02-2025,"Grains, Flours & Dals",Idly Rava L 1KG,4,60,50,10,1
09-02-2025,Spices & Seasonings,TATA SALT 1KG,15,30,30,0,1
09-02-2025,Snacks & Ready-to-Eat,VD SAGOPAPAD 150GM,14,55,55,0,1
09-02-2025,Snacks & Ready-to-Eat,TILLI CHIKKI,14,15,15,0,3
09-02-2025,"Grains, Flours & Dals",RED TURDAL 500GM,4,75,70,5,1
09-02-2025,"Grains, Flours & Dals",BAJRA 1 KG,4,30,25,5,0.5
09-02-2025,"Grains, Flours & Dals",FLOUR CHARGE,4,36,36,0,3
09-02-2025,"Grains, Flours & Dals",RED WHEAT 1 KG,4,260,240,20,2
09-02-2025,"Grains, Flours & Dals",RAGULU 1 KG,4,35,30,5,0.5
09-02-2025,Household & Cleaning,ROOPERI PITAMBARI SILVER 50ML,6,110,110,0,1
09-02-2025,"Dry Fruits, Nuts & Seeds",PULMAKHANA 100 GM,2,180,170,10,1
09-02-2025,Snacks & Ready-to-Eat,PALLI LADDU 200GMS,14,90,70,20,1
09-02-2025,Snacks & Ready-to-Eat,VD ATUKULU MIXTURE 175GM,14,60,60,0,1
09-02-2025,Snacks & Ready-to-Eat,JUNNU POWDER 100GM,14,70,70,0,1
09-02-2025,Sweeteners,NATURAL HONEY 1KG,16,560,480,80,1
09-02-2025,Snacks & Ready-to-Eat,GB SALT COOKIES,14,60,55,5,1
09-02-2025,Beverages,BRU GREEN LABEL 1.2G,1,6,6,0,3
09-02-2025,"Grains, Flours & Dals",BARLEY SEEDS 250GMS,4,40,35,5,1
09-02-2025,"Grains, Flours & Dals",Red Wheat Flour 1 kg,4,140,130,10,1
09-02-2025,"Grains, Flours & Dals",RAGULU 1 KG,4,35,30,5,0.5
09-02-2025,Oils & Ghee,Sesame oil 1 L,9,590,560,30,1
09-02-2025,"Grains, Flours & Dals",SABDANA 500GM,4,90,70,20,1
09-02-2025,Oils & Ghee,Sesame oil 1 L,9,1770,"1,680.00",90,3
09-02-2025,Oils & Ghee,Groundnut oil 1 L,9,360,330,30,1
09-02-2025,"Health, Wellness & Ayurvedic Products",MH Womens Malt 500GM,5,250,240,10,1
09-02-2025,"Health, Wellness & Ayurvedic Products",MH Millets Malt 500GM,5,200,190,10,1
09-02-2025,Pooja & Spiritual Items,OM SAINATH ISOBORNEOL 10GM,12,60,60,0,1
09-02-2025,Oils & Ghee,Coconut oil 500 ml,9,220,200,20,1
09-02-2025,Personal Care & Cosmetics,NEEM COMB,10,99,99,0,1
09-02-2025,"Grains, Flours & Dals",SRILATHA RICE RAVVA 500GM,4,35,35,0,1
09-02-2025,Sweeteners,YB JAGGERY POWDER 500GMS,16,150,150,0,2
09-02-2025,Spices & Seasonings,ROYAL SAFFRON,15,125,125,0,1
09-02-2025,"Grains, Flours & Dals",SL Idly Rava 1KG,4,130,110,20,2
09-02-2025,Oils & Ghee,Groundnut oil 5 L,9,1800,"1,600.00",200,1
09-02-2025,Spices & Seasonings,MD Sonti Powder 50GM,15,80,80,0,1
09-02-2025,"Dry Fruits, Nuts & Seeds",PUMPKIN SEEDS 250GM,2,200,160,40,1
09-02-2025,"Grains, Flours & Dals",Idly Rava L 1KG,4,60,50,10,1
09-02-2025,Pooja & Spiritual Items,HUNUMAN SINDOOR,12,60,60,0,1
09-02-2025,Spices & Seasonings,Black Till 250GM,15,180,150,30,2
09-02-2025,"Health, Wellness & Ayurvedic Products",DWI EUCALYPTUS 50ML,5,210,210,0,1
09-02-2025,Personal Care & Cosmetics,VETIVER BATH SCRUB,10,240,240,0,6
09-02-2025,"Grains, Flours & Dals",ANDU KORRALU (Browntop.m) 1 kg,4,260,220,40,1
09-02-2025,"Grains, Flours & Dals",UDALU (Barnyard millet) 1 kg,4,140,115,25,1
09-02-2025,Pooja & Spiritual Items,SOSR SWATHHI 365,12,30,30,0,1
09-02-2025,Spices & Seasonings,Chilli powder 500 gms,15,290,210,80,1
09-02-2025,Oils & Ghee,cow ghee 500 ml,9,430,390,40,1
09-02-2025,Oils & Ghee,Safflower oil 1 L,9,880,800,80,2
09-02-2025,"Dry Fruits, Nuts & Seeds",SUNFLOWER SEEDS 250GRM,2,150,130,20,1
09-02-2025,"Grains, Flours & Dals",MAAGAANI LOW GI SP 1KG,4,149,149,0,1
09-02-2025,"Grains, Flours & Dals",Wheat Flour 2 kgs,4,140,120,20,1
09-02-2025,Oils & Ghee,Sesame oil 1 L,9,590,560,30,1
09-02-2025,Sweeteners,YB Brown Sugar 1KG,16,140,140,0,1
09-02-2025,"Dry Fruits, Nuts & Seeds",PUMPKIN SEEDS 250GM,2,200,160,40,1
09-02-2025,Pooja & Spiritual Items,SOSR SWATHHI 365,12,30,30,0,1
09-02-2025,Pooja & Spiritual Items,SWATHI POOJA VATHULU,12,50,50,0,1
09-02-2025,Household & Cleaning,VIM EXTRA 110GM,6,50,50,0,5
09-02-2025,"Dry Fruits, Nuts & Seeds",ALMONDS 250GM,2,280,260,20,1
09-02-2025,Oils & Ghee,Groundnut oil 500ml,9,180,165,15,1
09-02-2025,"Dry Fruits, Nuts & Seeds",WATERMELON SEEDS 250GRM,2,320,280,40,1
09-02-2025,Oils & Ghee,Groundnut oil 1 L,9,360,330,30,1
09-02-2025,Sweeteners,ACHUBELLAM 500GM,16,50,40,10,1
09-02-2025,"Dry Fruits, Nuts & Seeds",PULMAKHANA 100 GM,2,180,170,10,1
09-02-2025,"Grains, Flours & Dals",split green gram 500 gms,4,75,70,5,1
09-02-2025,"Grains, Flours & Dals",Green gram 1 kg,4,150,130,20,1
09-02-2025,"Grains, Flours & Dals",RED TUDAL 1KG,4,150,140,10,1
09-02-2025,Snacks & Ready-to-Eat,ONION RINGS,14,50,50,0,1
09-02-2025,"Grains, Flours & Dals",Red Chana 500 GM,4,75,60,15,1
09-02-2025,Snacks & Ready-to-Eat,VD MINAPA SUNNUNDALU 12P,14,360,360,0,2
09-02-2025,"Grains, Flours & Dals",SL Suji Rava 500GM,4,32,32,0,1
09-02-2025,"Dry Fruits, Nuts & Seeds",Groundnuts 500 gms,2,95,85,10,1
09-02-2025,"Grains, Flours & Dals",MELMEKER 250GMS,4,60,45,15,1
09-02-2025,"Grains, Flours & Dals",Chittimuthaylu rice 1 kg,4,160,140,20,1
09-02-2025,Snacks & Ready-to-Eat,RINGS 200GM,14,30,30,0,1
09-02-2025,Snacks & Ready-to-Eat,Popcorn Seeds 250GM,14,45,40,5,1
09-02-2025,General Household & Kitchenware,SIRIDHANYALU BOOK,3,200,180,20,1
09-02-2025,Sweeteners,GS JAGGERY NUGGETS 500GM,16,120,120,0,1
09-02-2025,Oils & Ghee,Groundnut oil 1 L,9,360,330,30,1
09-02-2025,Sweeteners,PN ORGANIC JAGGERY POWDER 400GM,16,86,86,0,1
09-02-2025,"Grains, Flours & Dals",SL Idly Rava 1KG,4,65,55,10,1
09-02-2025,"Grains, Flours & Dals",MAAGAANI LOW GI SP L 1KG,4,600,525,75,5
09-02-2025,"Grains, Flours & Dals",Wheat Rava M 1KG,4,65,55,10,1
09-02-2025,Snacks & Ready-to-Eat,NGT CHATPATTA CHANA 90GM,14,25,25,0,1
09-02-2025,Sweeteners,SUGAR 1KG,16,60,50,10,1
09-02-2025,Spices & Seasonings,NUVVULU 500GM,15,200,170,30,1
09-02-2025,Oils & Ghee,Groundnut oil 1 L,9,360,330,30,1
09-02-2025,"Grains, Flours & Dals",RAGI FLOUR 500GRMS,4,40,35,5,1
09-02-2025,"Grains, Flours & Dals",Multigrain 1 kg,4,200,170,30,2
09-02-2025,"Grains, Flours & Dals",Multigrain 1 kg,4,200,170,30,2
09-02-2025,Spices & Seasonings,PN ORGANIC PINK SALT 1KG,15,124,124,0,1
09-02-2025,Oils & Ghee,Groundnut oil 1 L,9,360,330,30,1
09-02-2025,Spices & Seasonings,Telaga Pindi 500GM,15,80,70,10,1
09-02-2025,Oils & Ghee,Black Sesame oil 500 ml,9,220,190,30,1
09-02-2025,Oils & Ghee,Groundnut oil 1 L,9,360,330,30,1
09-02-2025,"Grains, Flours & Dals",Multigrain 1 kg,4,100,85,15,1
09-02-2025,"Grains, Flours & Dals",Wheat Flour 1 kg,4,140,120,20,2
09-02-2025,Spices & Seasonings,SWEET SOUNF,15,40,40,0,2
09-02-2025,Snacks & Ready-to-Eat,GANTASALA FOXTAIL SNACKS 150GM,14,60,60,0,1
09-02-2025,"Grains, Flours & Dals",MELMEKER 250GMS,4,60,45,15,1
09-02-2025,"Grains, Flours & Dals",White jowar.F 1 kg,4,100,80,20,1
09-02-2025,"Grains, Flours & Dals",MAAGAANI SP RICE 5KGS,4,649,560,89,1
09-02-2025,"Grains, Flours & Dals",BARLEY FLOUR 250GM,4,45,40,5,1
09-02-2025,"Grains, Flours & Dals",Bajra Flour 1 kg,4,70,60,10,1
09-02-2025,Personal Care & Cosmetics,COCONUT BATH SCRUBBER,10,40,40,0,1
09-02-2025,Spices & Seasonings,MG Dasa dinasalu 250gm,15,220,220,0,1
09-02-2025,Spices & Seasonings,GS Moringa Leaves Spicy Powder 100GM,15,90,90,0,1
09-02-2025,Snacks & Ready-to-Eat,VD CORNFLAKES MIXTURE 175GM,14,60,60,0,1
09-02-2025,Personal Care & Cosmetics,GAYATHRI KUMKUDUKAYA,10,300,300,0,2
09-02-2025,"Grains, Flours & Dals",Em Multimillet upma 500g,4,129,129,0,1
09-02-2025,"Grains, Flours & Dals",HS BAJRA FLAKES 250GM 1+1,4,119,119,0,1
09-02-2025,Beverages,REFRESH SHARBATH SUGAR FREE,1,299,285,14,1
09-02-2025,Sweeteners,GS A2 Buffalo Ghee 500ML,16,550,550,0,1
09-02-2025,"Grains, Flours & Dals",BASMATHI RICE 1KG,4,150,135,15,1
09-02-2025,"Grains, Flours & Dals",SABDANA,4,40,35,5,1
09-02-2025,"Grains, Flours & Dals",Wheat Flour 2 kgs,4,280,240,40,2
09-02-2025,Spices & Seasonings,Elaichi 25GM,15,145,120,25,1
09-02-2025,Sweeteners,MISHRI D,16,40,30,10,1
09-02-2025,"Grains, Flours & Dals",SL Idly Rava 1KG,4,65,55,10,1
09-02-2025,Snacks & Ready-to-Eat,BATANA NGT 70GMS,14,40,40,0,2
09-02-2025,Sweeteners,YB JAGGERY POWDER 1KG,16,140,140,0,1
09-02-2025,Snacks & Ready-to-Eat,VD VAMUPUSA 175GM,14,120,120,0,2
09-02-2025,Sweeteners,YB JAGGERY POWDER 500GMS,16,450,450,0,6
09-02-2025,Pooja & Spiritual Items,GD Aiswarya Deepam 700ML,12,195,195,0,1
09-02-2025,"Grains, Flours & Dals",SOYA BEANS 1KG,4,50,45,5,0.25
09-02-2025,Oils & Ghee,Sesame oil 1 L,9,590,560,30,1
09-02-2025,"Health, Wellness & Ayurvedic Products",PULIPIRI WARTS REMOVER 9GM,5,125,125,0,1
09-02-2025,Snacks & Ready-to-Eat,RSC ORANGE 100GMS,14,20,20,0,1
09-02-2025,Spices & Seasonings,DRY MIECHI 200GM,15,80,60,20,1
09-02-2025,Pooja & Spiritual Items,GD JASMINE 75GM,12,60,60,0,1
09-02-2025,"Grains, Flours & Dals",Red Chana 500 GM,4,75,60,15,1
09-02-2025,"Grains, Flours & Dals",KORRALU (FOXTAIL M) 500GM,4,65,55,10,1
09-02-2025,"Grains, Flours & Dals",Urad dall 1 Kg,4,185,170,15,1
09-02-2025,Spices & Seasonings,Menthulu 250 gms,15,50,45,5,1
09-02-2025,"Grains, Flours & Dals",Arikalu (kodo),4,70,65,5,1
09-02-2025,"Grains, Flours & Dals",MELMEKER 250GMS,4,60,45,15,1
09-02-2025,Personal Care & Cosmetics,GOW DURBAR NAVA 100GM SOAP,10,120,120,0,3
09-02-2025,"Grains, Flours & Dals",turdal 1kg,4,220,195,25,1
09-02-2025,Oils & Ghee,Groundnut oil 1 L,9,1440,"1,320.00",120,4
09-02-2025,Pooja & Spiritual Items,HERBAL VETIVER STICK 20INC,12,45,45,0,1
09-02-2025,Personal Care & Cosmetics,COLGATE KIDS 2 PLUS,10,30,30,0,1
09-02-2025,"Grains, Flours & Dals",BOBBARA PAPPU 500GM,4,85,80,5,1
09-02-2025,Personal Care & Cosmetics,GOW DURBAR 75G,10,60,60,0,1
09-02-2025,"Grains, Flours & Dals",RICE FLOUR 500 GM,4,35,28,7,1
09-02-2025,Household & Cleaning,SURF EXCEL 150GM,6,40,40,0,2
09-02-2025,Household & Cleaning,SURFEXCEL BAR 80G,6,20,20,0,2
09-02-2025,"Grains, Flours & Dals",Wheat Flour 1 kg,4,70,60,10,1
09-02-2025,"Grains, Flours & Dals",Green gram 500 gms,4,75,70,5,1
09-02-2025,Spices & Seasonings,Tamarind 250GMS,15,80,65,15,1
09-02-2025,Spices & Seasonings,Marati Magga 50GM,15,130,110,20,1
09-02-2025,Spices & Seasonings,Gasagasalu 50GM,15,130,110,20,1
09-02-2025,Oils & Ghee,BUFFALLO GHEE 500ML,9,410,370,40,1
09-02-2025,Spices & Seasonings,SHAHI BIRYANI MASALA,15,42,42,0,1
09-02-2025,Spices & Seasonings,SATHVI ANASAPUVUU 25GM,15,90,65,25,1
09-02-2025,Spices & Seasonings,EV Chicken Masala 50GM,15,48,48,0,1
09-02-2025,Spices & Seasonings,Dalchin Chekka 50GM,15,50,40,10,1
09-02-2025,Sweeteners,GS JAGGERY NUGGETS 500GM,16,120,120,0,1
09-02-2025,"Dry Fruits, Nuts & Seeds",PUMPKIN SEEDS 250GM,2,200,160,40,1
09-02-2025,"Dry Fruits, Nuts & Seeds",ALMONDS 250GM,2,280,260,20,1
09-02-2025,"Grains, Flours & Dals",turdal 1kg,4,220,195,25,1
09-02-2025,Oils & Ghee,Black Sesame oil 500 ml,9,660,570,90,3
09-02-2025,"Grains, Flours & Dals",PESARA PAPPU 500GMS,4,85,75,10,1
09-02-2025,"Dry Fruits, Nuts & Seeds",SUNFLOWER SEEDS 250GRM,2,150,130,20,1
09-02-2025,Spices & Seasonings,Elaichi 25GM,15,145,120,25,1
09-02-2025,"Grains, Flours & Dals",CHANA DAL 500GM,4,70,60,10,1
09-02-2025,Personal Care & Cosmetics,MYSORE SANDAL,10,69,69,0,1
09-02-2025,Snacks & Ready-to-Eat,KURNOOL MARMURA,14,70,55,15,1
09-02-2025,"Dry Fruits, Nuts & Seeds",CASHEW 250GM,2,680,620,60,2
09-02-2025,"Dry Fruits, Nuts & Seeds",YELLOW KISHMISH 250GM,2,130,110,20,1
09-02-2025,"Dry Fruits, Nuts & Seeds",Groundnuts 1 kg,2,190,170,20,1
09-02-2025,Snacks & Ready-to-Eat,VD MAIDA CHEGODI 175GM,14,60,60,0,1
09-02-2025,Snacks & Ready-to-Eat,VD VAMUPUSA 175GM,14,60,60,0,1
09-02-2025,Snacks & Ready-to-Eat,PALLI LADDU 200GMS,14,90,70,20,1
09-02-2025,Spices & Seasonings,Tamarind 250GMS,15,80,65,15,1
09-02-2025,Snacks & Ready-to-Eat,Sprouted Ragi Biscuits 450GM,14,300,300,0,2
09-02-2025,"Grains, Flours & Dals",VYS.SP.RICE BAG 1,4,1800,"1,650.00",150,1
09-02-2025,Personal Care & Cosmetics,Soapnut 250GM,10,45,45,0,1
09-02-2025,"Grains, Flours & Dals",BOMBAY RAVA,4,70,55,15,1
09-02-2025,"Health, Wellness & Ayurvedic Products",SHIKAKAI CHOORNAM,5,90,90,0,1
09-02-2025,"Grains, Flours & Dals",Multigrain 1 kg,4,200,170,30,2
09-02-2025,"Grains, Flours & Dals",Wheat Flour 1 kg,4,140,120,20,2
09-02-2025,Oils & Ghee,Groundnut oil 500ml,9,360,330,30,2
09-02-2025,"Grains, Flours & Dals",RAGI FLOUR 1KG,4,80,70,10,1
09-02-2025,Oils & Ghee,Groundnut oil 1 L,9,360,330,30,1
09-02-2025,Personal Care & Cosmetics,SVE SHIKAKAI SOAP 100GM,10,100,100,0,1
09-02-2025,"Grains, Flours & Dals",Wheat Rava M 1KG,4,65,55,10,1
09-02-2025,"Grains, Flours & Dals",RICE FLOUR 500 GM,4,35,28,7,1
09-02-2025,"Grains, Flours & Dals",SRILALITHA MAIDA FLOUR 500G,4,32,32,0,1
09-02-2025,"Grains, Flours & Dals",Arikalu (kodo),4,70,65,5,1
09-02-2025,"Grains, Flours & Dals",SA WHITE JOWAR RAVA 500GM,4,69,69,0,1
09-02-2025,Spices & Seasonings,Coriander seeds 200 gms,15,48,40,8,1
09-02-2025,Spices & Seasonings,Masala Karam 250 gms,15,130,120,10,1
09-02-2025,"Grains, Flours & Dals",Idly Rava L 1KG,4,60,50,10,1
09-02-2025,"Grains, Flours & Dals",split green gram 500 gms,4,75,70,5,1
09-02-2025,Spices & Seasonings,ROYAL SAFFRON 400GRMS,15,130,130,0,2
09-02-2025,Spices & Seasonings,RED COPRA 250GMS,15,85,74,11,1
09-02-2025,Spices & Seasonings,Gasagasalu 50GM,15,130,110,20,1
09-02-2025,Snacks & Ready-to-Eat,SD Vamu with palm jaggery 250gm,14,135,135,0,1
09-02-2025,"Grains, Flours & Dals",RAGULU 1 KG,4,14,12,2,0.2
09-02-2025,"Grains, Flours & Dals",JOWAR YELLOW 1 K,4,100,90,10,1
09-02-2025,"Grains, Flours & Dals",Brown RICE 1KG,4,70,65,5,1
09-02-2025,"Grains, Flours & Dals",BAJRA 1 KG,4,12,10,2,0.2
09-02-2025,"Grains, Flours & Dals",FLOUR CHARGE,4,24,24,0,2
09-02-2025,"Grains, Flours & Dals",DISANO OATS 1KG,4,28.5,28.5,0,0.1
09-02-2025,Milk & Dairy,ID PANEER,7,135,135,0,1
09-02-2025,"Grains, Flours & Dals",RICE FLOUR 1KG,4,70,55,15,1
09-02-2025,Snacks & Ready-to-Eat,NGT CHATPATTA CHANA 90GM,14,50,50,0,2
09-02-2025,"Grains, Flours & Dals",Wheat Flour 1 kg,4,70,60,10,1
09-02-2025,"Grains, Flours & Dals",Green gram 500 gms,4,75,70,5,1
09-02-2025,"Grains, Flours & Dals",Wheat Flour 1 kg,4,140,120,20,2
09-02-2025,"Grains, Flours & Dals",SB Javva Wheat Ravva 500GM,4,95,95,0,1
09-02-2025,Spices & Seasonings,PURO Healthy Salt 1KG,15,110,110,0,1
09-02-2025,"Dry Fruits, Nuts & Seeds",SD Mango cubes 200gm,2,90,90,0,1
09-02-2025,"Grains, Flours & Dals",Wheat Flour 1 kg,4,210,180,30,3
09-02-2025,Milk & Dairy,SANGAM TONED MILK 500ML,7,30,30,0,1
09-02-2025,Milk & Dairy,HERITAGE TONED MILK 500ML,7,62,62,0,2
09-02-2025,Oils & Ghee,Groundnut oil 5 L,9,3600,"3,200.00",400,2
09-02-2025,Spices & Seasonings,Chilli powder 1 kg,15,580,420,160,1
09-02-2025,Spices & Seasonings,Jeera 100GM,15,50,45,5,1
09-02-2025,Oils & Ghee,Sesame oil 1 L,9,590,560,30,1
09-02-2025,"Dry Fruits, Nuts & Seeds",Groundnuts 500 gms,2,95,85,10,1
09-02-2025,"Health, Wellness & Ayurvedic Products",MD Triphala Chorrnam 100GM,5,80,80,0,1
09-02-2025,"Grains, Flours & Dals",RAGI FLOUR 500GRMS,4,40,35,5,1
09-02-2025,"Grains, Flours & Dals",Yellow jowar.F 500 gms,4,55,50,5,1
09-02-2025,"Grains, Flours & Dals",SB Javva Wheat Ravva 500GM,4,95,95,0,1
09-02-2025,Oils & Ghee,Groundnut oil 5 L,9,1800,"1,600.00",200,1
09-02-2025,Oils & Ghee,Groundnut oil 1 L,9,360,330,30,1
09-02-2025,Oils & Ghee,Coconut oil 1 L,9,440,400,40,1
09-02-2025,Spices & Seasonings,SD Garlic Karam Powder 100GM,15,65,65,0,1
09-02-2025,Spices & Seasonings,SD Redgram Karam Powder 100GM,15,65,65,0,1
09-02-2025,"Health, Wellness & Ayurvedic Products",MORINGA LEAF POWDER M,5,160,160,0,2
09-02-2025,Spices & Seasonings,FLAXSEED KARAM,15,75,75,0,1
09-02-2025,"Dry Fruits, Nuts & Seeds",YB GRANMA NUTS,2,90,90,0,1
09-02-2025,Snacks & Ready-to-Eat,VD CORNFLAKES MIXTURE 175GM,14,120,120,0,2
09-02-2025,Spices & Seasonings,Tamarind 250GMS,15,80,65,15,1
09-02-2025,"Grains, Flours & Dals",AISHWARYA SP 25KG,4,1999,"1,690.00",309,1
09-02-2025,Oils & Ghee,Groundnut oil 1 L,9,360,330,30,1
09-02-2025,"Grains, Flours & Dals",HS Multimillet upma r 500g,4,65,65,0,1
09-02-2025,"Grains, Flours & Dals",VGR rice 1 kg,4,140,130,10,2
09-02-2025,"Grains, Flours & Dals",DH URAD GOTA 1KG,4,215,190,25,1
09-02-2025,"Grains, Flours & Dals",RAGULU 1 KG,4,70,60,10,1
09-02-2025,"Grains, Flours & Dals",BARLEY SEEDS 1KG,4,32,28,4,0.2
09-02-2025,"Grains, Flours & Dals",SOYA BEANS 1KG,4,40,36,4,0.2
09-02-2025,"Grains, Flours & Dals",DISANO OATS 1KG,4,57,57,0,0.2
09-02-2025,"Grains, Flours & Dals",JOWAR YELLOW 1 K,4,20,18,2,0.2
09-02-2025,"Grains, Flours & Dals",BAJRA 1 KG,4,12,10,2,0.2
09-02-2025,"Grains, Flours & Dals",FLOUR CHARGE,4,24,24,0,2
09-02-2025,"Grains, Flours & Dals",VYS.SP.RICE 5 KGS,4,350,325,25,1
09-02-2025,Oils & Ghee,Sesame oil 1 L,9,590,560,30,1
09-02-2025,Oils & Ghee,Coconut oil 1 L,9,440,400,40,1
09-02-2025,"Grains, Flours & Dals",MAATEJA rice 5 kg,4,360,345,15,1
09-02-2025,Oils & Ghee,Groundnut oil 1 L,9,720,660,60,2
09-02-2025,Oils & Ghee,Groundnut oil 1 L,9,720,660,60,2
09-02-2025,Sweeteners,GS Palm Jaggery Powder 400GM,16,360,360,0,2
08-02-2025,"Dry Fruits, Nuts & Seeds",SUNFLOWER SEEDS 250GRM,2,150,130,20,1
08-02-2025,Snacks & Ready-to-Eat,RAJGIRA PEANUT CHIKKI,14,15,15,0,3
08-02-2025,"Dry Fruits, Nuts & Seeds",YELLOW KISHMISH 250GM,2,130,110,20,1
08-02-2025,Snacks & Ready-to-Eat,WHITE SESAME CHIKKI,14,10,10,0,1
08-02-2025,"Dry Fruits, Nuts & Seeds",FLAX SEEDS 250GM,2,60,50,10,1
08-02-2025,Pooja & Spiritual Items,VRP APOORVA JAVADHU POW,12,35,35,0,1
08-02-2025,"Dry Fruits, Nuts & Seeds",PUMPKIN SEEDS 250GM,2,200,160,40,1
08-02-2025,Pooja & Spiritual Items,GD Dhoop Cones 40GM,12,30,30,0,1
08-02-2025,Oils & Ghee,Coconut oil 500 ml,9,220,200,20,1
08-02-2025,Milk & Dairy,SANGAM TONED MILK 500ML,7,180,180,0,6
08-02-2025,Spices & Seasonings,Turmeric powder 250 gms,15,100,75,25,1
08-02-2025,"Grains, Flours & Dals",VGR rice 1 kg,4,70,65,5,1
08-02-2025,"Grains, Flours & Dals",DOCTOR RICE DIABETIC SFR 1KG,4,240,240,0,2
08-02-2025,Oils & Ghee,Safflower oil 1 L,9,440,400,40,1
08-02-2025,"Dry Fruits, Nuts & Seeds",SALTED PISTA 250GM,2,400,350,50,1
08-02-2025,Snacks & Ready-to-Eat,VD Pappu Chekkalu 190gm,14,60,60,0,1
08-02-2025,Snacks & Ready-to-Eat,SD JOWAR WITH PALM JAGGERY 250GM,14,135,135,0,1
08-02-2025,"Dry Fruits, Nuts & Seeds",KAJU HALF 250GM,2,310,290,20,1
08-02-2025,"Dry Fruits, Nuts & Seeds",PUMPKIN SEEDS 250GM,2,200,160,40,1
08-02-2025,Snacks & Ready-to-Eat,COPRA LADDU 200GM,14,100,80,20,1
08-02-2025,"Dry Fruits, Nuts & Seeds",ALMONDS 250GM,2,280,260,20,1
08-02-2025,"Grains, Flours & Dals",Multigrain 1 kg,4,100,85,15,1
08-02-2025,Snacks & Ready-to-Eat,PALLI LADDU 200GMS,14,90,70,20,1
08-02-2025,Oils & Ghee,Safflower oil 1 L,9,880,800,80,2
08-02-2025,"Dry Fruits, Nuts & Seeds",PULMAKHANA 100 GM,2,180,170,10,1
08-02-2025,Personal Care & Cosmetics,MADDI HIBISCUS HAIR SHAMPOO 500ML,10,300,300,0,1
08-02-2025,"Dry Fruits, Nuts & Seeds",FLAX SEEDS 250GM,2,60,50,10,1
08-02-2025,"Grains, Flours & Dals",RICE FLOUR 500 GM,4,35,28,7,1
08-02-2025,Snacks & Ready-to-Eat,SALTED PHALLI,14,25,25,0,1
08-02-2025,"Grains, Flours & Dals",BOMBAY RAVA,4,70,55,15,1
08-02-2025,Milk & Dairy,SANGAM FULL CREAM MILK 500ML,7,38,38,0,1
08-02-2025,"Dry Fruits, Nuts & Seeds",SATHVI CHIA SEEDS 100GM,2,100,80,20,1
08-02-2025,Oils & Ghee,Castor oil 200 ml,9,100,80,20,1
08-02-2025,"Grains, Flours & Dals",SAMALU (Little millet) 1 kg,4,170,130,40,1
08-02-2025,"Grains, Flours & Dals",SL Idly Rava 1KG,4,65,55,10,1
08-02-2025,Snacks & Ready-to-Eat,MILK BREAD,14,55,55,0,1
08-02-2025,Sweeteners,YB JAGGERY POWDER 1KG,16,140,140,0,1
08-02-2025,"Dry Fruits, Nuts & Seeds",Groundnuts 1 kg,2,190,170,20,1
08-02-2025,Snacks & Ready-to-Eat,PALLI LADDU 200GMS,14,90,70,20,1
08-02-2025,Snacks & Ready-to-Eat,SESAME LADDU 200GM,14,100,80,20,1
08-02-2025,Snacks & Ready-to-Eat,SD DrybFruit LADDU WITH DATES 175GM,14,170,170,0,1
08-02-2025,Snacks & Ready-to-Eat,SESAME LADDU 200GM,14,100,80,20,1
08-02-2025,"Dry Fruits, Nuts & Seeds",SUNFLOWER SEEDS 250GRM,2,150,130,20,1
08-02-2025,Snacks & Ready-to-Eat,SD Vamu with palm jaggery 250gm,14,135,135,0,1
08-02-2025,Snacks & Ready-to-Eat,FOXTAIL NOODLES,14,75,75,0,1
08-02-2025,"Dry Fruits, Nuts & Seeds",PUMPKIN SEEDS 250GM,2,200,160,40,1
08-02-2025,Snacks & Ready-to-Eat,SD GINGER CANDY 200GM,14,120,120,0,1
08-02-2025,Snacks & Ready-to-Eat,SD JOWAR WITH PALM JAGGERY 250GM,14,135,135,0,1
08-02-2025,Snacks & Ready-to-Eat,BD RED RICE NOODLES 200G,14,70,70,0,1
08-02-2025,"Grains, Flours & Dals",JOWAR WHITE 1 KG,4,40,35,5,0.5
08-02-2025,Snacks & Ready-to-Eat,VD NUVULU LADDU 9PIC,14,180,180,0,1
08-02-2025,Snacks & Ready-to-Eat,GROUNDNUT LADDU WITH DATES,14,135,135,0,1
08-02-2025,Oils & Ghee,Safflower oil 500 ml,9,220,200,20,1
08-02-2025,Oils & Ghee,Sesame oil 500ml,9,295,280,15,1
08-02-2025,Personal Care & Cosmetics,HERBAL BATH POWDER,10,160,160,0,1
08-02-2025,"Grains, Flours & Dals",Wheat Flour 1 kg,4,70,60,10,1
08-02-2025,Snacks & Ready-to-Eat,MB MULTIMILLET NOODLES 180GM,14,95,95,0,1
08-02-2025,"Grains, Flours & Dals",RAGI FLOUR 500GRMS,4,40,35,5,1
08-02-2025,Personal Care & Cosmetics,KHADI Neem Anti Dandruff Shampoo,10,199,199,0,1
08-02-2025,Oils & Ghee,BUFFALLO GHEE 500ML,9,410,370,40,1
08-02-2025,Pooja & Spiritual Items,GD Sambrani Cup Dhoop 10 PC,12,192,192,0,2
08-02-2025,Sweeteners,NATURAL HONEY 250GM,16,150,130,20,1
08-02-2025,Snacks & Ready-to-Eat,NGT CHATPATTA CHANA 90GM,14,25,25,0,1
08-02-2025,"Dry Fruits, Nuts & Seeds",YB GRANMA NUTS,2,180,180,0,2
08-02-2025,"Grains, Flours & Dals",Wheat Rava M 1KG,4,65,55,10,1
08-02-2025,"Grains, Flours & Dals",KORRALU (FOXTAIL M) 1KG,4,300,220,80,2
08-02-2025,"Grains, Flours & Dals",White jowar.F 1 kg,4,100,80,20,1
08-02-2025,Sweeteners,SUGAR 1KG,16,60,50,10,1
08-02-2025,Spices & Seasonings,TATA SALT 1KG,15,30,30,0,1
08-02-2025,"Dry Fruits, Nuts & Seeds",CASHEW,2,680,590,90,1
08-02-2025,"Grains, Flours & Dals",CHANA DAL 500GM,4,70,60,10,1
08-02-2025,"Grains, Flours & Dals",PESARA PAPPU 1 KG,4,170,145,25,1
08-02-2025,Spices & Seasonings,AVALU 100GM,15,25,20,5,1
08-02-2025,"Dry Fruits, Nuts & Seeds",PUTNALU 500GMS,2,90,76,14,1
08-02-2025,"Grains, Flours & Dals",Idly Rava L 1KG,4,60,50,10,1
08-02-2025,"Grains, Flours & Dals",Urad dall 1 Kg,4,185,170,15,1
08-02-2025,Spices & Seasonings,Jeera 100GM,15,50,45,5,1
08-02-2025,"Grains, Flours & Dals",Multigrain 1 kg,4,200,170,30,2
08-02-2025,Oils & Ghee,Safflower oil 1 L,9,880,800,80,2
08-02-2025,"Grains, Flours & Dals",Wheat Flour 1 kg,4,140,120,20,2
08-02-2025,"Grains, Flours & Dals",turdal 1kg,4,440,390,50,2
08-02-2025,"Grains, Flours & Dals",BOBBARA PAPPU 500GM,4,85,80,5,1
08-02-2025,"Grains, Flours & Dals",RAGI FLOUR 1KG,4,80,70,10,1
08-02-2025,"Grains, Flours & Dals",RICE FLOUR 500 GM,4,35,28,7,1
08-02-2025,Snacks & Ready-to-Eat,RSC ORANGE 100GMS,14,20,20,0,1
08-02-2025,"Grains, Flours & Dals",Em Multimillet idli r 500g,4,129,129,0,1
08-02-2025,Oils & Ghee,Groundnut oil 1 L,9,360,330,30,1
08-02-2025,"Grains, Flours & Dals",Sathya Javva Wheat Rava 500GM,4,95,95,0,1
08-02-2025,"Grains, Flours & Dals",Wheat Flour 1 kg,4,70,60,10,1
08-02-2025,"Grains, Flours & Dals",Multigrain 1 kg,4,100,85,15,1
08-02-2025,Spices & Seasonings,KALONJI SEEDS,15,90,80,10,1
08-02-2025,Spices & Seasonings,GREEN SOUNF,15,60,40,20,1
08-02-2025,Spices & Seasonings,Jeera 100GM,15,50,45,5,1
08-02-2025,"Dry Fruits, Nuts & Seeds",SATHVI CHIA SEEDS 100GM,2,100,80,20,1
08-02-2025,Spices & Seasonings,Elaichi 25GM,15,145,120,25,1
08-02-2025,Spices & Seasonings,Vamu 100GM,15,60,50,10,1
08-02-2025,Sweeteners,YB JAGGERY POWDER 500GMS,16,75,75,0,1
08-02-2025,"Dry Fruits, Nuts & Seeds",Groundnuts 1 kg,2,380,340,40,2
08-02-2025,Sweeteners,YB Brown Sugar 500GM,16,75,75,0,1
08-02-2025,"Grains, Flours & Dals",Chana Flour 500 gms,4,70,65,5,1
08-02-2025,Spices & Seasonings,Menthulu 250 gms,15,50,45,5,1
08-02-2025,"Grains, Flours & Dals",DESI CHANA,4,100,100,0,4
08-02-2025,Spices & Seasonings,Tamarind 500GM,15,160,130,30,1
08-02-2025,"Grains, Flours & Dals",Green gram 1 kg,4,150,130,20,1
08-02-2025,Spices & Seasonings,MD Sonti Powder 50GM,15,100,100,0,1
08-02-2025,Spices & Seasonings,Dalchin Chekka 50GM,15,50,40,10,1
08-02-2025,Snacks & Ready-to-Eat,BATANA NGT 70GMS,14,20,20,0,1
08-02-2025,Oils & Ghee,Groundnut oil 500ml,9,180,165,15,1
08-02-2025,"Grains, Flours & Dals",Bombay Rava 500GM,4,35,30,5,1
08-02-2025,"Health, Wellness & Ayurvedic Products",PULIPIRI WARTS REMOVER 9GM,5,125,125,0,1
08-02-2025,Snacks & Ready-to-Eat,Popcorn Seeds 250GM,14,45,40,5,1
08-02-2025,Spices & Seasonings,ROYAL SAFFRON 400GRMS,15,65,65,0,1
08-02-2025,"Grains, Flours & Dals",Arikalu (kodo),4,70,65,5,1
08-02-2025,"Grains, Flours & Dals",KORRALU (FOXTAIL M) 500GM,4,65,55,10,1
08-02-2025,"Grains, Flours & Dals",SL Suji Rava 500GM,4,32,32,0,1
08-02-2025,Oils & Ghee,Groundnut oil 500ml,9,180,165,15,1
08-02-2025,"Grains, Flours & Dals",SAMALU (Little millet) 500 gms,4,85,65,20,1
08-02-2025,"Grains, Flours & Dals",ANDU KORRALU (Brown top .mlt) 500,4,130,110,20,1
08-02-2025,"Grains, Flours & Dals",UDALU (Barnyard millet) 500 gms,4,70,60,10,1
08-02-2025,"Grains, Flours & Dals",RAGI FLOUR 500GRMS,4,40,35,5,1
08-02-2025,"Grains, Flours & Dals",DESI CHANA,4,25,25,0,1
08-02-2025,"Grains, Flours & Dals",Idly Rava L 1KG,4,60,50,10,1
08-02-2025,"Grains, Flours & Dals",SPLIT BLACK GRAM 500 GM,4,90,85,5,1
08-02-2025,"Dry Fruits, Nuts & Seeds",Groundnuts 500 gms,2,95,85,10,1
08-02-2025,"Grains, Flours & Dals",MAAGAANI LOW GI SP L 1KG,4,360,315,45,3
08-02-2025,"Grains, Flours & Dals",Wheat Rava M 500GM,4,33,30,3,1
08-02-2025,"Grains, Flours & Dals",RAGI FLOUR 1KG,4,80,70,10,1
08-02-2025,Spices & Seasonings,Tamarind 500GM,15,160,130,30,1
08-02-2025,"Grains, Flours & Dals",MELMEKER 250GMS,4,60,45,15,1
08-02-2025,Snacks & Ready-to-Eat,BD RAGI NOODLES,14,75,75,0,1
08-02-2025,"Grains, Flours & Dals",HS Multimillet idly R 500 gms,4,65,65,0,1
08-02-2025,"Grains, Flours & Dals",HS RAGI Idly rava 500 gms,4,70,70,0,1
08-02-2025,Oils & Ghee,Groundnut oil 5 L,9,1800,"1,600.00",200,1
08-02-2025,"Grains, Flours & Dals",Wheat Flour 1 kg,4,350,300,50,5
08-02-2025,"Dry Fruits, Nuts & Seeds",ANJEER 250GM,2,400,360,40,1
08-02-2025,Snacks & Ready-to-Eat,RSC ORANGE 100GMS,14,20,20,0,1
08-02-2025,Spices & Seasonings,SWEET SOUNF,15,20,20,0,1
08-02-2025,"Grains, Flours & Dals",DESI CHANA,4,25,25,0,1
08-02-2025,Snacks & Ready-to-Eat,RSC ORANGE 100GMS,14,20,20,0,1
08-02-2025,"Grains, Flours & Dals",SRILATHA RICE RAVVA 500GM,4,35,35,0,1
08-02-2025,Oils & Ghee,GANTASALA A2 COW GHEE 250ML,9,299,299,0,1
08-02-2025,Spices & Seasonings,KALONJI SEEDS,15,90,80,10,1
08-02-2025,Spices & Seasonings,Chilli powder 500 gms,15,290,210,80,1
08-02-2025,"Grains, Flours & Dals",Wheat Flour 1 kg,4,70,60,10,1
08-02-2025,Oils & Ghee,Groundnut oil 1 L,9,360,330,30,1
08-02-2025,"Grains, Flours & Dals",split green gram 1 kg,4,150,140,10,1
08-02-2025,"Grains, Flours & Dals",Hs yellow jowar r 500g,4,99,99,0,1
08-02-2025,"Dry Fruits, Nuts & Seeds",PUMPKIN SEEDS 250GM,2,200,160,40,1
08-02-2025,"Grains, Flours & Dals",Em jowar idly R 500G,4,75,75,0,1
08-02-2025,"Grains, Flours & Dals",Green gram 1 kg,4,150,130,20,1
08-02-2025,"Grains, Flours & Dals",AISHWARYA SP 1KG,4,320,280,40,4
08-02-2025,"Grains, Flours & Dals",BLACK GRAM 1KG,4,150,140,10,1
08-02-2025,"Dry Fruits, Nuts & Seeds",Groundnuts 500 gms,2,190,170,20,2
08-02-2025,"Grains, Flours & Dals",Quinova 500 gms,4,110,100,10,1
08-02-2025,"Grains, Flours & Dals",KORRALU (FOXTAIL M) 500GM,4,65,55,10,1
08-02-2025,Oils & Ghee,Groundnut oil 1 L,9,360,330,30,1
08-02-2025,"Grains, Flours & Dals",Red uluvalu 500 gms,4,90,75,15,1
08-02-2025,Oils & Ghee,Coconut oil 500 ml,9,220,200,20,1
08-02-2025,Oils & Ghee,GANTASALA A2 COW GHEE 250ML,9,299,299,0,1
08-02-2025,Oils & Ghee,Groundnut oil 1 L,9,360,330,30,1
08-02-2025,"Dry Fruits, Nuts & Seeds",PUMPKIN SEEDS 250GM,2,200,160,40,1
08-02-2025,Snacks & Ready-to-Eat,BD RED RICE NOODLES 200G,14,70,70,0,1
08-02-2025,Snacks & Ready-to-Eat,ANNAPURNA APPALAM,14,35,35,0,1
08-02-2025,"Dry Fruits, Nuts & Seeds",ANJEER 250GM,2,400,360,40,1
08-02-2025,"Dry Fruits, Nuts & Seeds",SUNFLOWER SEEDS 250GRM,2,150,130,20,1
08-02-2025,Oils & Ghee,cow ghee 500 ml,9,430,390,40,1
08-02-2025,Snacks & Ready-to-Eat,WHOLE WHEAT BREAD,14,55,55,0,1
08-02-2025,"Health, Wellness & Ayurvedic Products",MH Womens Malt 500GM,5,500,480,20,2
08-02-2025,Oils & Ghee,Groundnut oil 1 L,9,720,660,60,2
08-02-2025,"Grains, Flours & Dals",RICE FLOUR 500 GM,4,70,56,14,2
08-02-2025,Snacks & Ready-to-Eat,GB SALT COOKIES,14,60,55,5,1
08-02-2025,Snacks & Ready-to-Eat,RINGS 200GM,14,30,30,0,1
08-02-2025,"Grains, Flours & Dals",BASMATHI RICE 1KG,4,300,270,30,2
08-02-2025,"Grains, Flours & Dals",POORI ATTA 1KG,4,210,180,30,3
08-02-2025,Snacks & Ready-to-Eat,3D PAPAD,14,40,40,0,1
08-02-2025,"Dry Fruits, Nuts & Seeds",CASHEW 250GM,2,340,310,30,1
08-02-2025,"Grains, Flours & Dals",white Bobarlu 500 gms,4,80,75,5,1
08-02-2025,"Grains, Flours & Dals",turdal 1kg,4,220,195,25,1
08-02-2025,"Grains, Flours & Dals",split green gram 1 kg,4,150,140,10,1
08-02-2025,"Grains, Flours & Dals",MAAGAANI LOW GI SP L 1KG,4,720,630,90,6
08-02-2025,Snacks & Ready-to-Eat,MAAGAANI M JOWAR PASTA 200GM,14,199,199,0,1
08-02-2025,"Grains, Flours & Dals",SB Javva Wheat Ravva 500GM,4,190,190,0,2
08-02-2025,Personal Care & Cosmetics,HEART SHAPE LOOFAH,10,79,79,0,1
08-02-2025,Personal Care & Cosmetics,ORGANIC SPONGE LOOFAH,10,70,70,0,1
08-02-2025,"Dry Fruits, Nuts & Seeds",PUTNALU 500GMS,2,90,76,14,1
08-02-2025,Snacks & Ready-to-Eat,RB Choco Delite Almonds Raisins 40g,14,45,45,0,1
08-02-2025,"Dry Fruits, Nuts & Seeds",Groundnuts 1 kg,2,190,170,20,1
08-02-2025,"Grains, Flours & Dals",MELMEKER 250GMS,4,60,45,15,1
08-02-2025,Snacks & Ready-to-Eat,DOSA BATTER 1KG,14,60,60,0,1
08-02-2025,Snacks & Ready-to-Eat,SD FINGER Millet with palm Jaggery 250gm,14,135,135,0,1
08-02-2025,Snacks & Ready-to-Eat,SD Little Millet WITH PLAM JAGGERY,14,135,135,0,1
08-02-2025,Household & Cleaning,SCOTCH BRITE,6,18,18,0,1
08-02-2025,"Grains, Flours & Dals",UDALU (Barnyard millet) 1 kg,4,140,115,25,1
08-02-2025,"Grains, Flours & Dals",Arikalu (kodo),4,70,65,5,1
08-02-2025,"Grains, Flours & Dals",JOWAR WHITE 1 KG,4,40,35,5,0.5
08-02-2025,"Grains, Flours & Dals",YB CHITTIMUTYALU RICE 1KG,4,200,200,0,1
08-02-2025,Snacks & Ready-to-Eat,VD DAHI MIRCHI(SALTED) 100GM,14,45,45,0,1
08-02-2025,Snacks & Ready-to-Eat,RSC ORANGE 100GMS,14,20,20,0,1
08-02-2025,Snacks & Ready-to-Eat,VD GUMMADI VADIYAM,14,75,75,0,1
08-02-2025,"Grains, Flours & Dals",SAMALU (Little millet) 500 gms,4,85,65,20,1
08-02-2025,"Grains, Flours & Dals",ANDU KORRALU (Brown top .mlt) 500,4,130,110,20,1
08-02-2025,"Grains, Flours & Dals",Wheat Flour 1 kg,4,350,300,50,5
08-02-2025,"Grains, Flours & Dals",HS jowar idly rava 500 gms,4,65,65,0,1
08-02-2025,Oils & Ghee,Groundnut oil 1 L,9,720,660,60,2
08-02-2025,"Dry Fruits, Nuts & Seeds",Groundnuts 1 kg,2,190,170,20,1
08-02-2025,"Grains, Flours & Dals",White jowar.F 1 kg,4,300,240,60,3
08-02-2025,Personal Care & Cosmetics,VETIVER BATH SCRUB,10,80,80,0,2
08-02-2025,"Dry Fruits, Nuts & Seeds",WALLNUTS 250GM,2,380,360,20,1
08-02-2025,"Dry Fruits, Nuts & Seeds",KAJU HALF 250GM,2,310,290,20,1
08-02-2025,Sweeteners,GS Organic Jaggery Powder 600GM,16,99,99,0,1
08-02-2025,Pooja & Spiritual Items,SREE REAL KASTURI STICKS 90GM,12,72,72,0,1
08-02-2025,Pooja & Spiritual Items,SOSR SWATHHI 365,12,60,60,0,2
08-02-2025,"Grains, Flours & Dals",SL Suji Rava 500GM,4,32,32,0,1
08-02-2025,"Grains, Flours & Dals",turdal 1kg,4,220,195,25,1
08-02-2025,"Grains, Flours & Dals",Wheat Flour 1 kg,4,70,60,10,1
08-02-2025,Personal Care & Cosmetics,MD Bath Powder 100GM,10,40,40,0,1
08-02-2025,"Grains, Flours & Dals",White jowar.F 1 kg,4,300,240,60,3
08-02-2025,Snacks & Ready-to-Eat,PEANUT CHIKKI 450GM,14,125,125,0,1
08-02-2025,"Grains, Flours & Dals",PRO SOYA CHUNKS 200G,4,79,79,0,1
08-02-2025,"Grains, Flours & Dals",Wheat Rava M 1KG,4,65,55,10,1
08-02-2025,"Grains, Flours & Dals",Wheat Rava M 500GM,4,66,60,6,2
08-02-2025,"Grains, Flours & Dals",Bajra Flour 1 kg,4,70,60,10,1
08-02-2025,"Grains, Flours & Dals",RAGI FLOUR 1KG,4,80,70,10,1
08-02-2025,Spices & Seasonings,ROYAL SAFFRON,15,125,125,0,1
08-02-2025,"Grains, Flours & Dals",Urad dall 1 Kg,4,185,170,15,1
08-02-2025,"Dry Fruits, Nuts & Seeds",Groundnuts 1 kg,2,190,170,20,1
08-02-2025,Snacks & Ready-to-Eat,PEANUT CHIKKI 450GM,14,125,125,0,1
08-02-2025,"Grains, Flours & Dals",VYS.SP RICE 1 KG,4,700,650,50,10
08-02-2025,Spices & Seasonings,Lavangam 50GM,15,60,50,10,1
08-02-2025,Sweeteners,ACHUBELLAM 500GM,16,50,40,10,1
08-02-2025,Snacks & Ready-to-Eat,SD FINGER Millet with palm Jaggery 250gm,14,135,135,0,1
08-02-2025,Snacks & Ready-to-Eat,VD RED CHILLI RICEPAPAD 150GM,14,50,50,0,1
08-02-2025,Snacks & Ready-to-Eat,VD GUMMADI VADIYAM,14,75,75,0,1
08-02-2025,Snacks & Ready-to-Eat,GB SALT COOKIES,14,60,55,5,1
08-02-2025,"Grains, Flours & Dals",Wheat Flour 1 kg,4,70,60,10,1
08-02-2025,"Grains, Flours & Dals",Wheat Flour 2 kgs,4,140,120,20,1
08-02-2025,Spices & Seasonings,Jeera 100GM,15,50,45,5,1
08-02-2025,Snacks & Ready-to-Eat,PALLI LADDU 200GMS,14,90,70,20,1
08-02-2025,"Dry Fruits, Nuts & Seeds",SALTED PISTA 250GM,2,400,350,50,1
08-02-2025,Snacks & Ready-to-Eat,BATANA NGT 70GMS,14,20,20,0,1
08-02-2025,Snacks & Ready-to-Eat,SD MASALA GAVVALU 200GM,14,95,95,0,1
08-02-2025,"Grains, Flours & Dals",RICE FLOUR 1KG,4,70,55,15,1
08-02-2025,Spices & Seasonings,Miriyalu 50GM,15,100,80,20,1
08-02-2025,Spices & Seasonings,SWEET SOUNF,15,20,20,0,1
08-02-2025,Snacks & Ready-to-Eat,RSC ORANGE 100GMS,14,20,20,0,1
08-02-2025,Spices & Seasonings,Menthulu 250 gms,15,50,45,5,1
08-02-2025,Snacks & Ready-to-Eat,SUNNUNDALU,14,120,120,0,1
08-02-2025,"Dry Fruits, Nuts & Seeds",Groundnuts 1 kg,2,190,170,20,1
08-02-2025,Sweeteners,GS Palm Jaggery Powder 400GM,16,360,360,0,2
08-02-2025,Sweeteners,YB JAGGERY POWDER 500GMS,16,75,75,0,1
08-02-2025,Pickles & Cooking Pastes,SD AMALA PICKLE,11,110,110,0,1
08-02-2025,"Grains, Flours & Dals",Multigrain 1 kg,4,100,85,15,1
08-02-2025,Spices & Seasonings,SREE MARUTHI IDLY KARAM 200GM,15,60,60,0,1
08-02-2025,"Grains, Flours & Dals",MAAGAANI SP RICE 20 KGS,4,2300,"1,960.00",340,1
08-02-2025,Sweeteners,YB JAGGERY POWDER 1KG,16,140,140,0,1
08-02-2025,Beverages,BRU GREEN LABEL 1.2G,1,94,94,0,47
08-02-2025,Spices & Seasonings,FLAXSEED KARAM,15,75,75,0,1
08-02-2025,Pickles & Cooking Pastes,SD GINGER PICKLE 250GM,11,110,110,0,1
08-02-2025,Snacks & Ready-to-Eat,RAJGIRA PEANUT CHIKKI,14,10,10,0,2
08-02-2025,Snacks & Ready-to-Eat,TILLI CHIKKI,14,10,10,0,2
08-02-2025,"Grains, Flours & Dals",AISHWARYA SP 1KG,4,240,210,30,3
08-02-2025,"Grains, Flours & Dals",AISHWARYA SP 1KG,4,1200,"1,050.00",150,15
08-02-2025,"Health, Wellness & Ayurvedic Products",AMLA PACHAK,5,100,100,0,1
08-02-2025,Snacks & Ready-to-Eat,SD FINGER Millet with palm Jaggery 250gm,14,135,135,0,1
08-02-2025,Snacks & Ready-to-Eat,BD BARELY NOODLES 200G,14,70,70,0,1
08-02-2025,Snacks & Ready-to-Eat,SD Vamu with palm jaggery 250gm,14,135,135,0,1
08-02-2025,"Grains, Flours & Dals",Wheat Flour 1 kg,4,70,60,10,1
08-02-2025,Pooja & Spiritual Items,BALAJI BEL PHOOL STICKS 90GM,12,60,60,0,1
08-02-2025,Oils & Ghee,Coconut oil 500 ml,9,660,600,60,3
08-02-2025,Oils & Ghee,Coconut oil 1 L,9,880,800,80,2
08-02-2025,Spices & Seasonings,SREE MARUTHI IDLY KARAM 200GM,15,60,60,0,1
08-02-2025,"Grains, Flours & Dals",MELMEKER 250GMS,4,60,45,15,1
08-02-2025,Sweeteners,YB Brown Sugar 500GM,16,75,75,0,1
08-02-2025,Spices & Seasonings,SWEET SOUNF,15,20,20,0,1
08-02-2025,Personal Care & Cosmetics,MADDI BATH POWDER 400GM,10,150,150,0,1
08-02-2025,Pooja & Spiritual Items,GD Sambrani Cup Dhoop 10 PC,12,96,96,0,1
08-02-2025,Snacks & Ready-to-Eat,FOXTAIL BIS,14,135,135,0,1
08-02-2025,Snacks & Ready-to-Eat,GB SALT COOKIES,14,120,110,10,2
08-02-2025,Oils & Ghee,Safflower oil 500 ml,9,220,200,20,1
08-02-2025,Snacks & Ready-to-Eat,ANNAPURNA APPALAM,14,35,35,0,1
08-02-2025,"Grains, Flours & Dals",SABDANA,4,40,35,5,1
08-02-2025,Snacks & Ready-to-Eat,VD GUMMADI VADIYAM,14,75,75,0,1
08-02-2025,"Dry Fruits, Nuts & Seeds",SATHVI CHIA SEEDS 100GM,2,100,80,20,1
08-02-2025,Sweeteners,YB JAGGERY POWDER 500GMS,16,75,75,0,1
08-02-2025,Spices & Seasonings,Jeera 100GM,15,50,45,5,1
08-02-2025,Sweeteners,NATURAL HONEY 250GM,16,150,130,20,1
08-02-2025,"Dry Fruits, Nuts & Seeds",Putnalu 250GM,2,45,38,7,1
08-02-2025,Snacks & Ready-to-Eat,PUMPKIN CHIKKI 200GM,14,140,120,20,1
08-02-2025,Sweeteners,MADHUR SUGAR 1KG,16,65,55,10,1
08-02-2025,Snacks & Ready-to-Eat,COPRA LADDU 200GM,14,100,80,20,1
08-02-2025,Oils & Ghee,Groundnut oil 1 L,9,360,330,30,1
08-02-2025,"Health, Wellness & Ayurvedic Products",MH Millets Malt 1KG,5,400,380,20,1
08-02-2025,"Grains, Flours & Dals",SATHVI BARELY SEEDS 500GMS,4,90,70,20,1
08-02-2025,Beverages,REFRESH SHARBATH SUGAR FREE,1,299,285,14,1
08-02-2025,"Grains, Flours & Dals",PESARA PAPPU 500GMS,4,85,75,10,1
08-02-2025,"Health, Wellness & Ayurvedic Products",MD Guduchi Choornam 100GM,5,110,110,0,1
08-02-2025,Spices & Seasonings,Elaichi 25GM,15,145,120,25,1
08-02-2025,Spices & Seasonings,Dalchin Chekka 50GM,15,50,40,10,1
08-02-2025,"Grains, Flours & Dals",turdal 1kg,4,220,195,25,1
08-02-2025,Beverages,3ROSES,1,90,90,0,1
08-02-2025,Snacks & Ready-to-Eat,VD BOONDI 175GM,14,60,60,0,1
08-02-2025,"Grains, Flours & Dals",DESI CHANA,4,25,25,0,1
08-02-2025,Snacks & Ready-to-Eat,JUNNU POWDER 100GM,14,70,70,0,1
08-02-2025,Snacks & Ready-to-Eat,SALTED PHALLI,14,25,25,0,1
08-02-2025,"Grains, Flours & Dals",Wheat Rava M 1KG,4,130,110,20,2
08-02-2025,"Grains, Flours & Dals",SL Idly Rava 1KG,4,260,220,40,4
08-02-2025,"Dry Fruits, Nuts & Seeds",FLAX SEEDS 250GM,2,240,200,40,4
08-02-2025,"Grains, Flours & Dals",turdal 1kg,4,220,195,25,1
08-02-2025,"Grains, Flours & Dals",SAMALU (Little millet) 1 kg,4,340,260,80,2
08-02-2025,"Grains, Flours & Dals",KORRALU (FOXTAIL M) 1KG,4,300,220,80,2
08-02-2025,"Grains, Flours & Dals",CHANA DAL 500GM,4,70,60,10,1
08-02-2025,Spices & Seasonings,TATA SALT 1KG,15,60,60,0,2
08-02-2025,"Grains, Flours & Dals",split black gram 1 kg,4,180,170,10,1
08-02-2025,"Grains, Flours & Dals",Urad dall 1 Kg,4,370,340,30,2
08-02-2025,Spices & Seasonings,Tamarind 500GM,15,160,130,30,1
08-02-2025,Household & Cleaning,VIM SOAP,6,100,100,0,20
08-02-2025,"Grains, Flours & Dals",RAGI FLOUR 500GRMS,4,80,70,10,2
08-02-2025,"Grains, Flours & Dals",Arikadu ( kodo),4,280,260,20,2
08-02-2025,"Grains, Flours & Dals",Multigrain 1 kg,4,200,170,30,2
08-02-2025,Spices & Seasonings,Avalu small 250 gms,15,120,80,40,2
08-02-2025,"Grains, Flours & Dals",Wheat Flour 1 kg,4,70,60,10,1
08-02-2025,Oils & Ghee,Sesame oil 1 L,9,590,560,30,1
08-02-2025,Beverages,GANTASALA TEJ DRY GINGER COFFEE,1,149,149,0,1
08-02-2025,Oils & Ghee,Groundnut oil 5 L,9,1800,"1,600.00",200,1
08-02-2025,Spices & Seasonings,Turmeric powder 250 gms,15,100,75,25,1
08-02-2025,"Grains, Flours & Dals",Idly Rava L 1KG,4,60,50,10,1
08-02-2025,"Grains, Flours & Dals",FLOUR CHARGE,4,28.8,28.8,0,2.4
08-02-2025,"Grains, Flours & Dals",Wheat Flour 1 kg,4,70,60,10,1
08-02-2025,Snacks & Ready-to-Eat,RAJGIRA PEANUT CHIKKI,14,5,5,0,1
08-02-2025,"Grains, Flours & Dals",UDALU (Barnyard millet) 500 gms,4,70,60,10,1
08-02-2025,Oils & Ghee,Groundnut oil 1 L,9,360,330,30,1
08-02-2025,Spices & Seasonings,ROYAL SAFFRON,15,125,125,0,1
08-02-2025,Spices & Seasonings,ROYAL SAFFRON 400GRMS,15,130,130,0,2
08-02-2025,Oils & Ghee,Coconut oil 1 L,9,440,400,40,1
08-02-2025,"Grains, Flours & Dals",Multigrain 1 kg,4,200,170,30,2
08-02-2025,Milk & Dairy,SANGAM CURD 450GM,7,38,38,0,1
08-02-2025,Oils & Ghee,Groundnut oil 1 L,9,360,330,30,1
08-02-2025,Snacks & Ready-to-Eat,VD Pappu Chekkalu 190gm,14,60,60,0,1
08-02-2025,Snacks & Ready-to-Eat,SATHVI PALLI CHIKKI 200GM,14,100,80,20,1
08-02-2025,"Grains, Flours & Dals",White jowar.F 1 kg,4,100,80,20,1
08-02-2025,"Grains, Flours & Dals",Red Wheat Flour 1 kg,4,140,130,10,1
08-02-2025,Snacks & Ready-to-Eat,PUMPKIN CHIKKI 200GM,14,140,120,20,1
08-02-2025,Baking & Cooking Aids,GONDH 50GRMS,0,40,40,0,1
08-02-2025,Oils & Ghee,Groundnut oil 1 L,9,720,660,60,2
08-02-2025,Snacks & Ready-to-Eat,Popcorn Seeds 500GM,14,90,80,10,1
08-02-2025,Snacks & Ready-to-Eat,MAAGAANI M JOWAR PASTA 200GM,14,199,199,0,1
08-02-2025,"Dry Fruits, Nuts & Seeds",YB GRANMA NUTS,2,90,90,0,1
08-02-2025,"Dry Fruits, Nuts & Seeds",FLAX SEEDS 250GM,2,60,50,10,1
08-02-2025,"Dry Fruits, Nuts & Seeds",PUMPKIN SEEDS 250GM,2,200,160,40,1
08-02-2025,"Grains, Flours & Dals",Yellow jowar .F1 kg,4,220,200,20,2
08-02-2025,Snacks & Ready-to-Eat,Popcorn Seeds 250GM,14,90,80,10,2
08-02-2025,"Grains, Flours & Dals",Brown RICE 1KG,4,140,130,10,2
08-02-2025,"Dry Fruits, Nuts & Seeds",SATHVI CHIA SEEDS 100GM,2,100,80,20,1
08-02-2025,"Dry Fruits, Nuts & Seeds",SABJA SEEDS 100GM,2,80,70,10,1
08-02-2025,Baking & Cooking Aids,GONDH 50GRMS,0,40,40,0,1
08-02-2025,"Dry Fruits, Nuts & Seeds",SUNFLOWER SEEDS 250GRM,2,150,130,20,1
08-02-2025,Oils & Ghee,Groundnut oil 1 L,9,360,330,30,1
08-02-2025,Personal Care & Cosmetics,ORAL B KIDS,10,25,25,0,1
08-02-2025,Personal Care & Cosmetics,Khadi Red Onion Shampoo 200ML,10,199,199,0,1
08-02-2025,Personal Care & Cosmetics,KHADI MIX FRUIT SOAP 125GM,10,80,80,0,1
08-02-2025,Snacks & Ready-to-Eat,PUMPKIN CHIKKI 200GM,14,140,120,20,1
08-02-2025,Snacks & Ready-to-Eat,VD MURUKU 175GM,14,60,60,0,1
08-02-2025,Snacks & Ready-to-Eat,SALTED PHALLI,14,25,25,0,1
08-02-2025,Snacks & Ready-to-Eat,BATANA NGT 70GMS,14,40,40,0,2
08-02-2025,Oils & Ghee,Groundnut oil 1 L,9,360,330,30,1
08-02-2025,Oils & Ghee,Sesame oil 1 L,9,590,560,30,1
08-02-2025,Snacks & Ready-to-Eat,SATHVI PALLI CHIKKI 200GM,14,200,160,40,2
08-02-2025,Snacks & Ready-to-Eat,SATHVI PALLI CHIKKI 200GM,14,100,80,20,1
08-02-2025,"Grains, Flours & Dals",White jowar.F 1 kg,4,100,80,20,1
08-02-2025,Snacks & Ready-to-Eat,GB SALT COOKIES,14,60,55,5,1
08-02-2025,Oils & Ghee,A2 BUFFALO GHEE 250ML,9,299,299,0,1
08-02-2025,Oils & Ghee,Groundnut oil 500ml,9,180,165,15,1
08-02-2025,Pickles & Cooking Pastes,SD MANGO TOKKU,11,110,110,0,1
08-02-2025,Sweeteners,NATURAL HONEY 250GM,16,150,130,20,1
08-02-2025,"Grains, Flours & Dals",RAGI FLOUR 500GRMS,4,40,35,5,1
08-02-2025,Oils & Ghee,BUFFALLO GHEE 500ML,9,410,370,40,1
08-02-2025,Oils & Ghee,GROUNDNUT OIL 1KG,9,700,700,0,2
08-02-2025,Sweeteners,ACHU BELLAM 1KG,16,100,80,20,1
08-02-2025,Snacks & Ready-to-Eat,COPRA LADDU 200GM,14,100,80,20,1
08-02-2025,Personal Care & Cosmetics,UVIS ALOEVERA GEL,10,149,149,0,1
08-02-2025,Snacks & Ready-to-Eat,GROUNDNUT LADDU WITH DATES,14,135,135,0,1
08-02-2025,"Dry Fruits, Nuts & Seeds",Groundnuts 1 kg,2,190,170,20,1
08-02-2025,"Grains, Flours & Dals",RAJMA 250GM,4,55,45,10,1
08-02-2025,"Grains, Flours & Dals",White Chana 250 GM,4,60,50,10,1
08-02-2025,Sweeteners,GS Organic Jaggery Powder 600GM,16,99,99,0,1
08-02-2025,Snacks & Ready-to-Eat,VD MINAPA MIRCHI PAPAD 195GM,14,60,60,0,1
08-02-2025,Spices & Seasonings,Masala Karam 250 gms,15,130,120,10,1
08-02-2025,Snacks & Ready-to-Eat,VD DAHI MIRCHI(SALTED) 100GM,14,45,45,0,1
08-02-2025,"Health, Wellness & Ayurvedic Products",MH Millets Malt 500GM,5,200,190,10,1
08-02-2025,Spices & Seasonings,SWASTIKS GINGER&amp;GARLIC,15,49,49,0,1
08-02-2025,Beverages,ASSAM MASALA TEA,1,199,199,0,1
08-02-2025,Personal Care & Cosmetics,HERBAL BATH POWDER 200GM,10,80,80,0,1
08-02-2025,Spices & Seasonings,kasturi methi,15,60,60,0,1
08-02-2025,Oils & Ghee,Groundnut oil 5 L,9,1800,"1,600.00",200,1
08-02-2025,Oils & Ghee,Sesame oil 500ml,9,295,280,15,1
08-02-2025,Spices & Seasonings,TATA SALT 1KG,15,60,60,0,2
08-02-2025,"Grains, Flours & Dals",Wheat Flour 1 kg,4,210,180,30,3
08-02-2025,Oils & Ghee,Groundnut oil 1 L,9,360,330,30,1
08-02-2025,Pickles & Cooking Pastes,SD MANGO PICKLE,11,110,110,0,1
08-02-2025,"Grains, Flours & Dals",SB Javva Wheat Ravva 500GM,4,95,95,0,1
08-02-2025,"Grains, Flours & Dals",CHANA DAL 1KG,4,35,30,5,0.25
08-02-2025,"Grains, Flours & Dals",SL Idly Rava 1KG,4,65,55,10,1
08-02-2025,"Grains, Flours & Dals",DH URAD GOTA 1KG,4,215,190,25,1
08-02-2025,Household & Cleaning,SURF EXCEL 150GM,6,20,20,0,1
08-02-2025,Snacks & Ready-to-Eat,GROUNDNUT LADDU WITH DATES,14,135,135,0,1
08-02-2025,Snacks & Ready-to-Eat,ANNAPURNA APPALAM,14,35,35,0,1
08-02-2025,Oils & Ghee,Groundnut oil 1 L,9,360,330,30,1
07-02-2025,"Grains, Flours & Dals",MAAGAANI LOW GI SP 1KG,4,105,105,0,1
07-02-2025,"Grains, Flours & Dals",RAGI FLOUR 500GRMS,4,80,70,10,2
07-02-2025,Oils & Ghee,Sesame oil 1 L,9,590,560,30,1
07-02-2025,Snacks & Ready-to-Eat,SD Flax seeds with dates 250gm,14,270,270,0,2
07-02-2025,Oils & Ghee,Groundnut oil 1 L,9,360,330,30,1
07-02-2025,"Health, Wellness & Ayurvedic Products",MH Womens Malt 500GM,5,250,240,10,1
07-02-2025,"Grains, Flours & Dals",turdal 1kg,4,220,195,25,1
07-02-2025,"Dry Fruits, Nuts & Seeds",SABJA SEEDS 100GM,2,80,70,10,1
07-02-2025,"Dry Fruits, Nuts & Seeds",SATHVI CHIA SEEDS 100GM,2,100,80,20,1
07-02-2025,"Grains, Flours & Dals",Red Wheat Flour 1 kg,4,140,130,10,1
07-02-2025,"Grains, Flours & Dals",VGR rice 1 kg,4,350,325,25,5
07-02-2025,Sweeteners,YB JAGGERY POWDER 1KG,16,140,140,0,1
07-02-2025,"Grains, Flours & Dals",CHANA DAL 500GM,4,70,60,10,1
07-02-2025,"Dry Fruits, Nuts & Seeds",PULMAKHANA 100 GM,2,180,170,10,1
07-02-2025,Spices & Seasonings,Tamarind 500GM,15,160,130,30,1
07-02-2025,Personal Care & Cosmetics,DETTOL 50ML,10,154,154,0,1
07-02-2025,Personal Care & Cosmetics,DWIBHASHI GULABA ARKA ROSA WATER,10,60,60,0,1
07-02-2025,"Grains, Flours & Dals",VGR rice 1 kg,4,140,130,10,2
07-02-2025,Oils & Ghee,Groundnut oil 5 L,9,1800,"1,600.00",200,1
07-02-2025,Oils & Ghee,Coconut oil 500 ml,9,220,200,20,1
07-02-2025,"Health, Wellness & Ayurvedic Products",RB Max Protein Oats &Raisins 55gm,5,100,100,0,2
07-02-2025,Snacks & Ready-to-Eat,COPRA LADDU 200GM,14,100,80,20,1
07-02-2025,"Dry Fruits, Nuts & Seeds",ALMONDS 250GM,2,280,260,20,1
07-02-2025,"Grains, Flours & Dals",Red Chana 250GM,4,70,60,10,2
07-02-2025,Sweeteners,YB JAGGERY POWDER 500GMS,16,75,75,0,1
07-02-2025,Spices & Seasonings,Masala Karam 500 gms,15,260,240,20,1
07-02-2025,"Grains, Flours & Dals",Multigrain 1 kg,4,100,85,15,1
07-02-2025,"Dry Fruits, Nuts & Seeds",Putnalu 250GM,2,45,38,7,1
07-02-2025,"Health, Wellness & Ayurvedic Products",YB APPLE CIDER VINEGAR500ML,5,500,500,0,1
07-02-2025,"Grains, Flours & Dals",RAJMA 250GM,4,55,45,10,1
07-02-2025,Snacks & Ready-to-Eat,ZEEDI,14,70,70,0,1
07-02-2025,"Grains, Flours & Dals",DISANO ROLED OATS,4,395,197.5,197.5,1
07-02-2025,Spices & Seasonings,Turmeric powder 250 gms,15,100,75,25,1
07-02-2025,"Grains, Flours & Dals",VGR rice 1 kg,4,210,195,15,3
07-02-2025,"Dry Fruits, Nuts & Seeds",SD Mango cubes 200gm,2,90,90,0,1
07-02-2025,Spices & Seasonings,Telaga Pindi 250 GM,15,40,35,5,1
07-02-2025,"Grains, Flours & Dals",Wheat Flour 1 kg,4,70,60,10,1
07-02-2025,Sweeteners,YB JAGGERY POWDER 500GMS,16,75,75,0,1
07-02-2025,"Grains, Flours & Dals",EM Ragi idli R 500G,4,75,75,0,1
07-02-2025,"Grains, Flours & Dals",JOWAR WHITE 1 KG,4,80,70,10,1
07-02-2025,Spices & Seasonings,Turmeric powder 250 gms,15,100,75,25,1
07-02-2025,Snacks & Ready-to-Eat,DOSA BATTER 1KG,14,60,60,0,1
07-02-2025,Oils & Ghee,Groundnut oil 1 L,9,720,660,60,2
07-02-2025,Oils & Ghee,A2 BUFFALO GHEE 250ML,9,299,299,0,1
07-02-2025,Snacks & Ready-to-Eat,Pani Poori Chips 250GM,14,50,40,10,1
07-02-2025,Oils & Ghee,BUFFALLO GHEE 500ML,9,1230,"1,110.00",120,3
07-02-2025,Sweeteners,YB JAGGERY POWDER 1KG,16,140,140,0,1
07-02-2025,Sweeteners,GS A2 Buffalo Ghee 500ML,16,1100,"1,100.00",0,2
07-02-2025,Sweeteners,YB Brown Sugar 500GM,16,75,75,0,1
07-02-2025,Sweeteners,YB JAGGERY POWDER 500GMS,16,150,150,0,2
07-02-2025,Oils & Ghee,Coconut oil 1 L,9,440,400,40,1
07-02-2025,Oils & Ghee,Castor oil 200 ml,9,100,80,20,1
07-02-2025,Snacks & Ready-to-Eat,SD Aswagandha with palm Jaggery250Gm,14,135,135,0,1
07-02-2025,"Dry Fruits, Nuts & Seeds",YELLOW KISHMISH 250GM,2,130,110,20,1
07-02-2025,Spices & Seasonings,Gasagasalu 50GM,15,130,110,20,1
07-02-2025,Oils & Ghee,Coconut oil 500 ml,9,220,200,20,1
07-02-2025,Oils & Ghee,GANTASALA A2 COW GHEE 250ML,9,299,299,0,1
07-02-2025,Oils & Ghee,Groundnut oil 1 L,9,720,660,60,2
07-02-2025,Oils & Ghee,Freedom Rice Bran Oil 1L,9,194,180,14,1
07-02-2025,Sweeteners,KAMAL JAGGERY 500GM,16,40,40,0,1
07-02-2025,"Grains, Flours & Dals",turdal 1kg,4,220,195,25,1
07-02-2025,"Dry Fruits, Nuts & Seeds",YB GRANMA NUTS,2,90,90,0,1
07-02-2025,"Grains, Flours & Dals",RAJMA 250GM,4,55,45,10,1
07-02-2025,Snacks & Ready-to-Eat,SD Ginger Candy 100g,14,60,60,0,1
07-02-2025,Spices & Seasonings,Turmeric powder 250 gms,15,100,75,25,1
07-02-2025,"Dry Fruits, Nuts & Seeds",Groundnuts 500 gms,2,95,85,10,1
07-02-2025,"Grains, Flours & Dals",Urad dall 1 Kg,4,185,170,15,1
07-02-2025,"Grains, Flours & Dals",split black gram 1 kg,4,180,170,10,1
07-02-2025,"Grains, Flours & Dals",PESARA PAPPU 500GMS,4,85,75,10,1
07-02-2025,"Grains, Flours & Dals",RAGI FLOUR 500GRMS,4,40,35,5,1
07-02-2025,Spices & Seasonings,Chilli powder 500 gms,15,290,210,80,1
07-02-2025,"Dry Fruits, Nuts & Seeds",PUMPKIN SEEDS 250GM,2,200,160,40,1
07-02-2025,Spices & Seasonings,Turmeric powder 250 gms,15,100,75,25,1
07-02-2025,"Grains, Flours & Dals",White jowar.F 1 kg,4,100,80,20,1
07-02-2025,Spices & Seasonings,SWEET SOUNF,15,20,20,0,1
07-02-2025,"Grains, Flours & Dals",FLOUR CHARGE,4,60,60,0,5
07-02-2025,"Grains, Flours & Dals",Wheat Flour 5 kgs,4,350,300,50,1
07-02-2025,"Grains, Flours & Dals",White jowar.F 1 kg,4,100,80,20,1
07-02-2025,"Grains, Flours & Dals",Green gram 1 kg,4,150,130,20,1
07-02-2025,"Grains, Flours & Dals",CORN FLOUR,4,80,70,10,1
07-02-2025,"Grains, Flours & Dals",Yellow jowar .F1 kg,4,110,100,10,1
07-02-2025,"Grains, Flours & Dals",BARLEY FLOUR 250GM,4,45,40,5,1
07-02-2025,"Grains, Flours & Dals",Idly Rava L 1KG,4,60,50,10,1
07-02-2025,"Dry Fruits, Nuts & Seeds",CASHEW 250GM,2,340,310,30,1
07-02-2025,Oils & Ghee,Sesame oil 1 L,9,590,560,30,1
07-02-2025,"Dry Fruits, Nuts & Seeds",ANJEER 250GM,2,400,360,40,1
07-02-2025,Pooja & Spiritual Items,BANDA PUVVU 25GM 25GM,12,80,60,20,1
07-02-2025,"Grains, Flours & Dals",KORRALU (FOXTAIL M) 1KG,4,300,220,80,2
07-02-2025,Snacks & Ready-to-Eat,urban murmura,14,60,55,5,1
07-02-2025,"Grains, Flours & Dals",Chana Flour 1 kg,4,140,130,10,1
07-02-2025,"Grains, Flours & Dals",RICE FLOUR 1KG,4,70,55,15,1
07-02-2025,Snacks & Ready-to-Eat,COPRA LADDU 200GM,14,100,80,20,1
07-02-2025,Snacks & Ready-to-Eat,BATANA NGT 70GMS,14,20,20,0,1
07-02-2025,Snacks & Ready-to-Eat,BELAM MENIPA SUNADULLU,14,180,180,0,1
07-02-2025,"Grains, Flours & Dals",Yellow jowar .F1 kg,4,110,100,10,1
07-02-2025,"Dry Fruits, Nuts & Seeds",Groundnuts 1 kg,2,190,170,20,1
07-02-2025,"Dry Fruits, Nuts & Seeds",YELLOW KISHMISH 250GM,2,130,110,20,1
07-02-2025,"Grains, Flours & Dals",DESI CHANA,4,50,50,0,2
07-02-2025,Snacks & Ready-to-Eat,KURNOOL MARMURA,14,70,55,15,1
07-02-2025,"Grains, Flours & Dals",Green gram 1 kg,4,150,130,20,1
07-02-2025,"Dry Fruits, Nuts & Seeds",DRIED KIWI 200GM,2,145,130,15,1
07-02-2025,"Grains, Flours & Dals",RAGI FLOUR 500GRMS,4,80,70,10,2
07-02-2025,Snacks & Ready-to-Eat,PALLI LADDU 200GMS,14,180,140,40,2
07-02-2025,"Health, Wellness & Ayurvedic Products",MD Aamlaki Choornam 100GM,5,80,80,0,1
07-02-2025,"Dry Fruits, Nuts & Seeds",SATHVI CHIA SEEDS 100GM,2,200,160,40,2
07-02-2025,"Grains, Flours & Dals",Multigrain 1 kg,4,100,85,15,1
07-02-2025,"Grains, Flours & Dals",THICK POHA 500GM,4,40,35,5,1
07-02-2025,"Grains, Flours & Dals",VL Sabdana 500GM,4,77,77,0,1
07-02-2025,Snacks & Ready-to-Eat,ELITE ELAICHI RUSK 200GM,14,35,35,0,1
07-02-2025,"Dry Fruits, Nuts & Seeds",SUNFLOWER SEEDS 250GRM,2,150,130,20,1
07-02-2025,"Grains, Flours & Dals",HS jowar idly rava 500 gms,4,65,65,0,1
07-02-2025,"Dry Fruits, Nuts & Seeds",SABJA SEEDS 100GM,2,160,140,20,2
07-02-2025,Spices & Seasonings,NUVVULU 500GM,15,200,170,30,1
07-02-2025,Pooja & Spiritual Items,GD Aiswarya Deepam 700ML,12,390,390,0,2
07-02-2025,"Grains, Flours & Dals",RAGI FLOUR 1KG,4,160,140,20,2
07-02-2025,"Dry Fruits, Nuts & Seeds",WATERMELON SEEDS 250GRM,2,320,280,40,1
07-02-2025,"Grains, Flours & Dals",Em Little idli R 500g,4,258,258,0,2
07-02-2025,"Grains, Flours & Dals",KORRALU (FOXTAIL M) 1KG,4,600,440,160,4
07-02-2025,"Grains, Flours & Dals",UDALU (Barnyard millet) 1 kg,4,280,230,50,2
07-02-2025,"Grains, Flours & Dals",Wheat Rava M 1KG,4,65,55,10,1
07-02-2025,"Grains, Flours & Dals",Bajra Flour 1 kg,4,70,60,10,1
07-02-2025,"Grains, Flours & Dals",DISANO OATS 1KG,4,285,285,0,1
07-02-2025,"Grains, Flours & Dals",SA Multi Grain Mix 500GM,4,318,318,0,2
07-02-2025,Spices & Seasonings,AV Iodized Salt 1KG,15,28,25,3,1
07-02-2025,"Dry Fruits, Nuts & Seeds",PUMPKIN SEEDS 250GM,2,200,160,40,1
07-02-2025,"Dry Fruits, Nuts & Seeds",ALMONDS 250GM,2,280,260,20,1
07-02-2025,Snacks & Ready-to-Eat,MB FOXTAIL MILLET NOODLES 180GM,14,95,95,0,1
07-02-2025,"Grains, Flours & Dals",SAMALU (Little millet) 1 kg,4,340,260,80,2
07-02-2025,"Dry Fruits, Nuts & Seeds",FLAX SEEDS 250GM,2,60,50,10,1
07-02-2025,Personal Care & Cosmetics,ROUND LOOFAH,10,60,60,0,1
07-02-2025,Spices & Seasonings,Telaga Pindi 500GM,15,80,70,10,1
07-02-2025,Snacks & Ready-to-Eat,SF NOODLES CLKASSIC MASALA,14,129,129,0,1
07-02-2025,"Grains, Flours & Dals",Brown RICE 1KG,4,350,325,25,5
07-02-2025,"Grains, Flours & Dals",BARLEY FLOUR 250GM,4,45,40,5,1
07-02-2025,"Grains, Flours & Dals",EM Foxtail idli r 500 g,4,218,218,0,2
07-02-2025,Snacks & Ready-to-Eat,RSC ORANGE 100GMS,14,40,40,0,2
07-02-2025,"Dry Fruits, Nuts & Seeds",PUTNALU 500GMS,2,180,152,28,2
07-02-2025,Snacks & Ready-to-Eat,BB VERMICELLI 1KG,14,95,90,5,1
07-02-2025,Oils & Ghee,Sesame oil 500ml,9,295,280,15,1
07-02-2025,Snacks & Ready-to-Eat,SD Bajra with palm Jaggery 250gm,14,135,135,0,1
07-02-2025,Snacks & Ready-to-Eat,MB SORGHUM NOODLES 180GM,14,95,95,0,1
07-02-2025,Snacks & Ready-to-Eat,TILLI CHIKKI,14,10,10,0,2
07-02-2025,"Health, Wellness & Ayurvedic Products",RB Max Protein Cheese&amp;,5,45,45,0,1
07-02-2025,Milk & Dairy,HRITAGE TOTAL CURD 130GM,7,20,20,0,2
07-02-2025,Spices & Seasonings,SREE MARUTHI IDLY KARAM 200GM,15,60,60,0,1
07-02-2025,"Grains, Flours & Dals",FLOUR CHARGE,4,48,48,0,4
07-02-2025,Snacks & Ready-to-Eat,SD MASALA GAVVALU 200GM,14,95,95,0,1
07-02-2025,Household & Cleaning,TIDE DOUBLE POWER LEMON &amp;MINT,6,146,146,0,1
07-02-2025,"Grains, Flours & Dals",WHEAT 1 KG,4,120,100,20,2
07-02-2025,Personal Care & Cosmetics,MD Bath Powder 100GM,10,40,40,0,1
07-02-2025,"Grains, Flours & Dals",FLOUR CHARGE,4,24,24,0,2
07-02-2025,"Grains, Flours & Dals",Wheat Flour 5 kgs,4,350,300,50,1
07-02-2025,Spices & Seasonings,Turmeric powder 250 gms,15,100,75,25,1
07-02-2025,Spices & Seasonings,Tamarind 500GM,15,160,130,30,1
07-02-2025,Sweeteners,YB JAGGERY POWDER 1KG,16,140,140,0,1
07-02-2025,"Dry Fruits, Nuts & Seeds",PUMPKIN SEEDS 250GM,2,200,160,40,1
07-02-2025,"Dry Fruits, Nuts & Seeds",ALMONDS 250GM,2,280,260,20,1
07-02-2025,"Grains, Flours & Dals",SH RED POHA 500GM,4,75,75,0,1
07-02-2025,Snacks & Ready-to-Eat,SATHVI REGIVADA 200GM,14,80,60,20,1
07-02-2025,Sweeteners,YB JAGGERY POWDER 500GMS,16,75,75,0,1
07-02-2025,"Health, Wellness & Ayurvedic Products",SHIKAKAI CHOORNAM,5,90,90,0,1
07-02-2025,"Dry Fruits, Nuts & Seeds",SATHVI CHIA SEEDS 100GM,2,100,80,20,1
07-02-2025,Pooja & Spiritual Items,GD Aiswarya Deepam 700ML,12,195,195,0,1
07-02-2025,"Dry Fruits, Nuts & Seeds",FLAX SEEDS 250GM,2,60,50,10,1
07-02-2025,Oils & Ghee,Black Sesame oil 500 ml,9,220,190,30,1
07-02-2025,"Dry Fruits, Nuts & Seeds",SD Mango cubes 200gm,2,90,90,0,1
07-02-2025,Milk & Dairy,SANGAM CURD 450GM,7,38,38,0,1
07-02-2025,"Grains, Flours & Dals",SINGHAM 26KG BAG,4,1650,"1,650.00",0,1
07-02-2025,Snacks & Ready-to-Eat,VD MAIDA CHEGODI 175GM,14,60,60,0,1
07-02-2025,"Grains, Flours & Dals",White jowar.F 1 kg,4,100,80,20,1
07-02-2025,Snacks & Ready-to-Eat,MIX MILLET NOODLES,14,75,75,0,1
07-02-2025,"Dry Fruits, Nuts & Seeds",PLAIN PISTA 250GM,2,660,550,110,1
07-02-2025,"Grains, Flours & Dals",Multigrain 1 kg,4,100,85,15,1
07-02-2025,Oils & Ghee,GANTASALA A2 COW GHEE 250ML,9,299,299,0,1
07-02-2025,"Grains, Flours & Dals",PRO ORG TUR DAL UNPOLISHED 500GM,4,176,176,0,1
07-02-2025,Oils & Ghee,Coconut oil 500 ml,9,220,200,20,1
07-02-2025,Snacks & Ready-to-Eat,PALLI LADDU 200GMS,14,90,70,20,1
07-02-2025,Snacks & Ready-to-Eat,VD RED CHILLI RICEPAPAD 150GM,14,50,50,0,1
07-02-2025,"Dry Fruits, Nuts & Seeds",ALMONDS 250GM,2,280,260,20,1
07-02-2025,"Grains, Flours & Dals",PRO ORG KABULI CHANNA 500GM,4,196,196,0,1
07-02-2025,Oils & Ghee,Groundnut oil 1 L,9,720,660,60,2
07-02-2025,"Dry Fruits, Nuts & Seeds",PUMPKIN SEEDS 250GM,2,200,160,40,1
07-02-2025,"Dry Fruits, Nuts & Seeds",Groundnuts 500 gms,2,95,85,10,1
07-02-2025,"Dry Fruits, Nuts & Seeds",Putnalu 250GM,2,45,38,7,1
07-02-2025,"Grains, Flours & Dals",VGR rice 1 kg,4,280,260,20,4
07-02-2025,Snacks & Ready-to-Eat,TILLI CHIKKI,14,5,5,0,1
07-02-2025,Spices & Seasonings,JEERA 250 gms,15,125,105,20,1
07-02-2025,"Grains, Flours & Dals",White Chana 250 GM,4,60,50,10,1
07-02-2025,Personal Care & Cosmetics,Soapnut 250GM,10,45,45,0,1
07-02-2025,"Health, Wellness & Ayurvedic Products",SHIKAKAI CHOORNAM,5,90,90,0,1
07-02-2025,"Grains, Flours & Dals",RAGI FLOUR 500GRMS,4,40,35,5,1
07-02-2025,"Grains, Flours & Dals",JOWAR WHITE 1 KG,4,80,70,10,1
07-02-2025,"Grains, Flours & Dals",FLOUR CHARGE,4,30,30,0,2.5
07-02-2025,"Grains, Flours & Dals",JOWAR YELLOW 1 K,4,50,45,5,0.5
07-02-2025,Sweeteners,YB Brown Sugar 1KG,16,140,140,0,1
07-02-2025,"Grains, Flours & Dals",RED WHEAT 1 KG,4,260,240,20,2
07-02-2025,Oils & Ghee,GANTASALA A2 COW GHEE 250ML,9,299,299,0,1
07-02-2025,"Grains, Flours & Dals",Wheat Flour 2 kgs,4,140,120,20,1
07-02-2025,"Health, Wellness & Ayurvedic Products",RB Max Protein PERI PERI 60gm,5,90,90,0,2
07-02-2025,"Grains, Flours & Dals",Urad dall 1 Kg,4,185,170,15,1
07-02-2025,"Grains, Flours & Dals",Green gram 1 kg,4,150,130,20,1
07-02-2025,Oils & Ghee,Groundnut oil 1 L,9,360,330,30,1
07-02-2025,"Grains, Flours & Dals",SINGHAM 26KG BAG,4,3300,"3,300.00",0,2
07-02-2025,"Health, Wellness & Ayurvedic Products",JAMBU SEED CHOORNAM 100GM,5,400,400,0,5
07-02-2025,Spices & Seasonings,JEERA 250 gms,15,125,105,20,1
07-02-2025,"Grains, Flours & Dals",Wheat Flour 1 kg,4,140,120,20,2
07-02-2025,Household & Cleaning,VIM 300GM,6,90,90,0,3
07-02-2025,Household & Cleaning,VIM MAHA BAR,6,20,20,0,2
07-02-2025,"Grains, Flours & Dals",HS Multimillet idly R 500 gms,4,195,195,0,3
07-02-2025,Personal Care & Cosmetics,GOHNSON BABY HAIR OIL 100,10,105,105,0,1
07-02-2025,"Grains, Flours & Dals",FLOUR CHARGE,4,74.4,74.4,0,6.2
07-02-2025,Personal Care & Cosmetics,MADDI BATH POWDER 400GM,10,150,150,0,1
07-02-2025,Milk & Dairy,SANGAM TONED MILK 500ML,7,60,60,0,2
07-02-2025,"Grains, Flours & Dals",THICK POHA 500GM,4,40,35,5,1
07-02-2025,Milk & Dairy,SANGAM CURD 450GM,7,38,38,0,1
07-02-2025,Pickles & Cooking Pastes,SD BEETROOT PICKLE,11,110,110,0,1
07-02-2025,Oils & Ghee,Groundnut oil 500ml,9,180,165,15,1
07-02-2025,Oils & Ghee,Castor oil 200 ml,9,100,80,20,1
07-02-2025,Oils & Ghee,OLIVANA 100ML,9,179,169,10,1
07-02-2025,"Grains, Flours & Dals",MELMEKER 250GMS,4,60,45,15,1
07-02-2025,Snacks & Ready-to-Eat,VD MINAPA VADIYAM,14,65,65,0,1
07-02-2025,"Grains, Flours & Dals",Idly Rava L 1KG,4,120,100,20,2
07-02-2025,Spices & Seasonings,AVALU 100GM,15,25,20,5,1
07-02-2025,Beverages,BRU GREEN LABEL 1.2G,1,40,40,0,20
07-02-2025,Spices & Seasonings,Turmeric powder 250 gms,15,100,75,25,1
07-02-2025,Spices & Seasonings,Menthulu 250 gms,15,50,45,5,1
07-02-2025,Pooja & Spiritual Items,GD TULASI 75GM,12,60,60,0,1
07-02-2025,"Grains, Flours & Dals",White jowar.F 1 kg,4,100,80,20,1
07-02-2025,"Dry Fruits, Nuts & Seeds",SABJA SEEDS 100GM,2,80,70,10,1
07-02-2025,Spices & Seasonings,Marati Magga 50GM,15,130,110,20,1
07-02-2025,"Grains, Flours & Dals",Wheat Flour 1 kg,4,280,240,40,4
07-02-2025,Oils & Ghee,Coconut oil 500 ml,9,220,200,20,1
07-02-2025,Spices & Seasonings,Jeera 100GM,15,50,45,5,1
07-02-2025,Pooja & Spiritual Items,SIVA JOOTHI 365 DEEPAPU,12,25,25,0,1
07-02-2025,Sweeteners,Natural Honey 500 gms,16,280,240,40,1
07-02-2025,Snacks & Ready-to-Eat,ZEEDI,14,70,70,0,1
07-02-2025,Sweeteners,MADHUR SUGAR 1KG,16,65,55,10,1
07-02-2025,Beverages,MARWADI CHAI 100GM,1,75,75,0,1
07-02-2025,"Grains, Flours & Dals",BARLEY SEEDS 1KG,4,8,7,1,0.05
07-02-2025,"Grains, Flours & Dals",WHEAT 1 KG,4,180,150,30,3
07-02-2025,"Grains, Flours & Dals",BAJRA 1 KG,4,6,5,1,0.1
07-02-2025,"Grains, Flours & Dals",FLOUR CHARGE,4,43.2,43.2,0,3.6
07-02-2025,"Grains, Flours & Dals",JOWAR WHITE 1 KG,4,16,14,2,0.2
07-02-2025,"Dry Fruits, Nuts & Seeds",FLAX SEEDS 1KG,2,24,20,4,0.1
07-02-2025,"Grains, Flours & Dals",RAGULU 1 KG,4,70,60,10,1
07-02-2025,"Grains, Flours & Dals",PESARA PAPPU 500GMS,4,85,75,10,1
07-02-2025,Milk & Dairy,SANGAM FULL CREAM MILK 500ML,7,38,38,0,1
07-02-2025,Snacks & Ready-to-Eat,SATHVI REGIVADA 200GM,14,80,60,20,1
07-02-2025,Snacks & Ready-to-Eat,BATANA NGT 70GMS,14,20,20,0,1
07-02-2025,Snacks & Ready-to-Eat,BLACK SESAME CHIKKI,14,50,50,0,10
07-02-2025,Snacks & Ready-to-Eat,SATHVI MIXED CHIKKI 200GM,14,120,100,20,1
07-02-2025,"Grains, Flours & Dals",RED TURDAL 500GM,4,75,70,5,1
07-02-2025,"Grains, Flours & Dals",Red Chana 500 GM,4,75,60,15,1
07-02-2025,Sweeteners,MISHRI 250 GM,16,35,30,5,1
07-02-2025,"Grains, Flours & Dals",DESI CHANA,4,100,100,0,4
07-02-2025,"Grains, Flours & Dals",THICK POHA 500GM,4,40,35,5,1
07-02-2025,"Grains, Flours & Dals",Green gram 500 gms,4,75,70,5,1
07-02-2025,General Household & Kitchenware,COMFY SNUG FIT XL +50MM,3,30,30,0,1
07-02-2025,"Grains, Flours & Dals",FLOUR CHARGE,4,48,48,0,4
07-02-2025,Sweeteners,MADHUR SUGAR 1KG,16,65,55,10,1
07-02-2025,"Grains, Flours & Dals",turdal 500 gms,4,110,100,10,1
07-02-2025,Snacks & Ready-to-Eat,PUMPKIN CHIKKI 200GM,14,140,120,20,1
07-02-2025,Snacks & Ready-to-Eat,SATHVI MIXED CHIKKI 200GM,14,120,100,20,1
07-02-2025,"Grains, Flours & Dals",MELMEKER 250GMS,4,60,45,15,1
07-02-2025,"Grains, Flours & Dals",RED TURDAL 500GM,4,75,70,5,1
07-02-2025,"Grains, Flours & Dals",White jowar.F 1 kg,4,200,160,40,2
07-02-2025,"Health, Wellness & Ayurvedic Products",RB Max Protein Salt & Caramel Bar 50g,5,75,75,0,1
07-02-2025,"Grains, Flours & Dals",RICE FLOUR 1KG,4,70,55,15,1
07-02-2025,"Health, Wellness & Ayurvedic Products",RB Max Protein Oats &Raisins 55gm,5,50,50,0,1
07-02-2025,Oils & Ghee,Groundnut oil 1 L,9,360,330,30,1
07-02-2025,"Health, Wellness & Ayurvedic Products",RB Max Protein Choco Almond bar 50g,5,75,75,0,1
07-02-2025,Snacks & Ready-to-Eat,VD ATUKULU MIXTURE 175GM,14,60,60,0,1
07-02-2025,"Grains, Flours & Dals",DESI CHANA,4,50,50,0,2
07-02-2025,Snacks & Ready-to-Eat,BELLAM MINAPA SUNADULLU,14,180,180,0,1
07-02-2025,Snacks & Ready-to-Eat,HS Ragi biscuits,14,50,50,0,1
07-02-2025,"Grains, Flours & Dals",Em Little idli R 500g,4,129,129,0,1
07-02-2025,Oils & Ghee,Castor oil 200 ml,9,100,80,20,1
07-02-2025,"Grains, Flours & Dals",Wheat Flour 2 kgs,4,140,120,20,1
07-02-2025,Oils & Ghee,Coconut oil 500 ml,9,220,200,20,1
07-02-2025,"Grains, Flours & Dals",Wheat Flour 1 kg,4,210,180,30,3
07-02-2025,"Grains, Flours & Dals",EM kodo upma R 500g,4,129,129,0,1
07-02-2025,"Grains, Flours & Dals",Chana Flour 500 gms,4,70,65,5,1
07-02-2025,Beverages,BRU GREEN LABEL 1.2G,1,96,96,0,48
07-02-2025,Household & Cleaning,VIM EXTRA 110GM,6,10,10,0,1
07-02-2025,Household & Cleaning,ARIEL COMPLETE SEMI-AUTO,6,154,154,0,1
07-02-2025,Personal Care & Cosmetics,MESWAK 100GM,10,70,70,0,1
07-02-2025,Household & Cleaning,SURFEXCEL BAR 80G,6,20,20,0,2
07-02-2025,Snacks & Ready-to-Eat,RAJGIRA PEANUT CHIKKI,14,5,5,0,1
07-02-2025,Oils & Ghee,Groundnut oil 1 L,9,360,330,30,1
07-02-2025,"Dry Fruits, Nuts & Seeds",WATERMELON SEEDS 250GRM,2,320,280,40,1
07-02-2025,"Grains, Flours & Dals",VGR rice 1 kg,4,140,130,10,2
07-02-2025,"Grains, Flours & Dals",AISHWARYA SP 1KG,4,400,350,50,5
07-02-2025,"Grains, Flours & Dals",MELMEKER 250GMS,4,60,45,15,1
07-02-2025,"Dry Fruits, Nuts & Seeds",PULMAKHANA 100 GM,2,180,170,10,1
07-02-2025,Snacks & Ready-to-Eat,PN ORGANIC PUFFED RICE 200GM,14,55,55,0,1
07-02-2025,"Grains, Flours & Dals",KORRALU (FOXTAIL M) 500GM,4,65,55,10,1
07-02-2025,"Grains, Flours & Dals",Wheat Flour 2 kgs,4,280,240,40,2
07-02-2025,"Grains, Flours & Dals",Wheat Flour 1 kg,4,70,60,10,1
07-02-2025,Snacks & Ready-to-Eat,SESAME LADDU 200GM,14,100,80,20,1
07-02-2025,"Grains, Flours & Dals",PESARA PAPPU 500GMS,4,85,75,10,1
07-02-2025,Oils & Ghee,Groundnut oil 1 L,9,360,330,30,1
07-02-2025,"Grains, Flours & Dals",Urad dall 1 Kg,4,185,170,15,1
07-02-2025,Snacks & Ready-to-Eat,SATHVI PALLI CHIKKI 200GM,14,100,80,20,1
07-02-2025,"Grains, Flours & Dals",split black gram 1 kg,4,180,170,10,1
07-02-2025,Spices & Seasonings,ROYAL SAFFRON 400GRMS,15,65,65,0,1
07-02-2025,"Grains, Flours & Dals",Chana Flour 500 gms,4,70,65,5,1
07-02-2025,"Dry Fruits, Nuts & Seeds",Groundnuts 500 gms,2,95,85,10,1
07-02-2025,"Grains, Flours & Dals",SABDANA,4,40,35,5,1
07-02-2025,Oils & Ghee,Coconut oil 500 ml,9,220,200,20,1
07-02-2025,"Grains, Flours & Dals",SH RED POHA 500GM,4,75,75,0,1
07-02-2025,Snacks & Ready-to-Eat,urban murmura,14,60,55,5,1
07-02-2025,Sweeteners,SD PALM JAGGERY 500GM,16,200,200,0,1
07-02-2025,"Grains, Flours & Dals",RAGULU 1 KG,4,70,60,10,1
07-02-2025,"Grains, Flours & Dals",Red Bobarlu 1 kg,4,190,170,20,1
07-02-2025,"Grains, Flours & Dals",Idly Rava L 1KG,4,60,50,10,1
07-02-2025,Spices & Seasonings,Coriander seeds 200 gms,15,48,40,8,1
07-02-2025,Snacks & Ready-to-Eat,RINGS 200GM,14,30,30,0,1
07-02-2025,"Health, Wellness & Ayurvedic Products",MD Aamlaki Choornam 100GM,5,80,80,0,1
07-02-2025,Snacks & Ready-to-Eat,VD MYSOREPAK 6PIC,14,100,100,0,1
07-02-2025,Personal Care & Cosmetics,SVE KHADI ALOEVERA GEL 200GM,10,270,270,0,1
07-02-2025,"Grains, Flours & Dals",UDALU (Barnyard millet) 1 kg,4,280,230,50,2
07-02-2025,General Household & Kitchenware,WOODEN SPOON BIG,3,80,80,0,2
07-02-2025,"Grains, Flours & Dals",Wheat Rava M 1KG,4,130,110,20,2
07-02-2025,"Grains, Flours & Dals",HS JOWAR FLAKES 250GM 1+1,4,119,119,0,1
07-02-2025,"Grains, Flours & Dals",KORRALU (FOXTAIL M) 1KG,4,300,220,80,2
07-02-2025,"Grains, Flours & Dals",SAMALU (Little millet) 1 kg,4,340,260,80,2
07-02-2025,Pooja & Spiritual Items,GD SANDAL 150GM,12,100,100,0,1
07-02-2025,Spices & Seasonings,MD Sonti Powder 50GM,15,80,80,0,1
07-02-2025,"Health, Wellness & Ayurvedic Products",MD Bringaraj Choornam 100GM,5,80,80,0,1
07-02-2025,"Grains, Flours & Dals",Em little upma R 500g,4,129,129,0,1
07-02-2025,Snacks & Ready-to-Eat,MB FOXTAIL MILLET NOODLES 180GM,14,95,95,0,1
07-02-2025,"Grains, Flours & Dals",BAJRA 1 KG,4,300,250,50,5
07-02-2025,"Grains, Flours & Dals",EM Foxtail idli r 500 g,4,109,109,0,1
07-02-2025,Personal Care & Cosmetics,ORGANIC SPONGE LOOFAH,10,70,70,0,1
07-02-2025,"Grains, Flours & Dals",ANDU KORRALU (Browntop.m) 1 kg,4,520,440,80,2
07-02-2025,Snacks & Ready-to-Eat,MB SORGHUM NOODLES 180GM,14,190,190,0,2
07-02-2025,"Grains, Flours & Dals",EM kodo upma R 500g,4,129,129,0,1
07-02-2025,Personal Care & Cosmetics,MD Soapnut Choornam 100GM,10,800,800,0,10
07-02-2025,"Grains, Flours & Dals",Em Multimillet idli r 500g,4,129,129,0,1
07-02-2025,"Grains, Flours & Dals",JOWAR WHITE 1 KG,4,400,350,50,5
07-02-2025,Personal Care & Cosmetics,HEART SHAPE LOOFAH,10,158,158,0,2
07-02-2025,"Grains, Flours & Dals",Em Multimillet upma 500g,4,129,129,0,1
07-02-2025,Snacks & Ready-to-Eat,MB MULTIMILLET NOODLES 180GM,14,95,95,0,1
07-02-2025,"Grains, Flours & Dals",Em kodo idli R 500G,4,129,129,0,1
07-02-2025,"Grains, Flours & Dals",Arikadu ( kodo),4,280,260,20,2
07-02-2025,"Grains, Flours & Dals",RAGI FLOUR 500GRMS,4,40,35,5,1
07-02-2025,"Grains, Flours & Dals",COW B rice 1 kg,4,72,69,3,1
07-02-2025,"Grains, Flours & Dals",Yellow jowar .F1 kg,4,110,100,10,1
07-02-2025,"Grains, Flours & Dals",SPLIT BLACK GRAM 500 GM,4,360,340,20,4
07-02-2025,"Grains, Flours & Dals",Idly Rava L 1KG,4,60,50,10,1
07-02-2025,Snacks & Ready-to-Eat,DISANO VERMICELLI 425 GM,14,50,50,0,1
07-02-2025,Oils & Ghee,Sesame oil 1 L,9,590,560,30,1
07-02-2025,Snacks & Ready-to-Eat,VD RED CHILLI RICEPAPAD 150GM,14,50,50,0,1
07-02-2025,Pooja & Spiritual Items,GD WOODS 150GM,12,110,110,0,1
07-02-2025,Oils & Ghee,Groundnut oil 1 L,9,1080,990,90,3
07-02-2025,Snacks & Ready-to-Eat,Pani Poori Chips 250GM,14,50,40,10,1
07-02-2025,Snacks & Ready-to-Eat,SATHVI PALLI CHIKKI 200GM,14,100,80,20,1
07-02-2025,Oils & Ghee,Safflower oil 500 ml,9,220,200,20,1
07-02-2025,Spices & Seasonings,Masala Karam 250 gms,15,130,120,10,1
07-02-2025,Oils & Ghee,Coconut oil 500 ml,9,220,200,20,1
07-02-2025,Oils & Ghee,Coconut oil 500 ml,9,220,200,20,1
07-02-2025,Oils & Ghee,Safflower oil 500 ml,9,220,200,20,1
07-02-2025,Spices & Seasonings,Masala Karam 250 gms,15,130,120,10,1
07-02-2025,Spices & Seasonings,DRY MIECHI 200GM,15,80,60,20,1
07-02-2025,Spices & Seasonings,DURGA SALT CRYSTAL 1KG,15,25,23.75,1.25,1
07-02-2025,Spices & Seasonings,Tamarind 500GM,15,160,130,30,1
07-02-2025,"Grains, Flours & Dals",SINGLE POLISH 1KG,4,195,185.25,9.75,3
07-02-2025,Sweeteners,ACHUBELLAM 500GM,16,50,40,10,1
07-02-2025,Oils & Ghee,Freedom Rice Bran Oil 1L,9,194,180,14,1
07-02-2025,Oils & Ghee,Groundnut oil 1 L,9,310,310,0,1
07-02-2025,"Grains, Flours & Dals",Wheat Rava M 1KG,4,65,55,10,1
07-02-2025,Snacks & Ready-to-Eat,MILK BREAD,14,30,28.5,1.5,1
07-02-2025,"Grains, Flours & Dals",HS Multimillet upma r 500g,4,65,61.75,3.25,1
07-02-2025,Spices & Seasonings,AV Iodized Salt 1KG,15,28,27.16,0.84,1
07-02-2025,Spices & Seasonings,LG 50GM,15,92,87.4,4.6,1
07-02-2025,Snacks & Ready-to-Eat,VD BELLAM GAVVALU 200GM,14,60,57,3,1
07-02-2025,"Grains, Flours & Dals",AMMA RICE RAVA 500GRMS,4,42,39.9,2.1,1
07-02-2025,"Grains, Flours & Dals",SABDANA 500GM,4,90,70,20,1
07-02-2025,Snacks & Ready-to-Eat,PALLI LADDU 200GMS,14,90,70,20,1
07-02-2025,"Grains, Flours & Dals",Multigrain 1 kg,4,300,255,45,3
07-02-2025,Sweeteners,GS Organic Jaggery Powder 600GM,16,198,198,0,2
07-02-2025,Snacks & Ready-to-Eat,NGT CHATPATTA CHANA 90GM,14,25,25,0,1
07-02-2025,Snacks & Ready-to-Eat,ZEEDI,14,70,70,0,1
07-02-2025,Oils & Ghee,Groundnut oil 1 L,9,360,330,30,1
07-02-2025,Oils & Ghee,Safflower oil 1 L,9,440,400,40,1
07-02-2025,"Grains, Flours & Dals",RAGI FLOUR 500GRMS,4,40,35,5,1
07-02-2025,Snacks & Ready-to-Eat,TILLI CHIKKI,14,25,25,0,5
07-02-2025,Oils & Ghee,Sesame oil 5 L,9,2950,"2,750.00",200,1
07-02-2025,"Grains, Flours & Dals",RAGI FLOUR 1KG,4,160,140,20,2
07-02-2025,Oils & Ghee,Black Sesame oil 500 ml,9,220,190,30,1
07-02-2025,"Grains, Flours & Dals",KORRALU (FOXTAIL M) 1KG,4,150,110,40,1
07-02-2025,"Grains, Flours & Dals",SAMALU (Little millet) 1 kg,4,170,130,40,1
07-02-2025,"Grains, Flours & Dals",UDALU (Barnyard millet) 1 kg,4,140,115,25,1
07-02-2025,"Grains, Flours & Dals",ANDU KORRALU (Browntop.m) 1 kg,4,260,220,40,1
07-02-2025,Snacks & Ready-to-Eat,KURNOOL MARMURA,14,70,55,15,1
07-02-2025,"Grains, Flours & Dals",THICK POHA 500GM,4,40,35,5,1
07-02-2025,"Grains, Flours & Dals",Wheat Flour 1 kg,4,70,60,10,1
07-02-2025,Sweeteners,SD PALM JAGGERY 500GM,16,200,200,0,1
07-02-2025,"Dry Fruits, Nuts & Seeds",FLAX SEEDS 250GM,2,60,50,10,1
07-02-2025,Snacks & Ready-to-Eat,SESAME CHIKKI,14,120,100,20,1
07-02-2025,Snacks & Ready-to-Eat,SATHVI PALLI CHIKKI 200GM,14,100,80,20,1
07-02-2025,"Health, Wellness & Ayurvedic Products",MD Aamlaki Choornam 100GM,5,160,160,0,2
07-02-2025,Oils & Ghee,Safflower oil 1 L,9,440,400,40,1
07-02-2025,Pooja & Spiritual Items,SWASTIK CAMPHOR 25GM,12,45,45,0,1
07-02-2025,Oils & Ghee,Groundnut oil 1 L,9,360,330,30,1
07-02-2025,Misc,HOME LIKES,8,10,10,0,1
07-02-2025,Snacks & Ready-to-Eat,PALLI LADDU 200GMS,14,90,70,20,1
07-02-2025,"Grains, Flours & Dals",Em little upma R 500g,4,129,129,0,1
07-02-2025,"Grains, Flours & Dals",Wheat Rava M 500GM,4,33,30,3,1
07-02-2025,Snacks & Ready-to-Eat,BATANA NGT 70GMS,14,40,40,0,2
07-02-2025,Snacks & Ready-to-Eat,KURNOOL MARMURA,14,140,110,30,2
07-02-2025,"Grains, Flours & Dals",DESI CHANA,4,50,50,0,2
07-02-2025,Snacks & Ready-to-Eat,NGT CHATPATTA CHANA 90GM,14,50,50,0,2
07-02-2025,Oils & Ghee,Groundnut oil 5 L,9,1800,"1,600.00",200,1
07-02-2025,"Dry Fruits, Nuts & Seeds",Groundnuts 1 kg,2,190,170,20,1
06-02-2025,Snacks & Ready-to-Eat,DOSA BATTER 1KG,14,60,60,0,1
06-02-2025,Oils & Ghee,Sesame oil 500ml,9,295,280,15,1
06-02-2025,Snacks & Ready-to-Eat,urban murmura,14,120,110,10,2
06-02-2025,Pooja & Spiritual Items,GD Aiswarya Deepam 700ML,12,195,195,0,1
06-02-2025,"Grains, Flours & Dals",YB Red RICE 1 KG,4,150,120,30,1
06-02-2025,Oils & Ghee,Sesame oil 1 L,9,590,560,30,1
06-02-2025,Snacks & Ready-to-Eat,RAJGIRA PEANUT CHIKKI,14,10,10,0,2
06-02-2025,"Health, Wellness & Ayurvedic Products",RB Max Protein Cheese&amp;,5,45,45,0,1
06-02-2025,Snacks & Ready-to-Eat,RSC ORANGE 100GMS,14,20,20,0,1
06-02-2025,Oils & Ghee,Sesame oil 500ml,9,295,280,15,1
06-02-2025,"Dry Fruits, Nuts & Seeds",WALLNUTS 250GM,2,320,290,30,1
06-02-2025,"Dry Fruits, Nuts & Seeds",ALMONDS 250GM,2,280,260,20,1
06-02-2025,"Dry Fruits, Nuts & Seeds",PLAIN PISTA 250GM,2,660,550,110,1
06-02-2025,"Grains, Flours & Dals",AISHWARYA LOW GI RICE 5KG,4,1400,"1,050.00",350,2
06-02-2025,"Dry Fruits, Nuts & Seeds",DRIED KIWI 200GM,2,145,130,15,1
06-02-2025,"Dry Fruits, Nuts & Seeds",GF DATES 500GM,2,156,149,7,1
06-02-2025,"Dry Fruits, Nuts & Seeds",WALLNUTS 250GM,2,320,290,30,1
06-02-2025,"Grains, Flours & Dals",SL Suji Rava 500GM,4,32,32,0,1
06-02-2025,"Grains, Flours & Dals",Wheat Flour 1 kg,4,140,120,20,2
06-02-2025,"Grains, Flours & Dals",JOWAR UPMA RAVA,4,0,0,0,1
06-02-2025,"Health, Wellness & Ayurvedic Products",MORINGA LEAF POWDER M,5,160,160,0,2
06-02-2025,"Health, Wellness & Ayurvedic Products",MD Ashwagandha Choornam 100GM,5,170,170,0,1
06-02-2025,"Health, Wellness & Ayurvedic Products",MD Triphala Chorrnam 100GM,5,80,80,0,1
06-02-2025,"Grains, Flours & Dals",DISANO ROLED OATS,4,197,197,0,1
06-02-2025,Oils & Ghee,Groundnut oil 1 L,9,360,330,30,1
06-02-2025,"Grains, Flours & Dals",turdal 500 gms,4,220,200,20,2
06-02-2025,Spices & Seasonings,AV Iodized Salt 1KG,15,28,25,3,1
06-02-2025,"Grains, Flours & Dals",SF BESAN 500GM,4,100,100,0,1
06-02-2025,Personal Care & Cosmetics,UVIS ALOEVERA GEL,10,125,125,0,1
06-02-2025,"Grains, Flours & Dals",white Bobarlu 1 KG,4,170,150,20,1
06-02-2025,Spices & Seasonings,Chilli powder 500 gms,15,290,210,80,1
06-02-2025,"Grains, Flours & Dals",PESARA PAPPU 500GMS,4,85,75,10,1
06-02-2025,"Grains, Flours & Dals",SRILALITHA MAIDA FLOUR 500G,4,64,64,0,2
06-02-2025,Oils & Ghee,BUFFALLO GHEE 500ML,9,410,370,40,1
06-02-2025,"Grains, Flours & Dals",SPLIT BLACK GRAM 500 GM,4,90,85,5,1
06-02-2025,"Dry Fruits, Nuts & Seeds",KAJU HALF 250GM,2,310,290,20,1
06-02-2025,"Dry Fruits, Nuts & Seeds",Groundnuts 500 gms,2,95,85,10,1
06-02-2025,Sweeteners,SUGAR 500 GM,16,30,25,5,1
06-02-2025,Sweeteners,SUGAR 1KG,16,120,100,20,2
06-02-2025,"Health, Wellness & Ayurvedic Products",DWI MANDARA TAILAM 100ML,5,160,160,0,1
06-02-2025,Spices & Seasonings,Coriander seeds 200 gms,15,48,40,8,1
06-02-2025,Spices & Seasonings,DRY MIECHI 200GM,15,80,60,20,1
06-02-2025,"Grains, Flours & Dals",Red Chana 500 GM,4,75,60,15,1
06-02-2025,"Dry Fruits, Nuts & Seeds",Groundnuts 1 kg,2,190,170,20,1
06-02-2025,"Grains, Flours & Dals",Chana Flour 500 gms,4,70,65,5,1
06-02-2025,"Grains, Flours & Dals",Urad dall 1 Kg,4,185,170,15,1
06-02-2025,"Dry Fruits, Nuts & Seeds",PULMAKHANA 100 GM,2,180,170,10,1
06-02-2025,"Dry Fruits, Nuts & Seeds",BLACK KISMIS 250GM,2,175,140,35,1
06-02-2025,Oils & Ghee,Black Sesame oil 500 ml,9,220,190,30,1
06-02-2025,"Grains, Flours & Dals",turdal 500 gms,4,110,100,10,1
06-02-2025,Pooja & Spiritual Items,GD SANDAL 150GM,12,110,110,0,1
06-02-2025,"Dry Fruits, Nuts & Seeds",PLAIN PISTA 250GM,2,660,550,110,1
06-02-2025,"Grains, Flours & Dals",THICK POHA 500GM,4,40,35,5,1
06-02-2025,Household & Cleaning,LIZOL FORAL CLEANER,6,116,116,0,1
06-02-2025,"Grains, Flours & Dals",Wheat Flour 1 kg,4,70,60,10,1
06-02-2025,Spices & Seasonings,Avalu small 250 gms,15,60,40,20,1
06-02-2025,"Grains, Flours & Dals",Green gram 500 gms,4,75,70,5,1
06-02-2025,Spices & Seasonings,GREEN SOUNF,15,60,40,20,1
06-02-2025,Spices & Seasonings,Chilli powder 1 kg,15,580,420,160,1
06-02-2025,Oils & Ghee,Sesame oil 500ml,9,295,280,15,1
06-02-2025,Oils & Ghee,Groundnut oil 500ml,9,180,165,15,1
06-02-2025,"Dry Fruits, Nuts & Seeds",FLAX SEEDS 250GM,2,60,50,10,1
06-02-2025,"Grains, Flours & Dals",Wheat Flour 1 kg,4,70,60,10,1
06-02-2025,"Dry Fruits, Nuts & Seeds",PULMAKHANA 100 GM,2,180,170,10,1
06-02-2025,"Grains, Flours & Dals",YB NAVARA RICE 500GM,4,100,100,0,1
06-02-2025,"Grains, Flours & Dals",Brown RICE 1KG,4,35,32.5,2.5,0.5
06-02-2025,"Grains, Flours & Dals",Wheat Flour 1 kg,4,70,60,10,1
06-02-2025,Snacks & Ready-to-Eat,NGT CHATPATTA CHANA 90GM,14,25,25,0,1
06-02-2025,"Dry Fruits, Nuts & Seeds",GF DATES 500GM,2,156,149,7,1
06-02-2025,"Dry Fruits, Nuts & Seeds",PUMPKIN SEEDS 250GM,2,200,160,40,1
06-02-2025,"Grains, Flours & Dals",turdal 1kg,4,220,195,25,1
06-02-2025,"Grains, Flours & Dals",RAGI FLOUR 1KG,4,80,70,10,1
06-02-2025,"Grains, Flours & Dals",RAGI FLOUR 1KG,4,80,70,10,1
06-02-2025,Personal Care & Cosmetics,HERBAL BATH POWDER 200GM,10,80,80,0,1
06-02-2025,Snacks & Ready-to-Eat,SUNNUNDALU 200GM,14,120,120,0,1
06-02-2025,Snacks & Ready-to-Eat,SATHVI MIXED CHIKKI 200GM,14,120,100,20,1
06-02-2025,"Grains, Flours & Dals",PN ORGANIC URAD WHITE WHOLE 500GM,4,158,158,0,1
06-02-2025,"Dry Fruits, Nuts & Seeds",SATHVI CHIA SEEDS 100GM,2,100,80,20,1
06-02-2025,Snacks & Ready-to-Eat,ELITE MILK RUSK 200GM,14,35,35,0,1
06-02-2025,Snacks & Ready-to-Eat,PALLI LADDU 200GMS,14,180,140,40,2
06-02-2025,Snacks & Ready-to-Eat,COPRA LADDU 200GM,14,200,160,40,2
06-02-2025,Snacks & Ready-to-Eat,GB SALT COOKIES,14,60,55,5,1
06-02-2025,"Grains, Flours & Dals",BARLEY SEEDS 1KG,4,160,140,20,1
06-02-2025,Oils & Ghee,Groundnut oil 500ml,9,180,165,15,1
06-02-2025,"Grains, Flours & Dals",CHANA DAL 1KG,4,35,30,5,0.25
06-02-2025,"Grains, Flours & Dals",turdal 500 gms,4,110,100,10,1
06-02-2025,"Grains, Flours & Dals",Wheat Flour 1 kg,4,70,60,10,1
06-02-2025,Milk & Dairy,SANGAM TONED MILK 500ML,7,30,30,0,1
06-02-2025,"Dry Fruits, Nuts & Seeds",YELLOW KISHMISH 250GM,2,130,110,20,1
06-02-2025,"Grains, Flours & Dals",Wheat Rava M 1KG,4,65,55,10,1
06-02-2025,"Grains, Flours & Dals",SPLIT BLACK GRAM 500 GM,4,90,85,5,1
06-02-2025,"Grains, Flours & Dals",Wheat Flour 1 kg,4,70,60,10,1
06-02-2025,"Dry Fruits, Nuts & Seeds",GF DATES 500GM,2,156,149,7,1
06-02-2025,"Health, Wellness & Ayurvedic Products",RB Max Protein Choco Almond bar 50g,5,75,75,0,1
06-02-2025,General Household & Kitchenware,IRN WDN HDI KADAIA 10,3,275,275,0,1
06-02-2025,"Dry Fruits, Nuts & Seeds",WATERMELON SEEDS 250GRM,2,320,280,40,1
06-02-2025,Pooja & Spiritual Items,VRP APOORVA JAVADHU POW,12,35,35,0,1
06-02-2025,"Dry Fruits, Nuts & Seeds",FLAX SEEDS 250GM,2,60,50,10,1
06-02-2025,"Dry Fruits, Nuts & Seeds",PUMPKIN SEEDS 250GM,2,200,160,40,1
06-02-2025,"Grains, Flours & Dals",RICE FLOUR 500 GM,4,70,56,14,2
06-02-2025,"Dry Fruits, Nuts & Seeds",ALMONDS 250GM,2,280,260,20,1
06-02-2025,"Grains, Flours & Dals",MELMEKER 250GMS,4,60,45,15,1
06-02-2025,Personal Care & Cosmetics,OVAL BODY LOOFAH,10,55,55,0,1
06-02-2025,Spices & Seasonings,RED COPRA 250GMS,15,85,74,11,1
06-02-2025,Oils & Ghee,Sesame oil 500ml,9,295,280,15,1
06-02-2025,"Grains, Flours & Dals",Chana Flour 500 gms,4,70,65,5,1
06-02-2025,"Grains, Flours & Dals",FLOUR CHARGE,4,64.8,64.8,0,5.4
06-02-2025,"Grains, Flours & Dals",RAGI FLOUR 500GRMS,4,40,35,5,1
06-02-2025,Snacks & Ready-to-Eat,urban murmura,14,60,55,5,1
06-02-2025,"Dry Fruits, Nuts & Seeds",YB GRANMA NUTS,2,90,90,0,1
06-02-2025,"Grains, Flours & Dals",Multigrain 1 kg,4,300,255,45,3
06-02-2025,Snacks & Ready-to-Eat,PALLI LADDU 200GMS,14,90,70,20,1
06-02-2025,Snacks & Ready-to-Eat,NGT CHATPATTA CHANA 90GM,14,50,50,0,2
06-02-2025,Snacks & Ready-to-Eat,SD Vamu with palm jaggery 250gm,14,135,135,0,1
06-02-2025,Snacks & Ready-to-Eat,PALLI LADDU 200GMS,14,360,280,80,4
06-02-2025,Spices & Seasonings,Tamarind 500GM,15,160,130,30,1
06-02-2025,Snacks & Ready-to-Eat,GANTASALA GINGER CANDY 200GM,14,105,105,0,1
06-02-2025,Snacks & Ready-to-Eat,RAJGIRA PEANUT CHIKKI 450GM,14,125,125,0,1
06-02-2025,Snacks & Ready-to-Eat,ZEEDI,14,70,70,0,1
06-02-2025,"Grains, Flours & Dals",RAGI FLOUR 1KG,4,80,70,10,1
06-02-2025,Snacks & Ready-to-Eat,SD Ginger Candy 100g,14,60,60,0,1
06-02-2025,Snacks & Ready-to-Eat,SESAME CHIKKI,14,120,100,20,1
06-02-2025,Snacks & Ready-to-Eat,COPRA LADDU 200GM,14,200,160,40,2
06-02-2025,Sweeteners,PN ORGANIC JAGGERY POWDER 400GM,16,86,86,0,1
06-02-2025,Oils & Ghee,Groundnut oil 1 L,9,360,330,30,1
06-02-2025,"Grains, Flours & Dals",RICE FLOUR 1KG,4,70,55,15,1
06-02-2025,"Grains, Flours & Dals",RAGI FLOUR 500GRMS,4,40,35,5,1
06-02-2025,"Grains, Flours & Dals",Green gram 500 gms,4,75,70,5,1
06-02-2025,"Grains, Flours & Dals",Wheat Flour 1 kg,4,140,120,20,2
06-02-2025,Oils & Ghee,Sesame oil 500ml,9,295,280,15,1
06-02-2025,"Grains, Flours & Dals",Urad dall 1 Kg,4,370,340,30,2
06-02-2025,"Grains, Flours & Dals",Idly Rava L 1KG,4,60,50,10,1
06-02-2025,Sweeteners,SUGAR 1KG,16,60,50,10,1
06-02-2025,Snacks & Ready-to-Eat,VD NUVULU PAPAD 200GM,14,100,100,0,1
06-02-2025,Spices & Seasonings,Lavangam 50GM,15,60,50,10,1
06-02-2025,"Grains, Flours & Dals",PRO SOYA CHUNKS 200G,4,79,79,0,1
06-02-2025,Snacks & Ready-to-Eat,SD MASALA GAVVALU 200GM,14,95,95,0,1
06-02-2025,Snacks & Ready-to-Eat,VD PAPPU CHEGODI 200GM,14,60,60,0,1
06-02-2025,Snacks & Ready-to-Eat,SD Aswagandha with palm Jaggery250Gm,14,135,135,0,1
06-02-2025,"Grains, Flours & Dals",FLOUR CHARGE,4,24,24,0,2
06-02-2025,Snacks & Ready-to-Eat,SATHVI MIXED CHIKKI 200GM,14,120,100,20,1
06-02-2025,"Grains, Flours & Dals",White jowar.F 1 kg,4,100,80,20,1
06-02-2025,"Grains, Flours & Dals",RAGI FLOUR 500GRMS,4,40,35,5,1
06-02-2025,"Grains, Flours & Dals",RICE FLOUR 1KG,4,70,55,15,1
06-02-2025,Oils & Ghee,Groundnut oil 1 L,9,360,330,30,1
06-02-2025,"Grains, Flours & Dals",Wheat Rava M 1KG,4,65,55,10,1
06-02-2025,Personal Care & Cosmetics,GOW DURBAR 75G,10,60,60,0,1
06-02-2025,Sweeteners,MISHRI D,16,40,30,10,1
06-02-2025,"Grains, Flours & Dals",Idly Rava L 1KG,4,60,50,10,1
06-02-2025,"Grains, Flours & Dals",AISHWARYA SP 1KG,4,400,350,50,5
06-02-2025,"Grains, Flours & Dals",ANDU KORRALU (Browntop.m) 1 kg,4,260,220,40,1
06-02-2025,Personal Care & Cosmetics,HIMALAYA LIP BALM 10GM,10,40,40,0,1
06-02-2025,"Grains, Flours & Dals",Arikadu ( kodo),4,420,390,30,3
06-02-2025,Snacks & Ready-to-Eat,DISANO VERMICELLI 425 GM,14,50,50,0,1
06-02-2025,Oils & Ghee,Coconut oil 1 L,9,880,800,80,2
06-02-2025,Snacks & Ready-to-Eat,RAJGIRA PEANUT CHIKKI,14,5,5,0,1
06-02-2025,Snacks & Ready-to-Eat,KURNOOL MARMURA,14,70,55,15,1
06-02-2025,"Grains, Flours & Dals",FLOUR CHARGE,4,12,12,0,1
06-02-2025,Spices & Seasonings,Telaga Pindi 500GM,15,80,70,10,1
06-02-2025,Snacks & Ready-to-Eat,Sprouted Ragi Biscuits 450GM,14,150,150,0,1
06-02-2025,Oils & Ghee,Sesame oil 1 L,9,590,560,30,1
06-02-2025,"Grains, Flours & Dals",SINGLE POLISH 1KG,4,650,650,0,10
06-02-2025,"Grains, Flours & Dals",SL Idly Rava 1KG,4,65,55,10,1
06-02-2025,"Grains, Flours & Dals",CHANA DAL 1KG,4,35,30,5,0.25
06-02-2025,Spices & Seasonings,DRY MIECHI 200GM,15,80,60,20,1
06-02-2025,"Grains, Flours & Dals",Chana Flour 500 gms,4,70,65,5,1
06-02-2025,"Grains, Flours & Dals",RED TURDAL 500GM,4,75,70,5,1
06-02-2025,"Grains, Flours & Dals",Urad dall 1 Kg,4,185,170,15,1
06-02-2025,"Grains, Flours & Dals",CORN FLOUR,4,80,70,10,1
06-02-2025,"Grains, Flours & Dals",White jowar.F 1 kg,4,200,160,40,2
06-02-2025,"Dry Fruits, Nuts & Seeds",Groundnuts 500 gms,2,95,85,10,1
06-02-2025,Spices & Seasonings,JEERA 250 gms,15,125,105,20,1
06-02-2025,"Dry Fruits, Nuts & Seeds",Putnalu 250GM,2,45,38,7,1
06-02-2025,"Grains, Flours & Dals",PESARA PAPPU 500GMS,4,85,75,10,1
06-02-2025,"Grains, Flours & Dals",Wheat Flour 1 kg,4,210,180,30,3
06-02-2025,"Health, Wellness & Ayurvedic Products",RB FRUITS &amp;seeds Cranberries,5,45,45,0,1
06-02-2025,"Health, Wellness & Ayurvedic Products",RB Peanut butter Peanuts Dark 40g,5,45,45,0,1
06-02-2025,Oils & Ghee,Groundnut oil 1 L,9,720,660,60,2
06-02-2025,"Grains, Flours & Dals",SL Idly Rava 1KG,4,130,110,20,2
06-02-2025,Sweeteners,MADHUR SUGAR 1KG,16,65,55,10,1
06-02-2025,Oils & Ghee,Sesame oil 1 L,9,590,560,30,1
06-02-2025,Oils & Ghee,Sesame oil 500ml,9,590,560,30,2
06-02-2025,"Grains, Flours & Dals",Arikalu (kodo),4,70,65,5,1
06-02-2025,"Grains, Flours & Dals",WHEAT 1 KG,4,240,200,40,4
06-02-2025,"Grains, Flours & Dals",RAGULU 1 KG,4,35,30,5,0.5
06-02-2025,"Grains, Flours & Dals",RED WHEAT 1 KG,4,130,120,10,1
06-02-2025,Snacks & Ready-to-Eat,MB MULTIMILLET NOODLES 180GM,14,95,95,0,1
06-02-2025,Oils & Ghee,cow ghee 500 ml,9,430,390,40,1
06-02-2025,Snacks & Ready-to-Eat,MILK BREAD,14,55,55,0,1
06-02-2025,Oils & Ghee,Sesame oil 500ml,9,295,280,15,1
06-02-2025,Snacks & Ready-to-Eat,MB FOXTAIL MILLET NOODLES 180GM,14,95,95,0,1
06-02-2025,"Grains, Flours & Dals",HS RAGI Idly rava 500 gms,4,140,140,0,2
06-02-2025,"Health, Wellness & Ayurvedic Products",MH Millets Malt 1KG,5,800,760,40,2
06-02-2025,"Grains, Flours & Dals",HS Multimillet idly R 500 gms,4,65,65,0,1
06-02-2025,Spices & Seasonings,MM CHAT MASALA,15,44,44,0,1
06-02-2025,Snacks & Ready-to-Eat,MB FOXTAIL MILLET NOODLES 180GM,14,95,95,0,1
06-02-2025,Snacks & Ready-to-Eat,BROWN BREAD,14,55,55,0,1
06-02-2025,"Health, Wellness & Ayurvedic Products",RB Max Protein Fruit &amp;Nut 50g,5,75,75,0,1
06-02-2025,Snacks & Ready-to-Eat,MB MULTIMILLET NOODLES 180GM,14,95,95,0,1
06-02-2025,Snacks & Ready-to-Eat,ELITE ELAICHI RUSK 200GM,14,35,35,0,1
06-02-2025,Sweeteners,MISHRI 250 GM,16,35,30,5,1
06-02-2025,"Grains, Flours & Dals",Multigrain 500 gms,4,50,43,7,1
06-02-2025,"Grains, Flours & Dals",BAJRA 1 KG,4,15,12.5,2.5,0.25
06-02-2025,Snacks & Ready-to-Eat,BLACK SESAME CHIKKI,14,10,10,0,2
06-02-2025,Snacks & Ready-to-Eat,PEANUT CHILLI,14,30,30,0,6
06-02-2025,"Dry Fruits, Nuts & Seeds",PULMAKHANA 100 GM,2,180,170,10,1
06-02-2025,Spices & Seasonings,Turmeric powder 250 gms,15,100,75,25,1
06-02-2025,General Household & Kitchenware,IRN WDN HDL DOSA TAWA 12,3,265,265,0,1
06-02-2025,Sweeteners,SD PALM JAGGERY 500GM,16,200,200,0,1
06-02-2025,Personal Care & Cosmetics,SUNNUPINDI SOAP UVS,10,198,198,0,2
06-02-2025,Oils & Ghee,Groundnut oil 1 L,9,360,330,30,1
06-02-2025,Personal Care & Cosmetics,VASELINE 5GM,10,5,5,0,1
06-02-2025,Personal Care & Cosmetics,COLGATE ACTIVE SALT,10,20,20,0,1
06-02-2025,Milk & Dairy,BROWN EGGS 1P,7,140,120,20,10
06-02-2025,Snacks & Ready-to-Eat,RAJGIRA PEANUT CHIKKI,14,30,30,0,6
06-02-2025,Spices & Seasonings,Chilli powder 500 gms,15,290,210,80,1
06-02-2025,Oils & Ghee,Sesame oil 500ml,9,295,280,15,1
06-02-2025,Snacks & Ready-to-Eat,VD Minapa papad 200gm,14,60,60,0,1
06-02-2025,Oils & Ghee,Groundnut oil 1 L,9,360,330,30,1
06-02-2025,"Grains, Flours & Dals",turdal 1kg,4,220,195,25,1
06-02-2025,"Grains, Flours & Dals",Wheat Rava M 500GM,4,33,30,3,1
06-02-2025,"Grains, Flours & Dals",RICE FLOUR 1KG,4,70,55,15,1
06-02-2025,"Dry Fruits, Nuts & Seeds",Putnalu 250GM,2,45,38,7,1
06-02-2025,"Grains, Flours & Dals",Multigrain 1 kg,4,100,85,15,1
06-02-2025,Snacks & Ready-to-Eat,ELITE ELAICHI RUSK 200GM,14,35,35,0,1
06-02-2025,"Grains, Flours & Dals",AMMA RICE RAVA 500GRMS,4,42,42,0,1
06-02-2025,Personal Care & Cosmetics,Khadi Shikakai With Amla Shampoo 200,10,199,199,0,1
06-02-2025,Milk & Dairy,HRITAGE TOTAL CURD 130GM,7,20,20,0,2
06-02-2025,Sweeteners,MISHRI 250 GM,16,35,30,5,1
06-02-2025,Oils & Ghee,Sesame oil 500ml,9,295,280,15,1
06-02-2025,Personal Care & Cosmetics,WILD STONE MUSK SOAP 125G,10,60,60,0,1
06-02-2025,Snacks & Ready-to-Eat,KURNOOL MARMURA,14,70,55,15,1
06-02-2025,Oils & Ghee,BUFFALLO GHEE 500ML,9,410,370,40,1
06-02-2025,Personal Care & Cosmetics,gow durbar sandal,10,40,40,0,1
06-02-2025,Snacks & Ready-to-Eat,MILK BREAD,14,30,30,0,1
06-02-2025,Oils & Ghee,Groundnut oil 1 L,9,360,330,30,1
06-02-2025,Oils & Ghee,A2 BUFFALO GHEE 250ML,9,299,299,0,1
06-02-2025,Sweeteners,NATURAL HONEY 1KG,16,560,480,80,1
06-02-2025,Milk & Dairy,BROWN EGGS TRAY 30P,7,360,330,30,1
06-02-2025,"Grains, Flours & Dals",URAD DALL,4,95,85,10,1
06-02-2025,"Grains, Flours & Dals",RAGULU 1 KG,4,70,60,10,1
06-02-2025,"Dry Fruits, Nuts & Seeds",GF DATES 500GM,2,156,149,7,1
06-02-2025,"Grains, Flours & Dals",HS jowar idly rava 500 gms,4,195,195,0,3
06-02-2025,"Grains, Flours & Dals",Wheat Flour 2 kgs,4,140,120,20,1
06-02-2025,Snacks & Ready-to-Eat,PEANUT CHILLI,14,75,75,0,15
06-02-2025,"Grains, Flours & Dals",Chana Flour 500 gms,4,70,65,5,1
06-02-2025,"Grains, Flours & Dals",Em little upma R 500g,4,129,129,0,1
06-02-2025,Oils & Ghee,Groundnut oil 1 L,9,720,660,60,2
06-02-2025,"Grains, Flours & Dals",RICE FLOUR 1KG,4,70,55,15,1
06-02-2025,"Grains, Flours & Dals",Bajra Flour 1 kg,4,210,180,30,3
06-02-2025,"Grains, Flours & Dals",White jowar.F 1 kg,4,300,240,60,3
06-02-2025,"Grains, Flours & Dals",split black gram 1 kg,4,360,340,20,2
06-02-2025,"Grains, Flours & Dals",Sathya Javva Wheat Rava 500GM,4,95,95,0,1
06-02-2025,"Grains, Flours & Dals",Wheat Flour 2 kgs,4,140,120,20,1
06-02-2025,"Grains, Flours & Dals",SL Idly Rava 1KG,4,130,110,20,2
06-02-2025,"Grains, Flours & Dals",Chana Flour 1 kg,4,140,130,10,1
06-02-2025,Oils & Ghee,Groundnut oil 1 L,9,1080,990,90,3
06-02-2025,"Grains, Flours & Dals",SL Idly Rava 1KG,4,65,55,10,1
06-02-2025,Snacks & Ready-to-Eat,VD BOONDI 175GM,14,60,60,0,1
06-02-2025,"Grains, Flours & Dals",SL Suji Rava 500GM,4,32,32,0,1
06-02-2025,"Grains, Flours & Dals",YB NAVARA RICE 500GM,4,100,100,0,1
06-02-2025,"Grains, Flours & Dals",Sathya Javva Wheat Rava 500GM,4,285,285,0,3
06-02-2025,"Grains, Flours & Dals",DH URAD GOTA 1KG,4,430,380,50,2
06-02-2025,"Grains, Flours & Dals",Wheat Flour 2 kgs,4,140,120,20,1
06-02-2025,Sweeteners,GS Organic Jaggery Powder 600GM,16,99,99,0,1
06-02-2025,Snacks & Ready-to-Eat,VD PAPPU CHEGODI 200GM,14,60,60,0,1
06-02-2025,"Grains, Flours & Dals",HS Ragi upma rava 500 gms,4,70,70,0,1
06-02-2025,Spices & Seasonings,PURO Healthy Salt Crystal 1KG,15,135,135,0,1
06-02-2025,Oils & Ghee,Sesame oil 1 L,9,590,560,30,1
06-02-2025,Oils & Ghee,Groundnut oil 1 L,9,360,330,30,1
06-02-2025,"Grains, Flours & Dals",White jowar.F 1 kg,4,100,80,20,1
06-02-2025,Snacks & Ready-to-Eat,SATHVI MIXED CHIKKI 200GM,14,120,100,20,1
06-02-2025,Snacks & Ready-to-Eat,BLACK SESAME CHIKKI,14,10,10,0,2
06-02-2025,Snacks & Ready-to-Eat,NGT CHATPATTA CHANA 90GM,14,25,25,0,1
06-02-2025,Snacks & Ready-to-Eat,COPRA LADDU 200GM,14,100,80,20,1
06-02-2025,Snacks & Ready-to-Eat,COPRA LADDU 200GM,14,100,80,20,1
06-02-2025,"Dry Fruits, Nuts & Seeds",FLAX SEEDS 250GM,2,60,50,10,1
06-02-2025,Snacks & Ready-to-Eat,SATHVI MIXED CHIKKI 200GM,14,120,100,20,1
06-02-2025,"Grains, Flours & Dals",Wheat Flour 1 kg,4,70,60,10,1
06-02-2025,Snacks & Ready-to-Eat,NGT CHATPATTA CHANA 90GM,14,25,25,0,1
06-02-2025,"Dry Fruits, Nuts & Seeds",GF DATES 500GM,2,156,149,7,1
06-02-2025,"Grains, Flours & Dals",RAGI FLOUR 1KG,4,80,70,10,1
06-02-2025,Oils & Ghee,Groundnut oil 1 L,9,360,330,30,1
06-02-2025,"Grains, Flours & Dals",Quinova 500 gms,4,110,100,10,1
06-02-2025,"Grains, Flours & Dals",Red Chana 500 GM,4,75,60,15,1
06-02-2025,"Dry Fruits, Nuts & Seeds",SABJA SEEDS 100GM,2,80,70,10,1
06-02-2025,"Grains, Flours & Dals",Red Bobarlu 500 gms,4,95,85,10,1
06-02-2025,Oils & Ghee,Black Sesame oil 1 L,9,880,760,120,2
06-02-2025,"Grains, Flours & Dals",White Chana 500GM,4,120,100,20,1
06-02-2025,Spices & Seasonings,ROYAL SAFFRON,15,125,125,0,1
06-02-2025,"Grains, Flours & Dals",Chana Flour 1 kg,4,140,130,10,1
06-02-2025,"Grains, Flours & Dals",SL Idly Rava 1KG,4,65,55,10,1
06-02-2025,"Grains, Flours & Dals",Wheat Rava M 500GM,4,33,30,3,1
06-02-2025,"Grains, Flours & Dals",Chana Flour 500 gms,4,70,65,5,1
06-02-2025,"Grains, Flours & Dals",FLOUR CHARGE,4,30,30,0,2.5
06-02-2025,"Grains, Flours & Dals",BLACK GRAM 1KG,4,150,140,10,1
06-02-2025,Spices & Seasonings,Tamarind 500GM,15,160,130,30,1
06-02-2025,Sweeteners,SUGAR 1KG,16,120,100,20,2
06-02-2025,"Grains, Flours & Dals",Wheat Flour 1 kg,4,70,60,10,1
06-02-2025,Spices & Seasonings,Elaichi 25GM,15,145,120,25,1
06-02-2025,Spices & Seasonings,NUVVULU 250GM,15,80,65,15,1
06-02-2025,"Grains, Flours & Dals",PESARA PAPPU 500GMS,4,85,75,10,1
06-02-2025,"Grains, Flours & Dals",VGR RICE bag 1,4,1899,"1,650.00",249,1
06-02-2025,"Grains, Flours & Dals",SL Idly Rava 1KG,4,325,275,50,5
06-02-2025,"Grains, Flours & Dals",VGR RICE bag 1,4,1899,"1,650.00",249,1
06-02-2025,"Grains, Flours & Dals",Chana Flour 1 kg,4,140,130,10,1
06-02-2025,Pooja & Spiritual Items,BALAJI KEWDA STICKS 220GM,12,150,150,0,1
06-02-2025,"Grains, Flours & Dals",Wheat Rava M 500GM,4,33,30,3,1
06-02-2025,"Grains, Flours & Dals",RAJMA 250GM,4,55,45,10,1
06-02-2025,"Grains, Flours & Dals",SL Idly Rava 1KG,4,130,110,20,2
06-02-2025,Pooja & Spiritual Items,BALAJI KASTURI DHOOP STICKS,12,70,70,0,1
06-02-2025,Pooja & Spiritual Items,BALAJI BEL PHOOL DHOOP STICKS 10STK,12,70,70,0,1
06-02-2025,"Grains, Flours & Dals",THICK POHA 500GM,4,40,35,5,1
06-02-2025,Oils & Ghee,Safflower oil 1 L,9,440,400,40,1
06-02-2025,"Grains, Flours & Dals",PESARA PAPPU 500GMS,4,85,75,10,1
06-02-2025,"Dry Fruits, Nuts & Seeds",SATHVI CHIA SEEDS 100GM,2,100,80,20,1
06-02-2025,Spices & Seasonings,Avalu small 250 gms,15,60,40,20,1
06-02-2025,"Grains, Flours & Dals",Wheat Flour 1 kg,4,70,60,10,1
06-02-2025,Spices & Seasonings,Jeera 100GM,15,50,45,5,1
06-02-2025,"Grains, Flours & Dals",White jowar.F 1 kg,4,100,80,20,1
06-02-2025,"Grains, Flours & Dals",MELMEKER 250GMS,4,60,45,15,1
06-02-2025,Spices & Seasonings,Coriander seeds 200 gms,15,48,40,8,1
06-02-2025,"Grains, Flours & Dals",Green gram 1 kg,4,150,130,20,1
06-02-2025,"Grains, Flours & Dals",SL Suji Rava 500GM,4,64,64,0,2
06-02-2025,"Grains, Flours & Dals",RED TURDAL 500GM,4,75,70,5,1
06-02-2025,Spices & Seasonings,ROYAL SAFFRON 400GRMS,15,65,65,0,1
06-02-2025,"Grains, Flours & Dals",SPLIT BLACK GRAM 500 GM,4,180,170,10,2
06-02-2025,Snacks & Ready-to-Eat,BB VERMICELLY 500GM,14,53,53,0,1
06-02-2025,Snacks & Ready-to-Eat,BD KODO MILLET NOODLES 200GM,14,75,75,0,1
06-02-2025,"Dry Fruits, Nuts & Seeds",Groundnuts 1 kg,2,190,170,20,1
06-02-2025,"Grains, Flours & Dals",SRILALITHA MAIDA FLOUR 500G,4,32,32,0,1
06-02-2025,"Dry Fruits, Nuts & Seeds",PULMAKHANA 100 GM,2,360,340,20,2
06-02-2025,"Grains, Flours & Dals",SPLIT BLACK GRAM 500 GM,4,450,425,25,5
06-02-2025,"Grains, Flours & Dals",Idly Rava L 1KG,4,180,150,30,3
06-02-2025,Spices & Seasonings,RED COPRA 250GMS,15,85,74,11,1
06-02-2025,"Grains, Flours & Dals",BASMATHI RICE 1KG,4,300,270,30,2
06-02-2025,"Dry Fruits, Nuts & Seeds",PUTNALU 500GMS,2,90,76,14,1
06-02-2025,"Dry Fruits, Nuts & Seeds",Groundnuts 1 kg,2,190,170,20,1
06-02-2025,Spices & Seasonings,AVALU 100GM,15,25,20,5,1
06-02-2025,Snacks & Ready-to-Eat,PN ORGANIC PUFFED RICE 200GM,14,55,55,0,1
06-02-2025,"Dry Fruits, Nuts & Seeds",YELLOW KISHMISH 250GM,2,130,110,20,1
06-02-2025,Spices & Seasonings,Coriander seeds 200 gms,15,48,40,8,1
06-02-2025,"Grains, Flours & Dals",JOWAR WHITE 1 KG,4,160,140,20,2
06-02-2025,"Grains, Flours & Dals",SAMALU (Little millet) 1 kg,4,340,260,80,2
06-02-2025,"Dry Fruits, Nuts & Seeds",FLAX SEEDS 250GM,2,120,100,20,2
06-02-2025,Oils & Ghee,Groundnut oil 1 L,9,720,660,60,2
06-02-2025,Spices & Seasonings,PURO Healthy Salt 1KG,15,110,110,0,1
06-02-2025,Snacks & Ready-to-Eat,VD MURUKU 175GM,14,120,120,0,2
06-02-2025,Spices & Seasonings,PURO Healthy Salt Crystal 1KG,15,135,135,0,1
06-02-2025,Snacks & Ready-to-Eat,PALLI LADDU 200GMS,14,180,140,40,2
06-02-2025,"Grains, Flours & Dals",Wheat Flour 1 kg,4,210,180,30,3
06-02-2025,Spices & Seasonings,Chilli powder 500 gms,15,290,210,80,1
06-02-2025,"Grains, Flours & Dals",White jowar.F 1 kg,4,100,80,20,1
06-02-2025,"Grains, Flours & Dals",Bajra Flour 1 kg,4,70,60,10,1
06-02-2025,"Grains, Flours & Dals",RAGI FLOUR 1KG,4,80,70,10,1
06-02-2025,"Grains, Flours & Dals",turdal 500 gms,4,110,100,10,1
06-02-2025,Spices & Seasonings,NUVVULU 500GM,15,200,170,30,1
06-02-2025,"Grains, Flours & Dals",RAGI FLOUR 1KG,4,80,70,10,1
06-02-2025,Snacks & Ready-to-Eat,NGT CHATPATTA CHANA 90GM,14,25,25,0,1
06-02-2025,Milk & Dairy,SANGAM TONED MILK 500ML,7,30,30,0,1
05-02-2025,Snacks & Ready-to-Eat,SD GAVVALU JAGGERY,14,95,95,0,1
05-02-2025,"Dry Fruits, Nuts & Seeds",ROASTED FLAXSEED,2,75,75,0,1
05-02-2025,"Dry Fruits, Nuts & Seeds",YB GRANMA NUTS,2,180,180,0,2
05-02-2025,Personal Care & Cosmetics,SVE PREMIUM WILD TURMEIC 100GM,10,110,110,0,1
05-02-2025,Snacks & Ready-to-Eat,SD Flax seeds with dates 250gm,14,135,135,0,1
05-02-2025,"Grains, Flours & Dals",Multigrain 1 kg,4,100,85,15,1
05-02-2025,"Grains, Flours & Dals",White jowar.F 1 kg,4,100,80,20,1
05-02-2025,"Grains, Flours & Dals",SRILALITHA MAIDA FLOUR 500G,4,32,32,0,1
05-02-2025,Oils & Ghee,Groundnut oil 1 L,9,720,660,60,2
05-02-2025,Milk & Dairy,BROWN EGGS TRAY 30P,7,360,330,30,1
05-02-2025,"Health, Wellness & Ayurvedic Products",MD Kasturi Pasupu Choornam 50GM,5,80,80,0,1
05-02-2025,Spices & Seasonings,GS Moringa Leaves Spicy Powder 100GM,15,90,90,0,1
05-02-2025,Oils & Ghee,Coconut oil 500 ml,9,220,200,20,1
05-02-2025,Personal Care & Cosmetics,MULTANI MITTI CHOORNAM,10,40,40,0,1
05-02-2025,"Grains, Flours & Dals",Wheat Flour 1 kg,4,70,60,10,1
05-02-2025,Snacks & Ready-to-Eat,NGT CHATPATTA CHANA 90GM,14,25,25,0,1
05-02-2025,Snacks & Ready-to-Eat,SD Little Millet WITH PLAM JAGGERY,14,135,135,0,1
05-02-2025,Milk & Dairy,BROWN EGGS 1P,7,168,144,24,12
05-02-2025,Snacks & Ready-to-Eat,Corn Chips 250GM,14,40,35,5,1
05-02-2025,Spices & Seasonings,Tamarind 250GMS,15,80,65,15,1
05-02-2025,Milk & Dairy,BROWN EGGS 1P,7,84,72,12,6
05-02-2025,Oils & Ghee,Coconut oil 500 ml,9,220,200,20,1
05-02-2025,"Grains, Flours & Dals",SB Javva Wheat Ravva 500GM,4,95,95,0,1
05-02-2025,"Grains, Flours & Dals",SINGLE POLISH 1KG,4,325,325,0,5
05-02-2025,Sweeteners,MISHRI 250 GM,16,35,30,5,1
05-02-2025,"Grains, Flours & Dals",Red Wheat Flour 1 kg,4,140,130,10,1
05-02-2025,Milk & Dairy,SANGAM CURD 450GM,7,38,38,0,1
05-02-2025,"Health, Wellness & Ayurvedic Products",RB Max Protein Salt & Caramel Bar 50g,5,75,75,0,1
05-02-2025,Milk & Dairy,SANGAM CURD 450GM,7,38,38,0,1
05-02-2025,"Grains, Flours & Dals",RAGI FLOUR 500GRMS,4,40,35,5,1
05-02-2025,Sweeteners,MISHRI 250 GM,16,35,30,5,1
05-02-2025,"Health, Wellness & Ayurvedic Products",DWI MANDARA TAILAM 200ML,5,280,280,0,1
05-02-2025,"Dry Fruits, Nuts & Seeds",SD Mango cubes 200gm,2,90,90,0,1
05-02-2025,"Grains, Flours & Dals",turdal 1kg,4,220,195,25,1
05-02-2025,"Grains, Flours & Dals",Idly Rava L 1KG,4,120,100,20,2
05-02-2025,Spices & Seasonings,AVALU 100GM,15,25,20,5,1
05-02-2025,Snacks & Ready-to-Eat,SESAME LADDU 200GM,14,100,80,20,1
05-02-2025,"Grains, Flours & Dals",SA Multi Grain Mix 500GM,4,159,159,0,1
05-02-2025,Snacks & Ready-to-Eat,BATANA NGT 70GMS,14,20,20,0,1
05-02-2025,Snacks & Ready-to-Eat,VD PANIPURI 100GM,14,30,30,0,1
05-02-2025,Spices & Seasonings,NUVVULU 250GM,15,100,85,15,1
05-02-2025,Oils & Ghee,Groundnut oil 1 L,9,360,330,30,1
05-02-2025,"Grains, Flours & Dals",PESARA PAPPU 1 KG,4,170,145,25,1
05-02-2025,"Grains, Flours & Dals",Urad dall 1 Kg,4,185,170,15,1
05-02-2025,"Grains, Flours & Dals",THIN POHA 500GM,4,40,35,5,1
05-02-2025,Spices & Seasonings,ROYAL SAFFRON 400GRMS,15,130,130,0,2
05-02-2025,Sweeteners,Mishri 500GM,16,140,120,20,2
05-02-2025,"Grains, Flours & Dals",chanadall 250 gms,4,0,0,0,1
05-02-2025,"Grains, Flours & Dals",THIN POHA 500GM,4,40,35,5,1
05-02-2025,Spices & Seasonings,DRY MIECHI 200GM,15,80,60,20,1
05-02-2025,"Dry Fruits, Nuts & Seeds",PUTNALU 500GMS,2,180,152,28,2
05-02-2025,Spices & Seasonings,Turmeric powder 250 gms,15,100,75,25,1
05-02-2025,Oils & Ghee,BUFFALLO GHEE 500ML,9,410,370,40,1
05-02-2025,Spices & Seasonings,Coriander seeds 200 gms,15,48,40,8,1
05-02-2025,"Grains, Flours & Dals",split green gram 500 gms,4,75,70,5,1
05-02-2025,"Grains, Flours & Dals",BARLEY FLOUR 250GM,4,45,40,5,1
05-02-2025,"Grains, Flours & Dals",white Bobarlu 500 gms,4,80,75,5,1
05-02-2025,Personal Care & Cosmetics,stay free 1,10,100,100,0,1
05-02-2025,Spices & Seasonings,ROYAL SAFFRON,15,125,125,0,1
05-02-2025,"Grains, Flours & Dals",RAJMA 250GM,4,55,45,10,1
05-02-2025,"Grains, Flours & Dals",turdal 500 gms,4,110,100,10,1
05-02-2025,"Dry Fruits, Nuts & Seeds",DIANUTS 500GM,2,240,240,0,2
05-02-2025,Sweeteners,GS Palm Jaggery Powder 400GM,16,180,180,0,1
05-02-2025,Spices & Seasonings,Tamarind 250GMS,15,160,130,30,2
05-02-2025,"Grains, Flours & Dals",Wheat Flour 1 kg,4,140,120,20,2
05-02-2025,Spices & Seasonings,Jeera 100GM,15,50,45,5,1
05-02-2025,Spices & Seasonings,LG 50GM,15,92,92,0,1
05-02-2025,"Grains, Flours & Dals",SABDANA 500GM,4,90,70,20,1
05-02-2025,"Grains, Flours & Dals",White Chana 250 GM,4,60,50,10,1
05-02-2025,"Grains, Flours & Dals",PESARA PAPPU 500GMS,4,85,75,10,1
05-02-2025,Milk & Dairy,SANGAM FULL CREAM MILK 500ML,7,38,38,0,1
05-02-2025,Snacks & Ready-to-Eat,VD MURUKU 175GM,14,60,60,0,1
05-02-2025,"Grains, Flours & Dals",Yellow jowar .F1 kg,4,110,100,10,1
05-02-2025,Snacks & Ready-to-Eat,RSC ORANGE 100GMS,14,20,20,0,1
05-02-2025,"Grains, Flours & Dals",RAGI FLOUR 1KG,4,80,70,10,1
05-02-2025,"Grains, Flours & Dals",Wheat Flour 1 kg,4,70,60,10,1
05-02-2025,"Grains, Flours & Dals",Green gram 500 gms,4,75,70,5,1
05-02-2025,"Grains, Flours & Dals",RAGI FLOUR 500GRMS,4,40,35,5,1
05-02-2025,"Dry Fruits, Nuts & Seeds",FLAX SEEDS 250GM,2,60,50,10,1
05-02-2025,Oils & Ghee,Groundnut oil 1 L,9,720,660,60,2
05-02-2025,"Grains, Flours & Dals",RAGI FLOUR 500GRMS,4,40,35,5,1
05-02-2025,"Grains, Flours & Dals",Wheat Flour 1 kg,4,70,60,10,1
05-02-2025,"Grains, Flours & Dals",White jowar.F 500 Gms,4,50,40,10,1
05-02-2025,"Grains, Flours & Dals",JOWAR WHITE 1 KG,4,40,35,5,0.5
05-02-2025,Personal Care & Cosmetics,GOW DURBAR NAVA 100GM SOAP,10,80,80,0,2
05-02-2025,"Grains, Flours & Dals",RAGULU 1 KG,4,35,30,5,0.5
05-02-2025,Snacks & Ready-to-Eat,SAJJA GAVVALU,14,95,95,0,1
05-02-2025,"Grains, Flours & Dals",Em jowar idly R 500G,4,75,75,0,1
05-02-2025,"Grains, Flours & Dals",idly/Dosa rice 1 kg,4,140,120,20,2
05-02-2025,"Grains, Flours & Dals",Brown RICE 1KG,4,70,65,5,1
05-02-2025,"Grains, Flours & Dals",Wheat Flour 1 kg,4,140,120,20,2
05-02-2025,"Grains, Flours & Dals",RAGI FLOUR 1KG,4,80,70,10,1
05-02-2025,Spices & Seasonings,ROYAL SAFFRON,15,125,125,0,1
05-02-2025,Oils & Ghee,Groundnut oil 1 L,9,360,330,30,1
05-02-2025,Oils & Ghee,Sesame oil 1 L,9,590,560,30,1
05-02-2025,Personal Care & Cosmetics,SVE PREMIUM PAPAYA SOAP 100GM,10,110,110,0,1
05-02-2025,"Health, Wellness & Ayurvedic Products",MH Millets Malt 500GM,5,200,190,10,1
05-02-2025,"Dry Fruits, Nuts & Seeds",PULMAKHANA 100 GM,2,180,170,10,1
05-02-2025,Personal Care & Cosmetics,MD HERBAL HAIR SHAMPOO,10,300,270,30,1
05-02-2025,"Dry Fruits, Nuts & Seeds",SATHVI CHIA SEEDS 100GM,2,300,240,60,3
05-02-2025,"Grains, Flours & Dals",Red Wheat Flour 1 kg,4,280,260,20,2
05-02-2025,Spices & Seasonings,PRO SESAME 200GM,15,284,284,0,2
05-02-2025,"Grains, Flours & Dals",Brown rice 5 kgs,4,350,325,25,1
05-02-2025,"Grains, Flours & Dals",VGR RICE 5 KGS,4,350,325,25,1
05-02-2025,Oils & Ghee,Coconut oil 1 L,9,440,400,40,1
05-02-2025,Spices & Seasonings,Vamu 100GM,15,60,50,10,1
05-02-2025,Spices & Seasonings,Jeera 100GM,15,50,45,5,1
05-02-2025,Oils & Ghee,Sesame oil 1 L,9,590,560,30,1
05-02-2025,Sweeteners,YB JAGGERY POWDER 1KG,16,280,280,0,2
05-02-2025,"Grains, Flours & Dals",DOCTOR RICE DIABETIC SFR 1KG,4,120,120,0,1
05-02-2025,Oils & Ghee,Groundnut oil 1 L,9,360,330,30,1
05-02-2025,"Grains, Flours & Dals",Wheat Rava M 1KG,4,65,55,10,1
05-02-2025,Milk & Dairy,BROWN EGGS TRAY 30P,7,360,330,30,1
05-02-2025,Sweeteners,YB JAGGERY POWDER 1KG,16,140,140,0,1
05-02-2025,Snacks & Ready-to-Eat,SD Pumpkin Seeds With Dates 175gm,14,170,170,0,1
05-02-2025,Snacks & Ready-to-Eat,PEANUT CHIKKI 450GM,14,125,125,0,1
05-02-2025,Pooja & Spiritual Items,SWASTIK CAMPHORE,12,180,180,0,2
05-02-2025,Spices & Seasonings,DRY MIECHI 200GM,15,80,60,20,1
05-02-2025,Snacks & Ready-to-Eat,RAJGIRA PEANUT CHIKKI 450GM,14,125,125,0,1
05-02-2025,Snacks & Ready-to-Eat,SD Sesame laddu with dates250gm,14,135,135,0,1
05-02-2025,Personal Care & Cosmetics,WHISPER NIGHTS XL+ 45 PADS,10,330,330,0,1
05-02-2025,Snacks & Ready-to-Eat,ZEEDI,14,140,140,0,2
05-02-2025,Sweeteners,KAMAL JAGGERY 500GM,16,40,40,0,1
05-02-2025,Personal Care & Cosmetics,WHISPER NIGHTS XXL+350MM 6PADS,10,130,130,0,1
05-02-2025,Sweeteners,ACHU BELLAM 1KG,16,100,80,20,1
05-02-2025,Sweeteners,SUGAR 1KG,16,60,50,10,1
05-02-2025,Pooja & Spiritual Items,GD KUMKUM 50GM,12,30,30,0,1
05-02-2025,Snacks & Ready-to-Eat,VD Minapa papad 200gm,14,60,60,0,1
05-02-2025,Snacks & Ready-to-Eat,SD Groundnut with palm jaggery 250gm,14,135,135,0,1
05-02-2025,Snacks & Ready-to-Eat,VD DAHI MIRCHI(SALTED) 100GM,14,45,45,0,1
05-02-2025,Snacks & Ready-to-Eat,MARMURA LADDU,14,80,60,20,1
05-02-2025,Snacks & Ready-to-Eat,BATANA NGT 70GMS,14,20,20,0,1
05-02-2025,Snacks & Ready-to-Eat,VD RICE SAGO PAPAD 150GM,14,55,55,0,1
05-02-2025,"Grains, Flours & Dals",Wheat Flour 1 kg,4,70,60,10,1
05-02-2025,"Grains, Flours & Dals",Multigrain 1 kg,4,200,170,30,2
05-02-2025,Oils & Ghee,Coconut oil 500 ml,9,220,200,20,1
05-02-2025,"Grains, Flours & Dals",THICK POHA 500GM,4,40,35,5,1
05-02-2025,"Grains, Flours & Dals",PESARA PAPPU 500GMS,4,85,75,10,1
05-02-2025,Snacks & Ready-to-Eat,RB Choco Delite Almonds Raisins 40g,14,90,90,0,2
05-02-2025,General Household & Kitchenware,VERMI COMPOST MIX,3,30,30,0,1
05-02-2025,"Grains, Flours & Dals",idly/Dosa rice 1 kg,4,70,60,10,1
05-02-2025,"Grains, Flours & Dals",SA WHITE JOWAR RAVA 500GM,4,69,69,0,1
05-02-2025,"Grains, Flours & Dals",FLOUR CHARGE,4,12,12,0,1
05-02-2025,Spices & Seasonings,Dalchin Rolls 50GM,15,70,70,0,1
05-02-2025,"Grains, Flours & Dals",Red Chana 500 GM,4,75,60,15,1
05-02-2025,Snacks & Ready-to-Eat,BB VERMICELLI 250GM,14,30,30,0,1
05-02-2025,Household & Cleaning,PITAMBARI,6,28,28,0,1
05-02-2025,Household & Cleaning,GAJANAND BLACK DRAGN 10STI,6,20,20,0,1
05-02-2025,"Grains, Flours & Dals",WHEAT 1 KG,4,60,50,10,1
05-02-2025,Pooja & Spiritual Items,SWATHI POOJA VATHULU,12,50,50,0,1
05-02-2025,Personal Care & Cosmetics,VASELINE 5GM,10,5,5,0,1
05-02-2025,Spices & Seasonings,PURO Healthy Salt 1KG,15,110,110,0,1
05-02-2025,Spices & Seasonings,NUVVULU 250GM,15,100,85,15,1
05-02-2025,Pooja & Spiritual Items,SWASTIK CAMPHOR 25GM,12,45,45,0,1
05-02-2025,Spices & Seasonings,SH CASSIA STICKS 50GM,15,75,75,0,1
05-02-2025,Spices & Seasonings,Poonam Mixed Masala 50GM,15,90,90,0,1
05-02-2025,Spices & Seasonings,Japatri 25GM,15,100,80,20,1
05-02-2025,"Grains, Flours & Dals",BASMATHI RICE 1KG,4,300,270,30,2
05-02-2025,"Grains, Flours & Dals",SINGLE POLISH 1KG,4,325,325,0,5
05-02-2025,"Health, Wellness & Ayurvedic Products",MXP CHOCO CLASSIC BAR,5,70,70,0,1
05-02-2025,Sweeteners,MADHUR SUGAR 1KG,16,130,110,20,2
05-02-2025,Personal Care & Cosmetics,GOW DURBAR 75G,10,60,60,0,1
05-02-2025,Snacks & Ready-to-Eat,VD RED CHILLI RICEPAPAD 150GM,14,50,50,0,1
05-02-2025,Snacks & Ready-to-Eat,VD RICE SAGO PAPAD 150GM,14,55,55,0,1
05-02-2025,"Grains, Flours & Dals",SINGLE POLISH 1KG,4,130,130,0,2
05-02-2025,Household & Cleaning,GAJANAND BLACK DRAGN 10STI,6,60,60,0,3
05-02-2025,"Health, Wellness & Ayurvedic Products",RB Max Protein Salt & Caramel Bar 50g,5,75,75,0,1
05-02-2025,"Grains, Flours & Dals",turdal 1kg,4,220,195,25,1
05-02-2025,Snacks & Ready-to-Eat,COPRA LADDU 200GM,14,100,80,20,1
05-02-2025,"Grains, Flours & Dals",SOYA BEANS 1KG,4,100,90,10,0.5
05-02-2025,"Grains, Flours & Dals",RAJMA 250GM,4,55,45,10,1
05-02-2025,"Grains, Flours & Dals",VGR RICE bag 1,4,1899,"1,650.00",249,1
05-02-2025,Spices & Seasonings,AVALU 100GM,15,25,20,5,1
05-02-2025,Snacks & Ready-to-Eat,RINGS 200GM,14,30,30,0,1
05-02-2025,Spices & Seasonings,DRY MIECHI 200GM,15,80,60,20,1
05-02-2025,"Grains, Flours & Dals",CHANA DAL 500GM,4,70,60,10,1
05-02-2025,Snacks & Ready-to-Eat,3D PAPAD,14,40,40,0,1
05-02-2025,"Dry Fruits, Nuts & Seeds",PUTNALU 500GMS,2,90,76,14,1
05-02-2025,"Grains, Flours & Dals",split urad dall 500 gms,4,90,80,10,1
05-02-2025,"Grains, Flours & Dals",Urad dall 1 Kg,4,185,170,15,1
05-02-2025,Snacks & Ready-to-Eat,VD SAGOPAPAD 150GM,14,55,55,0,1
05-02-2025,"Grains, Flours & Dals",Green gram 1 kg,4,150,130,20,1
05-02-2025,Snacks & Ready-to-Eat,VD DAHI MIRCHI(SALTED) 100GM,14,45,45,0,1
05-02-2025,Spices & Seasonings,Miriyalu 50GM,15,100,80,20,1
05-02-2025,"Dry Fruits, Nuts & Seeds",Groundnuts 1 kg,2,190,170,20,1
05-02-2025,Sweeteners,YB Brown Sugar 500GM,16,75,75,0,1
05-02-2025,"Grains, Flours & Dals",Em jowar idly R 500G,4,75,75,0,1
05-02-2025,Snacks & Ready-to-Eat,VD RICE MURUKU 150GM,14,50,50,0,1
05-02-2025,"Health, Wellness & Ayurvedic Products",RB Peanut butter Peanuts Dark 40g,5,45,45,0,1
05-02-2025,"Health, Wellness & Ayurvedic Products",RB Max Protein Fruit &amp;Nut 50g,5,75,75,0,1
05-02-2025,Spices & Seasonings,Tamarind 250GMS,15,80,65,15,1
05-02-2025,"Health, Wellness & Ayurvedic Products",RB Max Protein Choco chips 55gm,5,50,50,0,1
05-02-2025,"Grains, Flours & Dals",RAGULU 1 KG,4,35,30,5,0.5
05-02-2025,"Health, Wellness & Ayurvedic Products",RB Max Protein Choco Almond bar 50g,5,75,75,0,1
05-02-2025,Snacks & Ready-to-Eat,RI Yogurt Berry Oats 35g,14,45,45,0,1
05-02-2025,Snacks & Ready-to-Eat,SATHVI REGIVADA 200GM,14,80,60,20,1
05-02-2025,Snacks & Ready-to-Eat,SD MASALA GAVVALU 200GM,14,95,95,0,1
05-02-2025,"Grains, Flours & Dals",SINGLE POLISH 1KG,4,325,325,0,5
05-02-2025,Milk & Dairy,HERITAGE TONED MILK 500ML,7,62,62,0,2
05-02-2025,"Grains, Flours & Dals",BAJRA 1 KG,4,30,25,5,0.5
05-02-2025,"Grains, Flours & Dals",KORRALU (FOXTAIL M) 500GM,4,195,165,30,3
05-02-2025,"Grains, Flours & Dals",RAGULU 1 KG,4,35,30,5,0.5
05-02-2025,Snacks & Ready-to-Eat,ZEEDI,14,70,70,0,1
05-02-2025,Oils & Ghee,Groundnut oil 1 L,9,360,330,30,1
05-02-2025,"Dry Fruits, Nuts & Seeds",Groundnuts 1 kg,2,190,170,20,1
05-02-2025,"Dry Fruits, Nuts & Seeds",GF DATES 500GM,2,156,149,7,1
05-02-2025,Spices & Seasonings,SH CLOVES 30GM,15,95,95,0,1
05-02-2025,"Dry Fruits, Nuts & Seeds",GF KIMIA DATES 500GM,2,310,190,120,1
05-02-2025,Oils & Ghee,Coconut oil 500 ml,9,220,200,20,1
05-02-2025,Spices & Seasonings,PRO SESAME 200GM,15,142,142,0,1
05-02-2025,Spices & Seasonings,SONTI 50GM,15,30,20,10,1
05-02-2025,Sweeteners,MISHRI 250 GM,16,35,30,5,1
05-02-2025,Spices & Seasonings,SD Garlic Karam Powder 100GM,15,65,65,0,1
05-02-2025,Spices & Seasonings,SREE MARUTHI IDLY KARAM 200GM,15,300,300,0,5
05-02-2025,Oils & Ghee,Sesame oil 1 L,9,590,560,30,1
05-02-2025,Oils & Ghee,Coconut oil 500 ml,9,220,200,20,1
05-02-2025,Sweeteners,YB Brown Sugar 500GM,16,75,75,0,1
05-02-2025,Spices & Seasonings,Japatri 25GM,15,100,80,20,1
05-02-2025,Spices & Seasonings,JEERA 250 gms,15,125,105,20,1
05-02-2025,Spices & Seasonings,DRY MIECHI 200GM,15,80,60,20,1
05-02-2025,"Grains, Flours & Dals",idly/Dosa rice 1 kg,4,140,120,20,2
05-02-2025,"Dry Fruits, Nuts & Seeds",CASHEW 250GM,2,340,310,30,1
05-02-2025,Spices & Seasonings,DURGA SALT CRYSTAL 1KG,15,25,25,0,1
05-02-2025,"Dry Fruits, Nuts & Seeds",BLACK KISMIS 250GM,2,175,140,35,1
05-02-2025,"Dry Fruits, Nuts & Seeds",PLAIN PISTA 250GM,2,660,550,110,1
05-02-2025,Personal Care & Cosmetics,Soapnut 250GM,10,45,45,0,1
05-02-2025,Spices & Seasonings,NUVVULU 250GM,15,160,130,30,2
05-02-2025,"Grains, Flours & Dals",THICK POHA 500GM,4,40,35,5,1
05-02-2025,"Grains, Flours & Dals",AMMA RICE RAVA 500GRMS,4,84,84,0,2
05-02-2025,"Dry Fruits, Nuts & Seeds",SATHVI CHIA SEEDS 100GM,2,100,80,20,1
05-02-2025,Spices & Seasonings,Tamarind 250GMS,15,80,65,15,1
05-02-2025,"Grains, Flours & Dals",Wheat Flour 1 kg,4,140,120,20,2
05-02-2025,Spices & Seasonings,Avalu small 250 gms,15,60,40,20,1
05-02-2025,"Grains, Flours & Dals",RAGI FLOUR 500GRMS,4,80,70,10,2
05-02-2025,Oils & Ghee,Flaxseed oil 500 ml,9,300,270,30,1
05-02-2025,"Grains, Flours & Dals",Wheat Rava M 1KG,4,65,55,10,1
05-02-2025,"Health, Wellness & Ayurvedic Products",RB Max Protein Soft &Chewy 55gm,5,50,50,0,1
05-02-2025,"Grains, Flours & Dals",UDALU (Barnyard millet) 1 kg,4,140,115,25,1
05-02-2025,"Grains, Flours & Dals",SAMALU (Little millet) 1 kg,4,170,130,40,1
05-02-2025,"Dry Fruits, Nuts & Seeds",FLAX SEEDS 250GM,2,60,50,10,1
05-02-2025,Oils & Ghee,Groundnut oil 5 L,9,1800,"1,600.00",200,1
05-02-2025,"Grains, Flours & Dals",SL Idly Rava 1KG,4,130,110,20,2
05-02-2025,Spices & Seasonings,PURO Healthy Salt 1KG,15,220,220,0,2
05-02-2025,"Dry Fruits, Nuts & Seeds",ALMONDS 250GM,2,280,260,20,1
05-02-2025,"Dry Fruits, Nuts & Seeds",WATERMELON SEEDS 250GRM,2,320,280,40,1
05-02-2025,"Dry Fruits, Nuts & Seeds",PUMPKIN SEEDS 250GM,2,200,160,40,1
05-02-2025,"Grains, Flours & Dals",Bajra Flour 1 kg,4,70,60,10,1
05-02-2025,"Grains, Flours & Dals",RICE FLOUR 1KG,4,140,110,30,2
05-02-2025,"Grains, Flours & Dals",Chana Flour 1 kg,4,140,130,10,1
05-02-2025,Spices & Seasonings,BLACK JEERA 50 GM,15,45,30,15,1
05-02-2025,"Health, Wellness & Ayurvedic Products",PODAPATRI CHOORNAM,5,100,100,0,1
05-02-2025,"Health, Wellness & Ayurvedic Products",JAMBU SEED CHOORNAM 100GM,5,80,80,0,1
05-02-2025,"Health, Wellness & Ayurvedic Products",MD Aamlaki Choornam 100GM,5,80,80,0,1
05-02-2025,Snacks & Ready-to-Eat,PALLI LADDU 200GMS,14,180,140,40,2
05-02-2025,Snacks & Ready-to-Eat,NGT CHATPATTA CHANA 90GM,14,25,25,0,1
05-02-2025,Snacks & Ready-to-Eat,SESAME LADDU 200GM,14,100,80,20,1
05-02-2025,Snacks & Ready-to-Eat,VD PAPPU CHEGODI 200GM,14,60,60,0,1
05-02-2025,Snacks & Ready-to-Eat,VD MURUKU 175GM,14,60,60,0,1
05-02-2025,Snacks & Ready-to-Eat,COPRA LADDU 200GM,14,200,160,40,2
05-02-2025,Snacks & Ready-to-Eat,SD Bajra with palm Jaggery 250gm,14,135,135,0,1
05-02-2025,Snacks & Ready-to-Eat,RSC ORANGE 100GMS,14,20,20,0,1
05-02-2025,"Grains, Flours & Dals",FLOUR CHARGE,4,31.2,31.2,0,2.6
05-02-2025,"Health, Wellness & Ayurvedic Products",RB Max Protein Chinese Manchurian,5,45,45,0,1
05-02-2025,"Grains, Flours & Dals",Red Bobarlu 500 gms,4,95,85,10,1
05-02-2025,"Grains, Flours & Dals",SA Sprouted Ragi Flour 500GM,4,69,69,0,1
05-02-2025,Snacks & Ready-to-Eat,VD PAPPU CHEGODI 200GM,14,60,60,0,1
05-02-2025,"Dry Fruits, Nuts & Seeds",PULMAKHANA 100 GM,2,180,170,10,1
05-02-2025,Snacks & Ready-to-Eat,VD SANNAPUSA 175GM,14,60,60,0,1
05-02-2025,"Grains, Flours & Dals",Bombay Rava 500GM,4,35,30,5,1
05-02-2025,Pooja & Spiritual Items,999 SINGAPORE DHOOP POW 50GM,12,35,35,0,1
05-02-2025,"Dry Fruits, Nuts & Seeds",PUMPKIN SEEDS 250GM,2,200,160,40,1
05-02-2025,Spices & Seasonings,NUVVULU 500GM,15,160,130,30,1
05-02-2025,"Dry Fruits, Nuts & Seeds",SUNFLOWER SEEDS 250GRM,2,150,130,20,1
05-02-2025,"Dry Fruits, Nuts & Seeds",WALLNUTS 250GM,2,320,290,30,1
05-02-2025,"Grains, Flours & Dals",Red Wheat Flour 1 kg,4,140,130,10,1
05-02-2025,"Grains, Flours & Dals",MAATEJA rice 1 kg,4,720,690,30,10
05-02-2025,"Grains, Flours & Dals",turdal 1kg,4,220,195,25,1
05-02-2025,Oils & Ghee,Groundnut oil 1 L,9,360,330,30,1
05-02-2025,Oils & Ghee,Coconut oil 500 ml,9,220,200,20,1
05-02-2025,"Grains, Flours & Dals",Wheat Flour 1 kg,4,70,60,10,1
05-02-2025,Milk & Dairy,BROWN EGGS 1P,7,168,144,24,12
05-02-2025,Spices & Seasonings,Tamarind 500GM,15,160,130,30,1
05-02-2025,"Grains, Flours & Dals",PESARA PAPPU 1 KG,4,170,145,25,1
05-02-2025,"Dry Fruits, Nuts & Seeds",PUTNALU 500GMS,2,90,76,14,1
05-02-2025,Sweeteners,YB Brown Sugar 1KG,16,140,140,0,1
05-02-2025,"Dry Fruits, Nuts & Seeds",FLAX SEEDS 250GM,2,60,50,10,1
05-02-2025,"Grains, Flours & Dals",PRO ORG MEDIUM POHA 500G,4,78,78,0,1
05-02-2025,"Grains, Flours & Dals",DISANO OATS 1KG,4,142,142,0,1
05-02-2025,Sweeteners,MISHRI D,16,40,30,10,1
05-02-2025,"Grains, Flours & Dals",RAGI FLOUR 1KG,4,80,70,10,1
05-02-2025,Oils & Ghee,Coconut oil 500 ml,9,220,200,20,1
05-02-2025,"Grains, Flours & Dals",Sathya Javva Wheat Rava 500GM,4,95,95,0,1
05-02-2025,Household & Cleaning,TIDE MATIC TL 850ML,6,179,179,0,1
05-02-2025,Spices & Seasonings,SATHVI ANASAPUVUU 25GM,15,90,65,25,1
05-02-2025,"Grains, Flours & Dals",MAAGAANI MM KHAPLI ATTA 1KG,4,199,199,0,1
05-02-2025,Beverages,BRU GREEN LABEL 1.2G,1,24,24,0,12
05-02-2025,Snacks & Ready-to-Eat,SATHVI MIXED CHIKKI 200GM,14,120,100,20,1
05-02-2025,Spices & Seasonings,Japatri 25GM,15,100,80,20,1
05-02-2025,"Grains, Flours & Dals",White jowar.F 1 kg,4,100,80,20,1
05-02-2025,Snacks & Ready-to-Eat,VD BOONDI 175GM,14,60,60,0,1
05-02-2025,Snacks & Ready-to-Eat,SD GINGER CANDY 200GM,14,120,120,0,1
05-02-2025,Spices & Seasonings,Turmeric powder 250 gms,15,100,75,25,1
05-02-2025,Personal Care & Cosmetics,SVE RED SANDAL SOAP 100GM,10,100,100,0,1
05-02-2025,"Health, Wellness & Ayurvedic Products",MD Vibhithaki Choornam 100GM,5,60,60,0,1
05-02-2025,Oils & Ghee,Coconut oil 1 L,9,440,400,40,1
05-02-2025,Sweeteners,GS Palm Jaggery Powder 400GM,16,180,180,0,1
05-02-2025,Snacks & Ready-to-Eat,MB MULTIMILLET NOODLES 180GM,14,95,95,0,1
05-02-2025,Oils & Ghee,Sesame oil 1 L,9,590,560,30,1
05-02-2025,Snacks & Ready-to-Eat,COPRA LADDU 200GM,14,100,80,20,1
05-02-2025,Milk & Dairy,BROWN EGGS TRAY 30P,7,360,330,30,1
05-02-2025,Snacks & Ready-to-Eat,jeera papad,14,80,80,0,1
05-02-2025,Snacks & Ready-to-Eat,BATANA NGT 70GMS,14,20,20,0,1
05-02-2025,Oils & Ghee,Groundnut oil 1 L,9,720,660,60,2
05-02-2025,Snacks & Ready-to-Eat,ONION RINGS,14,50,50,0,1
05-02-2025,"Grains, Flours & Dals",JOWAR WHITE 1 KG,4,40,35,5,0.5
05-02-2025,Snacks & Ready-to-Eat,MORINGA LEAVES PAPAD 200GM,14,90,90,0,1
05-02-2025,"Grains, Flours & Dals",JOWAR YELLOW 1 K,4,25,22.5,2.5,0.25
05-02-2025,Snacks & Ready-to-Eat,Popcorn Seeds 250GM,14,45,40,5,1
05-02-2025,"Grains, Flours & Dals",SRILALITHA MAIDA FLOUR 500G,4,32,32,0,1
05-02-2025,Spices & Seasonings,Menthulu 250 gms,15,50,45,5,1
05-02-2025,Beverages,BRU GREEN LABEL 1.2G,1,12,12,0,6
05-02-2025,Spices & Seasonings,Jeera 100GM,15,50,45,5,1
05-02-2025,Snacks & Ready-to-Eat,Corn Chips 250GM,14,40,35,5,1
05-02-2025,"Grains, Flours & Dals",Wheat Flour 1 kg,4,70,60,10,1
05-02-2025,Personal Care & Cosmetics,COLGATE ACTIVE SALT,10,20,20,0,1
05-02-2025,"Grains, Flours & Dals",Urad dall 1 Kg,4,185,170,15,1
05-02-2025,Spices & Seasonings,Menthulu 250 gms,15,50,45,5,1
05-02-2025,"Grains, Flours & Dals",Wheat Flour 1 kg,4,140,120,20,2
05-02-2025,"Grains, Flours & Dals",doctor rice 1kg,4,720,720,0,6
05-02-2025,Oils & Ghee,Groundnut oil 1 L,9,360,330,30,1
05-02-2025,General Household & Kitchenware,IRN STL HDL KADAI 9,3,260,260,0,1
05-02-2025,"Grains, Flours & Dals",KORRALU (FOXTAIL M) 500GM,4,65,55,10,1
05-02-2025,"Grains, Flours & Dals",FLOUR CHARGE,4,36,36,0,3
05-02-2025,"Grains, Flours & Dals",Em Foxtail upma r 500 g,4,109,109,0,1
05-02-2025,"Grains, Flours & Dals",Multigrain 1 kg,4,100,85,15,1
05-02-2025,"Grains, Flours & Dals",SAMALU (Little millet) 500 gms,4,85,65,20,1
05-02-2025,"Grains, Flours & Dals",RICE FLOUR 1KG,4,70,55,15,1
05-02-2025,Oils & Ghee,Safflower oil 5 L,9,2200,"1,950.00",250,1
05-02-2025,Oils & Ghee,Coconut oil 1 L,9,440,400,40,1
05-02-2025,"Grains, Flours & Dals",FLOUR CHARGE,4,72,72,0,6
05-02-2025,"Grains, Flours & Dals",varalakshmi sabdana,4,77,69,8,1
05-02-2025,Personal Care & Cosmetics,DWI FOOT CARE 30G,10,90,90,0,1
05-02-2025,"Grains, Flours & Dals",HS Multimillet upma r 500g,4,65,65,0,1
05-02-2025,Snacks & Ready-to-Eat,BB ROASTED VERMICELLY 500GM,14,70,70,0,1
05-02-2025,Spices & Seasonings,Tamarind 500GM,15,160,130,30,1
05-02-2025,Personal Care & Cosmetics,HERBAL BATH POWDER,10,160,160,0,1
05-02-2025,Spices & Seasonings,Turmeric powder 250 gms,15,100,75,25,1
05-02-2025,Snacks & Ready-to-Eat,SD Bajra with palm Jaggery 250gm,14,135,135,0,1
05-02-2025,"Grains, Flours & Dals",Arikalu (kodo),4,70,65,5,1
05-02-2025,"Health, Wellness & Ayurvedic Products",MH Millets Malt 500GM,5,200,190,10,1
05-02-2025,"Grains, Flours & Dals",JOWAR YELLOW 1 K,4,100,90,10,1
05-02-2025,"Grains, Flours & Dals",SAMALU (Little millet) 500 gms,4,85,65,20,1
05-02-2025,"Grains, Flours & Dals",UDALU (Barnyard millet) 500 gms,4,70,60,10,1
05-02-2025,Snacks & Ready-to-Eat,COPRA LADDU 200GM,14,100,80,20,1
05-02-2025,"Grains, Flours & Dals",AISHWARYA SP 25KG,4,1999,"1,690.00",309,1
05-02-2025,"Grains, Flours & Dals",DOCTOR RICE DIABETIC SFR 1KG,4,720,720,0,6
05-02-2025,"Grains, Flours & Dals",SINGLE POLISH 1KG,4,650,650,0,10
05-02-2025,"Grains, Flours & Dals",SINGHAM 26KG BAG,4,1650,"1,650.00",0,1
05-02-2025,"Grains, Flours & Dals",Urad dall 1 Kg,4,185,170,15,1
05-02-2025,Oils & Ghee,Groundnut oil 1 L,9,1080,990,90,3
05-02-2025,Oils & Ghee,Sesame oil 1 L,9,590,560,30,1
05-02-2025,Oils & Ghee,Groundnut oil 5 L,9,1800,"1,600.00",200,1
05-02-2025,"Grains, Flours & Dals",Wheat Rava M 1KG,4,65,55,10,1
05-02-2025,"Grains, Flours & Dals",SL Idly Rava 1KG,4,65,55,10,1
05-02-2025,"Grains, Flours & Dals",CHANA DAL 1KG,4,140,120,20,1
05-02-2025,Spices & Seasonings,ROYAL SAFFRON,15,125,125,0,1
05-02-2025,"Grains, Flours & Dals",Bombay Rava 500GM,4,35,30,5,1
05-02-2025,"Grains, Flours & Dals",PESARA PAPPU 1 KG,4,170,145,25,1
05-02-2025,Sweeteners,SUGAR 1KG,16,120,100,20,2
05-02-2025,Spices & Seasonings,Jeera 100GM,15,50,45,5,1
05-02-2025,"Dry Fruits, Nuts & Seeds",Putnalu 250GM,2,45,38,7,1
05-02-2025,"Grains, Flours & Dals",Multigrain 1 kg,4,100,85,15,1
05-02-2025,Snacks & Ready-to-Eat,RAJGIRA PEANUT CHIKKI,14,50,50,0,10
05-02-2025,"Grains, Flours & Dals",Multigrain 1 kg,4,100,85,15,1
05-02-2025,"Grains, Flours & Dals",turdal 500 gms,4,110,100,10,1
05-02-2025,Household & Cleaning,VIM MAHA BAR,6,20,20,0,2
05-02-2025,"Dry Fruits, Nuts & Seeds",Groundnuts 500 gms,2,95,85,10,1
05-02-2025,Spices & Seasonings,Coriander seeds 200 gms,15,48,40,8,1
05-02-2025,Spices & Seasonings,JEERA 250 gms,15,125,105,20,1
05-02-2025,"Grains, Flours & Dals",VGR rice 1 kg,4,350,325,25,5
05-02-2025,Spices & Seasonings,Menthulu 250 gms,15,50,45,5,1
05-02-2025,Sweeteners,SUGAR 1KG,16,60,50,10,1
05-02-2025,Spices & Seasonings,ROYAL SAFFRON 400GRMS,15,65,65,0,1
05-02-2025,"Grains, Flours & Dals",Urad dall 1 Kg,4,185,170,15,1
05-02-2025,"Grains, Flours & Dals",White jowar.F 1 kg,4,200,160,40,2
05-02-2025,Spices & Seasonings,Avalu small 250 gms,15,60,40,20,1
05-02-2025,Spices & Seasonings,Elaichi 25GM,15,145,120,25,1
05-02-2025,Spices & Seasonings,Poonam Mixed Masala 50GM,15,90,90,0,1
05-02-2025,"Grains, Flours & Dals",SL Idly Rava 1KG,4,130,110,20,2
05-02-2025,Spices & Seasonings,Lavangam 50GM,15,60,50,10,1
05-02-2025,"Grains, Flours & Dals",Bombay Rava 500GM,4,35,30,5,1
05-02-2025,"Grains, Flours & Dals",turdal 1kg,4,220,195,25,1
05-02-2025,Household & Cleaning,EXO STEEL SCRUB,6,15,15,0,1
05-02-2025,Oils & Ghee,Sesame oil 500ml,9,295,280,15,1
05-02-2025,"Grains, Flours & Dals",KORRALU (FOXTAIL M) 1KG,4,150,110,40,1
05-02-2025,"Grains, Flours & Dals",RAGI FLOUR 1KG,4,80,70,10,1
05-02-2025,Milk & Dairy,SANGAM TONED MILK 500ML,7,30,30,0,1
05-02-2025,Milk & Dairy,SANGAM FULL CREAM MILK 500ML,7,38,38,0,1
05-02-2025,Milk & Dairy,SANGAM CURD 450GM,7,38,38,0,1
05-02-2025,Spices & Seasonings,Tamarind 250GMS,15,80,65,15,1
05-02-2025,"Grains, Flours & Dals",Wheat Rava S 1KG,4,65,55,10,1
05-02-2025,"Grains, Flours & Dals",BOMBAY RAVA,4,70,55,15,1
05-02-2025,Snacks & Ready-to-Eat,VD BELLAM GAVVALU 200GM,14,60,60,0,1
05-02-2025,Oils & Ghee,Black Sesame oil 500 ml,9,220,190,30,1
05-02-2025,Snacks & Ready-to-Eat,BD LITTLE MILLET NOODLES 200G,14,75,75,0,1
05-02-2025,Spices & Seasonings,PURO Healthy Salt 1KG,15,110,110,0,1
04-02-2025,Spices & Seasonings,SD IDLY KARAM,15,65,65,0,1
04-02-2025,"Grains, Flours & Dals",Wheat Rava M 500GM,4,33,30,3,1
04-02-2025,Snacks & Ready-to-Eat,VD BELLAM GAVVALU 200GM,14,60,60,0,1
04-02-2025,Snacks & Ready-to-Eat,VD PAPPU CHEGODI 200GM,14,60,60,0,1
04-02-2025,Snacks & Ready-to-Eat,PALLI LADDU 200GMS,14,90,70,20,1
04-02-2025,Oils & Ghee,Groundnut oil 1 L,9,360,330,30,1
04-02-2025,"Grains, Flours & Dals",RAGI FLOUR 1KG,4,80,70,10,1
04-02-2025,Personal Care & Cosmetics,HERBAL BATH POWDER 200GM,10,80,80,0,1
04-02-2025,"Grains, Flours & Dals",Sathya Javva Wheat Rava 500GM,4,95,95,0,1
04-02-2025,Oils & Ghee,Sesame oil 1 L,9,590,560,30,1
04-02-2025,Oils & Ghee,Groundnut oil 1 L,9,360,330,30,1
04-02-2025,Oils & Ghee,Groundnut oil 500ml,9,180,165,15,1
04-02-2025,"Grains, Flours & Dals",White Chana 500GM,4,120,100,20,1
04-02-2025,"Grains, Flours & Dals",RAJMA 500GM,4,90,90,0,1
04-02-2025,"Grains, Flours & Dals",white Bobarlu 500 gms,4,80,75,5,1
04-02-2025,Spices & Seasonings,SWEET SOUNF,15,20,20,0,1
04-02-2025,Personal Care & Cosmetics,COLGATE ACTIVE SALT,10,20,20,0,1
04-02-2025,"Health, Wellness & Ayurvedic Products",RB Max Protein Salt & Caramel Bar 50g,5,75,75,0,1
04-02-2025,"Health, Wellness & Ayurvedic Products",RB Max Protein Choco Almond bar 50g,5,75,75,0,1
04-02-2025,Oils & Ghee,Mustard oil 500 ml,9,220,195,25,1
04-02-2025,Household & Cleaning,SURFEXCEL BAR 80G,6,50,50,0,5
04-02-2025,"Grains, Flours & Dals",URAD DALL,4,95,85,10,1
04-02-2025,"Grains, Flours & Dals",PESARA PAPPU 500GMS,4,85,75,10,1
04-02-2025,Beverages,RED LABEL NATURAL CARE 100G,1,65,65,0,1
04-02-2025,"Dry Fruits, Nuts & Seeds",Groundnuts 500 gms,2,95,85,10,1
04-02-2025,Personal Care & Cosmetics,CLOSEUP,10,67,67,0,1
04-02-2025,Household & Cleaning,VIM SOAP,6,10,10,0,2
04-02-2025,Sweeteners,SUGAR 1KG,16,60,50,10,1
04-02-2025,Snacks & Ready-to-Eat,VD MAIDA CHEGODI 175GM,14,60,60,0,1
04-02-2025,Household & Cleaning,TIDE DOUBLE POWER JASMINE &amp;ROSE,6,66,66,0,1
04-02-2025,"Grains, Flours & Dals",turdal 500 gms,4,110,100,10,1
04-02-2025,Personal Care & Cosmetics,SANTOOR,10,50,50,0,5
04-02-2025,Snacks & Ready-to-Eat,VD MIXTURE 175 GM,14,60,60,0,1
04-02-2025,Snacks & Ready-to-Eat,BATANA NGT 70GMS,14,20,20,0,1
04-02-2025,Sweeteners,Natural Honey 500 gms,16,280,240,40,1
04-02-2025,Sweeteners,GS Organic Jaggery Powder 600GM,16,99,99,0,1
04-02-2025,Milk & Dairy,BROWN EGGS 1P,7,70,60,10,5
04-02-2025,"Dry Fruits, Nuts & Seeds",Groundnuts 500 gms,2,95,85,10,1
04-02-2025,"Grains, Flours & Dals",SA YELLOW JOWAR RAVA 500GM,4,95,95,0,1
04-02-2025,Snacks & Ready-to-Eat,SALTED PHALLI,14,25,25,0,1
04-02-2025,Snacks & Ready-to-Eat,NGT CHATPATTA CHANA 90GM,14,25,25,0,1
04-02-2025,Snacks & Ready-to-Eat,PALLI LADDU 200GMS,14,90,70,20,1
04-02-2025,Oils & Ghee,Sesame oil 1 L,9,590,560,30,1
04-02-2025,Snacks & Ready-to-Eat,SATHVI REGIVADA 200GM,14,80,60,20,1
04-02-2025,"Grains, Flours & Dals",Wheat Flour 2 kgs,4,140,120,20,1
04-02-2025,Snacks & Ready-to-Eat,SD DrybFruit LADDU WITH DATES 175GM,14,170,170,0,1
04-02-2025,Snacks & Ready-to-Eat,MARMURA LADDU,14,80,60,20,1
04-02-2025,Oils & Ghee,Groundnut oil 1 L,9,360,330,30,1
04-02-2025,Oils & Ghee,Flaxseed oil 500 ml,9,300,270,30,1
04-02-2025,Oils & Ghee,Sesame oil 1 L,9,590,560,30,1
04-02-2025,"Grains, Flours & Dals",Quinova 1 kg,4,440,390,50,2
04-02-2025,Spices & Seasonings,Jeera 100GM,15,50,45,5,1
04-02-2025,Snacks & Ready-to-Eat,VD ATUKULU MIXTURE 175GM,14,120,120,0,2
04-02-2025,Snacks & Ready-to-Eat,BATANA NGT 70GMS,14,60,60,0,3
04-02-2025,Spices & Seasonings,Coriander seeds 200 gms,15,48,40,8,1
04-02-2025,Snacks & Ready-to-Eat,VD Pappu Chekkalu 190gm,14,60,60,0,1
04-02-2025,Snacks & Ready-to-Eat,SAJJA GAVVALU,14,95,95,0,1
04-02-2025,Snacks & Ready-to-Eat,VD MIXTURE 175 GM,14,60,60,0,1
04-02-2025,Sweeteners,SD PALM JAGGERY 500GM,16,200,200,0,1
04-02-2025,Snacks & Ready-to-Eat,COPRA LADDU 200GM,14,100,80,20,1
04-02-2025,Snacks & Ready-to-Eat,BELLAM MINAPA SUNADULLU,14,180,180,0,1
04-02-2025,Snacks & Ready-to-Eat,SD FINGER Millet with palm Jaggery 250gm,14,135,135,0,1
04-02-2025,Snacks & Ready-to-Eat,SATHVI PALLI CHIKKI 200GM,14,100,80,20,1
04-02-2025,Snacks & Ready-to-Eat,SD Groundnut with palm jaggery 250gm,14,135,135,0,1
04-02-2025,Snacks & Ready-to-Eat,RSC ORANGE 100GMS,14,20,20,0,1
04-02-2025,Snacks & Ready-to-Eat,SD JOWAR WITH PALM JAGGERY 250GM,14,135,135,0,1
04-02-2025,"Grains, Flours & Dals",GS WHEAT POHA 200 GM,4,60,60,0,1
04-02-2025,Pooja & Spiritual Items,GD Yagnadhara 31PC,12,70,70,0,1
04-02-2025,"Dry Fruits, Nuts & Seeds",SABJA SEEDS 100GM,2,80,70,10,1
04-02-2025,"Dry Fruits, Nuts & Seeds",SATHVI CHIA SEEDS 100GM,2,100,80,20,1
04-02-2025,"Health, Wellness & Ayurvedic Products",MD Aamlaki Choornam 100GM,5,80,80,0,1
04-02-2025,Spices & Seasonings,Turmeric powder 250 gms,15,100,75,25,1
04-02-2025,"Health, Wellness & Ayurvedic Products",JAMBU SEED CHOORNAM 100GM,5,80,80,0,1
04-02-2025,Oils & Ghee,BUFFALLO GHEE 500ML,9,820,740,80,2
04-02-2025,Snacks & Ready-to-Eat,SF NOODLES CLKASSIC MASALA,14,129,129,0,1
04-02-2025,"Grains, Flours & Dals",turdal 1kg,4,220,195,25,1
04-02-2025,Spices & Seasonings,NUVVULU 500GM,15,200,170,30,1
04-02-2025,Oils & Ghee,Sesame oil 500ml,9,295,280,15,1
04-02-2025,Snacks & Ready-to-Eat,RB Choco Delite Almonds Raisins 40g,14,45,45,0,1
04-02-2025,"Health, Wellness & Ayurvedic Products",MORINGA LEAF POWDER M,5,80,75,5,1
04-02-2025,Snacks & Ready-to-Eat,RSC ORANGE 100GMS,14,20,20,0,1
04-02-2025,"Dry Fruits, Nuts & Seeds",SD Mango cubes 100gm,2,45,45,0,1
04-02-2025,Snacks & Ready-to-Eat,BATANA NGT 70GMS,14,40,40,0,2
04-02-2025,"Dry Fruits, Nuts & Seeds",GF DATES 500GM,2,156,156,0,1
04-02-2025,Snacks & Ready-to-Eat,VD CORNFLAKES MIXTURE 175GM,14,60,60,0,1
04-02-2025,Snacks & Ready-to-Eat,RAJGIRA PEANUT CHIKKI,14,45,45,0,9
04-02-2025,Snacks & Ready-to-Eat,VD ATUKULU MIXTURE 175GM,14,60,60,0,1
04-02-2025,Snacks & Ready-to-Eat,SF NOODLES CLKASSIC MASALA,14,129,129,0,1
04-02-2025,"Grains, Flours & Dals",FLOUR CHARGE,4,60,60,0,5
04-02-2025,Spices & Seasonings,SWEET SOUNF,15,20,20,0,1
04-02-2025,Snacks & Ready-to-Eat,MILLET PANCAKE CHOCOLATE,14,199,199,0,1
04-02-2025,"Health, Wellness & Ayurvedic Products",MADDI NEEM OIL 100ML,5,80,80,0,1
04-02-2025,Oils & Ghee,Coconut oil 500 ml,9,220,200,20,1
04-02-2025,Oils & Ghee,Groundnut oil 1 L,9,360,330,30,1
04-02-2025,Oils & Ghee,Groundnut oil 1 L,9,360,330,30,1
04-02-2025,Oils & Ghee,Sesame oil 1 L,9,590,560,30,1
04-02-2025,Oils & Ghee,Coconut oil 500 ml,9,220,200,20,1
04-02-2025,"Grains, Flours & Dals",Wheat Flour 1 kg,4,490,420,70,7
04-02-2025,Pooja & Spiritual Items,GD Dhoop Sticks 26GM,12,20,20,0,1
04-02-2025,Oils & Ghee,Black Sesame oil 500 ml,9,220,190,30,1
04-02-2025,Oils & Ghee,Black Sesame oil 500 ml,9,220,190,30,1
04-02-2025,Pooja & Spiritual Items,VRP APOORVA JAVADHU POW,12,35,35,0,1
04-02-2025,Sweeteners,MISHRI D,16,40,30,10,1
04-02-2025,"Grains, Flours & Dals",Multigrain 1 kg,4,100,85,15,1
04-02-2025,"Grains, Flours & Dals",MELMEKER 250GMS,4,60,45,15,1
04-02-2025,Spices & Seasonings,ROYAL SAFFRON,15,125,125,0,1
04-02-2025,Spices & Seasonings,Chilli powder 500 gms,15,290,210,80,1
04-02-2025,"Grains, Flours & Dals",Arikadu ( kodo),4,140,130,10,1
04-02-2025,"Grains, Flours & Dals",Wheat Flour 1 kg,4,70,60,10,1
04-02-2025,"Grains, Flours & Dals",Em Foxtail upma r 500 g,4,109,109,0,1
04-02-2025,"Grains, Flours & Dals",EM kodo upma R 500g,4,129,129,0,1
04-02-2025,"Dry Fruits, Nuts & Seeds",PULMAKHANA 100 GM,2,180,170,10,1
04-02-2025,"Grains, Flours & Dals",RAGI FLOUR 1KG,4,80,70,10,1
04-02-2025,"Grains, Flours & Dals",UDALU (Barnyard millet) 1 kg,4,140,115,25,1
04-02-2025,"Grains, Flours & Dals",SAMALU (Little millet) 1 kg,4,170,130,40,1
04-02-2025,"Grains, Flours & Dals",KORRALU (FOXTAIL M) 1KG,4,150,110,40,1
04-02-2025,"Grains, Flours & Dals",RICE FLOUR 1KG,4,140,110,30,2
04-02-2025,"Grains, Flours & Dals",Chana Flour 1 kg,4,140,130,10,1
04-02-2025,"Grains, Flours & Dals",PESARA PAPPU 500GMS,4,85,75,10,1
04-02-2025,Sweeteners,YB Brown Sugar 500GM,16,75,75,0,1
04-02-2025,"Dry Fruits, Nuts & Seeds",Groundnuts 1 kg,2,190,170,20,1
04-02-2025,"Grains, Flours & Dals",AISHWARYA SP 1KG,4,560,490,70,7
04-02-2025,Snacks & Ready-to-Eat,BD KODO MILLET NOODLES 200GM,14,75,75,0,1
04-02-2025,"Grains, Flours & Dals",CHANA DAL 1KG,4,35,30,5,0.25
04-02-2025,Snacks & Ready-to-Eat,COPRA LADDU 200GM,14,100,80,20,1
04-02-2025,Snacks & Ready-to-Eat,BATANA NGT 70GMS,14,40,40,0,2
04-02-2025,Oils & Ghee,Sesame oil 1 L,9,590,560,30,1
04-02-2025,Snacks & Ready-to-Eat,SATHVI REGIVADA 200GM,14,80,60,20,1
04-02-2025,Oils & Ghee,Coconut oil 500 ml,9,220,200,20,1
04-02-2025,Snacks & Ready-to-Eat,PALLI LADDU 200GMS,14,90,70,20,1
04-02-2025,Personal Care & Cosmetics,GAYATHRI KUMKUDUKAYA,10,450,450,0,3
04-02-2025,Baking & Cooking Aids,GONDH 50GRMS,0,40,40,0,1
04-02-2025,Pooja & Spiritual Items,GOMATHA AGARBATHI,12,225,225,0,3
04-02-2025,"Dry Fruits, Nuts & Seeds",SABJA SEEDS 100GM,2,80,70,10,1
04-02-2025,"Grains, Flours & Dals",SL Idly Rava 1KG,4,65,55,10,1
04-02-2025,Snacks & Ready-to-Eat,jeera papad,14,80,80,0,1
04-02-2025,Personal Care & Cosmetics,OVAL BODY LOOFAH,10,55,55,0,1
04-02-2025,Snacks & Ready-to-Eat,PEANUT CHILLI,14,20,20,0,4
04-02-2025,"Grains, Flours & Dals",turdal 1kg,4,220,195,25,1
04-02-2025,"Dry Fruits, Nuts & Seeds",SATHVI CHIA SEEDS 100GM,2,100,80,20,1
04-02-2025,Oils & Ghee,Coconut oil 1 L,9,440,400,40,1
04-02-2025,Snacks & Ready-to-Eat,BLACK SESAME CHIKKI,14,10,10,0,2
04-02-2025,"Grains, Flours & Dals",Multigrain 5 kgs,4,500,425,75,1
04-02-2025,Spices & Seasonings,SH CASSIA STICKS 50GM,15,75,75,0,1
04-02-2025,Snacks & Ready-to-Eat,BD RAGI NOODLES,14,75,75,0,1
04-02-2025,Oils & Ghee,Groundnut oil 1 L,9,360,330,30,1
04-02-2025,Pooja & Spiritual Items,VRP APOORVA JAVADHU POW,12,35,35,0,1
04-02-2025,General Household & Kitchenware,MATCH BOX,3,20,20,0,1
04-02-2025,Pooja & Spiritual Items,GD Dhoop Cones 40GM,12,30,30,0,1
04-02-2025,Oils & Ghee,Groundnut oil 1 L,9,360,330,30,1
04-02-2025,General Household & Kitchenware,GOOD HOME,3,15,15,0,1
04-02-2025,Oils & Ghee,Safflower oil 1 L,9,440,400,40,1
04-02-2025,Oils & Ghee,Coconut oil 1 L,9,440,400,40,1
04-02-2025,"Grains, Flours & Dals",RAGI FLOUR 1KG,4,80,70,10,1
04-02-2025,Snacks & Ready-to-Eat,VD RICE MURUKU 150GM,14,50,50,0,1
04-02-2025,Personal Care & Cosmetics,UVIS ALOEVERA GEL,10,125,125,0,1
04-02-2025,Snacks & Ready-to-Eat,VD VAMUPUSA 175GM,14,60,60,0,1
04-02-2025,Snacks & Ready-to-Eat,RAJGIRA PEANUT CHIKKI,14,10,10,0,2
04-02-2025,Snacks & Ready-to-Eat,VD BOONDI 175GM,14,60,60,0,1
04-02-2025,Snacks & Ready-to-Eat,VD SANNAPUSA 175GM,14,60,60,0,1
04-02-2025,"Grains, Flours & Dals",JOWAR WHITE 1 KG,4,40,35,5,0.5
04-02-2025,Snacks & Ready-to-Eat,SD Thati thandra 200gm,14,150,150,0,1
04-02-2025,"Grains, Flours & Dals",RAGULU 1 KG,4,17.5,15,2.5,0.25
04-02-2025,"Grains, Flours & Dals",Multigrain 1 kg,4,100,85,15,1
04-02-2025,"Grains, Flours & Dals",Sathya Javva Wheat Rava 500GM,4,95,95,0,1
04-02-2025,"Grains, Flours & Dals",Wheat Flour 1 kg,4,70,60,10,1
04-02-2025,Milk & Dairy,BROWN EGGS 1P,7,280,240,40,20
04-02-2025,"Grains, Flours & Dals",Wheat Flour 1 kg,4,140,120,20,2
04-02-2025,Personal Care & Cosmetics,GAYATHRI KUMKUDUKAYA,10,150,150,0,1
04-02-2025,"Grains, Flours & Dals",AISHWARYA SP 1KG,4,80,70,10,1
04-02-2025,General Household & Kitchenware,VERMI COMPOST MIX,3,30,30,0,1
04-02-2025,"Grains, Flours & Dals",DISANO OATS 1KG,4,71.25,71.25,0,0.25
04-02-2025,Snacks & Ready-to-Eat,VD MURUKU 175GM,14,120,120,0,2
04-02-2025,Oils & Ghee,Coconut oil 1 L,9,440,400,40,1
04-02-2025,Milk & Dairy,HRITAGE TOTAL CURD 130GM,7,30,30,0,3
04-02-2025,Snacks & Ready-to-Eat,Corn Chips 250GM,14,40,35,5,1
04-02-2025,Sweeteners,ACHUBELLAM 500GM,16,50,40,10,1
04-02-2025,Milk & Dairy,HERITAGE TONED MILK 500ML,7,31,31,0,1
04-02-2025,"Grains, Flours & Dals",Chana Flour 500 gms,4,70,65,5,1
04-02-2025,"Grains, Flours & Dals",UDALU (Barnyard millet) 1 kg,4,140,115,25,1
04-02-2025,"Grains, Flours & Dals",KORRALU (FOXTAIL M) 1KG,4,150,110,40,1
04-02-2025,Sweeteners,SD PALM JAGGERY 500GM,16,400,400,0,2
04-02-2025,"Grains, Flours & Dals",RICE FLOUR 500 GM,4,35,28,7,1
04-02-2025,Pooja & Spiritual Items,SWASTIK PURE CAMPHOR 7GM,12,20,20,0,1
04-02-2025,Pooja & Spiritual Items,GD Camphor 50GM,12,115,115,0,1
04-02-2025,Milk & Dairy,BROWN EGGS TRAY 30P,7,360,330,30,1
04-02-2025,Spices & Seasonings,Masala Karam 500 gms,15,260,240,20,1
04-02-2025,Oils & Ghee,Safflower oil 1 L,9,440,400,40,1
04-02-2025,Oils & Ghee,Coconut oil 500 ml,9,220,200,20,1
04-02-2025,"Grains, Flours & Dals",SH CHANA DAL 500GM,4,89,89,0,1
04-02-2025,Spices & Seasonings,Tamarind 250GMS,15,160,130,30,2
04-02-2025,Snacks & Ready-to-Eat,Corn Chips 250GM,14,40,35,5,1
04-02-2025,Snacks & Ready-to-Eat,MORINGA LEAVES PAPAD 200GM,14,90,90,0,1
04-02-2025,"Grains, Flours & Dals",YB NAVARA RICE 500GM,4,100,100,0,1
04-02-2025,"Grains, Flours & Dals",KORRALU (FOXTAIL M) 500GM,4,130,110,20,2
04-02-2025,"Grains, Flours & Dals",EM Foxtail idli r 500 g,4,109,109,0,1
04-02-2025,Spices & Seasonings,Miriyalu 50GM,15,200,160,40,2
04-02-2025,"Grains, Flours & Dals",DISANO ROLED OATS,4,395,395,0,1
04-02-2025,Pooja & Spiritual Items,SIVA JOOTHI 365 DEEPAPU,12,100,100,0,4
04-02-2025,"Grains, Flours & Dals",Wheat Rava M 500GM,4,33,30,3,1
04-02-2025,Personal Care & Cosmetics,SVE KHADI CARROT GEL 100GM,10,145,145,0,1
04-02-2025,"Health, Wellness & Ayurvedic Products",MD Kasturi Pasupu Choornam 50GM,5,80,80,0,1
04-02-2025,"Grains, Flours & Dals",YB BLACK RICE 500GM,4,150,150,0,1
04-02-2025,"Grains, Flours & Dals",FLOUR CHARGE,4,30,30,0,2.5
04-02-2025,Personal Care & Cosmetics,MD Bath Powder 100GM,10,40,40,0,1
04-02-2025,"Grains, Flours & Dals",Wheat Flour 1 kg,4,280,240,40,4
04-02-2025,Pickles & Cooking Pastes,SD MANGO PICKLE,11,110,110,0,1
04-02-2025,Milk & Dairy,HERITAGE TONED MILK 500ML,7,31,31,0,1
04-02-2025,"Grains, Flours & Dals",SRILALITHA MAIDA FLOUR 500G,4,32,32,0,1
04-02-2025,Snacks & Ready-to-Eat,PEANUT CHIKKI 450GM,14,125,125,0,1
04-02-2025,Spices & Seasonings,Telaga Pindi 250 GM,15,40,35,5,1
04-02-2025,Oils & Ghee,Sesame oil 500ml,9,295,280,15,1
04-02-2025,"Grains, Flours & Dals",turdal 1kg,4,220,195,25,1
04-02-2025,Oils & Ghee,Groundnut oil 1 L,9,720,660,60,2
04-02-2025,Milk & Dairy,BROWN EGGS TRAY 30P,7,360,330,30,1
04-02-2025,"Grains, Flours & Dals",RED RICE 1KG,4,150,120,30,1
04-02-2025,"Dry Fruits, Nuts & Seeds",SATHVI CHIA SEEDS 100GM,2,100,80,20,1
04-02-2025,Sweeteners,GS Organic Jaggery Powder 600GM,16,99,99,0,1
04-02-2025,Oils & Ghee,Sesame oil 500ml,9,295,280,15,1
04-02-2025,Snacks & Ready-to-Eat,VD GUMMADI VADIYAM,14,75,75,0,1
04-02-2025,Spices & Seasonings,Menthulu 250 gms,15,50,45,5,1
04-02-2025,"Health, Wellness & Ayurvedic Products",MD Bavanchi Choornam 50GM,5,100,100,0,1
04-02-2025,Spices & Seasonings,Turmeric powder 250 gms,15,100,75,25,1
04-02-2025,"Grains, Flours & Dals",RAGI FLOUR 1KG,4,80,70,10,1
04-02-2025,Spices & Seasonings,NUVVULU 250GM,15,100,85,15,1
04-02-2025,Spices & Seasonings,SONTI 50GM,15,30,20,10,1
04-02-2025,"Dry Fruits, Nuts & Seeds",SABJA SEEDS 100GM,2,80,70,10,1
04-02-2025,"Grains, Flours & Dals",RAGULU 1 KG,4,35,30,5,0.5
04-02-2025,"Grains, Flours & Dals",JOWAR WHITE 1 KG,4,40,35,5,0.5
04-02-2025,"Grains, Flours & Dals",Wheat Flour 1 kg,4,210,180,30,3
04-02-2025,Snacks & Ready-to-Eat,VD MURUKU 175GM,14,60,60,0,1
04-02-2025,Oils & Ghee,Sesame oil 1 L,9,590,560,30,1
04-02-2025,Spices & Seasonings,GREEN SOUNF,15,60,40,20,1
04-02-2025,Snacks & Ready-to-Eat,MARMURA LADDU,14,80,60,20,1
04-02-2025,"Grains, Flours & Dals",RAJMA 250GM,4,55,45,10,1
04-02-2025,"Grains, Flours & Dals",SAMALU (Little millet) 500 gms,4,85,65,20,1
04-02-2025,"Grains, Flours & Dals",Arikalu (kodo),4,70,65,5,1
04-02-2025,"Grains, Flours & Dals",Brown RICE 1KG,4,70,65,5,1
04-02-2025,"Grains, Flours & Dals",KORRALU (FOXTAIL M) 500GM,4,65,55,10,1
04-02-2025,Oils & Ghee,Groundnut oil 1 L,9,1080,990,90,3
04-02-2025,"Grains, Flours & Dals",Yellow jowar .F1 kg,4,110,100,10,1
04-02-2025,"Dry Fruits, Nuts & Seeds",SATHVI CHIA SEEDS 100GM,2,100,80,20,1
04-02-2025,"Grains, Flours & Dals",RAGI FLOUR 500GRMS,4,40,35,5,1
04-02-2025,"Dry Fruits, Nuts & Seeds",GF DATES 500GM,2,156,149,7,1
04-02-2025,"Dry Fruits, Nuts & Seeds",SUNFLOWER SEEDS 250GRM,2,150,130,20,1
04-02-2025,"Grains, Flours & Dals",turdal 1kg,4,220,195,25,1
04-02-2025,"Grains, Flours & Dals",DISANO OATS 1KG,4,28.5,28.5,0,0.1
04-02-2025,"Grains, Flours & Dals",BARLEY SEEDS 1KG,4,16,14,2,0.1
04-02-2025,"Dry Fruits, Nuts & Seeds",FLAX SEEDS 250GM,2,60,50,10,1
04-02-2025,"Grains, Flours & Dals",FLOUR CHARGE,4,96,96,0,8
04-02-2025,Sweeteners,MISHRI 250 GM,16,35,30,5,1
04-02-2025,"Grains, Flours & Dals",BARLEY FLOUR 250GM,4,45,40,5,1
04-02-2025,"Grains, Flours & Dals",Chana Flour 500 gms,4,70,65,5,1
04-02-2025,"Dry Fruits, Nuts & Seeds",WALLNUTS 250GM,2,320,290,30,1
04-02-2025,"Grains, Flours & Dals",Yellow jowar .F1 kg,4,110,100,10,1
04-02-2025,"Grains, Flours & Dals",Multigrain 1 kg,4,100,85,15,1
04-02-2025,"Grains, Flours & Dals",RAGI FLOUR 500GRMS,4,40,35,5,1
04-02-2025,"Dry Fruits, Nuts & Seeds",GF DATES 500GM,2,156,149,7,1
04-02-2025,"Dry Fruits, Nuts & Seeds",PLAIN PISTA 250GM,2,660,550,110,1
04-02-2025,Pooja & Spiritual Items,BALAJI KASTURI DHOOP STICKS,12,70,70,0,1
04-02-2025,"Dry Fruits, Nuts & Seeds",FLAX SEEDS 250GM,2,60,50,10,1
04-02-2025,Snacks & Ready-to-Eat,VD NUVULU CHEGODI 175GM,14,60,60,0,1
04-02-2025,Snacks & Ready-to-Eat,COPRA LADDU 200GM,14,100,80,20,1
04-02-2025,"Grains, Flours & Dals",SINGLE POLISH 1KG,4,325,325,0,5
04-02-2025,Snacks & Ready-to-Eat,SATHVI PALLI CHIKKI 200GM,14,100,80,20,1
04-02-2025,"Grains, Flours & Dals",MELMEKER 250GMS,4,60,45,15,1
04-02-2025,"Grains, Flours & Dals",White jowar.F 1 kg,4,100,80,20,1
04-02-2025,"Grains, Flours & Dals",Brown RICE 1KG,4,70,65,5,1
04-02-2025,Snacks & Ready-to-Eat,DOSA BATTER 1KG,14,60,60,0,1
04-02-2025,Snacks & Ready-to-Eat,MILLET PANCAKE CHOCOLATE,14,199,199,0,1
04-02-2025,Snacks & Ready-to-Eat,GANTASALA GINGER CANDY 200GM,14,105,105,0,1
04-02-2025,"Grains, Flours & Dals",split green gram 500 gms,4,75,70,5,1
04-02-2025,"Health, Wellness & Ayurvedic Products",DWI MADIPHALA 100ML,5,75,75,0,1
04-02-2025,Personal Care & Cosmetics,DETTOL 50ML,10,154,154,0,1
04-02-2025,Spices & Seasonings,PURO Healthy Salt 1KG,15,110,110,0,1
04-02-2025,Oils & Ghee,Freedom Rice Bran Oil 1L,9,194,180,14,1
04-02-2025,Household & Cleaning,VIM EXTRA 110GM,6,30,30,0,3
04-02-2025,Milk & Dairy,BROWN EGGS 1P,7,84,72,12,6
04-02-2025,Snacks & Ready-to-Eat,MB MULTIMILLET NOODLES 180GM,14,95,95,0,1
04-02-2025,"Health, Wellness & Ayurvedic Products",MH Millets Malt 500GM,5,200,190,10,1
04-02-2025,Snacks & Ready-to-Eat,MB FOXTAIL MILLET NOODLES 180GM,14,95,95,0,1
04-02-2025,"Grains, Flours & Dals",SA Multi Grain Mix 500GM,4,159,159,0,1
04-02-2025,"Grains, Flours & Dals",HS Ragi upma rava 500 gms,4,70,70,0,1
04-02-2025,"Health, Wellness & Ayurvedic Products",JAMBU SEED CHOORNAM 100GM,5,80,80,0,1
04-02-2025,Sweeteners,ACHU BELLAM 1KG,16,100,80,20,1
04-02-2025,Snacks & Ready-to-Eat,VD PANIPURI 100GM,14,30,30,0,1
04-02-2025,Sweeteners,NATURAL HONEY 1KG,16,560,480,80,1
04-02-2025,"Dry Fruits, Nuts & Seeds",PUMPKIN SEEDS 250GM,2,200,160,40,1
04-02-2025,Milk & Dairy,BROWN EGGS TRAY 30P,7,360,330,30,1
04-02-2025,Pooja & Spiritual Items,GD Kumkum 50GM,12,30,30,0,1
04-02-2025,Snacks & Ready-to-Eat,NGT CHATPATTA CHANA 90GM,14,25,25,0,1
04-02-2025,Spices & Seasonings,EVEREST PANI PURI MASALA 50GM,15,40,40,0,1
04-02-2025,General Household & Kitchenware,WDN HDI IND KADAI 8,3,180,180,0,1
04-02-2025,Pooja & Spiritual Items,GD JASMINE 75GM,12,60,60,0,1
04-02-2025,Snacks & Ready-to-Eat,DOSA BATTER 1KG,14,60,60,0,1
04-02-2025,Household & Cleaning,TIDE DOUBLE POWER JASMINE &amp;ROSE,6,66,66,0,1
04-02-2025,Snacks & Ready-to-Eat,Popcorn Seeds 250GM,14,45,40,5,1
04-02-2025,Personal Care & Cosmetics,COLGATE STRONG TEETH,10,40,40,0,2
04-02-2025,"Grains, Flours & Dals",RAGI FLOUR 1KG,4,80,70,10,1
04-02-2025,Oils & Ghee,Castor oil 200 ml,9,75,75,0,1
04-02-2025,"Grains, Flours & Dals",RICE FLOUR 1KG,4,70,55,15,1
04-02-2025,Personal Care & Cosmetics,KAIPO NONI TP 100GM,10,90,90,0,1
04-02-2025,Personal Care & Cosmetics,DWI NEEM TULSI SOAP 100GM,10,75,75,0,1
04-02-2025,"Grains, Flours & Dals",Multigrain 1 kg,4,100,85,15,1
04-02-2025,Oils & Ghee,Mustard oil 500 ml,9,220,195,25,1
04-02-2025,"Grains, Flours & Dals",RAGULU 1 KG,4,35,30,5,0.5
04-02-2025,Spices & Seasonings,Chilli powder 500 gms,15,290,210,80,1
04-02-2025,Personal Care & Cosmetics,UVIS MULTANI MITTI 200GM,10,90,90,0,1
04-02-2025,Spices & Seasonings,NUVVULU 500GM,15,160,130,30,1
04-02-2025,Spices & Seasonings,Elaichi 25GM,15,145,120,25,1
04-02-2025,"Grains, Flours & Dals",Wheat Flour 2 kgs,4,140,120,20,1
04-02-2025,Oils & Ghee,Safflower oil 500 ml,9,220,200,20,1
04-02-2025,Spices & Seasonings,DRY MIECHI 200GM,15,80,60,20,1
04-02-2025,Personal Care & Cosmetics,gow durbar sandal,10,80,80,0,2
04-02-2025,"Grains, Flours & Dals",VGR rice 1 kg,4,350,325,25,5
04-02-2025,"Grains, Flours & Dals",AISHWARYA SP 1KG,4,800,700,100,10
04-02-2025,Spices & Seasonings,Miriyalu 50GM,15,100,80,20,1
04-02-2025,Spices & Seasonings,Menthulu 250 gms,15,50,45,5,1
04-02-2025,Sweeteners,SUGAR 1KG,16,180,150,30,3
04-02-2025,Spices & Seasonings,Jeera 100GM,15,50,45,5,1
04-02-2025,Oils & Ghee,safflowe oil 1kg,9,1440,"1,290.00",150,3
04-02-2025,"Grains, Flours & Dals",Em jowar idly R 500G,4,75,75,0,1
04-02-2025,Pickles & Cooking Pastes,SD MESTA PICKLE,11,110,110,0,1
04-02-2025,Oils & Ghee,Coconut oil 500 ml,9,220,200,20,1
04-02-2025,Oils & Ghee,Groundnut oil 1 L,9,360,330,30,1
04-02-2025,"Grains, Flours & Dals",RAGI FLOUR 1KG,4,80,70,10,1
04-02-2025,Sweeteners,MISHRI D,16,40,30,10,1
04-02-2025,"Grains, Flours & Dals",KORRALU (FOXTAIL M) 1KG,4,150,110,40,1
04-02-2025,"Grains, Flours & Dals",Bombay Rava 500GM,4,35,30,5,1
04-02-2025,Oils & Ghee,Groundnut oil 1 L,9,720,660,60,2
04-02-2025,"Grains, Flours & Dals",Wheat Rava M 500GM,4,33,30,3,1
04-02-2025,"Grains, Flours & Dals",SL Idly Rava 1KG,4,65,55,10,1
04-02-2025,Snacks & Ready-to-Eat,RI SPORTS BAR 40G,14,90,90,0,2
04-02-2025,Pooja & Spiritual Items,GD Kumkum 50GM,12,60,60,0,2
04-02-2025,Snacks & Ready-to-Eat,PALLI LADDU 200GMS,14,90,70,20,1
04-02-2025,"Grains, Flours & Dals",MELMEKER 250GMS,4,60,45,15,1
04-02-2025,"Dry Fruits, Nuts & Seeds",Groundnuts 1 kg,2,190,170,20,1
04-02-2025,"Grains, Flours & Dals",CHANA DAL 500GM,4,70,60,10,1
04-02-2025,Snacks & Ready-to-Eat,RAJGIRA PEANUT CHIKKI 450GM,14,125,125,0,1
04-02-2025,Spices & Seasonings,ROYAL SAFFRON 400GRMS,15,130,130,0,2
04-02-2025,"Grains, Flours & Dals",SRILALITHA MAIDA FLOUR 500G,4,32,32,0,1
04-02-2025,"Grains, Flours & Dals",CHANA DAL 500GM,4,70,60,10,1
04-02-2025,Milk & Dairy,BROWN EGGS 1P,7,84,72,12,6
04-02-2025,"Grains, Flours & Dals",Wheat Flour 1 kg,4,70,60,10,1
04-02-2025,Spices & Seasonings,Jeera 100GM,15,50,45,5,1
04-02-2025,Pooja & Spiritual Items,BANDA PUVVU 25GM 25GM,12,80,60,20,1
04-02-2025,Oils & Ghee,Coconut oil 500 ml,9,220,200,20,1
04-02-2025,Oils & Ghee,Mustard oil 500 ml,9,220,195,25,1
04-02-2025,Oils & Ghee,Groundnut oil 500ml,9,180,165,15,1
04-02-2025,"Grains, Flours & Dals",turdal 1kg,4,220,195,25,1
04-02-2025,"Grains, Flours & Dals",RAGULU 1 KG,4,70,60,10,1
04-02-2025,Snacks & Ready-to-Eat,SESAME LADDU 200GM,14,100,80,20,1
04-02-2025,"Grains, Flours & Dals",Urad dall 1 Kg,4,370,340,30,2
04-02-2025,"Dry Fruits, Nuts & Seeds",KAJU HALF 250GM,2,310,290,20,1
04-02-2025,"Dry Fruits, Nuts & Seeds",Groundnuts 1 kg,2,190,170,20,1
04-02-2025,"Grains, Flours & Dals",Brown RICE 1KG,4,140,130,10,2
04-02-2025,"Dry Fruits, Nuts & Seeds",ALMONDS 250GM,2,280,260,20,1
04-02-2025,"Grains, Flours & Dals",SB Javva Wheat Ravva 500GM,4,95,95,0,1
04-02-2025,Oils & Ghee,Groundnut oil 1 L,9,360,330,30,1
04-02-2025,Milk & Dairy,SANGAM FULL CREAM MILK 500ML,7,38,38,0,1
04-02-2025,"Health, Wellness & Ayurvedic Products",RB Max Protein Choco Almond bar 50g,5,75,75,0,1
04-02-2025,"Grains, Flours & Dals",Quinova 1 kg,4,220,195,25,1
04-02-2025,Spices & Seasonings,Tamarind 250GMS,15,80,65,15,1
04-02-2025,Snacks & Ready-to-Eat,PALLI LADDU 200GMS,14,90,70,20,1
04-02-2025,"Grains, Flours & Dals",PESARA PAPPU 500GMS,4,85,75,10,1
04-02-2025,Spices & Seasonings,Masala Karam 500 gms,15,260,240,20,1
04-02-2025,Oils & Ghee,Safflower oil 1 L,9,440,400,40,1
04-02-2025,Spices & Seasonings,AVALU 100GM,15,25,20,5,1
04-02-2025,"Dry Fruits, Nuts & Seeds",Groundnuts 500 gms,2,190,170,20,2
04-02-2025,Spices & Seasonings,DRY MIECHI 200GM,15,80,60,20,1
04-02-2025,Beverages,BRU GREEN LABEL 100G,1,65,65,0,1
04-02-2025,Spices & Seasonings,Coriander seeds 200 gms,15,48,40,8,1
04-02-2025,"Grains, Flours & Dals",turdal 1kg,4,220,195,25,1
04-02-2025,"Health, Wellness & Ayurvedic Products",MD Kasturi Pasupu Choornam 50GM,5,80,80,0,1
04-02-2025,Milk & Dairy,BROWN EGGS TRAY 30P,7,360,330,30,1
04-02-2025,Oils & Ghee,Groundnut oil 1 L,9,360,330,30,1
04-02-2025,Snacks & Ready-to-Eat,SESAME LADDU 200GM,14,100,80,20,1
04-02-2025,Snacks & Ready-to-Eat,PALLI LADDU 200GMS,14,90,70,20,1
04-02-2025,"Grains, Flours & Dals",DESI CHANA,4,25,25,0,1
04-02-2025,Snacks & Ready-to-Eat,MARMURA LADDU,14,80,60,20,1
04-02-2025,Snacks & Ready-to-Eat,MARMURA LADDU,14,80,60,20,1
04-02-2025,Oils & Ghee,Groundnut oil 1 L,9,1080,990,90,3
04-02-2025,Oils & Ghee,Groundnut oil 1 L,9,360,330,30,1
04-02-2025,Oils & Ghee,Sesame oil 500ml,9,295,280,15,1
04-02-2025,Oils & Ghee,Castor oil 500 ml,9,250,200,50,1
04-02-2025,Milk & Dairy,BROWN EGGS 1P,7,350,300,50,25
04-02-2025,Spices & Seasonings,Masala Karam 250 gms,15,130,120,10,1
04-02-2025,"Dry Fruits, Nuts & Seeds",MAHA BEERA SEEDS 100GM,2,60,60,0,1
04-02-2025,General Household & Kitchenware,MATCH BOX,3,20,20,0,1
04-02-2025,Snacks & Ready-to-Eat,BB ROASTED VERMICELLY 850GM,14,117,117,0,1
04-02-2025,Pooja & Spiritual Items,GD Camphor 50GM,12,115,115,0,1
04-02-2025,"Grains, Flours & Dals",Wheat Rava M 500GM,4,33,30,3,1
04-02-2025,"Grains, Flours & Dals",Bombay Rava 500GM,4,35,30,5,1
04-02-2025,Spices & Seasonings,Jeera 100GM,15,50,45,5,1
04-02-2025,Snacks & Ready-to-Eat,NGT CHATPATTA CHANA 90GM,14,50,50,0,2
04-02-2025,Snacks & Ready-to-Eat,ID IDLY DOSA BATTER,14,90,90,0,1
04-02-2025,Snacks & Ready-to-Eat,VD Pappu Chekkalu 190gm,14,60,60,0,1
04-02-2025,Snacks & Ready-to-Eat,VD MIXTURE 175 GM,14,60,60,0,1
04-02-2025,Snacks & Ready-to-Eat,GANTASALA TOMATO SNACKS 150GM,14,60,60,0,1
04-02-2025,Snacks & Ready-to-Eat,VD VAMUPUSA 175GM,14,60,60,0,1
04-02-2025,"Grains, Flours & Dals",Multigrain 1 kg,4,100,85,15,1
04-02-2025,Milk & Dairy,SANGAM FULL CREAM MILK 500ML,7,38,38,0,1
04-02-2025,Milk & Dairy,HERITAGE TONED MILK 500ML,7,31,31,0,1
04-02-2025,"Grains, Flours & Dals",BASMATHI RICE 1KG,4,150,135,15,1
04-02-2025,"Dry Fruits, Nuts & Seeds",PULMAKHANA 100 GM,2,360,340,20,2
04-02-2025,Milk & Dairy,SANGAM TONED MILK 500ML,7,90,90,0,3
04-02-2025,Snacks & Ready-to-Eat,urban murmura,14,60,55,5,1
04-02-2025,Oils & Ghee,Groundnut oil 1 L,9,360,330,30,1
04-02-2025,"Grains, Flours & Dals",RAGI FLOUR 1KG,4,80,70,10,1
04-02-2025,"Grains, Flours & Dals",Red Wheat Flour 1 kg,4,280,260,20,2
04-02-2025,Oils & Ghee,Safflower oil 1 L,9,440,400,40,1
03-02-2025,Sweeteners,NATURAL HONEY 250GM,16,150,130,20,1
03-02-2025,"Grains, Flours & Dals",RAGI FLOUR 500GRMS,4,40,35,5,1
03-02-2025,Sweeteners,YB Brown Sugar 1KG,16,140,140,0,1
03-02-2025,"Grains, Flours & Dals",White Chana 500GM,4,120,100,20,1
03-02-2025,"Grains, Flours & Dals",white Bobarlu 500 gms,4,80,75,5,1
03-02-2025,Pooja & Spiritual Items,GD TULASI 75GM,12,60,60,0,1
03-02-2025,Pooja & Spiritual Items,GD Sambrani Cup Dhoop 10 PC,12,96,96,0,1
03-02-2025,Oils & Ghee,Coconut oil 1 L,9,440,400,40,1
03-02-2025,Pooja & Spiritual Items,BALAJI LAVENDER DOOP STICK 10STK,12,125,125,0,1
03-02-2025,Pooja & Spiritual Items,AMRUTHA SURABHI,12,80,80,0,1
03-02-2025,Pooja & Spiritual Items,GOW DURBAR GEETHA CAMPHOR,12,60,60,0,1
03-02-2025,Sweeteners,ACHU BELLAM 1KG,16,100,80,20,1
03-02-2025,Pooja & Spiritual Items,BALAJI ROSE DHOOP STIKS 10STK,12,125,125,0,1
03-02-2025,Sweeteners,YB Brown Sugar 500GM,16,75,75,0,1
03-02-2025,Sweeteners,GS Organic Jaggery Powder 600GM,16,99,99,0,1
03-02-2025,Spices & Seasonings,Elaichi 25GM,15,145,120,25,1
03-02-2025,Spices & Seasonings,Jeera 100GM,15,50,45,5,1
03-02-2025,Snacks & Ready-to-Eat,BATANA NGT 70GMS,14,40,40,0,2
03-02-2025,"Grains, Flours & Dals",Wheat Rava M 500GM,4,33,30,3,1
03-02-2025,Snacks & Ready-to-Eat,COPRA LADDU 200GM,14,100,80,20,1
03-02-2025,Snacks & Ready-to-Eat,BROWN BREAD,14,55,55,0,1
03-02-2025,Snacks & Ready-to-Eat,VD RED CHILLI RICEPAPAD 150GM,14,50,50,0,1
03-02-2025,Pooja & Spiritual Items,NALLAS VAISHNAVI MAISHAKSHI 50GM,12,50,50,0,1
03-02-2025,Pooja & Spiritual Items,AMRUTHA SURABHI,12,160,160,0,2
03-02-2025,Snacks & Ready-to-Eat,SATHVI REGIVADA 200GM,14,80,60,20,1
03-02-2025,Snacks & Ready-to-Eat,SESAME LADDU 200GM,14,100,80,20,1
03-02-2025,Snacks & Ready-to-Eat,PALLI LADDU 200GMS,14,90,70,20,1
03-02-2025,"Grains, Flours & Dals",Wheat Flour 1 kg,4,140,120,20,2
03-02-2025,Oils & Ghee,Groundnut oil 1 L,9,720,660,60,2
03-02-2025,Snacks & Ready-to-Eat,MARMURA LADDU,14,80,60,20,1
03-02-2025,Spices & Seasonings,Biryani Leaf 25GM,15,30,30,0,1
03-02-2025,Snacks & Ready-to-Eat,MARMURA LADDU,14,80,60,20,1
03-02-2025,Spices & Seasonings,Marati Magga 50GM,15,130,110,20,1
03-02-2025,Oils & Ghee,Groundnut oil 1 L,9,360,330,30,1
03-02-2025,Snacks & Ready-to-Eat,COPRA LADDU 200GM,14,100,80,20,1
03-02-2025,Pooja & Spiritual Items,VRP APOORVA JAVADHU POW,12,35,35,0,1
03-02-2025,Snacks & Ready-to-Eat,urban murmura,14,60,55,5,1
03-02-2025,Snacks & Ready-to-Eat,ONION RINGS,14,50,50,0,1
03-02-2025,Snacks & Ready-to-Eat,VD GUMMADI VADIYAM,14,75,75,0,1
03-02-2025,"Grains, Flours & Dals",SA WHITE JOWAR RAVA 500GM,4,69,69,0,1
03-02-2025,Snacks & Ready-to-Eat,MARMURA LADDU,14,80,60,20,1
03-02-2025,Personal Care & Cosmetics,INDICA EASY,10,60,60,0,2
03-02-2025,"Grains, Flours & Dals",Quinova 500 gms,4,110,100,10,1
03-02-2025,Snacks & Ready-to-Eat,SATHVI MIXED CHIKKI 200GM,14,120,100,20,1
03-02-2025,Snacks & Ready-to-Eat,Corn Chips 250GM,14,40,35,5,1
03-02-2025,Personal Care & Cosmetics,GAYATHRI KUMKUDUKAYA,10,150,150,0,1
03-02-2025,Spices & Seasonings,Turmeric powder 250 gms,15,100,75,25,1
03-02-2025,Personal Care & Cosmetics,CLOSEUP,10,67,67,0,1
03-02-2025,Snacks & Ready-to-Eat,MILK BREAD,14,30,30,0,1
03-02-2025,Sweeteners,KAMAL JAGGERY 500GM,16,40,40,0,1
03-02-2025,Personal Care & Cosmetics,SVE KHADI ALOEVERA GEL 100GM,10,140,140,0,1
03-02-2025,"Dry Fruits, Nuts & Seeds",SABJA SEEDS 100GM,2,80,70,10,1
03-02-2025,Personal Care & Cosmetics,GAYATHRI KUMKUDUKAYA,10,150,150,0,1
03-02-2025,Snacks & Ready-to-Eat,ELITE MILK RUSK 200GM,14,35,35,0,1
03-02-2025,Milk & Dairy,SANGAM CURD 450GM,7,38,38,0,1
03-02-2025,"Grains, Flours & Dals",Em Multimillet upma 500g,4,129,129,0,1
03-02-2025,"Grains, Flours & Dals",EM Foxtail idli r 500 g,4,109,109,0,1
03-02-2025,Snacks & Ready-to-Eat,GS INSTANT KORRA DOSA MIX 400GM,14,120,120,0,1
03-02-2025,Snacks & Ready-to-Eat,VD MINAPA VADIYAM,14,65,65,0,1
03-02-2025,"Grains, Flours & Dals",JOWAR WHITE 1 KG,4,40,35,5,0.5
03-02-2025,Pooja & Spiritual Items,VRP APOORVA JAVADHU POW,12,35,35,0,1
03-02-2025,"Grains, Flours & Dals",Em Little idli R 500g,4,129,129,0,1
03-02-2025,"Grains, Flours & Dals",SINGLE POLISH 1KG,4,130,130,0,2
03-02-2025,"Grains, Flours & Dals",Wheat Rava M 1KG,4,65,55,10,1
03-02-2025,Snacks & Ready-to-Eat,VD RED CHILLI RICEPAPAD 150GM,14,50,50,0,1
03-02-2025,Oils & Ghee,Groundnut oil 1 L,9,360,330,30,1
03-02-2025,Oils & Ghee,Groundnut oil 500ml,9,180,165,15,1
03-02-2025,"Grains, Flours & Dals",Bombay Rava 500GM,4,35,30,5,1
03-02-2025,Sweeteners,YB Brown Sugar 500GM,16,75,75,0,1
03-02-2025,Oils & Ghee,Sesame oil 500ml,9,295,280,15,1
03-02-2025,Snacks & Ready-to-Eat,VD BELLAM GAVVALU 200GM,14,60,60,0,1
03-02-2025,"Grains, Flours & Dals",WHEAT 1 KG,4,30,25,5,0.5
03-02-2025,Oils & Ghee,Groundnut oil 1 L,9,360,330,30,1
03-02-2025,"Grains, Flours & Dals",Wheat Rava M 1KG,4,65,55,10,1
03-02-2025,"Grains, Flours & Dals",JOWAR WHITE 1 KG,4,80,70,10,1
03-02-2025,Sweeteners,GS Organic Jaggery Powder 600GM,16,99,99,0,1
03-02-2025,"Grains, Flours & Dals",THICK POHA 500GM,4,40,35,5,1
03-02-2025,"Grains, Flours & Dals",RAGULU 1 KG,4,70,60,10,1
03-02-2025,"Grains, Flours & Dals",SABDANA 500GM,4,90,70,20,1
03-02-2025,Spices & Seasonings,Jeera 100GM,15,50,45,5,1
03-02-2025,"Grains, Flours & Dals",Em jowar idly R 500G,4,75,75,0,1
03-02-2025,Spices & Seasonings,PRO ORG AJWAIN 100G,15,70,70,0,1
03-02-2025,Personal Care & Cosmetics,GA DANT MANJAN TP 50GM,10,60,60,0,1
03-02-2025,"Grains, Flours & Dals",ANDU KORRALU (Brown top .mlt) 500,4,130,110,20,1
03-02-2025,"Grains, Flours & Dals",RAGI FLOUR 500GRMS,4,40,35,5,1
03-02-2025,"Grains, Flours & Dals",Multigrain 1 kg,4,100,85,15,1
03-02-2025,"Grains, Flours & Dals",Quinova 500 gms,4,110,100,10,1
03-02-2025,Snacks & Ready-to-Eat,3D PAPAD,14,40,40,0,1
03-02-2025,Sweeteners,MISHRI 250 GM,16,35,30,5,1
03-02-2025,"Health, Wellness & Ayurvedic Products",MH Millets Malt 500GM,5,200,190,10,1
03-02-2025,"Health, Wellness & Ayurvedic Products",MD Guduchi Choornam 100GM,5,110,110,0,1
03-02-2025,Oils & Ghee,Coconut oil 1 L,9,440,400,40,1
03-02-2025,Oils & Ghee,Groundnut oil 1 L,9,720,660,60,2
03-02-2025,Oils & Ghee,Sesame oil 500ml,9,295,280,15,1
03-02-2025,"Grains, Flours & Dals",DOCTOR RICE DIABETIC SFR 1KG,4,480,480,0,4
03-02-2025,Snacks & Ready-to-Eat,COPRA LADDU 200GM,14,100,80,20,1
03-02-2025,"Grains, Flours & Dals",Multigrain 1 kg,4,100,85,15,1
03-02-2025,Oils & Ghee,Sesame oil 1 L,9,590,560,30,1
03-02-2025,Oils & Ghee,Safflower oil 1 L,9,440,400,40,1
03-02-2025,Oils & Ghee,Sesame oil 1 L,9,590,560,30,1
03-02-2025,Oils & Ghee,GANTASALA A2 COW GHEE 500ML,9,550,550,0,1
03-02-2025,"Grains, Flours & Dals",Wheat Flour 1 kg,4,70,60,10,1
03-02-2025,"Grains, Flours & Dals",DH URAD GOTA 1KG,4,215,190,25,1
03-02-2025,Snacks & Ready-to-Eat,URBAN MARMURA 450GM,14,70,70,0,1
03-02-2025,"Grains, Flours & Dals",turdal 1kg,4,220,195,25,1
03-02-2025,"Grains, Flours & Dals",SL Idly Rava 1KG,4,65,55,10,1
03-02-2025,"Grains, Flours & Dals",Bombay Rava 500GM,4,35,30,5,1
03-02-2025,"Dry Fruits, Nuts & Seeds",PRO ORG RAW PEANUTS 500GM,2,174,174,0,1
03-02-2025,Snacks & Ready-to-Eat,ANNAPURNA APPALAM,14,70,70,0,2
03-02-2025,Pickles & Cooking Pastes,SD TOMATO PICKLE,11,110,110,0,1
03-02-2025,Spices & Seasonings,Japatri 25GM,15,100,80,20,1
03-02-2025,Oils & Ghee,Sesame oil 1 L,9,1180,"1,120.00",60,2
03-02-2025,"Grains, Flours & Dals",KORRALU (FOXTAIL M) 1KG,4,150,110,40,1
03-02-2025,Milk & Dairy,BROWN EGGS TRAY 30P,7,360,330,30,1
03-02-2025,"Dry Fruits, Nuts & Seeds",DRYDATES YELLOW 250GM,2,270,240,30,2
03-02-2025,"Dry Fruits, Nuts & Seeds",PUMPKIN SEEDS 250GM,2,200,160,40,1
03-02-2025,"Grains, Flours & Dals",White Chana 500GM,4,120,100,20,1
03-02-2025,Oils & Ghee,Groundnut oil 1 L,9,360,330,30,1
03-02-2025,"Dry Fruits, Nuts & Seeds",WATERMELON SEEDS 250GRM,2,320,280,40,1
03-02-2025,Spices & Seasonings,Menthulu 250 gms,15,50,45,5,1
03-02-2025,"Dry Fruits, Nuts & Seeds",WALLNUTS 250GM,2,640,580,60,2
03-02-2025,Snacks & Ready-to-Eat,VD SANNAPUSA 175GM,14,60,60,0,1
03-02-2025,Snacks & Ready-to-Eat,VD MAIDA CHEGODI 175GM,14,60,60,0,1
03-02-2025,"Grains, Flours & Dals",split green gram 500 gms,4,75,70,5,1
03-02-2025,"Grains, Flours & Dals",WHITE BATANI 500GM,4,80,60,20,1
03-02-2025,Snacks & Ready-to-Eat,VD VAMUPUSA 175GM,14,60,60,0,1
03-02-2025,Snacks & Ready-to-Eat,VD BELLAM GAVVALU 200GM,14,60,60,0,1
03-02-2025,"Dry Fruits, Nuts & Seeds",PLAIN PISTA 250GM,2,660,550,110,1
03-02-2025,Snacks & Ready-to-Eat,PALLI LADDU 200GMS,14,90,70,20,1
03-02-2025,Snacks & Ready-to-Eat,MILK BREAD,14,30,30,0,1
03-02-2025,"Dry Fruits, Nuts & Seeds",Groundnuts 500 gms,2,95,85,10,1
03-02-2025,"Dry Fruits, Nuts & Seeds",Groundnuts 1 kg,2,190,170,20,1
03-02-2025,Oils & Ghee,Sesame oil 1 L,9,1180,"1,120.00",60,2
03-02-2025,"Grains, Flours & Dals",Red Bobarlu 1 kg,4,190,170,20,1
03-02-2025,"Grains, Flours & Dals",Wheat Flour 1 kg,4,140,120,20,2
03-02-2025,Sweeteners,GS Palm Jaggery Powder 400GM,16,180,180,0,1
03-02-2025,Oils & Ghee,Coconut oil 500 ml,9,220,200,20,1
03-02-2025,Oils & Ghee,Sesame oil 500ml,9,295,280,15,1
03-02-2025,Snacks & Ready-to-Eat,MARMURA LADDU,14,80,60,20,1
03-02-2025,"Grains, Flours & Dals",Em Multimillet upma 500g,4,258,258,0,2
03-02-2025,"Grains, Flours & Dals",Arikadu ( kodo),4,140,130,10,1
03-02-2025,"Grains, Flours & Dals",SAMALU (Little millet) 1 kg,4,170,130,40,1
03-02-2025,General Household & Kitchenware,MATCH BOX,3,20,20,0,1
03-02-2025,Pooja & Spiritual Items,GD Camphor 50GM,12,115,115,0,1
03-02-2025,"Grains, Flours & Dals",White jowar.F 1 kg,4,100,80,20,1
03-02-2025,"Grains, Flours & Dals",MELMEKER 250GMS,4,60,45,15,1
03-02-2025,"Grains, Flours & Dals",white Bobarlu 500 gms,4,80,75,5,1
03-02-2025,Snacks & Ready-to-Eat,Corn Chips 250GM,14,40,35,5,1
03-02-2025,"Dry Fruits, Nuts & Seeds",SATHVI CHIA SEEDS 100GM,2,100,80,20,1
03-02-2025,Snacks & Ready-to-Eat,VD MYSOREPAK 6PIC,14,100,100,0,1
03-02-2025,"Grains, Flours & Dals",RAGI FLOUR 500GRMS,4,40,35,5,1
03-02-2025,Pooja & Spiritual Items,SS DASANGAM CONE 20PICS,12,45,45,0,1
03-02-2025,Pooja & Spiritual Items,SWASTIK CAMPHOR 25GM,12,45,45,0,1
03-02-2025,Pooja & Spiritual Items,DASANGAM DHOOP POWDER 50GM,12,43,43,0,1
03-02-2025,"Dry Fruits, Nuts & Seeds",DRIED KIWI 200GM,2,145,130,15,1
03-02-2025,"Dry Fruits, Nuts & Seeds",DRYDATES YELLOW 250GM,2,135,120,15,1
03-02-2025,Personal Care & Cosmetics,DWIBHASHI GULABA ARKA ROSA WATER,10,60,60,0,1
03-02-2025,"Dry Fruits, Nuts & Seeds",PULMAKHANA 100 GM,2,360,340,20,2
03-02-2025,"Grains, Flours & Dals",Wheat Flour 1 kg,4,210,180,30,3
03-02-2025,"Health, Wellness & Ayurvedic Products",RB Max Protein Choco chips 55gm,5,50,50,0,1
03-02-2025,Sweeteners,GS Organic Jaggery Powder 600GM,16,99,99,0,1
03-02-2025,Oils & Ghee,Mustard oil 500 ml,9,220,195,25,1
03-02-2025,Oils & Ghee,Safflower oil 1 L,9,440,400,40,1
03-02-2025,Oils & Ghee,Sesame oil 1 L,9,590,560,30,1
03-02-2025,Oils & Ghee,Groundnut oil 1 L,9,360,330,30,1
03-02-2025,Sweeteners,YB Brown Sugar 1KG,16,140,140,0,1
03-02-2025,"Grains, Flours & Dals",RICE FLOUR 1KG,4,70,55,15,1
03-02-2025,Oils & Ghee,Groundnut oil 500ml,9,180,165,15,1
03-02-2025,Snacks & Ready-to-Eat,COPRA LADDU 200GM,14,100,80,20,1
03-02-2025,"Grains, Flours & Dals",PRO ORG RED POHA 500GM,4,89,89,0,1
03-02-2025,Snacks & Ready-to-Eat,PALLI LADDU 200GMS,14,180,140,40,2
03-02-2025,"Dry Fruits, Nuts & Seeds",PULMAKHANA 100 GM,2,180,170,10,1
03-02-2025,"Grains, Flours & Dals",RAGI FLOUR 1KG,4,80,70,10,1
03-02-2025,"Grains, Flours & Dals",Wheat Flour 1 kg,4,70,60,10,1
03-02-2025,"Health, Wellness & Ayurvedic Products",MD Pippalla Churnam 30GM,5,150,150,0,1
03-02-2025,"Health, Wellness & Ayurvedic Products",JAMBU SEED CHOORNAM 100GM,5,80,80,0,1
03-02-2025,"Health, Wellness & Ayurvedic Products",MD Sugandhi Pala Churnam 30GM,5,90,90,0,1
03-02-2025,"Health, Wellness & Ayurvedic Products",MD Vasa Choornam 30GM,5,80,80,0,1
03-02-2025,General Household & Kitchenware,DOYO RO CELL,3,100,100,0,2
03-02-2025,Spices & Seasonings,MD Sonti Powder 50GM,15,80,80,0,1
03-02-2025,Snacks & Ready-to-Eat,SATHVI REGIVADA 200GM,14,80,60,20,1
03-02-2025,"Health, Wellness & Ayurvedic Products",MH Millets Malt 500GM,5,200,190,10,1
03-02-2025,Snacks & Ready-to-Eat,SATHVI MIXED CHIKKI 200GM,14,120,100,20,1
03-02-2025,"Grains, Flours & Dals",PESARA PAPPU 1 KG,4,170,145,25,1
03-02-2025,"Grains, Flours & Dals",CHANA DAL 1KG,4,35,30,5,0.25
03-02-2025,"Grains, Flours & Dals",SAMALU (Little millet) 1 kg,4,170,130,40,1
03-02-2025,"Dry Fruits, Nuts & Seeds",PUMPKIN SEEDS 250GM,2,200,160,40,1
03-02-2025,"Grains, Flours & Dals",RAGI FLOUR 1KG,4,80,70,10,1
03-02-2025,"Grains, Flours & Dals",UDALU (Barnyard millet) 1 kg,4,140,115,25,1
03-02-2025,"Grains, Flours & Dals",KORRALU (FOXTAIL M) 1KG,4,150,110,40,1
03-02-2025,Snacks & Ready-to-Eat,PUMPKIN CHIKKI 200GM,14,140,120,20,1
03-02-2025,Snacks & Ready-to-Eat,NGT CHATPATTA CHANA 90GM,14,25,25,0,1
03-02-2025,"Dry Fruits, Nuts & Seeds",SUNFLOWER SEEDS 250GRM,2,150,130,20,1
03-02-2025,Snacks & Ready-to-Eat,SD Moringa with plam jaggery 250gm,14,270,270,0,2
03-02-2025,"Grains, Flours & Dals",Arikadu ( kodo),4,140,130,10,1
03-02-2025,Snacks & Ready-to-Eat,VD PAPPU CHEGODI 200GM,14,60,60,0,1
03-02-2025,Oils & Ghee,Coconut oil 500 ml,9,220,200,20,1
03-02-2025,"Grains, Flours & Dals",KORRALU (FOXTAIL M) 500GM,4,65,55,10,1
03-02-2025,Oils & Ghee,Groundnut oil 500ml,9,180,165,15,1
03-02-2025,"Dry Fruits, Nuts & Seeds",SATHVI CHIA SEEDS 100GM,2,100,80,20,1
03-02-2025,"Grains, Flours & Dals",White jowar.F 1 kg,4,100,80,20,1
03-02-2025,Personal Care & Cosmetics,SVE PREMIUM PAPAYA SOAP 100GM,10,220,220,0,2
03-02-2025,Personal Care & Cosmetics,GAYATHRI KUMKUDUKAYA,10,300,300,0,2
03-02-2025,Snacks & Ready-to-Eat,SESAME LADDU 200GM,14,100,80,20,1
03-02-2025,Snacks & Ready-to-Eat,PALLI LADDU 200GMS,14,90,70,20,1
03-02-2025,Snacks & Ready-to-Eat,ELITE ELAICHI RUSK 200GM,14,35,35,0,1
03-02-2025,Oils & Ghee,BUFFALLO GHEE 500ML,9,410,370,40,1
03-02-2025,Snacks & Ready-to-Eat,MARMURA LADDU,14,80,60,20,1
03-02-2025,"Grains, Flours & Dals",KORRALU (FOXTAIL M) 500GM,4,65,55,10,1
03-02-2025,Oils & Ghee,Groundnut oil 1 L,9,720,660,60,2
03-02-2025,"Grains, Flours & Dals",URAD DALL,4,190,170,20,2
03-02-2025,Snacks & Ready-to-Eat,Corn Chips 250GM,14,40,35,5,1
03-02-2025,Household & Cleaning,LIZOL JAQSMINE 500ML,6,116,116,0,1
03-02-2025,Pooja & Spiritual Items,GB Bharatha Woods 75GM,12,60,60,0,1
03-02-2025,Pooja & Spiritual Items,JVK SAMBRANI STICK 20PCS,12,40,40,0,1
03-02-2025,Snacks & Ready-to-Eat,KURNOOL MARMURA,14,350,275,75,5
03-02-2025,"Grains, Flours & Dals",split black gram 1 kg,4,180,170,10,1
03-02-2025,Oils & Ghee,Freedom Rice Bran Oil 1L,9,194,180,14,1
03-02-2025,Pooja & Spiritual Items,SWATHI POOJA VATHULU,12,50,50,0,1
03-02-2025,"Grains, Flours & Dals",turdal 500 gms,4,110,100,10,1
03-02-2025,Snacks & Ready-to-Eat,SESAME CHIKKI,14,120,100,20,1
03-02-2025,Snacks & Ready-to-Eat,BATANA NGT 70GMS,14,40,40,0,2
03-02-2025,"Grains, Flours & Dals",SRILALITHA MAIDA FLOUR 500G,4,32,32,0,1
03-02-2025,"Grains, Flours & Dals",DESI CHANA,4,50,50,0,2
03-02-2025,"Grains, Flours & Dals",Chana Flour 500 gms,4,70,65,5,1
03-02-2025,Milk & Dairy,SANGAM TONED MILK 500ML,7,90,90,0,3
03-02-2025,"Health, Wellness & Ayurvedic Products",MD Tulasi Leaf Powder 50GM,5,80,80,0,1
03-02-2025,Milk & Dairy,SANGAM TONED MILK 500ML,7,30,30,0,1
03-02-2025,"Health, Wellness & Ayurvedic Products",MD Aamlaki Choornam 100GM,5,80,80,0,1
03-02-2025,Oils & Ghee,Coconut oil 500 ml,9,220,200,20,1
03-02-2025,Personal Care & Cosmetics,Soapnut 250GM,10,60,60,0,1
03-02-2025,Personal Care & Cosmetics,SVE KHADI ALOEVERA GEL 100GM,10,140,140,0,1
03-02-2025,"Health, Wellness & Ayurvedic Products",MD Hibiscus Flower Choornam 30GM,5,100,100,0,1
03-02-2025,"Health, Wellness & Ayurvedic Products",MD Neem Leaf Choornam 100GM,5,80,80,0,1
03-02-2025,Household & Cleaning,LIZOL CITRUS 625ML,6,149,149,0,1
03-02-2025,Oils & Ghee,Black Sesame oil 1 L,9,1760,"1,520.00",240,4
03-02-2025,"Grains, Flours & Dals",CHANA DAL 1KG,4,140,120,20,1
03-02-2025,Pooja & Spiritual Items,BALAJI KASTURI DHOOP STICKS,12,70,70,0,1
03-02-2025,"Dry Fruits, Nuts & Seeds",ALMONDS 250GM,2,280,260,20,1
03-02-2025,"Dry Fruits, Nuts & Seeds",SD Mango cubes 200gm,2,90,90,0,1
03-02-2025,Sweeteners,MISHRI D,16,40,30,10,1
03-02-2025,"Grains, Flours & Dals",turdal 1kg,4,440,390,50,2
03-02-2025,"Grains, Flours & Dals",SL Idly Rava 1KG,4,130,110,20,2
03-02-2025,Oils & Ghee,Freedom Rice Bran Oil 1L,9,388,360,28,2
03-02-2025,"Grains, Flours & Dals",Urad dall 1 Kg,4,555,510,45,3
03-02-2025,Snacks & Ready-to-Eat,PN ORGANIC PUFFED RICE 200GM,14,55,55,0,1
03-02-2025,"Grains, Flours & Dals",SRILALITHA 5KG PINK B,4,370,370,0,1
03-02-2025,Spices & Seasonings,Menthulu 250 gms,15,50,45,5,1
03-02-2025,"Dry Fruits, Nuts & Seeds",Groundnuts 1 kg,2,190,170,20,1
03-02-2025,Spices & Seasonings,PN ORGANIC PINK SALT 1KG,15,248,248,0,2
03-02-2025,Sweeteners,GS A2 Buffalo Ghee 500ML,16,550,550,0,1
03-02-2025,"Grains, Flours & Dals",RED TURDAL 500GM,4,75,70,5,1
03-02-2025,Spices & Seasonings,Tamarind 500GM,15,160,130,30,1
03-02-2025,"Grains, Flours & Dals",BARLEY FLOUR 250GM,4,45,40,5,1
03-02-2025,Sweeteners,Mishri 500GM,16,70,60,10,1
03-02-2025,"Grains, Flours & Dals",PESARA PAPPU 500GMS,4,85,75,10,1
03-02-2025,Household & Cleaning,VIM TROPICAL LEMON FRESHNESS 250ML,6,110,110,0,2
03-02-2025,"Grains, Flours & Dals",DH URAD GOTA 1KG,4,215,190,25,1
03-02-2025,Spices & Seasonings,Jeera 100GM,15,50,45,5,1
03-02-2025,Spices & Seasonings,Gasagasalu 50GM,15,130,110,20,1
03-02-2025,"Grains, Flours & Dals",Wheat Flour 1 kg,4,140,120,20,2
03-02-2025,"Grains, Flours & Dals",THICK POHA 500GM,4,40,35,5,1
03-02-2025,General Household & Kitchenware,PREMIER KITTCHEN TOWEL,3,160,160,0,1
03-02-2025,"Grains, Flours & Dals",Bombay Rava 500GM,4,35,30,5,1
03-02-2025,"Grains, Flours & Dals",White jowar.F 1 kg,4,100,80,20,1
03-02-2025,Snacks & Ready-to-Eat,Popcorn Seeds 250GM,14,45,40,5,1
03-02-2025,"Grains, Flours & Dals",PESARA PAPPU 1 KG,4,170,145,25,1
03-02-2025,Personal Care & Cosmetics,MADDI BATH POWDER 400GM,10,150,150,0,1
03-02-2025,Personal Care & Cosmetics,OVAL BODY LOOFAH,10,60,60,0,1
03-02-2025,"Grains, Flours & Dals",Wheat Flour 500 gms,4,17.5,15,2.5,0.5
03-02-2025,Personal Care & Cosmetics,UVIS ONION SHAMPOO,10,210,210,0,1
03-02-2025,Snacks & Ready-to-Eat,ZEEDI,14,140,140,0,2
03-02-2025,Oils & Ghee,Sesame oil 500ml,9,295,280,15,1
03-02-2025,"Grains, Flours & Dals",Multigrain 1 kg,4,100,85,15,1
03-02-2025,Snacks & Ready-to-Eat,VD VAMUPUSA 175GM,14,60,60,0,1
03-02-2025,"Grains, Flours & Dals",SL Idly Rava 1KG,4,130,110,20,2
03-02-2025,"Grains, Flours & Dals",KORRALU (FOXTAIL M) 1KG,4,150,110,40,1
03-02-2025,"Grains, Flours & Dals",Brown RICE 1KG,4,140,130,10,2
03-02-2025,"Grains, Flours & Dals",SINGHAM 26KG BAG,4,1650,"1,650.00",0,1
03-02-2025,"Grains, Flours & Dals",Urad dall 1 Kg,4,370,340,30,2
03-02-2025,Personal Care & Cosmetics,MYSORE SANDAL,10,82,82,0,1
03-02-2025,"Grains, Flours & Dals",Wheat Flour 1 kg,4,70,60,10,1
03-02-2025,Snacks & Ready-to-Eat,PUMPKIN CHIKKI 200GM,14,140,120,20,1
03-02-2025,Snacks & Ready-to-Eat,VD BELLAM GAVVALU 200GM,14,60,60,0,1
03-02-2025,Snacks & Ready-to-Eat,MILLET NOODLES CURRY MASALA,14,129,129,0,1
03-02-2025,"Grains, Flours & Dals",PRO ORG RED POHA 500GM,4,89,89,0,1
03-02-2025,Pooja & Spiritual Items,BANDA PUVVU 25GM 25GM,12,80,60,20,1
03-02-2025,"Health, Wellness & Ayurvedic Products",RB Max Protein Chinese Manchurian,5,45,45,0,1
03-02-2025,Snacks & Ready-to-Eat,SESAME LADDU 200GM,14,100,80,20,1
03-02-2025,"Grains, Flours & Dals",Bombay Rava 500GM,4,35,30,5,1
03-02-2025,Spices & Seasonings,RED COPRA 500GM,15,170,148,22,1
03-02-2025,Household & Cleaning,VIM EXTRA 110GM,6,40,40,0,4
03-02-2025,Spices & Seasonings,Turmeric powder 1 kg,15,400,300,100,1
03-02-2025,Oils & Ghee,Groundnut oil 1 L,9,360,330,30,1
03-02-2025,"Grains, Flours & Dals",turdal 1kg,4,220,195,25,1
03-02-2025,Spices & Seasonings,AVALU 100GM,15,25,20,5,1
03-02-2025,Oils & Ghee,Sesame oil 500ml,9,295,280,15,1
03-02-2025,Spices & Seasonings,Coriander seeds 200 gms,15,48,40,8,1
03-02-2025,Spices & Seasonings,NUVVULU 250GM,15,80,65,15,1
03-02-2025,"Grains, Flours & Dals",RAGULU 1 KG,4,70,60,10,1
03-02-2025,Sweeteners,NATURAL HONEY 250GM,16,150,130,20,1
03-02-2025,"Grains, Flours & Dals",RAGULU 1 KG,4,70,60,10,1
03-02-2025,"Grains, Flours & Dals",KORRALU (FOXTAIL M) 1KG,4,150,110,40,1
03-02-2025,"Grains, Flours & Dals",JOWAR YELLOW 1 K,4,100,90,10,1
03-02-2025,"Grains, Flours & Dals",AISHWARYA SP 1KG,4,160,140,20,2
03-02-2025,Snacks & Ready-to-Eat,RAGI LADDU,14,120,120,0,1
03-02-2025,Spices & Seasonings,Menthulu 250 gms,15,50,45,5,1
03-02-2025,"Dry Fruits, Nuts & Seeds",SD Mango cubes 100gm,2,45,45,0,1
03-02-2025,"Grains, Flours & Dals",Multigrain 1 kg,4,200,170,30,2
03-02-2025,Spices & Seasonings,SD Redgram Karam Powder 100GM,15,65,65,0,1
03-02-2025,"Grains, Flours & Dals",DH URAD GOTA 1KG,4,430,380,50,2
03-02-2025,Spices & Seasonings,Tamalapaku Karam Powder 100GM,15,80,80,0,1
03-02-2025,Snacks & Ready-to-Eat,SD Thati thandra 200gm,14,150,150,0,1
03-02-2025,Beverages,BISLERI 2 L,1,30,30,0,1
03-02-2025,"Grains, Flours & Dals",SL Idly Rava 1KG,4,130,110,20,2
03-02-2025,"Grains, Flours & Dals",Wheat Rava S 500GM,4,33,30,3,1
03-02-2025,Snacks & Ready-to-Eat,SD Ginger Candy 100g,14,60,60,0,1
03-02-2025,"Grains, Flours & Dals",SB Javva Wheat Ravva 500GM,4,190,190,0,2
03-02-2025,Snacks & Ready-to-Eat,BELAM MENIPA SUNADULLU,14,360,360,0,2
03-02-2025,"Grains, Flours & Dals",Em Multimillet idli r 500g,4,129,129,0,1
03-02-2025,"Grains, Flours & Dals",Em Multimillet upma 500g,4,129,129,0,1
03-02-2025,"Dry Fruits, Nuts & Seeds",SUNFLOWER SEEDS 250GRM,2,150,130,20,1
03-02-2025,"Dry Fruits, Nuts & Seeds",PUMPKIN SEEDS 250GM,2,200,160,40,1
03-02-2025,"Dry Fruits, Nuts & Seeds",WATERMELON SEEDS 250GRM,2,320,280,40,1
03-02-2025,Sweeteners,NATURAL HONEY 1KG,16,560,480,80,1
03-02-2025,"Dry Fruits, Nuts & Seeds",FLAX SEEDS 250GM,2,60,50,10,1
03-02-2025,"Dry Fruits, Nuts & Seeds",KAJU HALF 250GM,2,310,290,20,1
03-02-2025,Snacks & Ready-to-Eat,BLACK SESAME CHIKKI,14,45,45,0,1
03-02-2025,Sweeteners,NATURAL HONEY 250GM,16,150,130,20,1
03-02-2025,Pickles & Cooking Pastes,SD MANGO TOKKU,11,110,110,0,1
03-02-2025,Pooja & Spiritual Items,SOSR SWATHHI 365,12,30,30,0,1
03-02-2025,"Grains, Flours & Dals",split black gram 1 kg,4,180,170,10,1
03-02-2025,Spices & Seasonings,Turmeric powder 250 gms,15,100,75,25,1
03-02-2025,"Grains, Flours & Dals",BLACK GRAM 1KG,4,150,140,10,1
03-02-2025,Spices & Seasonings,ROYAL SAFFRON 400GRMS,15,65,65,0,1
03-02-2025,"Grains, Flours & Dals",Urad dall 1 Kg,4,185,170,15,1
03-02-2025,Snacks & Ready-to-Eat,VD MYSOREPAK 6PIC,14,100,100,0,1
03-02-2025,"Grains, Flours & Dals",Wheat Flour 1 kg,4,280,240,40,4
03-02-2025,Spices & Seasonings,Chilli powder 1 kg,15,580,420,160,1
03-02-2025,Spices & Seasonings,Turmeric powder 500 gms,15,200,150,50,1
03-02-2025,Oils & Ghee,Groundnut oil 5 L,9,1800,"1,600.00",200,1
03-02-2025,Oils & Ghee,Black Sesame oil 1 L,9,880,760,120,2
03-02-2025,Spices & Seasonings,Turmeric powder 250 gms,15,200,150,50,2
03-02-2025,Snacks & Ready-to-Eat,TILLI CHIKKI,14,20,20,0,4
03-02-2025,"Dry Fruits, Nuts & Seeds",Groundnuts 500 gms,2,95,85,10,1
03-02-2025,"Grains, Flours & Dals",THIN POHA 500GM,4,40,35,5,1
03-02-2025,Snacks & Ready-to-Eat,ELITE ELAICHI RUSK 200GM,14,35,35,0,1
03-02-2025,Beverages,RED LABEL 100GM,1,50,50,0,1
03-02-2025,Oils & Ghee,Coconut oil 500 ml,9,220,200,20,1
03-02-2025,Snacks & Ready-to-Eat,SD Vamu with palm jaggery 250gm,14,135,135,0,1
03-02-2025,Snacks & Ready-to-Eat,BATANA NGT 70GMS,14,20,20,0,1
03-02-2025,Household & Cleaning,VIM MAHA BAR,6,10,10,0,1
03-02-2025,Household & Cleaning,EXO STEEL SCRUB,6,15,15,0,1
03-02-2025,Household & Cleaning,VIM EXTRA 110GM,6,15,15,0,1
03-02-2025,Oils & Ghee,Groundnut oil 1 L,9,360,330,30,1
03-02-2025,Snacks & Ready-to-Eat,MILK BREAD,14,55,55,0,1
03-02-2025,Spices & Seasonings,Menthulu 250 gms,15,50,45,5,1
03-02-2025,Spices & Seasonings,AVALU 100GM,15,50,40,10,2
03-02-2025,"Grains, Flours & Dals",Idly Rava L 1KG,4,60,50,10,1
03-02-2025,Spices & Seasonings,JEERA 250 gms,15,125,105,20,1
03-02-2025,"Grains, Flours & Dals",Chana Flour 500 gms,4,70,65,5,1
03-02-2025,Household & Cleaning,VIM SOAP,6,40,40,0,8
03-02-2025,Snacks & Ready-to-Eat,VD MINAPA VADIYAM,14,65,65,0,1
03-02-2025,Spices & Seasonings,Tamarind 500GM,15,160,130,30,1
03-02-2025,Beverages,RED LABEL NATURAL CARE 100G,1,65,65,0,1
03-02-2025,"Dry Fruits, Nuts & Seeds",SD Mango cubes 200gm,2,90,90,0,1
03-02-2025,"Health, Wellness & Ayurvedic Products",VAMU WATER,5,140,140,0,2
03-02-2025,Spices & Seasonings,AV Iodized Salt 1KG,15,84,75,9,3
03-02-2025,Pooja & Spiritual Items,BALAJI KASTURI DHOOP STICKS,12,350,350,0,5
03-02-2025,Snacks & Ready-to-Eat,VD RED CHILLI RICEPAPAD 150GM,14,50,50,0,1
03-02-2025,General Household & Kitchenware,SCISSORS,3,205,205,0,1
03-02-2025,Pooja & Spiritual Items,BALAJI BEL PHOOL DHOOP STICKS 10STK,12,70,70,0,1
03-02-2025,Personal Care & Cosmetics,BIOTIQUE HERBCOLOR 1N,10,300,300,0,1
03-02-2025,"Grains, Flours & Dals",BOMBAY RAVA,4,140,110,30,2
03-02-2025,Oils & Ghee,Coconut oil 1 L,9,440,400,40,1
03-02-2025,Spices & Seasonings,Elaichi 25GM,15,290,240,50,2
03-02-2025,"Grains, Flours & Dals",THICK POHA 1KG,4,80,70,10,1
03-02-2025,Snacks & Ready-to-Eat,PN ORGANIC PUFFED RICE 200GM,14,55,55,0,1
03-02-2025,Oils & Ghee,Groundnut oil 1 L,9,720,660,60,2
03-02-2025,Snacks & Ready-to-Eat,BELLAM MINAPA SUNADULLU,14,180,180,0,1
03-02-2025,Spices & Seasonings,SD Garlic Karam Powder 100GM,15,65,65,0,1
03-02-2025,"Grains, Flours & Dals",THICK POHA 500GM,4,40,35,5,1
03-02-2025,Snacks & Ready-to-Eat,SD Moringa with plam jaggery 250gm,14,135,135,0,1
03-02-2025,Snacks & Ready-to-Eat,SD Bajra with palm Jaggery 250gm,14,135,135,0,1
03-02-2025,Snacks & Ready-to-Eat,SD Pumpkin Seeds With Dates 175gm,14,170,170,0,1
03-02-2025,Snacks & Ready-to-Eat,PN ORGANIC PUFFED RICE 200GM,14,55,55,0,1
03-02-2025,"Grains, Flours & Dals",white Bobarlu 500 gms,4,80,75,5,1
03-02-2025,"Dry Fruits, Nuts & Seeds",ANJEER 250GM,2,400,360,40,1
03-02-2025,"Grains, Flours & Dals",White Chana 250 GM,4,60,50,10,1
03-02-2025,Snacks & Ready-to-Eat,SD Vamu with palm jaggery 250gm,14,135,135,0,1
03-02-2025,"Grains, Flours & Dals",ANDU KORRALU (Brown top .mlt) 500,4,130,110,20,1
03-02-2025,Pickles & Cooking Pastes,SD AMALA PICKLE,11,110,110,0,1
03-02-2025,Pickles & Cooking Pastes,SD MESTA PICKLE,11,110,110,0,1
03-02-2025,Household & Cleaning,EXO STEEL SCRUB,6,30,30,0,2
03-02-2025,Household & Cleaning,VIM EXTRA 110GM,6,20,20,0,2
03-02-2025,"Grains, Flours & Dals",UDALU (Barnyard millet) 1 kg,4,140,115,25,1
03-02-2025,Milk & Dairy,BROWN EGGS TRAY 30P,7,360,330,30,1
03-02-2025,Snacks & Ready-to-Eat,GANTASALA FLAX SEEDS SPICY,14,90,90,0,1
03-02-2025,"Grains, Flours & Dals",SAMALU (Little millet) 1 kg,4,170,130,40,1
03-02-2025,Snacks & Ready-to-Eat,jeera papad,14,80,80,0,1
03-02-2025,Personal Care & Cosmetics,MADDI HIBISCUS HAIR SHAMPOO 500ML,10,199,199,0,1
03-02-2025,"Health, Wellness & Ayurvedic Products",AMLA PACHAK,5,100,100,0,1
03-02-2025,Snacks & Ready-to-Eat,BD LITTLE MILLET NOODLES 200G,14,150,150,0,2
03-02-2025,Snacks & Ready-to-Eat,BD KODO MILLET NOODLES 200GM,14,150,150,0,2
03-02-2025,Snacks & Ready-to-Eat,SD Aswagandha with palm Jaggery250Gm,14,135,135,0,1
03-02-2025,Snacks & Ready-to-Eat,VD BELLAM GAVVALU 200GM,14,60,60,0,1
03-02-2025,Snacks & Ready-to-Eat,VD MIXTURE 175 GM,14,60,60,0,1
03-02-2025,"Grains, Flours & Dals",turdal 500 gms,4,110,100,10,1
03-02-2025,"Dry Fruits, Nuts & Seeds",Groundnuts 500 gms,2,95,85,10,1
03-02-2025,"Grains, Flours & Dals",split black gram 1 kg,4,180,170,10,1
03-02-2025,"Grains, Flours & Dals",CHANA DAL 500GM,4,70,60,10,1
03-02-2025,"Grains, Flours & Dals",BARLEY FLOUR 250GM,4,45,40,5,1
03-02-2025,"Grains, Flours & Dals",Idly Rava L 1KG,4,120,100,20,2
03-02-2025,"Grains, Flours & Dals",Urad dall 1 Kg,4,185,170,15,1
03-02-2025,"Dry Fruits, Nuts & Seeds",Putnalu 250GM,2,45,38,7,1
03-02-2025,Oils & Ghee,Sesame oil 1 L,9,590,560,30,1
03-02-2025,"Grains, Flours & Dals",SRILATHA RICE RAVVA 500GM,4,35,35,0,1
03-02-2025,Spices & Seasonings,Jeera 100GM,15,50,45,5,1
03-02-2025,Snacks & Ready-to-Eat,INSTANT JOWAR DOSA MIX,14,120,120,0,1
03-02-2025,Snacks & Ready-to-Eat,GS INSTANT KORRA DOSA MIX 400GM,14,240,240,0,2
03-02-2025,Snacks & Ready-to-Eat,RAGI LADDU,14,120,120,0,1
03-02-2025,Snacks & Ready-to-Eat,BD LITTLE MILLET NOODLES 200G,14,75,75,0,1
03-02-2025,"Grains, Flours & Dals",Wheat Flour 1 kg,4,140,120,20,2
03-02-2025,Snacks & Ready-to-Eat,SD FINGER Millet with palm Jaggery 250gm,14,135,135,0,1
03-02-2025,Sweeteners,Natural Honey 500 gms,16,280,240,40,1
03-02-2025,Oils & Ghee,Groundnut oil 1 L,9,720,660,60,2
03-02-2025,Oils & Ghee,Sesame oil 1 L,9,1180,"1,120.00",60,2
03-02-2025,Spices & Seasonings,NUVVULU 500GM,15,160,130,30,1
03-02-2025,Milk & Dairy,BROWN EGGS 1P,7,336,288,48,24
03-02-2025,"Grains, Flours & Dals",BARLEY FLOUR 250GM,4,45,40,5,1
03-02-2025,Snacks & Ready-to-Eat,GB SALT COOKIES,14,60,55,5,1
03-02-2025,"Grains, Flours & Dals",Wheat Flour 3 kgs,4,210,180,30,1
03-02-2025,"Grains, Flours & Dals",White jowar.F 1 kg,4,200,160,40,2
03-02-2025,Snacks & Ready-to-Eat,MB SORGHUM NOODLES 180GM,14,95,95,0,1
03-02-2025,Sweeteners,MISHRI 250 GM,16,35,30,5,1
03-02-2025,Personal Care & Cosmetics,MD Soapnut Choornam 100GM,10,80,80,0,1
03-02-2025,Snacks & Ready-to-Eat,GS RAGI SNACKS 200GM,14,120,120,0,2
03-02-2025,Sweeteners,GS Organic Jaggery Powder 600GM,16,99,99,0,1
03-02-2025,"Grains, Flours & Dals",Multigrain 1 kg,4,100,85,15,1
03-02-2025,Spices & Seasonings,NUVVULU 250GM,15,80,65,15,1
03-02-2025,Milk & Dairy,BROWN EGGS 1P,7,84,72,12,6
03-02-2025,Snacks & Ready-to-Eat,MB FOXTAIL MILLET NOODLES 180GM,14,95,95,0,1
03-02-2025,"Health, Wellness & Ayurvedic Products",MD Orange Peel Choornam 50GM,5,80,80,0,1
03-02-2025,"Dry Fruits, Nuts & Seeds",ALMONDS 250GM,2,560,520,40,2
03-02-2025,"Dry Fruits, Nuts & Seeds",FLAX SEEDS 250GM,2,60,50,10,1
03-02-2025,Household & Cleaning,VIM EXTRA 110GM,6,20,20,0,2
03-02-2025,"Dry Fruits, Nuts & Seeds",CASHEW 250GM,2,340,310,30,1
03-02-2025,"Grains, Flours & Dals",SABDANA,4,40,35,5,1
03-02-2025,"Dry Fruits, Nuts & Seeds",PULMAKHANA 100 GM,2,180,170,10,1
03-02-2025,Snacks & Ready-to-Eat,GB SALT COOKIES,14,120,110,10,2
03-02-2025,"Dry Fruits, Nuts & Seeds",PLAIN PISTA 250GM,2,660,550,110,1
03-02-2025,"Grains, Flours & Dals",Multigrain 1 kg,4,100,85,15,1
03-02-2025,"Dry Fruits, Nuts & Seeds",ANJEER 250GM,2,400,360,40,1
03-02-2025,Oils & Ghee,Coconut oil 500 ml,9,220,200,20,1
03-02-2025,Snacks & Ready-to-Eat,PALLI LADDU 200GMS,14,90,70,20,1
03-02-2025,"Grains, Flours & Dals",RAGI FLOUR 500GRMS,4,40,35,5,1
03-02-2025,"Grains, Flours & Dals",SB Javva Wheat Ravva 500GM,4,95,95,0,1
03-02-2025,"Grains, Flours & Dals",SA YELLOW JOWAR RAVA 500GM,4,95,95,0,1
03-02-2025,Snacks & Ready-to-Eat,SATHVI PALLI CHIKKI 200GM,14,100,80,20,1
03-02-2025,Snacks & Ready-to-Eat,MARMURA LADDU,14,80,60,20,1
03-02-2025,Snacks & Ready-to-Eat,TILLI CHIKKI,14,15,15,0,3
03-02-2025,"Grains, Flours & Dals",THICK POHA 500GM,4,40,35,5,1
03-02-2025,Oils & Ghee,Safflower oil 1 L,9,440,400,40,1
03-02-2025,Snacks & Ready-to-Eat,NGT CHATPATTA CHANA 90GM,14,50,50,0,2
03-02-2025,"Grains, Flours & Dals",Arikadu ( kodo),4,140,130,10,1
03-02-2025,"Grains, Flours & Dals",RAGI FLOUR 1KG,4,80,70,10,1
03-02-2025,"Grains, Flours & Dals",KORRALU (FOXTAIL M) 1KG,4,150,110,40,1
03-02-2025,Household & Cleaning,VIM EXTRA 110GM,6,20,20,0,2
03-02-2025,"Grains, Flours & Dals",turdal 500 gms,4,110,100,10,1
03-02-2025,"Grains, Flours & Dals",SL Idly Rava 1KG,4,65,55,10,1
03-02-2025,Beverages,RED LABEL NATURAL CARE 100G,1,65,65,0,1
03-02-2025,"Grains, Flours & Dals",Urad dall 1 Kg,4,370,340,30,2
03-02-2025,"Grains, Flours & Dals",Multigrain 1 kg,4,100,85,15,1
03-02-2025,Spices & Seasonings,Chilli powder 500 gms,15,290,210,80,1
03-02-2025,"Grains, Flours & Dals",Multigrain 1 kg,4,100,85,15,1
03-02-2025,Spices & Seasonings,AV Iodized Salt 1KG,15,28,25,3,1
03-02-2025,"Grains, Flours & Dals",SINGLE POLISH 1KG,4,975,975,0,15
03-02-2025,Oils & Ghee,BUFFALLO GHEE 500ML,9,410,370,40,1
03-02-2025,"Grains, Flours & Dals",RED TURDAL 500GM,4,75,70,5,1
03-02-2025,Sweeteners,SUGAR 1KG,16,60,50,10,1
03-02-2025,"Grains, Flours & Dals",CHANA DAL 500GM,4,70,60,10,1
03-02-2025,Household & Cleaning,TIDE DOUBLE POWER JASMINE &amp;ROSE,6,66,66,0,1
03-02-2025,Household & Cleaning,EXO DISHWASH POWER OF CYCLOZAN,6,15,15,0,1
03-02-2025,"Grains, Flours & Dals",Urad dall 1 Kg,4,370,340,30,2
03-02-2025,"Dry Fruits, Nuts & Seeds",Groundnuts 500 gms,2,95,85,10,1
03-02-2025,"Grains, Flours & Dals",VGR rice 1 kg,4,350,325,25,5
03-02-2025,Spices & Seasonings,JEERA 250 gms,15,125,105,20,1
03-02-2025,Sweeteners,MISHRI 250 GM,16,35,30,5,1
03-02-2025,"Grains, Flours & Dals",MIXED FLOUR,4,322,322,0,1
03-02-2025,"Dry Fruits, Nuts & Seeds",Groundnuts 1 kg,2,190,170,20,1
03-02-2025,"Dry Fruits, Nuts & Seeds",PULMAKHANA 100 GM,2,180,170,10,1
03-02-2025,Snacks & Ready-to-Eat,RINGS 200GM,14,60,60,0,2
03-02-2025,"Grains, Flours & Dals",Idly Rava L 1KG,4,60,50,10,1
03-02-2025,"Health, Wellness & Ayurvedic Products",MD Trikatu Choornam 30GM,5,150,150,0,1
03-02-2025,Spices & Seasonings,Tamarind 250GMS,15,80,65,15,1
03-02-2025,Oils & Ghee,Sesame oil 1 L,9,590,560,30,1
03-02-2025,"Grains, Flours & Dals",THICK POHA 500GM,4,40,35,5,1
03-02-2025,"Dry Fruits, Nuts & Seeds",Putnalu 250GM,2,90,76,14,2
03-02-2025,"Grains, Flours & Dals",RAGI FLOUR 1KG,4,80,70,10,1
03-02-2025,Household & Cleaning,VIM EXTRA 110GM,6,40,40,0,4
03-02-2025,Sweeteners,Natural Honey 500 gms,16,280,240,40,1
03-02-2025,"Grains, Flours & Dals",Wheat Rava M 500GM,4,33,30,3,1
03-02-2025,"Grains, Flours & Dals",SINGLE POLISH 1KG,4,325,325,0,5
03-02-2025,"Grains, Flours & Dals",Bombay Rava 500GM,4,35,30,5,1
03-02-2025,"Grains, Flours & Dals",turdal 1kg,4,440,390,50,2
03-02-2025,Oils & Ghee,Groundnut oil 1 L,9,360,330,30,1
03-02-2025,Personal Care & Cosmetics,KAIPO NONI TP 100GM,10,90,90,0,1
03-02-2025,"Health, Wellness & Ayurvedic Products",ORGANIC MORINGA POWER 100GM,5,498,498,0,2
03-02-2025,"Grains, Flours & Dals",SA Sprouted Ragi Flour 500GM,4,69,69,0,1
03-02-2025,"Dry Fruits, Nuts & Seeds",FLAX SEEDS 250GM,2,60,50,10,1
03-02-2025,"Grains, Flours & Dals",VGR rice 1 kg,4,210,195,15,3
03-02-2025,"Grains, Flours & Dals",Brown RICE 1KG,4,140,130,10,2
03-02-2025,"Grains, Flours & Dals",JOWAR YELLOW 1 K,4,100,90,10,1
03-02-2025,"Dry Fruits, Nuts & Seeds",SD Mango cubes 100gm,2,45,45,0,1
03-02-2025,Spices & Seasonings,ROYAL SAFFRON 400GRMS,15,65,65,0,1
03-02-2025,"Grains, Flours & Dals",THICK POHA 500GM,4,40,35,5,1
03-02-2025,"Dry Fruits, Nuts & Seeds",Putnalu 250GM,2,45,38,7,1
03-02-2025,"Grains, Flours & Dals",RAGULU 1 KG,4,35,30,5,0.5
03-02-2025,Snacks & Ready-to-Eat,BATANA NGT 70GMS,14,20,20,0,1
03-02-2025,Sweeteners,YB Brown Sugar 1KG,16,140,140,0,1
03-02-2025,Spices & Seasonings,PRO ORG BLACK PEPPER WHOLE 100G,15,210,210,0,1
03-02-2025,Spices & Seasonings,SONTI 50GM,15,30,20,10,1
03-02-2025,"Grains, Flours & Dals",Bombay Rava 500GM,4,35,30,5,1
03-02-2025,Household & Cleaning,EXO STEEL SCRUB,6,30,30,0,2
03-02-2025,"Grains, Flours & Dals",Idly Rava L 1KG,4,60,50,10,1
03-02-2025,Spices & Seasonings,PRO ORG CASSIA 50G,15,85,85,0,1
03-02-2025,"Dry Fruits, Nuts & Seeds",PRO ORG RAW PEANUTS 500GM,2,348,348,0,2
03-02-2025,"Grains, Flours & Dals",SA YELLOW JOWAR RAVA 500GM,4,285,285,0,3
03-02-2025,Spices & Seasonings,pickles chilli .pwdr 500 gms,15,355,325,30,1
03-02-2025,Spices & Seasonings,JEERA 250 gms,15,125,105,20,1
03-02-2025,"Dry Fruits, Nuts & Seeds",Groundnuts 1 kg,2,190,170,20,1
03-02-2025,Spices & Seasonings,Coriander seeds 200 gms,15,48,40,8,1
03-02-2025,"Grains, Flours & Dals",FLOUR CHARGE,4,24,24,0,2
03-02-2025,"Grains, Flours & Dals",JOWAR YELLOW 1 K,4,200,180,20,2
03-02-2025,Personal Care & Cosmetics,PARACHUTE 45ML,10,20,20,0,1
03-02-2025,"Grains, Flours & Dals",Urad dall 1 Kg,4,185,170,15,1
03-02-2025,Sweeteners,GS Organic Jaggery Powder 600GM,16,99,99,0,1
03-02-2025,"Grains, Flours & Dals",BOMBAY RAVA,4,70,55,15,1
03-02-2025,"Grains, Flours & Dals",SH TUR DAL 500GM,4,495,495,0,3
03-02-2025,"Grains, Flours & Dals",PRO ORG TUR DAL UNPOLISHED 500GM,4,176,176,0,1
03-02-2025,"Grains, Flours & Dals",RAJMA 500GM,4,90,90,0,1
03-02-2025,"Grains, Flours & Dals",Wheat Flour 1 kg,4,140,120,20,2
03-02-2025,Spices & Seasonings,PRO ORG AJWAIN 100G,15,105,105,0,1
03-02-2025,Household & Cleaning,ODOMOS,6,32,32,0,1
03-02-2025,Snacks & Ready-to-Eat,VD VAMUPUSA 175GM,14,60,60,0,1
03-02-2025,Oils & Ghee,Coconut oil 500 ml,9,220,200,20,1
03-02-2025,Personal Care & Cosmetics,COLGATE STRONG TEETH,10,20,20,0,1
03-02-2025,"Grains, Flours & Dals",FLOUR CHARGE,4,28.8,28.8,0,2.4
03-02-2025,"Grains, Flours & Dals",Chana Flour 500 gms,4,70,65,5,1
03-02-2025,"Grains, Flours & Dals",EM Foxtail idli r 500 g,4,109,109,0,1
03-02-2025,Spices & Seasonings,Dalchin Rolls 50GM,15,40,40,0,1
03-02-2025,Personal Care & Cosmetics,MD Henna Choornam 100GM,10,80,80,0,1
03-02-2025,"Grains, Flours & Dals",Em Little idli R 500g,4,129,129,0,1
03-02-2025,Milk & Dairy,HERITAGE TOTAL CURD 500GM,7,50,50,0,1
03-02-2025,Spices & Seasonings,Lavangam 50GM,15,60,50,10,1
03-02-2025,Oils & Ghee,Groundnut oil 1 L,9,360,330,30,1
03-02-2025,Oils & Ghee,Castor oil 500 ml,9,250,200,50,1
03-02-2025,"Grains, Flours & Dals",Wheat Flour 1 kg,4,70,60,10,1
03-02-2025,Milk & Dairy,BROWN EGGS 1P,7,168,144,24,12
03-02-2025,Snacks & Ready-to-Eat,PALLI LADDU 200GMS,14,90,70,20,1
03-02-2025,Snacks & Ready-to-Eat,SESAME LADDU 200GM,14,100,80,20,1
03-02-2025,Snacks & Ready-to-Eat,BATANA NGT 70GMS,14,40,40,0,2
03-02-2025,Spices & Seasonings,AV Iodized Salt 1KG,15,28,25,3,1
03-02-2025,Spices & Seasonings,Elaichi 25GM,15,145,120,25,1
03-02-2025,"Dry Fruits, Nuts & Seeds",KAJU HALF 250GM,2,310,290,20,1
03-02-2025,General Household & Kitchenware,TEA CUP 1P,3,90,90,0,2
03-02-2025,Oils & Ghee,BUFFALLO GHEE 500ML,9,410,370,40,1
03-02-2025,Spices & Seasonings,Biryani Leaf 25GM,15,40,40,0,2
03-02-2025,Spices & Seasonings,Japatri 25GM,15,100,80,20,1
03-02-2025,"Grains, Flours & Dals",White jowar.F 1 kg,4,100,80,20,1
03-02-2025,Snacks & Ready-to-Eat,urban murmura,14,60,55,5,1
03-02-2025,"Grains, Flours & Dals",turdal 1kg,4,220,195,25,1
03-02-2025,Spices & Seasonings,ROYAL SAFFRON,15,125,125,0,1
03-02-2025,"Grains, Flours & Dals",Wheat Flour 1 kg,4,140,120,20,2
03-02-2025,"Grains, Flours & Dals",Multigrain 1 kg,4,100,85,15,1
03-02-2025,Sweeteners,GS Organic Jaggery Powder 600GM,16,99,99,0,1
03-02-2025,Oils & Ghee,Sesame oil 1 L,9,590,560,30,1
03-02-2025,Sweeteners,GS Organic Jaggery Powder 600GM,16,198,198,0,2
03-02-2025,"Dry Fruits, Nuts & Seeds",Putnalu 250GM,2,45,38,7,1
03-02-2025,Snacks & Ready-to-Eat,BATANA NGT 70GMS,14,40,40,0,2
03-02-2025,Snacks & Ready-to-Eat,SF MILLET PANCAKE CLASSIC 150GM,14,149,149,0,1
03-02-2025,"Grains, Flours & Dals",MAAGAANI SP RICE 5KGS,4,1298,"1,120.00",178,2
03-02-2025,Milk & Dairy,SANGAM TONED MILK 500ML,7,60,60,0,2
03-02-2025,Milk & Dairy,SANGAM CURD 450GM,7,38,38,0,1
03-02-2025,Snacks & Ready-to-Eat,PALLI LADDU 200GMS,14,90,70,20,1
03-02-2025,"Grains, Flours & Dals",THICK POHA 500GM,4,40,35,5,1
03-02-2025,Snacks & Ready-to-Eat,VD RIBBON PAKODI 175GM,14,60,60,0,1
03-02-2025,Pooja & Spiritual Items,VRP APOORVA JAVADHU POW,12,35,35,0,1
03-02-2025,"Dry Fruits, Nuts & Seeds",Groundnuts 1 kg,2,190,170,20,1
03-02-2025,"Dry Fruits, Nuts & Seeds",Groundnuts 500 gms,2,95,85,10,1
03-02-2025,"Grains, Flours & Dals",Arikalu (kodo),4,70,65,5,1
03-02-2025,Oils & Ghee,Coconut oil 500 ml,9,220,200,20,1
03-02-2025,"Grains, Flours & Dals",Sathya Javva Wheat Rava 500GM,4,190,190,0,2
03-02-2025,Oils & Ghee,Groundnut oil 1 L,9,360,330,30,1
02-02-2025,Sweeteners,ACHU BELLAM 1KG,16,100,80,20,1
02-02-2025,Sweeteners,MISHRI D,16,40,30,10,1
02-02-2025,"Grains, Flours & Dals",KORRALU (FOXTAIL M) 1KG,4,150,110,40,1
02-02-2025,"Grains, Flours & Dals",Wheat Rava M 500GM,4,33,30,3,1
02-02-2025,"Grains, Flours & Dals",PRO SOYA CHUNKS 200G,4,79,79,0,1
02-02-2025,"Grains, Flours & Dals",turdal 1kg,4,220,195,25,1
02-02-2025,Spices & Seasonings,Menthulu 250 gms,15,50,45,5,1
02-02-2025,"Dry Fruits, Nuts & Seeds",Putnalu 250GM,2,45,38,7,1
02-02-2025,Sweeteners,KAMAL JAGGERY 500GM,16,40,40,0,1
02-02-2025,Oils & Ghee,Sesame oil 500ml,9,295,280,15,1
02-02-2025,Oils & Ghee,Coconut oil 500 ml,9,220,200,20,1
02-02-2025,Oils & Ghee,Groundnut oil 1 L,9,360,330,30,1
02-02-2025,Pooja & Spiritual Items,BALAJI KASTURI DHOOP STICKS,12,210,210,0,3
02-02-2025,"Grains, Flours & Dals",RAGI FLOUR 1KG,4,80,70,10,1
02-02-2025,Snacks & Ready-to-Eat,SD Moringa with plam jaggery 250gm,14,135,135,0,1
02-02-2025,Sweeteners,GS Palm Jaggery Powder 400GM,16,360,360,0,2
02-02-2025,Snacks & Ready-to-Eat,GS SORGHUM SNACKS 150GM,14,60,60,0,1
02-02-2025,"Grains, Flours & Dals",Black uluvalu 500 gms,4,90,70,20,1
02-02-2025,Snacks & Ready-to-Eat,VD Pappu Chekkalu 190gm,14,60,60,0,1
02-02-2025,Snacks & Ready-to-Eat,Sprouted Ragi Biscuits 450GM,14,300,300,0,2
02-02-2025,Personal Care & Cosmetics,OVAL BODY LOOFAH,10,55,55,0,1
02-02-2025,Snacks & Ready-to-Eat,RINGS 200GM,14,30,30,0,1
02-02-2025,"Dry Fruits, Nuts & Seeds",SD Mango cubes 100gm,2,45,45,0,1
02-02-2025,"Health, Wellness & Ayurvedic Products",RB Max Protein Choco Berry bar 50g,5,75,75,0,1
02-02-2025,Sweeteners,Natural Honey 500 gms,16,280,240,40,1
02-02-2025,Snacks & Ready-to-Eat,MAAGAANI M JOWAR PASTA 200GM,14,199,199,0,1
02-02-2025,"Grains, Flours & Dals",Wheat Flour 1 kg,4,70,60,10,1
02-02-2025,Snacks & Ready-to-Eat,MILLET NOODLES CURRY MASALA,14,129,129,0,1
02-02-2025,"Grains, Flours & Dals",BOMBAY RAVA,4,70,55,15,1
02-02-2025,Oils & Ghee,Coconut oil 1 L,9,440,400,40,1
02-02-2025,"Grains, Flours & Dals",RICE FLOUR 500 GM,4,35,28,7,1
02-02-2025,Oils & Ghee,Groundnut oil 1 L,9,360,330,30,1
02-02-2025,General Household & Kitchenware,VERMI COMPOST MIX,3,30,30,0,1
02-02-2025,"Grains, Flours & Dals",VGR rice 1 kg,4,350,325,25,5
02-02-2025,Oils & Ghee,BUFFALLO GHEE 500ML,9,410,370,40,1
02-02-2025,Oils & Ghee,Mustard oil 500 ml,9,220,195,25,1
02-02-2025,Snacks & Ready-to-Eat,PALLI LADDU 200GMS,14,90,70,20,1
02-02-2025,"Grains, Flours & Dals",Urad dall 1 Kg,4,185,170,15,1
02-02-2025,"Dry Fruits, Nuts & Seeds",Groundnuts 1 kg,2,190,170,20,1
02-02-2025,Spices & Seasonings,PURO Healthy Salt 1KG,15,110,110,0,1
02-02-2025,Beverages,KINLEY,1,20,20,0,1
02-02-2025,Oils & Ghee,Groundnut oil 1 L,9,720,660,60,2
02-02-2025,"Grains, Flours & Dals",Wheat Rava M 1KG,4,65,55,10,1
02-02-2025,Snacks & Ready-to-Eat,urban murmura,14,60,55,5,1
02-02-2025,Spices & Seasonings,FLAXSEED KARAM,15,75,75,0,1
02-02-2025,Snacks & Ready-to-Eat,INSTANT JOWAR DOSA MIX,14,120,120,0,1
02-02-2025,"Grains, Flours & Dals",Em jowar idly R 500G,4,75,75,0,1
02-02-2025,"Grains, Flours & Dals",Brown RICE 1KG,4,210,195,15,3
02-02-2025,"Health, Wellness & Ayurvedic Products",RB Max Protein Choco Berry bar 50g,5,75,75,0,1
02-02-2025,Spices & Seasonings,Masala Karam 250 gms,15,130,120,10,1
02-02-2025,General Household & Kitchenware,GOOD HOME,3,15,15,0,1
02-02-2025,Personal Care & Cosmetics,MYSORE SANDAL SOAP 75G,10,42,42,0,1
02-02-2025,Pooja & Spiritual Items,SREE REAL KASTURI STICKS 90GM,12,72,72,0,1
02-02-2025,Snacks & Ready-to-Eat,INSTANT JOWAR DOSA MIX,14,120,120,0,1
02-02-2025,Household & Cleaning,EXO SOAP,6,32,32,0,1
02-02-2025,Personal Care & Cosmetics,SVE PREMIUM WILD TURMEIC 100GM,10,110,110,0,1
02-02-2025,Oils & Ghee,Sesame oil 1 L,9,590,560,30,1
02-02-2025,"Health, Wellness & Ayurvedic Products",GD 27 HERBS OIL 120ML,5,150,150,0,1
02-02-2025,Snacks & Ready-to-Eat,SATHVI PALLI CHIKKI 200GM,14,100,80,20,1
02-02-2025,Personal Care & Cosmetics,COW DURBAR 7 HERBS SHAMPOO,10,125,125,0,1
02-02-2025,"Health, Wellness & Ayurvedic Products",MD Hibiscus Flower Choornam 30GM,5,100,100,0,1
02-02-2025,Oils & Ghee,Groundnut oil 1 L,9,360,330,30,1
02-02-2025,Snacks & Ready-to-Eat,urban murmura,14,60,55,5,1
02-02-2025,"Grains, Flours & Dals",SINGLE POLISH 1KG,4,325,325,0,5
02-02-2025,Oils & Ghee,Groundnut oil 5 L,9,1800,"1,600.00",200,1
02-02-2025,Sweeteners,Natural Honey 500 gms,16,280,240,40,1
02-02-2025,"Grains, Flours & Dals",RAGULU 1 KG,4,70,60,10,1
02-02-2025,"Grains, Flours & Dals",THICK POHA 500GM,4,40,35,5,1
02-02-2025,"Grains, Flours & Dals",VGR rice 1 kg,4,210,195,15,3
02-02-2025,"Dry Fruits, Nuts & Seeds",SD Mango cubes 100gm,2,90,90,0,2
02-02-2025,Snacks & Ready-to-Eat,KURNOOL MARMURA,14,140,110,30,2
02-02-2025,Sweeteners,Natural Honey 500 gms,16,280,240,40,1
02-02-2025,Oils & Ghee,Groundnut oil 1 L,9,360,330,30,1
02-02-2025,Milk & Dairy,BROWN EGGS TRAY 30P,7,360,330,30,1
02-02-2025,Oils & Ghee,Safflower oil 1 L,9,440,400,40,1
02-02-2025,"Grains, Flours & Dals",Wheat Flour 1 kg,4,70,60,10,1
02-02-2025,"Grains, Flours & Dals",White jowar.F 1 kg,4,100,80,20,1
02-02-2025,Oils & Ghee,Safflower oil 500 ml,9,220,200,20,1
02-02-2025,Oils & Ghee,Sesame oil 500ml,9,295,280,15,1
02-02-2025,Spices & Seasonings,PURO Healthy Salt 1KG,15,110,110,0,1
02-02-2025,Oils & Ghee,Groundnut oil 1 L,9,360,330,30,1
02-02-2025,Oils & Ghee,Safflower oil 1 L,9,440,400,40,1
02-02-2025,Snacks & Ready-to-Eat,VD SAGOPAPAD 150GM,14,55,55,0,1
02-02-2025,Snacks & Ready-to-Eat,BD PEARL MILLET NOODLES 200G,14,70,70,0,1
02-02-2025,Sweeteners,MADHUR SUGAR 1KG,16,65,55,10,1
02-02-2025,Milk & Dairy,BROWN EGGS 1P,7,84,72,12,6
02-02-2025,"Grains, Flours & Dals",Multigrain 1 kg,4,100,85,15,1
02-02-2025,Personal Care & Cosmetics,UVIS ONION SHAMPOO,10,210,210,0,1
02-02-2025,Snacks & Ready-to-Eat,VD RICE MURUKU 150GM,14,50,50,0,1
02-02-2025,"Health, Wellness & Ayurvedic Products",RB Max Protein Choco Almond bar 50g,5,75,75,0,1
02-02-2025,Snacks & Ready-to-Eat,3D PAPAD,14,40,40,0,1
02-02-2025,Snacks & Ready-to-Eat,MILK BREAD,14,55,55,0,1
02-02-2025,Personal Care & Cosmetics,VETIVER BATH SCRUB,10,50,50,0,1
02-02-2025,Snacks & Ready-to-Eat,VD DAHI MIRCHI(SALTED) 100GM,14,45,45,0,1
02-02-2025,Snacks & Ready-to-Eat,VD SAGOPAPAD 150GM,14,55,55,0,1
02-02-2025,Snacks & Ready-to-Eat,VD Minapa papad 200gm,14,60,60,0,1
02-02-2025,"Health, Wellness & Ayurvedic Products",RB Max Protein Choco Berry bar 50g,5,75,75,0,1
02-02-2025,Personal Care & Cosmetics,ORGANIC SPONGE LOOFAH,10,70,70,0,1
02-02-2025,Snacks & Ready-to-Eat,RINGS 200GM,14,60,60,0,2
02-02-2025,Snacks & Ready-to-Eat,BATANA NGT 70GMS,14,60,60,0,3
02-02-2025,Milk & Dairy,BROWN EGGS TRAY 30P,7,360,330,30,1
02-02-2025,"Grains, Flours & Dals",Wheat Rava M 1KG,4,65,55,10,1
02-02-2025,"Grains, Flours & Dals",KORRALU (FOXTAIL M) 1KG,4,150,110,40,1
02-02-2025,"Grains, Flours & Dals",SAMALU (Little millet) 1 kg,4,170,130,40,1
02-02-2025,Snacks & Ready-to-Eat,SD Atreyapuram DRY Fruit ghee,14,150,150,0,1
02-02-2025,Spices & Seasonings,NUVVULU 500GM,15,160,130,30,1
02-02-2025,"Grains, Flours & Dals",FLOUR CHARGE,4,51.6,51.6,0,4.3
02-02-2025,"Grains, Flours & Dals",VGR rice 1 kg,4,140,130,10,2
02-02-2025,Snacks & Ready-to-Eat,VD VAMUPUSA 175GM,14,60,60,0,1
02-02-2025,"Grains, Flours & Dals",Multigrain 1 kg,4,100,85,15,1
02-02-2025,"Grains, Flours & Dals",Multigrain 1 kg,4,100,85,15,1
02-02-2025,Snacks & Ready-to-Eat,SD Pumpkin Seeds With Dates 175gm,14,170,170,0,1
02-02-2025,Snacks & Ready-to-Eat,VD SAGOPAPAD 150GM,14,55,55,0,1
02-02-2025,"Grains, Flours & Dals",White jowar.F 1 kg,4,100,80,20,1
02-02-2025,"Grains, Flours & Dals",Em Foxtail upma r 500 g,4,109,109,0,1
02-02-2025,"Grains, Flours & Dals",SAMALU (Little millet) 1 kg,4,170,130,40,1
02-02-2025,Household & Cleaning,EXO STEEL SCRUB,6,30,30,0,2
02-02-2025,Snacks & Ready-to-Eat,VD RED CHILLI RICEPAPAD 150GM,14,50,50,0,1
02-02-2025,Personal Care & Cosmetics,REVLON COLOR N CARE,10,45,45,0,1
02-02-2025,Oils & Ghee,Groundnut oil 1 L,9,1080,990,90,3
02-02-2025,"Grains, Flours & Dals",HS RAGI Idly rava 500 gms,4,70,70,0,1
02-02-2025,Sweeteners,ACHUBELLAM 500GM,16,50,40,10,1
02-02-2025,Snacks & Ready-to-Eat,SD FINGER Millet with palm Jaggery 250gm,14,135,135,0,1
02-02-2025,"Grains, Flours & Dals",SABDANA,4,40,35,5,1
02-02-2025,"Grains, Flours & Dals",White jowar.F 1 kg,4,200,160,40,2
02-02-2025,"Grains, Flours & Dals",MELMEKER 250GMS,4,60,45,15,1
02-02-2025,Spices & Seasonings,Gasagasalu 50GM,15,130,110,20,1
02-02-2025,"Grains, Flours & Dals",EM Ragi idli R 500G,4,75,75,0,1
02-02-2025,Snacks & Ready-to-Eat,PUMPKIN CHIKKI 200GM,14,140,120,20,1
02-02-2025,Oils & Ghee,Safflower oil 1 L,9,440,400,40,1
02-02-2025,"Dry Fruits, Nuts & Seeds",SABJA SEEDS 100GM,2,80,70,10,1
02-02-2025,Oils & Ghee,Coconut oil 1 L,9,440,400,40,1
02-02-2025,"Grains, Flours & Dals",Wheat Flour 2 kgs,4,140,120,20,1
02-02-2025,"Grains, Flours & Dals",White jowar.F 1 kg,4,100,80,20,1
02-02-2025,Spices & Seasonings,DRY MIECHI 200GM,15,80,60,20,1
02-02-2025,Snacks & Ready-to-Eat,BATANA NGT 70GMS,14,20,20,0,1
02-02-2025,"Grains, Flours & Dals",RAGI FLOUR 500GRMS,4,40,35,5,1
02-02-2025,Snacks & Ready-to-Eat,NGT CHATPATTA CHANA 90GM,14,25,25,0,1
02-02-2025,"Dry Fruits, Nuts & Seeds",PLAIN PISTA 250GM,2,660,550,110,1
02-02-2025,Spices & Seasonings,Elaichi 25GM,15,145,120,25,1
02-02-2025,Spices & Seasonings,Jeera 100GM,15,50,45,5,1
02-02-2025,"Dry Fruits, Nuts & Seeds",Groundnuts 500 gms,2,95,85,10,1
02-02-2025,Spices & Seasonings,Coriander seeds 200 gms,15,48,40,8,1
02-02-2025,Oils & Ghee,Groundnut oil 1 L,9,360,330,30,1
02-02-2025,Spices & Seasonings,Lavangam 50GM,15,60,50,10,1
02-02-2025,Pickles & Cooking Pastes,SD GINGER PICKLE 250GM,11,110,110,0,1
02-02-2025,Household & Cleaning,EXO SOAP,6,32,32,0,1
02-02-2025,Snacks & Ready-to-Eat,ZEEDI,14,70,70,0,1
02-02-2025,"Grains, Flours & Dals",SL Idly Rava 1KG,4,65,55,10,1
02-02-2025,"Grains, Flours & Dals",DH URAD GOTA 1KG,4,430,380,50,2
02-02-2025,Personal Care & Cosmetics,MD Bath Powder 100GM,10,40,40,0,1
02-02-2025,"Grains, Flours & Dals",Em Multimillet upma 500g,4,129,129,0,1
02-02-2025,"Grains, Flours & Dals",RAGI FLOUR 500GRMS,4,40,35,5,1
02-02-2025,Spices & Seasonings,ROYAL SAFFRON 400GRMS,15,65,65,0,1
02-02-2025,"Grains, Flours & Dals",RED TURDAL 500GM,4,75,70,5,1
02-02-2025,Personal Care & Cosmetics,SVE RED SANDAL SOAP 100GM,10,90,90,0,1
02-02-2025,Snacks & Ready-to-Eat,RINGS 200GM,14,30,30,0,1
02-02-2025,"Dry Fruits, Nuts & Seeds",Groundnuts 1 kg,2,190,170,20,1
02-02-2025,Oils & Ghee,Groundnut oil 1 L,9,360,330,30,1
02-02-2025,Oils & Ghee,Black Sesame oil 1 L,9,440,380,60,1
02-02-2025,Oils & Ghee,Sesame oil 1 L,9,590,560,30,1
02-02-2025,"Grains, Flours & Dals",SRILATHA RICE RAVVA 500GM,4,35,35,0,1
02-02-2025,Oils & Ghee,Safflower oil 1 L,9,440,400,40,1
02-02-2025,"Grains, Flours & Dals",PRO ORGANIC MOONG GREEN,4,148,148,0,1
02-02-2025,Spices & Seasonings,Elaichi 25GM,15,145,120,25,1
02-02-2025,"Grains, Flours & Dals",Bombay Rava 500GM,4,35,30,5,1
02-02-2025,Oils & Ghee,Groundnut oil 1 L,9,360,330,30,1
02-02-2025,"Grains, Flours & Dals",Wheat Rava M 500GM,4,33,30,3,1
02-02-2025,"Grains, Flours & Dals",RICE FLOUR 1KG,4,70,55,15,1
02-02-2025,Snacks & Ready-to-Eat,VAKKALU,14,80,60,20,1
02-02-2025,"Dry Fruits, Nuts & Seeds",SD Mango cubes 200gm,2,90,90,0,1
02-02-2025,Snacks & Ready-to-Eat,SATHVI PALLI CHIKKI 200GM,14,100,80,20,1
02-02-2025,Personal Care & Cosmetics,MADDI BATH POWDER 400GM,10,150,150,0,1
02-02-2025,Personal Care & Cosmetics,MD Henna Choornam 100GM,10,80,80,0,1
02-02-2025,"Dry Fruits, Nuts & Seeds",DRYDATES YELLOW 250GM,2,135,120,15,1
02-02-2025,"Health, Wellness & Ayurvedic Products",MD Aamlaki Choornam 100GM,5,80,80,0,1
02-02-2025,"Health, Wellness & Ayurvedic Products",MD Mandara Leaf Powder 50GM,5,100,100,0,1
02-02-2025,"Health, Wellness & Ayurvedic Products",NEELI LEAF CHOORNAM,5,110,110,0,1
02-02-2025,"Dry Fruits, Nuts & Seeds",SALTED PISTA 250GM,2,400,350,50,1
02-02-2025,"Dry Fruits, Nuts & Seeds",ANJEER 250GM,2,400,360,40,1
02-02-2025,"Dry Fruits, Nuts & Seeds",YELLOW KISHMISH 250GM,2,130,110,20,1
02-02-2025,"Grains, Flours & Dals",Red Chana 250GM,4,35,30,5,1
02-02-2025,"Grains, Flours & Dals",Bombay Rava 500GM,4,35,30,5,1
02-02-2025,"Grains, Flours & Dals",White jowar.F 1 kg,4,200,160,40,2
02-02-2025,Snacks & Ready-to-Eat,VD BOONDI 175GM,14,60,60,0,1
02-02-2025,"Grains, Flours & Dals",BARLEY FLOUR 250GM,4,45,40,5,1
02-02-2025,"Grains, Flours & Dals",RAGULU 1 KG,4,70,60,10,1
02-02-2025,"Dry Fruits, Nuts & Seeds",Putnalu 250GM,2,45,38,7,1
02-02-2025,Spices & Seasonings,Tamarind 250GMS,15,80,65,15,1
02-02-2025,Snacks & Ready-to-Eat,VD MYSOREPAK 6PIC,14,100,100,0,1
02-02-2025,Milk & Dairy,SANGAM FULL CREAM MILK 500ML,7,38,38,0,1
02-02-2025,Snacks & Ready-to-Eat,RAJGIRA PEANUT CHIKKI,14,25,25,0,5
02-02-2025,Oils & Ghee,Safflower oil 500 ml,9,220,200,20,1
02-02-2025,"Dry Fruits, Nuts & Seeds",SD Mango cubes 100gm,2,45,45,0,1
02-02-2025,"Dry Fruits, Nuts & Seeds",Groundnuts 1 kg,2,190,170,20,1
02-02-2025,Spices & Seasonings,ROYAL SAFFRON 400GRMS,15,65,65,0,1
02-02-2025,"Dry Fruits, Nuts & Seeds",Groundnuts 1 kg,2,190,170,20,1
02-02-2025,"Grains, Flours & Dals",split urad dall 250 gms,4,45,40,5,1
02-02-2025,"Grains, Flours & Dals",Black gram 500 gms,4,75,70,5,1
02-02-2025,Sweeteners,SUGAR 1KG,16,120,100,20,2
02-02-2025,"Grains, Flours & Dals",Urad dall 1 Kg,4,370,340,30,2
02-02-2025,"Grains, Flours & Dals",split green gram 500 gms,4,75,70,5,1
02-02-2025,Spices & Seasonings,Tamarind 500GM,15,160,130,30,1
02-02-2025,"Grains, Flours & Dals",SABDANA,4,40,35,5,1
02-02-2025,Snacks & Ready-to-Eat,RSC ORANGE 100GMS,14,20,20,0,1
02-02-2025,"Grains, Flours & Dals",WHITE BATANI,4,40,30,10,1
02-02-2025,Spices & Seasonings,GREEN SOUNF,15,60,40,20,1
02-02-2025,Spices & Seasonings,Elaichi 25GM,15,145,120,25,1
02-02-2025,Spices & Seasonings,Jeera 100GM,15,50,45,5,1
02-02-2025,"Dry Fruits, Nuts & Seeds",Putnalu 250GM,2,45,38,7,1
02-02-2025,"Grains, Flours & Dals",CHANA DAL 1KG,4,35,30,5,0.25
02-02-2025,Oils & Ghee,Groundnut oil 1 L,9,720,660,60,2
02-02-2025,"Grains, Flours & Dals",turdal 1kg,4,220,195,25,1
02-02-2025,"Grains, Flours & Dals",SL Idly Rava 1KG,4,65,55,10,1
02-02-2025,Spices & Seasonings,Lavangam 50GM,15,60,50,10,1
02-02-2025,Spices & Seasonings,RED COPRA 500GM,15,170,148,22,1
02-02-2025,"Grains, Flours & Dals",KORRALU (FOXTAIL M) 1KG,4,150,110,40,1
02-02-2025,Oils & Ghee,Groundnut oil 1 L,9,360,330,30,1
02-02-2025,"Grains, Flours & Dals",turdal 500 gms,4,220,200,20,2
02-02-2025,"Dry Fruits, Nuts & Seeds",PUMPKIN SEEDS 250GM,2,400,320,80,2
02-02-2025,"Dry Fruits, Nuts & Seeds",DRYDATES YELLOW 250GM,2,135,120,15,1
02-02-2025,Snacks & Ready-to-Eat,BATANA NGT 70GMS,14,20,20,0,1
02-02-2025,Sweeteners,NATURAL HONEY 1KG,16,1120,960,160,2
02-02-2025,Pooja & Spiritual Items,SWATHI POOJA VATHULU,12,50,50,0,1
02-02-2025,Spices & Seasonings,Lavangam 50GM,15,60,50,10,1
02-02-2025,"Grains, Flours & Dals",SA YELLOW JOWAR RAVA 500GM,4,95,95,0,1
02-02-2025,Sweeteners,MISHRI 250 GM,16,70,66.5,3.5,2
02-02-2025,"Grains, Flours & Dals",YB CHITTIMUTYALU RICE 1KG,4,200,200,0,1
02-02-2025,Spices & Seasonings,PRO ORG CASSIA 50G,15,170,170,0,2
02-02-2025,"Grains, Flours & Dals",JOWAR UPMA RAVA,4,0,0,0,1
02-02-2025,"Grains, Flours & Dals",Em Multimillet upma 500g,4,258,258,0,2
02-02-2025,"Grains, Flours & Dals",Wheat Flour 2 kgs,4,140,120,20,1
02-02-2025,Oils & Ghee,Safflower oil 1 L,9,440,400,40,1
02-02-2025,Snacks & Ready-to-Eat,NGT CHATPATTA CHANA 90GM,14,50,50,0,2
02-02-2025,"Dry Fruits, Nuts & Seeds",SUNFLOWER SEEDS 250GRM,2,150,130,20,1
02-02-2025,"Grains, Flours & Dals",Multigrain 1 kg,4,200,170,30,2
02-02-2025,"Grains, Flours & Dals",Red Wheat Flour 1 kg,4,140,130,10,1
02-02-2025,"Grains, Flours & Dals",SL Suji Rava 500GM,4,32,32,0,1
02-02-2025,Oils & Ghee,Sesame oil 1 L,9,2950,"2,800.00",150,5
02-02-2025,"Grains, Flours & Dals",RAGULU 1 KG,4,70,60,10,1
02-02-2025,"Grains, Flours & Dals",DH URAD GOTA 1KG,4,430,380,50,2
02-02-2025,Sweeteners,MADHUR SUGAR 1KG,16,65,55,10,1
02-02-2025,Spices & Seasonings,PURO Healthy Salt 1KG,15,110,110,0,1
02-02-2025,Snacks & Ready-to-Eat,jeera papad,14,80,80,0,1
02-02-2025,"Grains, Flours & Dals",RICE FLOUR 500 GM,4,35,28,7,1
02-02-2025,Spices & Seasonings,JEERA 250 gms,15,125,105,20,1
02-02-2025,"Grains, Flours & Dals",RED TURDAL 500GM,4,75,70,5,1
02-02-2025,"Grains, Flours & Dals",Chittimuthaylu rice 1 kg,4,160,140,20,1
02-02-2025,"Grains, Flours & Dals",Chana Flour 500 gms,4,70,65,5,1
02-02-2025,"Grains, Flours & Dals",Idly Rava L 1KG,4,120,100,20,2
02-02-2025,Snacks & Ready-to-Eat,VD SAGOPAPAD 150GM,14,110,110,0,2
02-02-2025,"Dry Fruits, Nuts & Seeds",Groundnuts 1 kg,2,190,170,20,1
02-02-2025,Spices & Seasonings,Tamarind 500GM,15,160,130,30,1
02-02-2025,Spices & Seasonings,DRY MIECHI 200GM,15,80,60,20,1
02-02-2025,Oils & Ghee,Safflower oil 1 L,9,440,400,40,1
02-02-2025,Spices & Seasonings,Jeera 100GM,15,50,45,5,1
02-02-2025,"Grains, Flours & Dals",THICK POHA 500GM,4,40,35,5,1
02-02-2025,"Grains, Flours & Dals",SRILATHA RICE RAVVA 500GM,4,70,70,0,2
02-02-2025,Pooja & Spiritual Items,GD Aiswarya Deepam 700ML,12,195,195,0,1
02-02-2025,Snacks & Ready-to-Eat,jeera papad,14,80,80,0,1
02-02-2025,"Grains, Flours & Dals",CHANA DAL 1KG,4,35,30,5,0.25
02-02-2025,Spices & Seasonings,kasturi methi,15,60,60,0,1
02-02-2025,Sweeteners,SUGAR 1KG,16,60,50,10,1
02-02-2025,"Dry Fruits, Nuts & Seeds",Putnalu 250GM,2,45,38,7,1
02-02-2025,"Grains, Flours & Dals",RAGULU 1 KG,4,70,60,10,1
02-02-2025,"Dry Fruits, Nuts & Seeds",SALTED PISTA 250GM,2,400,350,50,1
02-02-2025,"Grains, Flours & Dals",JOWAR UPMA RAVA,4,0,0,0,1
02-02-2025,"Grains, Flours & Dals",RAGI FLOUR 1KG,4,80,70,10,1
02-02-2025,Spices & Seasonings,sf jeera,15,120,120,0,1
02-02-2025,Spices & Seasonings,SH MUSTARD 100GM,15,60,60,0,2
02-02-2025,Oils & Ghee,Black Sesame oil 1 L,9,440,380,60,1
02-02-2025,"Grains, Flours & Dals",SA WHITE JOWAR RAVA 500GM,4,138,138,0,2
02-02-2025,Spices & Seasonings,Menthulu 250 gms,15,50,45,5,1
02-02-2025,"Grains, Flours & Dals",BARLEY SEEDS 250GMS,4,40,35,5,1
02-02-2025,Sweeteners,YB Brown Sugar 500GM,16,75,75,0,1
02-02-2025,"Grains, Flours & Dals",Multigrain 1 kg,4,100,85,15,1
02-02-2025,"Grains, Flours & Dals",UDALU (Barnyard millet) 500 gms,4,70,60,10,1
02-02-2025,"Grains, Flours & Dals",JOWAR WHITE 1 KG,4,160,140,20,2
02-02-2025,"Grains, Flours & Dals",WHEAT 1 KG,4,60,50,10,1
02-02-2025,Pooja & Spiritual Items,HERBAL VETIVER STICK 20INC,12,45,45,0,1
02-02-2025,"Dry Fruits, Nuts & Seeds",ALMONDS 250GM,2,280,260,20,1
02-02-2025,Spices & Seasonings,PURO Healthy Salt 1KG,15,110,110,0,1
02-02-2025,"Grains, Flours & Dals",Wheat Rava M 1KG,4,130,110,20,2
02-02-2025,Sweeteners,KAMAL JAGGERY 500GM,16,40,40,0,1
02-02-2025,"Grains, Flours & Dals",RAGI FLOUR 1KG,4,80,70,10,1
02-02-2025,"Grains, Flours & Dals",Multigrain 1 kg,4,100,85,15,1
02-02-2025,Snacks & Ready-to-Eat,VD MURUKU 175GM,14,60,60,0,1
02-02-2025,"Grains, Flours & Dals",DH URAD GOTA 1KG,4,430,380,50,2
02-02-2025,"Grains, Flours & Dals",White jowar.F 1 kg,4,100,80,20,1
02-02-2025,"Grains, Flours & Dals",DESI CHANA,4,50,50,0,2
02-02-2025,Household & Cleaning,TIDE DOUBLE POWER JASMINE &amp;ROSE,6,66,66,0,1
02-02-2025,Snacks & Ready-to-Eat,ANNAPURNA APPALAM,14,35,35,0,1
02-02-2025,Snacks & Ready-to-Eat,VD Pappu Chekkalu 190gm,14,60,60,0,1
02-02-2025,"Grains, Flours & Dals",Urad dall 1 Kg,4,185,170,15,1
02-02-2025,"Grains, Flours & Dals",white Bobarlu 500 gms,4,80,75,5,1
02-02-2025,"Grains, Flours & Dals",Bombay Rava 500GM,4,35,30,5,1
02-02-2025,Snacks & Ready-to-Eat,BATANA NGT 70GMS,14,40,40,0,2
02-02-2025,Oils & Ghee,Groundnut oil 500ml,9,180,165,15,1
02-02-2025,"Grains, Flours & Dals",turdal 1kg,4,220,195,25,1
02-02-2025,Oils & Ghee,Sesame oil 1 L,9,590,560,30,1
02-02-2025,Snacks & Ready-to-Eat,VD VAMUPUSA 175GM,14,60,60,0,1
02-02-2025,Milk & Dairy,BROWN EGGS 1P,7,140,120,20,10
02-02-2025,Spices & Seasonings,Tamarind 250GMS,15,80,65,15,1
02-02-2025,Snacks & Ready-to-Eat,VD VAMUPUSA 175GM,14,60,60,0,1
02-02-2025,Snacks & Ready-to-Eat,SD Aswagandha with palm Jaggery250Gm,14,135,135,0,1
02-02-2025,Personal Care & Cosmetics,DWI ALOEVERA 100GM,10,100,100,0,1
02-02-2025,Oils & Ghee,A2 BUFFALO GHEE 250ML,9,299,299,0,1
02-02-2025,General Household & Kitchenware,IRN 4MM DOSA TAWA 12,3,460,460,0,1
02-02-2025,"Grains, Flours & Dals",Wheat Flour 1 kg,4,70,60,10,1
02-02-2025,"Dry Fruits, Nuts & Seeds",PULMAKHANA 100 GM,2,180,170,10,1
02-02-2025,Spices & Seasonings,SATHVI KARAKAYA 25 GM,15,50,30,20,1
02-02-2025,"Health, Wellness & Ayurvedic Products",AMLA PACHAK,5,100,100,0,1
02-02-2025,Spices & Seasonings,SH MUSTARD 100GM,15,30,30,0,1
02-02-2025,Spices & Seasonings,Telaga Pindi 250 GM,15,40,35,5,1
02-02-2025,Oils & Ghee,Coconut oil 500 ml,9,220,200,20,1
02-02-2025,Milk & Dairy,BROWN EGGS 1P,7,168,144,24,12
02-02-2025,Oils & Ghee,BUFFALLO GHEE 500ML,9,410,370,40,1
02-02-2025,Spices & Seasonings,Menthulu 250 gms,15,50,45,5,1
02-02-2025,Beverages,BRU GREEN LABEL 200G,1,140,140,0,1
02-02-2025,Sweeteners,SUGAR 500 GM,16,30,25,5,1
02-02-2025,"Grains, Flours & Dals",Idly Rava L 1KG,4,60,50,10,1
02-02-2025,"Dry Fruits, Nuts & Seeds",Groundnuts 1 kg,2,190,170,20,1
02-02-2025,Spices & Seasonings,THOKA MIRYALU 50GM,15,210,180,30,1
02-02-2025,"Dry Fruits, Nuts & Seeds",PUTNALU 500GMS,2,90,76,14,1
02-02-2025,"Grains, Flours & Dals",white Bobarlu 500 gms,4,80,75,5,1
02-02-2025,"Grains, Flours & Dals",Wheat Flour 1 kg,4,70,60,10,1
02-02-2025,Oils & Ghee,Groundnut oil 1 L,9,360,330,30,1
02-02-2025,"Grains, Flours & Dals",Bombay Rava 500GM,4,35,30,5,1
02-02-2025,Oils & Ghee,BUFFALLO GHEE 500ML,9,410,370,40,1
02-02-2025,Milk & Dairy,BROWN EGGS 1P,7,84,72,12,6
02-02-2025,Oils & Ghee,Coconut oil 1 L,9,440,400,40,1
02-02-2025,Pooja & Spiritual Items,GD Aiswarya Deepam 700ML,12,195,195,0,1
02-02-2025,"Grains, Flours & Dals",CHANA DAL 500GM,4,70,60,10,1
02-02-2025,"Grains, Flours & Dals",SPLIT BLACK GRAM 500 GM,4,90,85,5,1
02-02-2025,"Grains, Flours & Dals",RED TURDAL 500GM,4,75,70,5,1
02-02-2025,"Grains, Flours & Dals",white Bobarlu 500 gms,4,80,75,5,1
02-02-2025,"Grains, Flours & Dals",JOWAR WHITE 1 KG,4,80,70,10,1
02-02-2025,"Grains, Flours & Dals",BOMBAY RAVA,4,70,55,15,1
02-02-2025,"Grains, Flours & Dals",Wheat Flour 2 kgs,4,140,120,20,1
02-02-2025,Oils & Ghee,Safflower oil 1 L,9,1320,"1,200.00",120,3
02-02-2025,Pooja & Spiritual Items,GD Camphor 50GM,12,115,115,0,1
02-02-2025,Pooja & Spiritual Items,GD Aiswarya Deepam 700ML,12,195,195,0,1
02-02-2025,"Grains, Flours & Dals",Wheat Rava M 1KG,4,65,55,10,1
02-02-2025,"Grains, Flours & Dals",RICE FLOUR 1KG,4,70,55,15,1
02-02-2025,Snacks & Ready-to-Eat,GS Instant Raagi Dosa Mix 400GM,14,120,120,0,1
02-02-2025,Snacks & Ready-to-Eat,VD MAIDA CHEGODI 175GM,14,60,60,0,1
02-02-2025,Snacks & Ready-to-Eat,VD BELLAM GAVVALU 200GM,14,95,95,0,1
02-02-2025,Snacks & Ready-to-Eat,VD MURUKU 175GM,14,60,60,0,1
02-02-2025,Snacks & Ready-to-Eat,PALLI LADDU 200GMS,14,90,70,20,1
02-02-2025,"Grains, Flours & Dals",MAAGAANI LOW GI SP 1KG,4,149,149,0,1
02-02-2025,Spices & Seasonings,Tamarind 250GMS,15,160,130,30,2
02-02-2025,Beverages,RED LABEL 100GM,1,50,50,0,1
02-02-2025,Oils & Ghee,Groundnut oil 1 L,9,360,330,30,1
02-02-2025,"Grains, Flours & Dals",turdal 1kg,4,220,195,25,1
02-02-2025,Sweeteners,MADHUR SUGAR 1KG,16,65,55,10,1
02-02-2025,Spices & Seasonings,ROYAL SAFFRON 400GRMS,15,65,65,0,1
02-02-2025,"Grains, Flours & Dals",CHANA DAL 500GM,4,35,30,5,0.5
02-02-2025,Spices & Seasonings,DRY MIECHI 200GM,15,80,60,20,1
02-02-2025,Snacks & Ready-to-Eat,VD Pappu Chekkalu 190gm,14,60,60,0,1
02-02-2025,Spices & Seasonings,DURGA SALT CRYSTAL 1KG,15,25,25,0,1
02-02-2025,"Grains, Flours & Dals",FLOUR CHARGE,4,36,36,0,3
02-02-2025,"Grains, Flours & Dals",WHEAT 1 KG,4,180,150,30,3
02-02-2025,Spices & Seasonings,ROYAL SAFFRON,15,125,125,0,1
02-02-2025,"Grains, Flours & Dals",RAGI FLOUR 1KG,4,80,70,10,1
02-02-2025,Milk & Dairy,BROWN EGGS TRAY 30P,7,360,330,30,1
02-02-2025,Oils & Ghee,Groundnut oil 1 L,9,360,330,30,1
02-02-2025,"Grains, Flours & Dals",PRO SABUDHANA 500GM,4,89,89,0,1
02-02-2025,Oils & Ghee,Safflower oil 1 L,9,440,400,40,1
02-02-2025,"Grains, Flours & Dals",BOMBAY RAVA,4,70,55,15,1
02-02-2025,"Grains, Flours & Dals",Wheat Flour 1 kg,4,140,120,20,2
02-02-2025,Snacks & Ready-to-Eat,MILK BREAD,14,55,55,0,1
02-02-2025,Snacks & Ready-to-Eat,SD Bajra with palm Jaggery 250gm,14,135,135,0,1
02-02-2025,Snacks & Ready-to-Eat,VD RICE PAPAD 150GM,14,50,50,0,1
02-02-2025,Snacks & Ready-to-Eat,urban murmura,14,70,70,0,1
02-02-2025,Spices & Seasonings,GS Moringa Leaves Spicy Powder 100GM,15,90,90,0,1
02-02-2025,"Grains, Flours & Dals",turdal 1kg,4,220,195,25,1
02-02-2025,Personal Care & Cosmetics,REVLON,10,45,45,0,1
02-02-2025,Milk & Dairy,BROWN EGGS 1P,7,168,144,24,12
02-02-2025,Oils & Ghee,Mustard oil 500 ml,9,220,195,25,1
02-02-2025,Oils & Ghee,Sesame oil 500ml,9,295,280,15,1
02-02-2025,Oils & Ghee,BUFFALLO GHEE 500ML,9,410,370,40,1
02-02-2025,Snacks & Ready-to-Eat,MIX MILLET NOODLES,14,75,75,0,1
02-02-2025,Sweeteners,Mishri 500GM,16,70,60,10,1
02-02-2025,Spices & Seasonings,Dalchin Rolls 50GM,15,45,45,0,1
02-02-2025,Pooja & Spiritual Items,GD Dhoop Sticks 26GM,12,40,40,0,2
02-02-2025,Spices & Seasonings,Black Till 250GM,15,90,75,15,1
02-02-2025,"Grains, Flours & Dals",SA WHITE JOWAR RAVA 500GM,4,69,69,0,1
02-02-2025,"Grains, Flours & Dals",VL Sabdana 500GM,4,77,77,0,1
02-02-2025,"Grains, Flours & Dals",Wheat Flour 1 kg,4,140,120,20,2
02-02-2025,"Grains, Flours & Dals",RAGI FLOUR 500GRMS,4,40,35,5,1
02-02-2025,Snacks & Ready-to-Eat,SATHVI REGIVADA 200GM,14,80,60,20,1
02-02-2025,Oils & Ghee,Groundnut oil 1 L,9,360,330,30,1
02-02-2025,"Health, Wellness & Ayurvedic Products",MXP CHOCO CLASSIC BAR,5,80,80,0,1
02-02-2025,Milk & Dairy,BROWN EGGS TRAY 30P,7,360,330,30,1
02-02-2025,Milk & Dairy,HERITAGE TONED MILK 500ML,7,62,62,0,2
02-02-2025,"Grains, Flours & Dals",Wheat Flour 1 kg,4,70,60,10,1
02-02-2025,Oils & Ghee,Groundnut oil 1 L,9,360,330,30,1
02-02-2025,"Grains, Flours & Dals",Wheat Rava M 500GM,4,33,30,3,1
02-02-2025,Snacks & Ready-to-Eat,VD MYSOREPAK 6PIC,14,100,100,0,1
02-02-2025,"Grains, Flours & Dals",Brown RICE 1KG,4,70,65,5,1
02-02-2025,Spices & Seasonings,RED COPRA 250GMS,15,85,74,11,1
02-02-2025,Snacks & Ready-to-Eat,SD Thati thandra 200gm,14,150,150,0,1
02-02-2025,"Dry Fruits, Nuts & Seeds",SD Mango cubes 200gm,2,90,90,0,1
02-02-2025,Snacks & Ready-to-Eat,BD BARELY NOODLES 200G,14,70,70,0,1
02-02-2025,Snacks & Ready-to-Eat,SATHVI REGIVADA 200GM,14,80,60,20,1
02-02-2025,Oils & Ghee,Coconut oil 500 ml,9,220,200,20,1
02-02-2025,Spices & Seasonings,Telaga Pindi 250 GM,15,40,35,5,1
02-02-2025,"Grains, Flours & Dals",split green gram 500 gms,4,75,70,5,1
02-02-2025,General Household & Kitchenware,VERMI COMPOST MIX,3,30,30,0,1
02-02-2025,Spices & Seasonings,THREE MANGO RAI 200G,15,42,42,0,1
02-02-2025,Spices & Seasonings,NUVVULU 250GM,15,100,85,15,1
02-02-2025,Oils & Ghee,Groundnut oil 500ml,9,180,165,15,1
02-02-2025,Snacks & Ready-to-Eat,BATANA NGT 70GMS,14,20,20,0,1
02-02-2025,Pooja & Spiritual Items,SOSR SWATHHI 365,12,90,90,0,3
02-02-2025,Oils & Ghee,Coconut oil 500 ml,9,220,200,20,1
02-02-2025,Spices & Seasonings,LG 50GM,15,92,92,0,1
02-02-2025,Snacks & Ready-to-Eat,VD MINAPA VADIYAM,14,65,65,0,1
02-02-2025,Snacks & Ready-to-Eat,RINGS 200GM,14,90,90,0,3
02-02-2025,"Grains, Flours & Dals",FLOUR CHARGE,4,30,30,0,2.5
02-02-2025,Snacks & Ready-to-Eat,VD GUMMADI VADIYAM,14,75,75,0,1
02-02-2025,"Grains, Flours & Dals",JOWAR WHITE 1 KG,4,80,70,10,1
02-02-2025,"Grains, Flours & Dals",Idly Rava L 1KG,4,120,100,20,2
02-02-2025,Snacks & Ready-to-Eat,VD MAIDA CHEGODI 175GM,14,60,60,0,1
02-02-2025,Snacks & Ready-to-Eat,RINGS 200GM,14,60,60,0,2
02-02-2025,Snacks & Ready-to-Eat,SD Sesame laddu with dates250gm,14,135,135,0,1
02-02-2025,"Grains, Flours & Dals",SRILALITHA MAIDA FLOUR 500G,4,32,32,0,1
02-02-2025,"Grains, Flours & Dals",BAJRA 1 KG,4,60,50,10,1
02-02-2025,Snacks & Ready-to-Eat,ONION RINGS,14,50,50,0,1
02-02-2025,Snacks & Ready-to-Eat,GB SALT COOKIES,14,60,55,5,1
02-02-2025,Snacks & Ready-to-Eat,SF COOKIES CHOCO RAGI,14,99,99,0,1
02-02-2025,"Dry Fruits, Nuts & Seeds",nut powder,2,499,499,0,1
02-02-2025,Snacks & Ready-to-Eat,millet cake,14,119,119,0,1
02-02-2025,"Grains, Flours & Dals",RAGI FLOUR 1KG,4,80,70,10,1
02-02-2025,Spices & Seasonings,sf jeera,15,120,120,0,1
02-02-2025,Oils & Ghee,Groundnut oil 500ml,9,180,165,15,1
02-02-2025,"Dry Fruits, Nuts & Seeds",SH GROUNDNUT 250GM,2,85,85,0,1
02-02-2025,Spices & Seasonings,PRO ORG CORIANDER WHOLE 100G,15,140,140,0,2
02-02-2025,"Grains, Flours & Dals",DH URAD GOTA 1KG,4,215,190,25,1
02-02-2025,"Grains, Flours & Dals",RAGULU 1 KG,4,70,60,10,1
02-02-2025,Oils & Ghee,Coconut oil 500 ml,9,220,200,20,1
02-02-2025,Spices & Seasonings,PRO ORG MUSTARD SMALL -RAI 200G,15,84,84,0,1
02-02-2025,"Grains, Flours & Dals",PRO ORGANIC MOONG GREEN,4,148,148,0,1
02-02-2025,Spices & Seasonings,SH TAMARIND SEEDLESS 500GM,15,260,260,0,1
02-02-2025,Spices & Seasonings,PRO ORG TURMERIC POWDER 100G,15,70,70,0,1
02-02-2025,"Grains, Flours & Dals",ANDU KORRALU (Browntop.m) 1 kg,4,260,220,40,1
02-02-2025,"Grains, Flours & Dals",Chana Flour 500 gms,4,70,65,5,1
02-02-2025,Oils & Ghee,Groundnut oil 500ml,9,180,165,15,1
02-02-2025,Snacks & Ready-to-Eat,urban murmura,14,60,55,5,1
02-02-2025,Snacks & Ready-to-Eat,GANTASALA FLAX SEEDS SPICY,14,90,90,0,1
02-02-2025,"Grains, Flours & Dals",Wheat Flour 1 kg,4,70,60,10,1
02-02-2025,"Grains, Flours & Dals",SRILATHA RICE RAVVA 500GM,4,35,35,0,1
02-02-2025,"Grains, Flours & Dals",Multigrain 1 kg,4,100,85,15,1
02-02-2025,"Grains, Flours & Dals",RAGULU 1 KG,4,70,60,10,1
02-02-2025,"Grains, Flours & Dals",DH URAD GOTA 1KG,4,215,190,25,1
02-02-2025,Oils & Ghee,Safflower oil 1 L,9,1760,"1,600.00",160,4
02-02-2025,Household & Cleaning,VIM TROPICAL LEMON FRESHNESS 250ML,6,45,45,0,3
02-02-2025,Pickles & Cooking Pastes,SD MESTA PICKLE,11,110,110,0,1
02-02-2025,Snacks & Ready-to-Eat,MB MULTIMILLET NOODLES 180GM,14,95,95,0,1
02-02-2025,"Grains, Flours & Dals",SINGLE POLISH 1KG,4,65,65,0,1
02-02-2025,Beverages,ASSAM MASALA TEA,1,199,199,0,1
02-02-2025,Spices & Seasonings,MG Dasa dinasalu 250gm,15,220,220,0,1
02-02-2025,"Health, Wellness & Ayurvedic Products",RB Max Protein Soft &Chewy 55gm,5,60,60,0,1
02-02-2025,Beverages,GANTASALA TEJ DRY GINGER COFFEE,1,149,149,0,1
02-02-2025,"Grains, Flours & Dals",RAGI FLOUR 1KG,4,160,140,20,2
02-02-2025,"Grains, Flours & Dals",turdal 1kg,4,220,195,25,1
02-02-2025,Spices & Seasonings,PURO Healthy Salt 1KG,15,220,220,0,2
02-02-2025,Milk & Dairy,BROWN EGGS TRAY 30P,7,360,330,30,1
02-02-2025,"Grains, Flours & Dals",COW B rice 1 kg,4,144,138,6,2
02-02-2025,Spices & Seasonings,JEERA 250 gms,15,125,105,20,1
02-02-2025,Personal Care & Cosmetics,ORGANIC SPONGE LOOFAH,10,70,70,0,1
02-02-2025,"Grains, Flours & Dals",Red Wheat Flour 1 kg,4,420,390,30,3
02-02-2025,Pickles & Cooking Pastes,SD TOMATO PICKLE,11,110,110,0,1
02-02-2025,Snacks & Ready-to-Eat,PN ORGANIC PUFFED RICE 200GM,14,55,55,0,1
02-02-2025,Snacks & Ready-to-Eat,MB PEARL MILLET NOODLES 180GM,14,95,95,0,1
02-02-2025,"Grains, Flours & Dals",Brown RICE 1KG,4,140,130,10,2
02-02-2025,"Dry Fruits, Nuts & Seeds",CASHEW 250GM,2,340,310,30,1
02-02-2025,Oils & Ghee,ANURAG RB OIL,9,120,100,20,1
02-02-2025,"Grains, Flours & Dals",Idly Rava L 1KG,4,60,50,10,1
02-02-2025,Snacks & Ready-to-Eat,SD Aswagandha with palm Jaggery250Gm,14,135,135,0,1
02-02-2025,"Health, Wellness & Ayurvedic Products",SAI DURGA MORINGA LEAVES 100GM,5,75,75,0,1
02-02-2025,"Grains, Flours & Dals",JOWAR UPMA RAVA,4,0,0,0,1
02-02-2025,Sweeteners,SD PALM JAGGERY 500GM,16,400,400,0,2
02-02-2025,Snacks & Ready-to-Eat,SD FINGER Millet with palm Jaggery 250gm,14,135,135,0,1
02-02-2025,Spices & Seasonings,SD IDLY KARAM,15,65,65,0,1
02-02-2025,Oils & Ghee,Groundnut oil 1 L,9,360,330,30,1
02-02-2025,"Grains, Flours & Dals",SINGHAM 26KG BAG,4,1650,"1,650.00",0,1
02-02-2025,Oils & Ghee,Sesame oil 1 L,9,590,560,30,1
02-02-2025,Oils & Ghee,Safflower oil 1 L,9,880,800,80,2
02-02-2025,"Health, Wellness & Ayurvedic Products",MD Guduchi Choornam 100GM,5,110,110,0,1
02-02-2025,Oils & Ghee,GANTASALA A2 COW GHEE 250ML,9,299,299,0,1
02-02-2025,Sweeteners,GS Palm Jaggery Powder 400GM,16,180,180,0,1
02-02-2025,"Grains, Flours & Dals",Wheat Flour 1 kg,4,140,120,20,2
02-02-2025,"Grains, Flours & Dals",Green gram 500 gms,4,150,140,10,2
02-02-2025,"Grains, Flours & Dals",BOMBAY RAVA,4,70,55,15,1
02-02-2025,"Grains, Flours & Dals",THICK POHA 1KG,4,160,140,20,2
02-02-2025,"Grains, Flours & Dals",RAGI FLOUR 500GRMS,4,40,35,5,1
02-02-2025,"Grains, Flours & Dals",Wheat Rava M 1KG,4,65,55,10,1
02-02-2025,"Dry Fruits, Nuts & Seeds",PUTNALU 500GMS,2,90,76,14,1
02-02-2025,"Grains, Flours & Dals",Idly Rava L 1KG,4,120,100,20,2
02-02-2025,"Grains, Flours & Dals",PESARA PAPPU 1 KG,4,170,145,25,1
02-02-2025,Sweeteners,GS Palm Jaggery Powder 400GM,16,180,180,0,1
02-02-2025,"Grains, Flours & Dals",MAAGAANI LOW GI SP L 1KG,4,240,210,30,2
02-02-2025,"Grains, Flours & Dals",WHEAT 1 KG,4,360,300,60,6
02-02-2025,"Grains, Flours & Dals",FLOUR CHARGE,4,72,72,0,6
02-02-2025,Snacks & Ready-to-Eat,KURNOOL MARMURA,14,70,55,15,1
02-02-2025,Spices & Seasonings,Masala Karam 250 gms,15,130,120,10,1
02-02-2025,"Dry Fruits, Nuts & Seeds",PULMAKHANA 100 GM,2,180,170,10,1
02-02-2025,Personal Care & Cosmetics,GOW DURBAR 75G,10,180,180,0,3
02-02-2025,Pooja & Spiritual Items,GD Camphor 50GM,12,230,230,0,2
02-02-2025,"Grains, Flours & Dals",RICE FLOUR 500 GM,4,35,28,7,1
02-02-2025,Oils & Ghee,Coconut oil 1 L,9,440,400,40,1
02-02-2025,"Grains, Flours & Dals",VGR RICE 10 KGS,4,700,650,50,1
02-02-2025,Spices & Seasonings,Telaga Pindi 500GM,15,80,70,10,1
02-02-2025,Spices & Seasonings,Tamarind 500GM,15,160,130,30,1
02-02-2025,"Grains, Flours & Dals",split black gram 1 kg,4,180,170,10,1
02-02-2025,Oils & Ghee,Groundnut oil 5 L,9,1800,"1,600.00",200,1
02-02-2025,Sweeteners,MISHRI 250 GM,16,35,30,5,1
02-02-2025,Oils & Ghee,Mustard oil 500 ml,9,220,195,25,1
02-02-2025,Oils & Ghee,Safflower oil 1 L,9,440,400,40,1
02-02-2025,Oils & Ghee,Flaxseed oil 500 ml,9,300,270,30,1
02-02-2025,"Grains, Flours & Dals",SINGLE POLISH 1KG,4,650,650,0,10
02-02-2025,"Dry Fruits, Nuts & Seeds",PULMAKHANA 100 GM,2,180,170,10,1
02-02-2025,Snacks & Ready-to-Eat,KURNOOL MARMURA,14,70,55,15,1
02-02-2025,Spices & Seasonings,Menthulu 250 gms,15,50,45,5,1
02-02-2025,Spices & Seasonings,pickles chilli .pwdr 500 gms,15,355,325,30,1
02-02-2025,Spices & Seasonings,TM MIRCH POWDER 200GM,15,163,163,0,1
02-02-2025,Spices & Seasonings,TM MIRCH POWDER 200GM,15,163,163,0,1
02-02-2025,Spices & Seasonings,pickles chilli .pwdr 500 gms,15,355,325,30,1
02-02-2025,Spices & Seasonings,DRY MIECHI 200GM,15,80,60,20,1
02-02-2025,Spices & Seasonings,Tamarind 500GM,15,160,130,30,1
02-02-2025,Oils & Ghee,Groundnut oil 1 L,9,720,660,60,2
02-02-2025,"Grains, Flours & Dals",MAAGAANI LOW GI SP L 1KG,4,360,315,45,3
02-02-2025,Milk & Dairy,BROWN EGGS TRAY 30P,7,720,660,60,2
02-02-2025,Snacks & Ready-to-Eat,PEANUT CHILLI,14,30,30,0,6
02-02-2025,Household & Cleaning,EXO DISHWASH POWER OF CYCLOZAN,6,32,32,0,1
02-02-2025,Spices & Seasonings,SWEET SOUNF,15,20,20,0,1
02-02-2025,"Dry Fruits, Nuts & Seeds",Groundnuts 500 gms,2,95,85,10,1
02-02-2025,Snacks & Ready-to-Eat,RSC ORANGE 100GMS,14,20,20,0,1
02-02-2025,"Grains, Flours & Dals",Urad dall 1 Kg,4,185,170,15,1
02-02-2025,Sweeteners,YB JAGGERY POWDER 500GMS,16,75,75,0,1
02-02-2025,"Grains, Flours & Dals",Wheat Rava S 1KG,4,65,55,10,1
02-02-2025,Snacks & Ready-to-Eat,SD Atreyapuram DRY Fruit ghee,14,150,150,0,1
02-02-2025,Pooja & Spiritual Items,GOW DURBAR GEETHA CAMPHOR,12,60,60,0,1
02-02-2025,Pooja & Spiritual Items,GD KUMKUM 50GM,12,90,90,0,3
02-02-2025,Spices & Seasonings,Turmeric powder 250 gms,15,100,75,25,1
02-02-2025,Personal Care & Cosmetics,DWIBHASHI GULABA ARKA ROSA WATER,10,60,60,0,1
02-02-2025,"Grains, Flours & Dals",idly/Dosa rice 1 kg,4,140,120,20,2
02-02-2025,Pooja & Spiritual Items,GD Kumkum 50GM,12,30,30,0,1
02-02-2025,"Grains, Flours & Dals",Wheat Flour 1 kg,4,210,180,30,3
02-02-2025,Milk & Dairy,SANGAM CURD 450GM,7,38,38,0,1
02-02-2025,"Dry Fruits, Nuts & Seeds",PUMPKIN SEEDS 250GM,2,400,320,80,2
02-02-2025,Spices & Seasonings,Biryani Leaf 25GM,15,20,20,0,1
02-02-2025,Snacks & Ready-to-Eat,SATHVI PALLI CHIKKI 200GM,14,100,80,20,1
02-02-2025,"Dry Fruits, Nuts & Seeds",BLACK KISMIS 250GM,2,350,280,70,2
02-02-2025,"Grains, Flours & Dals",White jowar.F 1 kg,4,200,160,40,2
02-02-2025,"Dry Fruits, Nuts & Seeds",YELLOW KISHMISH 250GM,2,130,110,20,1
02-02-2025,Oils & Ghee,BUFFALLO GHEE 500ML,9,410,370,40,1
02-02-2025,Milk & Dairy,BROWN EGGS 1P,7,168,144,24,12
02-02-2025,Oils & Ghee,Groundnut oil 1 L,9,720,660,60,2
02-02-2025,Sweeteners,Natural Honey 500 gms,16,280,240,40,1
02-02-2025,"Grains, Flours & Dals",RAGI FLOUR 1KG,4,80,70,10,1
02-02-2025,"Grains, Flours & Dals",RICE FLOUR 1KG,4,210,165,45,3
02-02-2025,"Grains, Flours & Dals",Wheat Rava M 1KG,4,65,55,10,1
02-02-2025,"Grains, Flours & Dals",SB Javva Wheat Ravva 500GM,4,95,95,0,1
02-02-2025,"Grains, Flours & Dals",Bombay Rava 500GM,4,35,30,5,1
02-02-2025,Snacks & Ready-to-Eat,BATANA NGT 70GMS,14,20,20,0,1
02-02-2025,Pooja & Spiritual Items,VRP APOORVA JAVADHU POW,12,35,35,0,1
02-02-2025,"Grains, Flours & Dals",HS Multimillet upma r 500g,4,130,130,0,2
02-02-2025,"Grains, Flours & Dals",SL Idly Rava 1KG,4,65,55,10,1
02-02-2025,Sweeteners,Mishri 500GM,16,70,60,10,1
02-02-2025,"Grains, Flours & Dals",SL Suji Rava 500GM,4,32,32,0,1
02-02-2025,Sweeteners,SUGAR 1KG,16,60,50,10,1
02-02-2025,"Grains, Flours & Dals",Yellow jowar .F1 kg,4,110,100,10,1
02-02-2025,"Grains, Flours & Dals",SA WHITE JOWAR RAVA 500GM,4,69,69,0,1
02-02-2025,Personal Care & Cosmetics,MD Soapnut Choornam 100GM,10,80,80,0,1
02-02-2025,Snacks & Ready-to-Eat,VD GUMMADI VADIYAM,14,75,75,0,1
02-02-2025,"Grains, Flours & Dals",MELMEKER 250GMS,4,60,45,15,1
02-02-2025,"Grains, Flours & Dals",SA YELLOW JOWAR RAVA 500GM,4,95,95,0,1
02-02-2025,"Grains, Flours & Dals",HS Ragi upma rava 500 gms,4,70,70,0,1
02-02-2025,Snacks & Ready-to-Eat,NGT CHATPATTA CHANA 90GM,14,25,25,0,1
02-02-2025,Snacks & Ready-to-Eat,SATHVI REGIVADA 200GM,14,80,60,20,1
02-02-2025,"Grains, Flours & Dals",VL Sabdana 500GM,4,77,77,0,1
02-02-2025,Spices & Seasonings,Vamu 100GM,15,60,50,10,1
02-02-2025,Spices & Seasonings,LG 50GM,15,92,92,0,1
02-02-2025,"Grains, Flours & Dals",THICK POHA 1KG,4,80,70,10,1
02-02-2025,Pooja & Spiritual Items,SWAATHI GATTI DEEPAM VATTULU,12,60,60,0,2
02-02-2025,"Grains, Flours & Dals",SRILATHA RICE RAVVA 500GM,4,35,35,0,1
02-02-2025,Snacks & Ready-to-Eat,JUNNU POWDER 100GM,14,70,70,0,1
02-02-2025,"Grains, Flours & Dals",Red Bobarlu 500 gms,4,95,85,10,1
02-02-2025,"Grains, Flours & Dals",SAMALU (Little millet) 500 gms,4,85,65,20,1
02-02-2025,"Grains, Flours & Dals",Multigrain 1 kg,4,200,170,30,2
02-02-2025,Oils & Ghee,Safflower oil 1 L,9,880,800,80,2
02-02-2025,"Grains, Flours & Dals",Arikalu (kodo),4,70,65,5,1
02-02-2025,"Grains, Flours & Dals",Em Multimillet idli r 500g,4,258,258,0,2
02-02-2025,"Grains, Flours & Dals",Yellow jowar .F1 kg,4,220,200,20,2
02-02-2025,"Grains, Flours & Dals",RED TURDAL 500GM,4,75,70,5,1
02-02-2025,"Grains, Flours & Dals",Red Chana 500 GM,4,75,60,15,1
02-02-2025,"Grains, Flours & Dals",BAJRA 1 KG,4,15,12.5,2.5,0.25
02-02-2025,"Grains, Flours & Dals",JOWAR WHITE 1 KG,4,20,17.5,2.5,0.25
02-02-2025,"Grains, Flours & Dals",RED WHEAT 1 KG,4,32.5,30,2.5,0.25
02-02-2025,"Grains, Flours & Dals",SRILALITHA MAIDA FLOUR 500G,4,32,32,0,1
02-02-2025,"Dry Fruits, Nuts & Seeds",Groundnuts 500 gms,2,95,85,10,1
02-02-2025,"Grains, Flours & Dals",AISHWARYA SP 1KG,4,400,350,50,5
02-02-2025,Pooja & Spiritual Items,GB Bharatha Woods 75GM,12,60,60,0,1
02-02-2025,"Grains, Flours & Dals",VGR rice 1 kg,4,210,195,15,3
02-02-2025,Snacks & Ready-to-Eat,BROWN BREAD,14,60,60,0,1
02-02-2025,Sweeteners,SD PALM JAGGERY 500GM,16,600,600,0,3
02-02-2025,Spices & Seasonings,Black Till 250GM,15,540,450,90,6
02-02-2025,"Grains, Flours & Dals",Green gram 1 kg,4,150,130,20,1
02-02-2025,Spices & Seasonings,SATHVI ANASAPUVUU 25GM,15,90,65,25,1
02-02-2025,Oils & Ghee,Coconut oil 500 ml,9,220,200,20,1
02-02-2025,"Grains, Flours & Dals",VGR RICE bag 1,4,1899,"1,650.00",249,1
02-02-2025,"Grains, Flours & Dals",SB Javva Wheat Ravva 500GM,4,95,95,0,1
02-02-2025,"Grains, Flours & Dals",Wheat Flour 1 kg,4,70,60,10,1
02-02-2025,Spices & Seasonings,GREEN SOUNF,15,60,40,20,1
02-02-2025,Oils & Ghee,Sesame oil 1 L,9,590,560,30,1
02-02-2025,Snacks & Ready-to-Eat,RAJGIRA PEANUT CHIKKI,14,10,10,0,2
02-02-2025,Snacks & Ready-to-Eat,PEANUT CHILLI,14,5,5,0,1
02-02-2025,Spices & Seasonings,Tamalapaku Karam Powder 100GM,15,80,80,0,1
02-02-2025,Spices & Seasonings,Gasagasalu 50GM,15,130,110,20,1
02-02-2025,Oils & Ghee,Safflower oil 1 L,9,440,400,40,1
02-02-2025,Snacks & Ready-to-Eat,SD Vamu with palm jaggery 250gm,14,135,135,0,1
02-02-2025,"Grains, Flours & Dals",RED WHEAT 1 KG,4,390,360,30,3
02-02-2025,Snacks & Ready-to-Eat,ZEEDI,14,70,70,0,1
02-02-2025,"Grains, Flours & Dals",WHEAT 1 KG,4,180,150,30,3
02-02-2025,Snacks & Ready-to-Eat,SESAME CHIKKI,14,120,100,20,1
02-02-2025,"Grains, Flours & Dals",KORRALU (FOXTAIL M) 500GM,4,65,55,10,1
02-02-2025,"Grains, Flours & Dals",Arikalu (kodo),4,70,65,5,1
02-02-2025,"Grains, Flours & Dals",Multigrain 1 kg,4,300,255,45,3
02-02-2025,"Grains, Flours & Dals",UDALU (Barnyard millet) 500 gms,4,70,60,10,1
02-02-2025,"Grains, Flours & Dals",SAMALU (Little millet) 500 gms,4,85,65,20,1
02-02-2025,Snacks & Ready-to-Eat,VD VAMUPUSA 175GM,14,60,60,0,1
02-02-2025,"Grains, Flours & Dals",SABDANA 500GM,4,90,70,20,1
02-02-2025,"Grains, Flours & Dals",Wheat Flour 1 kg,4,350,300,50,5
02-02-2025,Pooja & Spiritual Items,GD Aiswarya Deepam 700ML,12,390,390,0,2
02-02-2025,Pooja & Spiritual Items,GD Sree Chandan 50GM,12,50,50,0,1
02-02-2025,"Grains, Flours & Dals",Bajra Flour 500 gms,4,35,30,5,1
02-02-2025,"Grains, Flours & Dals",RAGI FLOUR 500GRMS,4,40,35,5,1
02-02-2025,Personal Care & Cosmetics,MD Henna Choornam 100GM,10,80,80,0,1
02-02-2025,"Grains, Flours & Dals",EM kodo upma R 500g,4,129,129,0,1
02-02-2025,"Grains, Flours & Dals",Em Foxtail upma r 500 g,4,109,109,0,1
02-02-2025,"Grains, Flours & Dals",SA Sprouted Ragi Flour 500GM,4,69,69,0,1
02-02-2025,"Grains, Flours & Dals",RAGI FLOUR 500GRMS,4,40,35,5,1
02-02-2025,Milk & Dairy,BROWN EGGS 1P,7,266,228,38,19
02-02-2025,Sweeteners,YB JAGGERY POWDER 500GMS,16,75,75,0,1
02-02-2025,"Grains, Flours & Dals",Bajra Flour 1 kg,4,70,60,10,1
02-02-2025,Oils & Ghee,Groundnut oil 1 L,9,1080,990,90,3
02-02-2025,"Grains, Flours & Dals",DOCTOR RICE DIABETIC SFR 1KG,4,120,120,0,1
02-02-2025,"Dry Fruits, Nuts & Seeds",Groundnuts 500 gms,2,95,85,10,1
02-02-2025,"Grains, Flours & Dals",SA YELLOW JOWAR RAVA 500GM,4,190,190,0,2
02-02-2025,Spices & Seasonings,Gasagasalu 50GM,15,260,220,40,2
02-02-2025,"Grains, Flours & Dals",Sathya Javva Wheat Rava 500GM,4,190,190,0,2
02-02-2025,"Grains, Flours & Dals",Wheat Flour 1 kg,4,140,120,20,2
02-02-2025,"Grains, Flours & Dals",RAGI FLOUR 1KG,4,80,70,10,1
02-02-2025,"Grains, Flours & Dals",JOWAR WHITE 1 KG,4,40,35,5,0.5
02-02-2025,"Grains, Flours & Dals",BAJRA 1 KG,4,30,25,5,0.5
02-02-2025,General Household & Kitchenware,SIRIDHANYALU BOOK,3,200,180,20,1
02-02-2025,"Grains, Flours & Dals",RAGULU 1 KG,4,35,30,5,0.5
02-02-2025,"Grains, Flours & Dals",UDALU (Barnyard millet) 500 gms,4,70,60,10,1
02-02-2025,Spices & Seasonings,Jeera 100GM,15,50,45,5,1
02-02-2025,"Dry Fruits, Nuts & Seeds",Putnalu 250GM,2,45,38,7,1
02-02-2025,Snacks & Ready-to-Eat,SD FINGER Millet with palm Jaggery 250gm,14,135,135,0,1
02-02-2025,Snacks & Ready-to-Eat,GS INSTANT KORRA DOSA MIX 400GM,14,120,120,0,1
02-02-2025,Personal Care & Cosmetics,UVIS BLACK HENNA 100GM,10,175,175,0,1
02-02-2025,"Grains, Flours & Dals",JOWAR WHITE 1 KG,4,8,7,1,0.1
02-02-2025,Snacks & Ready-to-Eat,VD SAGOPAPAD 150GM,14,55,55,0,1
02-02-2025,"Dry Fruits, Nuts & Seeds",FLAX SEEDS 1KG,2,48,40,8,0.2
02-02-2025,Snacks & Ready-to-Eat,TILLI CHIKKI,14,5,5,0,1
02-02-2025,"Grains, Flours & Dals",BAJRA 1 KG,4,6,5,1,0.1
02-02-2025,"Grains, Flours & Dals",THICK POHA 500GM,4,40,35,5,1
02-02-2025,"Grains, Flours & Dals",RAGULU 1 KG,4,7,6,1,0.1
02-02-2025,"Grains, Flours & Dals",SRILATHA RICE RAVVA 500GM,4,70,70,0,2
02-02-2025,"Dry Fruits, Nuts & Seeds",SATHVI CHIA SEEDS 100GM,2,200,160,40,2
02-02-2025,"Dry Fruits, Nuts & Seeds",SUNFLOWER SEEDS 250GRM,2,150,130,20,1
02-02-2025,"Grains, Flours & Dals",Multigrain 1 kg,4,200,170,30,2
02-02-2025,"Grains, Flours & Dals",BARLEY SEEDS 1KG,4,16,14,2,0.1
02-02-2025,"Dry Fruits, Nuts & Seeds",PUMPKIN SEEDS 250GM,2,200,160,40,1
02-02-2025,"Grains, Flours & Dals",DISANO OATS 1KG,4,28.5,28.5,0,0.1
02-02-2025,"Grains, Flours & Dals",WHEAT 1 KG,4,120,100,20,2
02-02-2025,"Grains, Flours & Dals",SOYA BEANS 1KG,4,20,18,2,0.1
02-02-2025,Pooja & Spiritual Items,GD Dhoop Cones 40GM,12,30,30,0,1
02-02-2025,Oils & Ghee,Groundnut oil 1 L,9,720,660,60,2
02-02-2025,"Health, Wellness & Ayurvedic Products",RB Max Protein Salt & Caramel Bar 50g,5,75,75,0,1
02-02-2025,"Dry Fruits, Nuts & Seeds",Groundnuts 1 kg,2,380,340,40,2
02-02-2025,"Health, Wellness & Ayurvedic Products",RB Max Protein Choco Almond bar 50g,5,75,75,0,1
02-02-2025,Milk & Dairy,BROWN EGGS 1P,7,70,60,10,5
02-02-2025,"Grains, Flours & Dals",Em kodo idli R 500G,4,129,129,0,1
02-02-2025,Spices & Seasonings,Avalu small 250 gms,15,60,40,20,1
02-02-2025,"Grains, Flours & Dals",Wheat Rava M 500GM,4,33,30,3,1
02-02-2025,Oils & Ghee,Groundnut oil 1 L,9,720,660,60,2
02-02-2025,"Grains, Flours & Dals",Wheat Rava S 500GM,4,33,30,3,1
02-02-2025,Spices & Seasonings,ROYAL SAFFRON,15,125,125,0,1
02-02-2025,"Grains, Flours & Dals",turdal 1kg,4,660,585,75,3
02-02-2025,Beverages,BRU GREEN LABEL 200G,1,140,140,0,1
02-02-2025,Sweeteners,SUGAR 1KG,16,120,100,20,2
02-02-2025,"Grains, Flours & Dals",Urad dall 1 Kg,4,185,170,15,1
02-02-2025,Spices & Seasonings,JEERA 250 gms,15,125,105,20,1
02-02-2025,Snacks & Ready-to-Eat,TILLI CHIKKI,14,10,10,0,2
02-02-2025,Snacks & Ready-to-Eat,PEANUT CHILLI,14,10,10,0,2
02-02-2025,Snacks & Ready-to-Eat,BD LITTLE MILLET NOODLES 200G,14,75,75,0,1
02-02-2025,Snacks & Ready-to-Eat,GB SALT COOKIES,14,60,55,5,1
02-02-2025,Milk & Dairy,BROWN EGGS 1P,7,140,120,20,10
02-02-2025,"Grains, Flours & Dals",Em Multimillet upma 500g,4,129,129,0,1
02-02-2025,Snacks & Ready-to-Eat,PALLI LADDU 200GMS,14,90,70,20,1
02-02-2025,"Grains, Flours & Dals",RAGI FLOUR 500GRMS,4,40,35,5,1
02-02-2025,Snacks & Ready-to-Eat,SD FINGER Millet with palm Jaggery 250gm,14,135,135,0,1
02-02-2025,"Health, Wellness & Ayurvedic Products",RB Max Protein Salt & Caramel Bar 50g,5,75,75,0,1
02-02-2025,Snacks & Ready-to-Eat,SD Thati thandra 200gm,14,150,150,0,1
02-02-2025,Personal Care & Cosmetics,ROUND LOOFAH,10,130,130,0,2
02-02-2025,Pooja & Spiritual Items,GD SANDAL 150GM,12,100,100,0,1
02-02-2025,Milk & Dairy,BROWN EGGS TRAY 30P,7,360,330,30,1
02-02-2025,"Grains, Flours & Dals",DR.RICE 5KG,4,600,600,0,1
02-02-2025,Snacks & Ready-to-Eat,Corn Chips 250GM,14,40,35,5,1
02-02-2025,Personal Care & Cosmetics,SEV TULASI SOAP 100GM,10,90,90,0,1
02-02-2025,"Health, Wellness & Ayurvedic Products",DWI LAVANGA TAILA 20ML,5,60,60,0,1
02-02-2025,Snacks & Ready-to-Eat,DOSA BATTER 1KG,14,60,60,0,1
02-02-2025,"Dry Fruits, Nuts & Seeds",KAJU HALF 250GM,2,310,290,20,1
02-02-2025,Spices & Seasonings,THOKA MIRYALU 50GM,15,210,180,30,1
02-02-2025,Snacks & Ready-to-Eat,SATHVI PALLI CHIKKI 200GM,14,100,80,20,1
02-02-2025,Household & Cleaning,PITAMBARI,6,56,56,0,2
02-02-2025,Sweeteners,YB Brown Sugar 1KG,16,140,140,0,1
02-02-2025,Snacks & Ready-to-Eat,SESAME LADDU 200GM,14,100,80,20,1
02-02-2025,Milk & Dairy,BROWN EGGS 1P,7,140,120,20,10
02-02-2025,Snacks & Ready-to-Eat,BLACK SESAME CHIKKI,14,10,10,0,2
02-02-2025,Oils & Ghee,Groundnut oil 1 L,9,360,330,30,1
02-02-2025,"Grains, Flours & Dals",SL Idly Rava 1KG,4,65,55,10,1
02-02-2025,Oils & Ghee,Coconut oil 500 ml,9,220,200,20,1
02-02-2025,"Grains, Flours & Dals",RAGULU 1 KG,4,35,30,5,0.5
02-02-2025,Spices & Seasonings,Japatri 25GM,15,200,160,40,2
02-02-2025,Spices & Seasonings,SATHVI ANASAPUVUU 25GM,15,180,130,50,2
02-02-2025,Spices & Seasonings,Dalchin Rolls 50GM,15,90,90,0,2
02-02-2025,Spices & Seasonings,Lavangam 50GM,15,120,100,20,2
02-02-2025,"Grains, Flours & Dals",Wheat Rava M 500GM,4,33,30,3,1
02-02-2025,Snacks & Ready-to-Eat,PALLI LADDU 200GMS,14,90,70,20,1
02-02-2025,"Grains, Flours & Dals",SL Suji Rava 500GM,4,32,32,0,1
02-02-2025,Personal Care & Cosmetics,OVAL BODY LOOFAH,10,165,165,0,3
02-02-2025,Milk & Dairy,SANGAM TONED MILK 500ML,7,60,60,0,2
02-02-2025,"Grains, Flours & Dals",COW B rice 1 kg,4,144,138,6,2
02-02-2025,"Grains, Flours & Dals",SINGLE POLISH 1KG,4,195,195,0,3
02-02-2025,Milk & Dairy,BROWN EGGS 1P,7,70,60,10,5
02-02-2025,Milk & Dairy,SANGAM CURD 450GM,7,38,38,0,1
02-02-2025,"Health, Wellness & Ayurvedic Products",RB Max Protein Choco Almond bar 50g,5,75,75,0,1
02-02-2025,"Grains, Flours & Dals",Wheat Flour 1 kg,4,280,240,40,4
02-02-2025,Snacks & Ready-to-Eat,Sprouted Ragi Biscuits 450GM,14,150,150,0,1
02-02-2025,Snacks & Ready-to-Eat,NGT CHATPATTA CHANA 90GM,14,25,25,0,1
02-02-2025,Snacks & Ready-to-Eat,RSC ORANGE 100GMS,14,20,20,0,1
02-02-2025,"Grains, Flours & Dals",DESI CHANA,4,50,50,0,2
02-02-2025,Sweeteners,YB JAGGERY POWDER 1KG,16,140,140,0,1
02-02-2025,"Health, Wellness & Ayurvedic Products",RB Max Protein Salt & Caramel Bar 50g,5,75,75,0,1
02-02-2025,"Grains, Flours & Dals",RAGI FLOUR 1KG,4,160,140,20,2
02-02-2025,Household & Cleaning,VIM COOLING FRESHNESS MINT,6,60,60,0,3
02-02-2025,Spices & Seasonings,SONTI 50GM,15,30,20,10,1
02-02-2025,Pooja & Spiritual Items,GD Aiswarya Deepam 700ML,12,195,195,0,1
02-02-2025,"Grains, Flours & Dals",Red uluvalu 250 gms,4,45,40,5,1
02-02-2025,"Grains, Flours & Dals",Wheat Rava M 1KG,4,195,165,30,3
02-02-2025,Snacks & Ready-to-Eat,urban murmura,14,60,55,5,1
02-02-2025,Household & Cleaning,EXO STEEL SCRUB,6,15,15,0,1
02-02-2025,Household & Cleaning,SURF EXCEL BIG BAR 250G,6,32,32,0,1
02-02-2025,Pooja & Spiritual Items,GD Dhoop Cones 40GM,12,30,30,0,1
02-02-2025,"Grains, Flours & Dals",turdal 1kg,4,440,390,50,2
02-02-2025,Snacks & Ready-to-Eat,BB ROASTED VERMICELLY 850GM,14,117,117,0,1
02-02-2025,Spices & Seasonings,AV Iodized Salt 1KG,15,28,25,3,1
02-02-2025,Spices & Seasonings,Vamu 100GM,15,60,50,10,1
02-02-2025,Spices & Seasonings,Jeera 100GM,15,50,45,5,1
02-02-2025,"Grains, Flours & Dals",BOMBAY RAVA,4,140,110,30,2
02-02-2025,Household & Cleaning,SURF EXCEL 150GM,6,20,20,0,1
02-02-2025,Snacks & Ready-to-Eat,SD Moringa with plam jaggery 250gm,14,135,135,0,1
02-02-2025,Snacks & Ready-to-Eat,VD RIBBON PAKODI 175GM,14,60,60,0,1
02-02-2025,Snacks & Ready-to-Eat,PALLI LADDU 200GMS,14,90,70,20,1
02-02-2025,"Grains, Flours & Dals",THICK POHA 1KG,4,160,140,20,2
02-02-2025,Household & Cleaning,SRFR EXCEL,6,30,30,0,3
02-02-2025,"Dry Fruits, Nuts & Seeds",Groundnuts 1 kg,2,190,170,20,1
02-02-2025,Spices & Seasonings,DURGA SALT CRYSTAL 1KG,15,25,25,0,1
02-02-2025,"Grains, Flours & Dals",BARLEY SEEDS 250GMS,4,40,35,5,1
02-02-2025,"Grains, Flours & Dals",Urad dall 1 Kg,4,370,340,30,2
02-02-2025,"Grains, Flours & Dals",Green gram 1 kg,4,150,130,20,1
02-02-2025,Snacks & Ready-to-Eat,VD MAIDA CHEGODI 175GM,14,60,60,0,1
02-02-2025,"Grains, Flours & Dals",CHANA DAL 500GM,4,70,60,10,1
02-02-2025,Snacks & Ready-to-Eat,SATHVI PALLI CHIKKI 200GM,14,100,80,20,1
02-02-2025,"Dry Fruits, Nuts & Seeds",PUTNALU 500GMS,2,180,152,28,2
02-02-2025,Spices & Seasonings,Miriyalu 50GM,15,100,80,20,1
02-02-2025,"Grains, Flours & Dals",Idly Rava L 1KG,4,180,150,30,3
02-02-2025,Spices & Seasonings,AVALU 100GM,15,25,20,5,1
02-02-2025,Sweeteners,SUGAR 1KG,16,60,50,10,1
02-02-2025,Spices & Seasonings,Tamarind 500GM,15,160,130,30,1
02-02-2025,Pooja & Spiritual Items,HAND MADE VOTHULU,12,50,50,0,1
02-02-2025,Oils & Ghee,Groundnut oil 5 L,9,1800,"1,600.00",200,1
02-02-2025,Spices & Seasonings,Chilli powder 500 gms,15,580,420,160,2
02-02-2025,"Grains, Flours & Dals",RAGI FLOUR 500GRMS,4,40,35,5,1
02-02-2025,Snacks & Ready-to-Eat,PALLI LADDU 200GMS,14,90,70,20,1
02-02-2025,Snacks & Ready-to-Eat,VD MAIDA CHEGODI 175GM,14,120,120,0,2
02-02-2025,"Grains, Flours & Dals",DESI CHANA,4,50,50,0,2
02-02-2025,Snacks & Ready-to-Eat,SATHVI PALLI CHIKKI 200GM,14,100,80,20,1
02-02-2025,Oils & Ghee,Groundnut oil 1 L,9,360,330,30,1
02-02-2025,"Grains, Flours & Dals",Wheat Rava S 1KG,4,65,55,10,1
02-02-2025,"Grains, Flours & Dals",BOMBAY RAVA,4,70,55,15,1
02-02-2025,Spices & Seasonings,Chilli powder 1 kg,15,1160,840,320,2
02-02-2025,Pooja & Spiritual Items,GD Aiswarya Deepam 700ML,12,390,390,0,2
02-02-2025,Personal Care & Cosmetics,GOW DURBAR 75G,10,120,120,0,2
02-02-2025,Pooja & Spiritual Items,GD JASMINE 75GM,12,120,120,0,2
02-02-2025,Spices & Seasonings,SATHVI ANASAPUVUU 25GM,15,90,65,25,1
02-02-2025,Spices & Seasonings,Dalchin Chekka 50GM,15,45,45,0,1
02-02-2025,"Dry Fruits, Nuts & Seeds",PUMPKIN SEEDS 250GM,2,200,160,40,1
02-02-2025,"Dry Fruits, Nuts & Seeds",WATERMELON SEEDS 250GRM,2,320,280,40,1
02-02-2025,"Dry Fruits, Nuts & Seeds",SUNFLOWER SEEDS 250GRM,2,150,130,20,1
02-02-2025,"Dry Fruits, Nuts & Seeds",BLACK KISMIS 250GM,2,175,140,35,1
02-02-2025,Personal Care & Cosmetics,ROUND LOOFAH,10,55,55,0,1
02-02-2025,Milk & Dairy,BROWN EGGS 1P,7,84,72,12,6
02-02-2025,"Grains, Flours & Dals",PESARA PAPPU 500GMS,4,85,75,10,1
02-02-2025,Oils & Ghee,Sesame oil 1 L,9,590,560,30,1
02-02-2025,Snacks & Ready-to-Eat,VD SAGOPAPAD 150GM,14,55,55,0,1
02-02-2025,"Grains, Flours & Dals",DESI CHANA,4,50,50,0,2
02-02-2025,"Grains, Flours & Dals",Yellow jowar .F1 kg,4,110,100,10,1
02-02-2025,"Dry Fruits, Nuts & Seeds",PULMAKHANA 100 GM,2,540,510,30,3
02-02-2025,Oils & Ghee,Groundnut oil 1 L,9,360,330,30,1
02-02-2025,"Grains, Flours & Dals",CHANA DAL 1KG,4,35,30,5,0.25
02-02-2025,"Grains, Flours & Dals",SF BESAN 500GM,4,100,100,0,1
02-02-2025,Snacks & Ready-to-Eat,BATANA NGT 70GMS,14,20,20,0,1
02-02-2025,Oils & Ghee,Groundnut oil 5 L,9,1800,"1,600.00",200,1
02-02-2025,Sweeteners,ACHUBELLAM 500GM,16,50,40,10,1
02-02-2025,Milk & Dairy,BROWN EGGS 1P,7,210,180,30,15
02-02-2025,Spices & Seasonings,Marati Magga 50GM,15,130,110,20,1
02-02-2025,Spices & Seasonings,GREEN SOUNF,15,60,40,20,1
02-02-2025,Pooja & Spiritual Items,BANDA PUVVU 25GM 25GM,12,80,60,20,1
02-02-2025,Spices & Seasonings,Gasagasalu 50GM,15,130,110,20,1
02-02-2025,Milk & Dairy,HERITAGE TOTAL CURD 500GM,7,50,50,0,1
02-02-2025,Pooja & Spiritual Items,JAGI KAYA 25GM,12,80,60,20,1
02-02-2025,Oils & Ghee,Groundnut oil 1 L,9,360,330,30,1
02-02-2025,Spices & Seasonings,RED COPRA 250GMS,15,85,74,11,1
02-02-2025,"Dry Fruits, Nuts & Seeds",PULMAKHANA 100 GM,2,180,170,10,1
02-02-2025,"Grains, Flours & Dals",SPLIT BLACK GRAM 500 GM,4,180,170,10,2
02-02-2025,Spices & Seasonings,SATHVI KARAKAYA 25 GM,15,50,30,20,1
02-02-2025,Spices & Seasonings,SATHVI ANASAPUVUU 25GM,15,90,65,25,1
02-02-2025,"Grains, Flours & Dals",JOWAR YELLOW 1 K,4,25,22.5,2.5,0.25
02-02-2025,"Grains, Flours & Dals",SPLIT BLACK GRAM 500 GM,4,180,170,10,2
02-02-2025,"Grains, Flours & Dals",RAGULU 1 KG,4,17.5,15,2.5,0.25
02-02-2025,"Grains, Flours & Dals",RED WHEAT 1 KG,4,260,240,20,2
02-02-2025,Spices & Seasonings,Vamu 100GM,15,120,100,20,2
02-02-2025,Oils & Ghee,Groundnut oil 1 L,9,360,330,30,1
02-02-2025,"Grains, Flours & Dals",SAMALU (Little millet) 1 kg,4,170,130,40,1
02-02-2025,"Grains, Flours & Dals",KORRALU (FOXTAIL M) 1KG,4,150,110,40,1
02-02-2025,"Grains, Flours & Dals",KORRALU (FOXTAIL M) 1KG,4,150,110,40,1
02-02-2025,Oils & Ghee,Groundnut oil 1 L,9,360,330,30,1
02-02-2025,"Health, Wellness & Ayurvedic Products",MH Millets Malt 500GM,5,400,380,20,2
02-02-2025,Milk & Dairy,BROWN EGGS 1P,7,168,144,24,12
02-02-2025,"Grains, Flours & Dals",Wheat Flour 1 kg,4,70,60,10,1
02-02-2025,Snacks & Ready-to-Eat,VD Pappu Chekkalu 190gm,14,60,60,0,1
02-02-2025,"Grains, Flours & Dals",AISHWARYA SP 1KG,4,400,345,55,5
02-02-2025,Oils & Ghee,Groundnut oil 1 L,9,720,660,60,2
02-02-2025,Milk & Dairy,BROWN EGGS TRAY 30P,7,360,330,30,1
02-02-2025,Spices & Seasonings,RED COPRA 500GM,15,170,148,22,1
02-02-2025,Spices & Seasonings,AVALU 100GM,15,25,20,5,1
02-02-2025,Spices & Seasonings,DRY MIECHI 200GM,15,80,60,20,1
02-02-2025,"Grains, Flours & Dals",RAGI FLOUR 500GRMS,4,40,35,5,1
02-02-2025,Spices & Seasonings,Gasagasalu 50GM,15,130,110,20,1
02-02-2025,"Grains, Flours & Dals",Chittimuthaylu rice 1 kg,4,160,140,20,1
01-02-2025,Snacks & Ready-to-Eat,TILLI CHIKKI,14,125,125,0,1
01-02-2025,"Grains, Flours & Dals",RAGI FLOUR 1KG,4,80,70,10,1
01-02-2025,Milk & Dairy,BROWN EGGS 1P,7,84,72,12,6
01-02-2025,"Grains, Flours & Dals",Multigrain 1 kg,4,500,425,75,5
01-02-2025,Spices & Seasonings,SV Dried Kasuri Methi 100GM,15,95,95,0,1
01-02-2025,Oils & Ghee,Safflower oil 1 L,9,440,400,40,1
01-02-2025,"Grains, Flours & Dals",THICK POHA 500GM,4,40,35,5,1
01-02-2025,"Grains, Flours & Dals",Wheat Flour 1 kg,4,70,60,10,1
01-02-2025,"Grains, Flours & Dals",Urad dall 1 Kg,4,185,170,15,1
01-02-2025,"Dry Fruits, Nuts & Seeds",Groundnuts 1 kg,2,190,170,20,1
01-02-2025,Spices & Seasonings,DURGA SALT CRYSTAL 1KG,15,25,25,0,1
01-02-2025,Beverages,ASSAM MASALA TEA,1,199,199,0,1
01-02-2025,"Grains, Flours & Dals",SL Idly Rava 1KG,4,65,55,10,1
01-02-2025,Snacks & Ready-to-Eat,SD Ginger Candy 100g,14,60,60,0,1
01-02-2025,"Grains, Flours & Dals",BAJRA 1 KG,4,60,50,10,1
01-02-2025,"Dry Fruits, Nuts & Seeds",SD Mango cubes 100gm,2,45,45,0,1
01-02-2025,"Grains, Flours & Dals",Black gram 500 gms,4,75,70,5,1
01-02-2025,Snacks & Ready-to-Eat,RB Choco Delite Almonds Raisins 40g,14,135,135,0,3
01-02-2025,Snacks & Ready-to-Eat,SD Thati thandra 200gm,14,150,150,0,1
01-02-2025,"Health, Wellness & Ayurvedic Products",SHIKAKAI CHOORNAM,5,80,80,0,1
01-02-2025,"Grains, Flours & Dals",JOWAR UPMA RAVA,4,0,0,0,1
01-02-2025,"Grains, Flours & Dals",Multigrain 1 kg,4,100,85,15,1
01-02-2025,"Grains, Flours & Dals",RAGI FLOUR 500GRMS,4,40,35,5,1
01-02-2025,"Grains, Flours & Dals",JOWAR WHITE 1 KG,4,80,70,10,1
01-02-2025,Personal Care & Cosmetics,MD Soapnut Choornam 100GM,10,80,80,0,1
01-02-2025,"Grains, Flours & Dals",Idly Rava L 1KG,4,60,50,10,1
01-02-2025,Pooja & Spiritual Items,GD TULASI 75GM,12,60,60,0,1
01-02-2025,"Grains, Flours & Dals",Yellow jowar .F1 kg,4,110,100,10,1
01-02-2025,Snacks & Ready-to-Eat,RINGS 200GM,14,30,30,0,1
01-02-2025,Personal Care & Cosmetics,MD Henna Choornam 100GM,10,160,160,0,2
01-02-2025,"Health, Wellness & Ayurvedic Products",MD Bringaraj Choornam 100GM,5,160,160,0,2
01-02-2025,Personal Care & Cosmetics,SVE SHIKAKAI SOAP 100GM,10,100,100,0,1
01-02-2025,Oils & Ghee,Groundnut oil 1 L,9,320,320,0,1
01-02-2025,Snacks & Ready-to-Eat,VD MYSOREPAK 6PIC,14,100,100,0,1
01-02-2025,Snacks & Ready-to-Eat,RAJGIRA PEANUT CHIKKI,14,25,25,0,5
01-02-2025,Snacks & Ready-to-Eat,BATANA NGT 70GMS,14,20,20,0,1
01-02-2025,Oils & Ghee,Castor oil 200 ml,9,100,80,20,1
01-02-2025,Oils & Ghee,Groundnut oil 1 L,9,1440,"1,320.00",120,4
01-02-2025,Sweeteners,MISHRI D,16,40,30,10,1
01-02-2025,"Dry Fruits, Nuts & Seeds",SD Mango cubes 100gm,2,45,45,0,1
01-02-2025,Spices & Seasonings,PRO ORG AJWAIN 100G,15,70,70,0,1
01-02-2025,"Grains, Flours & Dals",HS Multimillet idly R 500 gms,4,130,130,0,2
01-02-2025,"Grains, Flours & Dals",WHEAT 1 KG,4,120,100,20,2
01-02-2025,"Grains, Flours & Dals",RED WHEAT 1 KG,4,390,360,30,3
01-02-2025,"Grains, Flours & Dals",AISHWARYA SP 1KG,4,160,138,22,2
01-02-2025,Sweeteners,Mishri 500GM,16,70,60,10,1
01-02-2025,"Grains, Flours & Dals",Brown RICE 1KG,4,140,130,10,2
01-02-2025,"Health, Wellness & Ayurvedic Products",RB Max Protein Choco Berry bar 50g,5,75,75,0,1
01-02-2025,"Grains, Flours & Dals",Wheat Flour 3 kgs,4,210,180,30,1
01-02-2025,"Grains, Flours & Dals",KORRALU (FOXTAIL M) 500GM,4,65,55,10,1
01-02-2025,"Grains, Flours & Dals",Arikalu (kodo),4,70,65,5,1
01-02-2025,Snacks & Ready-to-Eat,TILLI CHIKKI,14,45,45,0,9
01-02-2025,"Grains, Flours & Dals",ANDU KORRALU (Brown top .mlt) 500,4,130,110,20,1
01-02-2025,"Grains, Flours & Dals",SAMALU (Little millet) 500 gms,4,85,65,20,1
01-02-2025,"Grains, Flours & Dals",UDALU (Barnyard millet) 500 gms,4,70,60,10,1
01-02-2025,Spices & Seasonings,NUVVULU 250GM,15,80,65,15,1
01-02-2025,Snacks & Ready-to-Eat,VD CORNFLAKES MIXTURE 175GM,14,60,60,0,1
01-02-2025,Snacks & Ready-to-Eat,BATANA NGT 70GMS,14,20,20,0,1
01-02-2025,Snacks & Ready-to-Eat,SALTED PHALLI,14,25,25,0,1
01-02-2025,"Grains, Flours & Dals",Wheat Rava M 500GM,4,33,30,3,1
01-02-2025,Spices & Seasonings,ROYAL SAFFRON 400GRMS,15,65,65,0,1
01-02-2025,"Dry Fruits, Nuts & Seeds",Groundnuts 1 kg,2,190,170,20,1
01-02-2025,"Grains, Flours & Dals",Black uluvalu 250 gms,4,45,35,10,1
01-02-2025,"Grains, Flours & Dals",SPLIT BLACK GRAM 500 GM,4,90,85,5,1
01-02-2025,"Grains, Flours & Dals",White jowar.F 1 kg,4,100,80,20,1
01-02-2025,Snacks & Ready-to-Eat,ANNAPURNA APPALAM,14,35,35,0,1
01-02-2025,Spices & Seasonings,ROYAL SAFFRON 400GRMS,15,65,65,0,1
01-02-2025,Spices & Seasonings,Turmeric powder 250 gms,15,100,75,25,1
01-02-2025,"Grains, Flours & Dals",BOMBAY RAVA,4,70,55,15,1
01-02-2025,"Health, Wellness & Ayurvedic Products",PULIPIRI WARTS REMOVER 9GM,5,125,125,0,1
01-02-2025,Snacks & Ready-to-Eat,Corn Chips 250GM,14,40,35,5,1
01-02-2025,"Dry Fruits, Nuts & Seeds",PUMPKIN SEEDS 250GM,2,200,160,40,1
01-02-2025,Oils & Ghee,A2 BUFFALO GHEE 250ML,9,299,299,0,1
01-02-2025,Snacks & Ready-to-Eat,KURNOOL MARMURA,14,70,55,15,1
01-02-2025,"Grains, Flours & Dals",SABDANA,4,40,35,5,1
01-02-2025,"Grains, Flours & Dals",Em Foxtail upma r 500 g,4,109,109,0,1
01-02-2025,"Grains, Flours & Dals",KORRALU (FOXTAIL M) 500GM,4,65,55,10,1
01-02-2025,Snacks & Ready-to-Eat,RINGS 200GM,14,30,30,0,1
01-02-2025,"Grains, Flours & Dals",MELMEKER 250GMS,4,60,45,15,1
01-02-2025,Sweeteners,GS Organic Jaggery Powder 600GM,16,99,99,0,1
01-02-2025,Snacks & Ready-to-Eat,SESAME LADDU 200GM,14,100,80,20,1
01-02-2025,Snacks & Ready-to-Eat,RAJGIRA PEANUT CHIKKI,14,5,5,0,1
01-02-2025,"Health, Wellness & Ayurvedic Products",RB Max Protein Choco Almond bar 50g,5,75,75,0,1
01-02-2025,"Grains, Flours & Dals",RAGI FLOUR 500GRMS,4,40,35,5,1
01-02-2025,"Grains, Flours & Dals",SAMALU (Little millet) 1 kg,4,170,130,40,1
01-02-2025,Snacks & Ready-to-Eat,SALTED PHALLI,14,50,50,0,2
01-02-2025,Snacks & Ready-to-Eat,SESAME CHIKKI,14,120,100,20,1
01-02-2025,Snacks & Ready-to-Eat,SD FINGER Millet with palm Jaggery 250gm,14,135,135,0,1
01-02-2025,Pooja & Spiritual Items,SWAATHI GATTI DEEPAM VATTULU,12,30,30,0,1
01-02-2025,"Dry Fruits, Nuts & Seeds",SATHVI CHIA SEEDS 100GM,2,200,160,40,2
01-02-2025,"Grains, Flours & Dals",Red uluvalu 500 gms,4,90,75,15,1
01-02-2025,"Grains, Flours & Dals",RAJMA 500GM,4,90,90,0,1
01-02-2025,"Dry Fruits, Nuts & Seeds",YELLOW KISHMISH 250GM,2,130,110,20,1
01-02-2025,Snacks & Ready-to-Eat,SD Groundnut with palm jaggery 250gm,14,135,135,0,1
01-02-2025,Personal Care & Cosmetics,INDICA EASY,10,60,60,0,2
01-02-2025,Pooja & Spiritual Items,GB Bharatha Woods 75GM,12,120,120,0,2
01-02-2025,Sweeteners,MISHRI 250 GM,16,35,30,5,1
01-02-2025,Snacks & Ready-to-Eat,SATHVI PALLI CHIKKI 200GM,14,100,80,20,1
01-02-2025,Oils & Ghee,Groundnut oil 500ml,9,180,165,15,1
01-02-2025,Oils & Ghee,Coconut oil 500 ml,9,220,200,20,1
01-02-2025,Milk & Dairy,HRITAGE TOTAL CURD 130GM,7,40,40,0,4
01-02-2025,Oils & Ghee,Coconut oil 1 L,9,440,400,40,1
01-02-2025,Oils & Ghee,Groundnut oil 1 L,9,1080,990,90,3
01-02-2025,Snacks & Ready-to-Eat,SATHVI REGIVADA 200GM,14,320,240,80,4
01-02-2025,"Grains, Flours & Dals",RAGI FLOUR 500GRMS,4,40,35,5,1
01-02-2025,Personal Care & Cosmetics,MD Bath Powder 100GM,10,40,40,0,1
01-02-2025,Snacks & Ready-to-Eat,ONION RINGS,14,50,50,0,1
01-02-2025,Snacks & Ready-to-Eat,VD RED CHILLI RICEPAPAD 150GM,14,50,50,0,1
01-02-2025,"Grains, Flours & Dals",HS RAGI Idly rava 500 gms,4,70,70,0,1
01-02-2025,"Grains, Flours & Dals",HS Multimillet idly R 500 gms,4,65,65,0,1
01-02-2025,"Grains, Flours & Dals",HS Jowar upma rava 500 gms,4,65,65,0,1
01-02-2025,"Grains, Flours & Dals",SRILATHA RICE RAVVA 500GM,4,35,35,0,1
01-02-2025,Oils & Ghee,Castor oil 500 ml,9,250,200,50,1
01-02-2025,Pooja & Spiritual Items,999 SINGAPORE DHOOP POW 50GM,12,70,70,0,2
01-02-2025,Milk & Dairy,BROWN EGGS TRAY 30P,7,360,330,30,1
01-02-2025,Spices & Seasonings,Menthulu 250 gms,15,50,45,5,1
01-02-2025,"Grains, Flours & Dals",Red Wheat Flour 1 kg,4,280,260,20,2
01-02-2025,"Grains, Flours & Dals",White jowar.F 1 kg,4,100,80,20,1
01-02-2025,Personal Care & Cosmetics,PARACHUTE 45ML,10,20,20,0,1
01-02-2025,Pickles & Cooking Pastes,SD MANGO TOKKU,11,110,110,0,1
01-02-2025,Snacks & Ready-to-Eat,VD PAPPU CHEGODI 200GM,14,60,60,0,1
01-02-2025,Snacks & Ready-to-Eat,SATHVI PALLI CHIKKI 200GM,14,100,80,20,1
01-02-2025,Snacks & Ready-to-Eat,SD Bajra with palm Jaggery 250gm,14,135,135,0,1
01-02-2025,Personal Care & Cosmetics,OVAL BODY LOOFAH,10,55,55,0,1
01-02-2025,Snacks & Ready-to-Eat,ZEEDI,14,70,70,0,1
01-02-2025,Snacks & Ready-to-Eat,SD Ginger Candy 100g,14,60,60,0,1
01-02-2025,"Grains, Flours & Dals",DISANO OATS 1KG,4,285,285,0,1
01-02-2025,Personal Care & Cosmetics,KHADI Amla Bringaraj Shampoo 200ML,10,220,220,0,1
01-02-2025,Snacks & Ready-to-Eat,BD BARELY NOODLES 200G,14,70,70,0,1
01-02-2025,Oils & Ghee,Castor oil 200 ml,9,100,80,20,1
01-02-2025,Spices & Seasonings,Lavangam 50GM,15,60,50,10,1
01-02-2025,Spices & Seasonings,SATHVI KARAKAYA 25 GM,15,100,60,40,2
01-02-2025,Oils & Ghee,Sesame oil 500ml,9,295,280,15,1
01-02-2025,"Grains, Flours & Dals",White jowar.F 1 kg,4,100,80,20,1
01-02-2025,Snacks & Ready-to-Eat,MIX MILLET NOODLES,14,75,75,0,1
01-02-2025,"Grains, Flours & Dals",SA Sprouted Ragi Flour 500GM,4,69,69,0,1
01-02-2025,"Grains, Flours & Dals",Wheat Rava M 1KG,4,65,55,10,1
01-02-2025,"Grains, Flours & Dals",split urad dall 250 gms,4,45,40,5,1
01-02-2025,"Dry Fruits, Nuts & Seeds",SD Mango cubes 100gm,2,45,45,0,1
01-02-2025,Oils & Ghee,Sesame oil 500ml,9,295,280,15,1
01-02-2025,Snacks & Ready-to-Eat,MIX MILLET NOODLES,14,75,75,0,1
01-02-2025,Personal Care & Cosmetics,BAMBOO TOOTH BRUSH,10,120,120,0,1
01-02-2025,Milk & Dairy,BROWN EGGS 1P,7,112,96,16,8
01-02-2025,Snacks & Ready-to-Eat,NGT CHATPATTA CHANA 90GM,14,100,100,0,4
01-02-2025,"Health, Wellness & Ayurvedic Products",RB Peanut butter Peanuts Dark 40g,5,45,45,0,1
01-02-2025,Oils & Ghee,Mustard oil 500 ml,9,220,195,25,1
01-02-2025,"Health, Wellness & Ayurvedic Products",MD Aamlaki Choornam 100GM,5,80,80,0,1
01-02-2025,Spices & Seasonings,Coconut Powder 250GM,15,70,70,0,1
01-02-2025,"Grains, Flours & Dals",RAGI FLOUR 1KG,4,80,70,10,1
01-02-2025,Oils & Ghee,Castor oil 200 ml,9,100,80,20,1
01-02-2025,Spices & Seasonings,Black Till 250GM,15,90,75,15,1
01-02-2025,Snacks & Ready-to-Eat,RB Choco Delite Almonds Raisins 40g,14,45,45,0,1
01-02-2025,"Grains, Flours & Dals",KORRALU (FOXTAIL M) 500GM,4,65,55,10,1
01-02-2025,Spices & Seasonings,BLACK JEERA 50 GM,15,45,30,15,1
01-02-2025,Spices & Seasonings,DURGA SALT CRYSTAL 1KG,15,25,25,0,1
01-02-2025,Snacks & Ready-to-Eat,SATHVI PALLI CHIKKI 200GM,14,100,80,20,1
01-02-2025,"Grains, Flours & Dals",Wheat Flour 1 kg,4,140,120,20,2
01-02-2025,"Grains, Flours & Dals",RAGI FLOUR 500GRMS,4,40,35,5,1
01-02-2025,"Grains, Flours & Dals",Em jowar idly R 500G,4,75,75,0,1
01-02-2025,"Grains, Flours & Dals",SINGHAM 26KG BAG,4,1650,"1,650.00",0,1
01-02-2025,Milk & Dairy,BROWN EGGS TRAY 30P,7,360,330,30,1
01-02-2025,"Grains, Flours & Dals",Red uluvalu 500 gms,4,90,75,15,1
01-02-2025,"Grains, Flours & Dals",Green gram 500 gms,4,75,70,5,1
01-02-2025,"Grains, Flours & Dals",white Bobarlu 500 gms,4,80,75,5,1
01-02-2025,"Grains, Flours & Dals",Urad dall 1 Kg,4,185,170,15,1
01-02-2025,"Health, Wellness & Ayurvedic Products",MD Kasturi Pasupu Choornam 50GM,5,80,80,0,1
01-02-2025,Milk & Dairy,BROWN EGGS TRAY 30P,7,360,330,30,1
01-02-2025,Snacks & Ready-to-Eat,SESAME LADDU 200GM,14,200,160,40,2
01-02-2025,"Grains, Flours & Dals",Multigrain 1 kg,4,200,170,30,2
01-02-2025,Personal Care & Cosmetics,MD Bath Powder 100GM,10,40,40,0,1
01-02-2025,"Grains, Flours & Dals",UDALU (Barnyard millet) 500 gms,4,70,60,10,1
01-02-2025,"Dry Fruits, Nuts & Seeds",SUNFLOWER SEEDS 250GRM,2,150,130,20,1
01-02-2025,"Grains, Flours & Dals",SAMALU (Little millet) 500 gms,4,85,65,20,1
01-02-2025,"Grains, Flours & Dals",ANDU KORRALU (Brown top .mlt) 500,4,130,110,20,1
01-02-2025,"Grains, Flours & Dals",Arikalu (kodo),4,70,65,5,1
01-02-2025,"Grains, Flours & Dals",WHITE BATANI 500GM,4,80,60,20,1
01-02-2025,Snacks & Ready-to-Eat,PEANUT CHILLI,14,25,25,0,5
01-02-2025,"Grains, Flours & Dals",KORRALU (FOXTAIL M) 500GM,4,65,55,10,1
01-02-2025,"Dry Fruits, Nuts & Seeds",FLAX SEEDS 250GM,2,120,100,20,2
01-02-2025,Personal Care & Cosmetics,SVE KHADI ALOEVERA GEL 100GM,10,140,140,0,1
01-02-2025,Sweeteners,NATURAL HONEY 1KG,16,560,480,80,1
01-02-2025,Oils & Ghee,Groundnut oil 5 L,9,1800,"1,600.00",200,1
01-02-2025,"Dry Fruits, Nuts & Seeds",PUMPKIN SEEDS 250GM,2,200,160,40,1
01-02-2025,Snacks & Ready-to-Eat,VD MIXTURE 175 GM,14,120,120,0,2
01-02-2025,Snacks & Ready-to-Eat,BATANA NGT 70GMS,14,40,40,0,2
01-02-2025,Snacks & Ready-to-Eat,VD VAMUPUSA 175GM,14,60,60,0,1
01-02-2025,Snacks & Ready-to-Eat,Sprouted Ragi Biscuits 450GM,14,150,150,0,1
01-02-2025,Snacks & Ready-to-Eat,PN ORGANIC PUFFED RICE 200GM,14,55,55,0,1
01-02-2025,"Grains, Flours & Dals",DESI CHANA,4,50,50,0,2
01-02-2025,Snacks & Ready-to-Eat,SD JOWAR WITH PALM JAGGERY 250GM,14,135,135,0,1
01-02-2025,Household & Cleaning,GOOD KNIGHT GOLD FLASH,6,80,80,0,1
01-02-2025,Milk & Dairy,BROWN EGGS 1P,7,168,144,24,12
01-02-2025,"Grains, Flours & Dals",Wheat Flour 1 kg,4,70,60,10,1
01-02-2025,"Grains, Flours & Dals",RAGULU 1 KG,4,70,60,10,1
01-02-2025,"Grains, Flours & Dals",Wheat Flour 3 kgs,4,210,180,30,1
01-02-2025,"Grains, Flours & Dals",ANDU KORRALU (Browntop.m) 1 kg,4,520,440,80,2
01-02-2025,"Grains, Flours & Dals",UDALU (Barnyard millet) 1 kg,4,280,230,50,2
01-02-2025,Personal Care & Cosmetics,HERBAL BATH POWDER 200GM,10,80,80,0,1
01-02-2025,"Grains, Flours & Dals",Wheat Rava M 500GM,4,33,30,3,1
01-02-2025,"Grains, Flours & Dals",RAGI FLOUR 500GRMS,4,40,35,5,1
01-02-2025,Snacks & Ready-to-Eat,NGT CHATPATTA CHANA 90GM,14,25,25,0,1
01-02-2025,"Grains, Flours & Dals",Bajra Flour 500 gms,4,35,30,5,1
01-02-2025,"Grains, Flours & Dals",Multigrain 1 kg,4,100,85,15,1
01-02-2025,Oils & Ghee,Sesame oil 5 L,9,2950,"2,750.00",200,1
01-02-2025,"Grains, Flours & Dals",AISHWARYA SP 5KG,4,400,375,25,1
01-02-2025,"Health, Wellness & Ayurvedic Products",JAMBU SEED CHOORNAM 100GM,5,160,160,0,2
01-02-2025,Personal Care & Cosmetics,ORGANIC SPONGE LOOFAH,10,70,70,0,1
01-02-2025,Snacks & Ready-to-Eat,VD MINAPA VADIYAM,14,65,65,0,1
01-02-2025,"Dry Fruits, Nuts & Seeds",SD Mango cubes 100gm,2,45,45,0,1
01-02-2025,Spices & Seasonings,Dalchin Rolls 50GM,15,45,45,0,1
01-02-2025,Personal Care & Cosmetics,OVAL BODY LOOFAH,10,55,55,0,1
01-02-2025,Sweeteners,YB JAGGERY POWDER 500GMS,16,75,75,0,1
01-02-2025,"Dry Fruits, Nuts & Seeds",SATHVI CHIA SEEDS 100GM,2,100,80,20,1
01-02-2025,"Grains, Flours & Dals",RAGI FLOUR 500GRMS,4,40,35,5,1
01-02-2025,Snacks & Ready-to-Eat,RAJGIRA PEANUT CHIKKI,14,5,5,0,1
01-02-2025,Oils & Ghee,Coconut oil 500 ml,9,220,200,20,1
01-02-2025,Snacks & Ready-to-Eat,urban murmura,14,60,55,5,1
01-02-2025,Oils & Ghee,Groundnut oil 1 L,9,360,330,30,1
01-02-2025,Snacks & Ready-to-Eat,Popcorn Seeds 250GM,14,45,40,5,1
01-02-2025,"Health, Wellness & Ayurvedic Products",AMLA PACHAK,5,100,100,0,1
01-02-2025,"Grains, Flours & Dals",DESI CHANA,4,25,25,0,1
01-02-2025,"Dry Fruits, Nuts & Seeds",SALTED PISTA 250GM,2,400,350,50,1
01-02-2025,"Grains, Flours & Dals",Wheat Flour 1 kg,4,70,60,10,1
01-02-2025,"Grains, Flours & Dals",Wheat Flour 1 kg,4,140,120,20,2
01-02-2025,"Grains, Flours & Dals",Green gram 1 kg,4,150,130,20,1
01-02-2025,"Grains, Flours & Dals",JOWAR WHITE 1 KG,4,80,70,10,1
01-02-2025,Snacks & Ready-to-Eat,VD DAHI MIRCHI(SALTED) 100GM,14,45,45,0,1
01-02-2025,Personal Care & Cosmetics,GAYATHRI KUMKUDUKAYA,10,150,150,0,1
01-02-2025,"Grains, Flours & Dals",JOWAR UPMA RAVA,4,0,0,0,1
01-02-2025,Snacks & Ready-to-Eat,SESAME LADDU 200GM,14,100,80,20,1
01-02-2025,"Grains, Flours & Dals",Wheat Flour 2 kgs,4,140,120,20,1
01-02-2025,"Grains, Flours & Dals",RAGI FLOUR 1KG,4,80,70,10,1
01-02-2025,Oils & Ghee,Groundnut oil 1 L,9,360,330,30,1
01-02-2025,Oils & Ghee,Sesame oil 1 L,9,590,560,30,1
01-02-2025,"Grains, Flours & Dals",Em Multimillet idli r 500g,4,516,516,0,4
01-02-2025,"Grains, Flours & Dals",VGR rice 1 kg,4,210,195,15,3
01-02-2025,"Dry Fruits, Nuts & Seeds",Groundnuts 1 kg,2,190,170,20,1
01-02-2025,"Grains, Flours & Dals",AISHWARYA SP 5KG,4,400,375,25,1
01-02-2025,"Grains, Flours & Dals",Urad dall 1 Kg,4,185,170,15,1
01-02-2025,Spices & Seasonings,Dalchin Rolls 50GM,15,45,45,0,1
01-02-2025,Spices & Seasonings,Coriander seeds 200 gms,15,48,40,8,1
01-02-2025,"Grains, Flours & Dals",Wheat Rava M 500GM,4,33,30,3,1
01-02-2025,"Grains, Flours & Dals",CHANA DAL 1KG,4,35,30,5,0.25
01-02-2025,"Grains, Flours & Dals",Bombay Rava 500GM,4,35,30,5,1
01-02-2025,Oils & Ghee,cow ghee 500 ml,9,430,390,40,1
01-02-2025,Sweeteners,NATURAL HONEY 250GM,16,150,130,20,1
01-02-2025,Spices & Seasonings,Telaga Pindi 250 GM,15,40,35,5,1
01-02-2025,"Dry Fruits, Nuts & Seeds",ANJEER 250GM,2,400,360,40,1
01-02-2025,"Grains, Flours & Dals",PESARA PAPPU 500GMS,4,85,75,10,1
01-02-2025,"Grains, Flours & Dals",SRILATHA RICE RAVVA 500GM,4,35,35,0,1
01-02-2025,"Grains, Flours & Dals",THICK POHA 500GM,4,40,35,5,1
01-02-2025,Spices & Seasonings,NUVVULU 500GM,15,160,130,30,1
01-02-2025,Spices & Seasonings,Tamarind 250GMS,15,80,65,15,1
01-02-2025,"Grains, Flours & Dals",Multigrain 1 kg,4,100,85,15,1
01-02-2025,Spices & Seasonings,LG 50GM,15,92,92,0,1
01-02-2025,Snacks & Ready-to-Eat,Corn Chips 250GM,14,40,35,5,1
01-02-2025,Spices & Seasonings,DRY MIECHI 200GM,15,80,60,20,1
01-02-2025,"Grains, Flours & Dals",Chana Flour 500 gms,4,70,65,5,1
01-02-2025,"Grains, Flours & Dals",PESARA PAPPU 1 KG,4,170,145,25,1
01-02-2025,Spices & Seasonings,ROYAL SAFFRON 400GRMS,15,65,65,0,1
01-02-2025,"Dry Fruits, Nuts & Seeds",PUTNALU 500GMS,2,180,152,28,2
01-02-2025,"Grains, Flours & Dals",CHANA DAL 500GM,4,70,60,10,1
01-02-2025,"Grains, Flours & Dals",split green gram 500 gms,4,75,70,5,1
01-02-2025,"Grains, Flours & Dals",split black gram 1 kg,4,180,170,10,1
01-02-2025,"Grains, Flours & Dals",SPLIT BLACK GRAM 500 GM,4,180,170,10,2
01-02-2025,"Dry Fruits, Nuts & Seeds",Groundnuts 1 kg,2,190,170,20,1
01-02-2025,Snacks & Ready-to-Eat,urban murmura,14,60,55,5,1
01-02-2025,"Grains, Flours & Dals",SINGLE POLISH 1KG,4,325,325,0,5
01-02-2025,"Grains, Flours & Dals",RICE FLOUR 500 GM,4,35,28,7,1
01-02-2025,"Grains, Flours & Dals",Wheat Rava M 500GM,4,33,30,3,1
01-02-2025,"Grains, Flours & Dals",SA Multi Grain Mix 500GM,4,159,159,0,1
01-02-2025,"Grains, Flours & Dals",turdal 1kg,4,440,390,50,2
01-02-2025,General Household & Kitchenware,MATCH BOX,3,20,20,0,1
01-02-2025,"Grains, Flours & Dals",SL Idly Rava 1KG,4,130,110,20,2
01-02-2025,"Grains, Flours & Dals",Wheat Flour 1 kg,4,140,120,20,2
01-02-2025,"Grains, Flours & Dals",Yellow jowar .F1 kg,4,110,100,10,1
01-02-2025,Snacks & Ready-to-Eat,RAJGIRA PEANUT CHIKKI,14,20,20,0,4
01-02-2025,Milk & Dairy,BROWN EGGS 1P,7,70,60,10,5
01-02-2025,"Grains, Flours & Dals",RED WHEAT 1 KG,4,65,60,5,0.5
01-02-2025,"Grains, Flours & Dals",RAGULU 1 KG,4,14,12,2,0.2
01-02-2025,"Grains, Flours & Dals",SOYA BEANS 1KG,4,10,9,1,0.05
01-02-2025,"Grains, Flours & Dals",WHEAT 1 KG,4,42,35,7,0.7
01-02-2025,Oils & Ghee,Groundnut oil 1 L,9,360,330,30,1
01-02-2025,"Grains, Flours & Dals",DISANO OATS 1KG,4,14.25,14.25,0,0.05
01-02-2025,"Grains, Flours & Dals",BARLEY SEEDS 1KG,4,8,7,1,0.05
01-02-2025,"Dry Fruits, Nuts & Seeds",FLAX SEEDS 1KG,2,72,60,12,0.3
01-02-2025,"Grains, Flours & Dals",BAJRA 1 KG,4,12,10,2,0.2
01-02-2025,Snacks & Ready-to-Eat,PUDEENA SEV 200GM,14,60,60,0,1
01-02-2025,Spices & Seasonings,Telaga Pindi 250 GM,15,40,35,5,1
01-02-2025,Pickles & Cooking Pastes,SD RED CHILLI PICKLE,11,110,110,0,1
01-02-2025,"Health, Wellness & Ayurvedic Products",MH Womens Malt 500GM,5,250,240,10,1
01-02-2025,Snacks & Ready-to-Eat,GANTASALA KARIVEPAKU SNACKS,14,60,60,0,1
01-02-2025,"Health, Wellness & Ayurvedic Products",MH Millets Malt 1KG,5,2000,"1,900.00",100,5
01-02-2025,Snacks & Ready-to-Eat,SD Little Millet WITH PLAM JAGGERY,14,135,135,0,1
01-02-2025,"Dry Fruits, Nuts & Seeds",ALMONDS 250GM,2,280,260,20,1
01-02-2025,Snacks & Ready-to-Eat,SD Aswagandha with palm Jaggery250Gm,14,135,135,0,1
01-02-2025,Snacks & Ready-to-Eat,SD Vamu with palm jaggery 250gm,14,135,135,0,1
01-02-2025,"Grains, Flours & Dals",SRILATHA RICE RAVVA 500GM,4,35,35,0,1
01-02-2025,Oils & Ghee,Coconut oil 1 L,9,440,400,40,1
01-02-2025,Oils & Ghee,Coconut oil 500 ml,9,220,200,20,1
01-02-2025,Oils & Ghee,Mustard oil 500 ml,9,220,195,25,1
01-02-2025,Oils & Ghee,Groundnut oil 1 L,9,360,330,30,1
01-02-2025,"Dry Fruits, Nuts & Seeds",PUMPKIN SEEDS 250GM,2,200,160,40,1
01-02-2025,Sweeteners,MISHRI D,16,40,30,10,1
01-02-2025,"Health, Wellness & Ayurvedic Products",RB Max Protein Fruit &amp;Nut 50g,5,75,75,0,1
01-02-2025,"Dry Fruits, Nuts & Seeds",SUNFLOWER SEEDS 250GRM,2,150,130,20,1
01-02-2025,"Dry Fruits, Nuts & Seeds",ANJEER 250GM,2,400,360,40,1
01-02-2025,Pooja & Spiritual Items,BANDA PUVVU 25GM 25GM,12,80,60,20,1
01-02-2025,"Dry Fruits, Nuts & Seeds",WALLNUTS 250GM,2,320,290,30,1
01-02-2025,"Grains, Flours & Dals",split urad dall 500 gms,4,90,80,10,1
01-02-2025,"Dry Fruits, Nuts & Seeds",BLACK KISMIS 250GM,2,175,140,35,1
01-02-2025,"Dry Fruits, Nuts & Seeds",PULMAKHANA 100 GM,2,180,170,10,1
01-02-2025,"Dry Fruits, Nuts & Seeds",YELLOW KISHMISH 250GM,2,130,110,20,1
01-02-2025,"Grains, Flours & Dals",JOWAR WHITE 1 KG,4,40,35,5,0.5
01-02-2025,"Dry Fruits, Nuts & Seeds",Groundnuts 1 kg,2,190,170,20,1
01-02-2025,Milk & Dairy,SANGAM TONED MILK 500ML,7,60,60,0,2
01-02-2025,"Grains, Flours & Dals",Bombay Rava 500GM,4,35,30,5,1
01-02-2025,"Grains, Flours & Dals",DISANO ROLED OATS,4,197,197,0,1
01-02-2025,"Grains, Flours & Dals",KORRALU (FOXTAIL M) 1KG,4,150,110,40,1
01-02-2025,"Grains, Flours & Dals",PRO ORG KABULI CHANNA 500GM,4,196,196,0,1
01-02-2025,"Grains, Flours & Dals",JOWAR UPMA RAVA,4,75,75,0,1
01-02-2025,"Grains, Flours & Dals",RAGULU 1 KG,4,35,30,5,0.5
01-02-2025,"Grains, Flours & Dals",Multigrain 1 kg,4,100,85,15,1
01-02-2025,Oils & Ghee,Coconut oil 1 L,9,440,400,40,1
01-02-2025,"Grains, Flours & Dals",RED WHEAT 1 KG,4,390,360,30,3
01-02-2025,"Grains, Flours & Dals",FLOUR CHARGE,4,36,36,0,3
01-02-2025,Oils & Ghee,Groundnut oil 1 L,9,360,330,30,1
01-02-2025,"Grains, Flours & Dals",Wheat Rava M 500GM,4,66,60,6,2
01-02-2025,Baking & Cooking Aids,Baking Soda 50GM,0,20,15,5,1
01-02-2025,"Grains, Flours & Dals",PESARA PAPPU 500GMS,4,85,75,10,1
01-02-2025,Oils & Ghee,Safflower oil 1 L,9,440,400,40,1
01-02-2025,"Grains, Flours & Dals",Wheat Flour 1 kg,4,140,120,20,2
01-02-2025,Spices & Seasonings,GREEN SOUNF,15,60,40,20,1
01-02-2025,"Grains, Flours & Dals",DH URAD GOTA 1KG,4,430,380,50,2
01-02-2025,"Grains, Flours & Dals",CHANA DAL 500GM,4,140,120,20,2
01-02-2025,"Grains, Flours & Dals",White jowar.F 1 kg,4,100,80,20,1
01-02-2025,"Dry Fruits, Nuts & Seeds",PUTNALU 500GMS,2,90,76,14,1
01-02-2025,"Grains, Flours & Dals",Green gram 1 kg,4,150,130,20,1
01-02-2025,"Grains, Flours & Dals",BASMATHI RICE 1KG,4,450,405,45,3
01-02-2025,"Grains, Flours & Dals",AISHWARYA SP 5KG,4,400,375,25,1
01-02-2025,"Grains, Flours & Dals",SPLIT BLACK GRAM 500 GM,4,90,85,5,1
01-02-2025,"Dry Fruits, Nuts & Seeds",Groundnuts 1 kg,2,190,170,20,1
01-02-2025,"Grains, Flours & Dals",turdal 1kg,4,220,195,25,1
01-02-2025,Spices & Seasonings,SWASTIKS GINGER&amp;GARLIC,15,49,49,0,1
01-02-2025,Sweeteners,MADHUR SUGAR 1KG,16,65,55,10,1
01-02-2025,Milk & Dairy,BROWN EGGS 1P,7,84,72,12,6
01-02-2025,Snacks & Ready-to-Eat,VD SAGOPAPAD 150GM,14,55,55,0,1
01-02-2025,Snacks & Ready-to-Eat,SATHVI PALLI CHIKKI 200GM,14,100,80,20,1
01-02-2025,Personal Care & Cosmetics,COLGATE ACTIVE SALT,10,40,40,0,2
01-02-2025,Oils & Ghee,Sesame oil 1 L,9,590,560,30,1
01-02-2025,Snacks & Ready-to-Eat,SATHVI PALLI CHIKKI 200GM,14,100,80,20,1
01-02-2025,Spices & Seasonings,DRY MIECHI 200GM,15,80,60,20,1
01-02-2025,"Grains, Flours & Dals",Urad dall 1 Kg,4,370,340,30,2
01-02-2025,"Dry Fruits, Nuts & Seeds",Groundnuts 1 kg,2,190,170,20,1
01-02-2025,"Grains, Flours & Dals",Brown RICE 1KG,4,70,65,5,1
01-02-2025,"Grains, Flours & Dals",RED TUDAL 1KG,4,300,280,20,2
01-02-2025,"Grains, Flours & Dals",Idly Rava L 1KG,4,60,50,10,1
01-02-2025,Snacks & Ready-to-Eat,BB VERMICELLY 500GM,14,106,106,0,2
01-02-2025,"Dry Fruits, Nuts & Seeds",PUTNALU 500GMS,2,90,76,14,1
01-02-2025,Snacks & Ready-to-Eat,SD FINGER Millet with palm Jaggery 250gm,14,135,135,0,1
01-02-2025,"Grains, Flours & Dals",SB Javva Wheat Ravva 500GM,4,190,190,0,2
01-02-2025,"Grains, Flours & Dals",CHANA DAL 1KG,4,140,120,20,1
01-02-2025,"Grains, Flours & Dals",RICE FLOUR 1KG,4,140,110,30,2
01-02-2025,"Grains, Flours & Dals",BOMBAY RAVA,4,70,55,15,1
01-02-2025,"Grains, Flours & Dals",PESARA PAPPU 500GMS,4,85,75,10,1
01-02-2025,Snacks & Ready-to-Eat,MORINGA LEAVES PAPAD 200GM,14,90,90,0,1
01-02-2025,Snacks & Ready-to-Eat,GB SALT COOKIES,14,60,55,5,1
01-02-2025,"Health, Wellness & Ayurvedic Products",MH Millets Malt 500GM,5,200,190,10,1
01-02-2025,Snacks & Ready-to-Eat,RINGS 200GM,14,30,30,0,1
01-02-2025,Snacks & Ready-to-Eat,SD VAMU APPADALU 200GM,14,80,80,0,1
01-02-2025,General Household & Kitchenware,BB BOWL,3,420,399,21,1
01-02-2025,Spices & Seasonings,RED COPRA 250GMS,15,85,74,11,1
01-02-2025,Snacks & Ready-to-Eat,FOXTAIL BIS,14,135,135,0,1
01-02-2025,"Grains, Flours & Dals",RAGI FLOUR 500GRMS,4,40,35,5,1
01-02-2025,"Grains, Flours & Dals",VGR rice 1 kg,4,700,650,50,10
01-02-2025,"Grains, Flours & Dals",Brown RICE 1KG,4,700,650,50,10
01-02-2025,Snacks & Ready-to-Eat,RSC ORANGE 100GMS,14,20,20,0,1
01-02-2025,Oils & Ghee,Safflower oil 500 ml,9,220,200,20,1
01-02-2025,"Grains, Flours & Dals",Wheat Flour 1 kg,4,280,240,40,4
01-02-2025,Oils & Ghee,Safflower oil 1 L,9,440,400,40,1
01-02-2025,Snacks & Ready-to-Eat,SATHVI REGIVADA 200GM,14,80,60,20,1
01-02-2025,"Dry Fruits, Nuts & Seeds",PUTNALU 500GMS,2,90,76,14,1
01-02-2025,"Dry Fruits, Nuts & Seeds",Groundnuts 1 kg,2,190,170,20,1
01-02-2025,"Grains, Flours & Dals",JOWAR YELLOW 1 K,4,100,90,10,1
01-02-2025,"Grains, Flours & Dals",UDALU (Barnyard millet) 1 kg,4,140,115,25,1
01-02-2025,"Grains, Flours & Dals",SL Idly Rava 1KG,4,65,55,10,1
01-02-2025,"Grains, Flours & Dals",turdal 1kg,4,220,195,25,1
01-02-2025,"Grains, Flours & Dals",Bombay Rava 500GM,4,35,30,5,1
01-02-2025,Beverages,KINLEY,1,20,20,0,1
01-02-2025,"Grains, Flours & Dals",turdal 1kg,4,220,195,25,1
01-02-2025,"Grains, Flours & Dals",Urad dall 1 Kg,4,185,170,15,1
01-02-2025,"Grains, Flours & Dals",MELMEKER 250GMS,4,60,45,15,1
01-02-2025,"Grains, Flours & Dals",RAGULU 1 KG,4,70,60,10,1
01-02-2025,Sweeteners,GS Palm Jaggery Powder 400GM,16,180,180,0,1
01-02-2025,Snacks & Ready-to-Eat,SATHVI REGIVADA 200GM,14,80,60,20,1
01-02-2025,"Grains, Flours & Dals",MELMEKER 250GMS,4,60,45,15,1
01-02-2025,Snacks & Ready-to-Eat,SESAME CHIKKI,14,120,100,20,1
01-02-2025,"Grains, Flours & Dals",RAGI FLOUR 500GRMS,4,40,35,5,1
01-02-2025,"Grains, Flours & Dals",Wheat Flour 1 kg,4,70,60,10,1
01-02-2025,"Grains, Flours & Dals",Yellow jowar .F1 kg,4,110,100,10,1
01-02-2025,Snacks & Ready-to-Eat,SD Bajra with palm Jaggery 250gm,14,135,135,0,1
01-02-2025,"Grains, Flours & Dals",Black uluvalu 500 gms,4,90,70,20,1
01-02-2025,Snacks & Ready-to-Eat,GB SALT COOKIES,14,60,55,5,1
01-02-2025,"Grains, Flours & Dals",BAJRA 1 KG,4,60,50,10,1
01-02-2025,"Grains, Flours & Dals",JOWAR WHITE 1 KG,4,80,70,10,1
01-02-2025,"Grains, Flours & Dals",KORRALU (FOXTAIL M) 500GM,4,65,55,10,1
01-02-2025,"Grains, Flours & Dals",SAMALU (Little millet) 500 gms,4,85,65,20,1
01-02-2025,"Grains, Flours & Dals",RAGULU 1 KG,4,280,240,40,4
01-02-2025,Sweeteners,GS Organic Jaggery Powder 600GM,16,99,99,0,1
01-02-2025,Sweeteners,YB JAGGERY POWDER 500GMS,16,75,75,0,1
01-02-2025,Snacks & Ready-to-Eat,SD FINGER Millet with palm Jaggery 250gm,14,135,135,0,1
01-02-2025,"Health, Wellness & Ayurvedic Products",RB Max Protein Fruit &amp;Nuts 500g,5,399,399,0,1
01-02-2025,"Grains, Flours & Dals",KORRALU (FOXTAIL M) 1KG,4,150,110,40,1
01-02-2025,Spices & Seasonings,FLAXSEED KARAM,15,75,75,0,1
01-02-2025,"Grains, Flours & Dals",BARLEY SEEDS 1KG,4,80,70,10,0.5
01-02-2025,"Grains, Flours & Dals",SAMALU (Little millet) 1 kg,4,170,130,40,1
01-02-2025,"Health, Wellness & Ayurvedic Products",MXP CHOCO CLASSIC BAR,5,140,140,0,2
01-02-2025,"Grains, Flours & Dals",AMMA RICE RAVA 500GRMS,4,84,84,0,2
01-02-2025,"Dry Fruits, Nuts & Seeds",SATHVI CHIA SEEDS 100GM,2,200,160,40,2
01-02-2025,Spices & Seasonings,KALONJI SEEDS,15,90,80,10,1
01-02-2025,"Dry Fruits, Nuts & Seeds",SABJA SEEDS 100GM,2,80,70,10,1
01-02-2025,"Grains, Flours & Dals",MELMEKER 250GMS,4,60,45,15,1
01-02-2025,Sweeteners,MISHRI 250 GM,16,35,30,5,1
01-02-2025,"Dry Fruits, Nuts & Seeds",MAHA BEERA SEEDS 100GM,2,60,60,0,1
01-02-2025,Snacks & Ready-to-Eat,SD FLAX SEED APPADALU,14,90,90,0,1
01-02-2025,Spices & Seasonings,DALCHIN POWDER M,15,100,90,10,1
01-02-2025,"Health, Wellness & Ayurvedic Products",MD Hibiscus Flower Choornam 30GM,5,100,100,0,1
01-02-2025,"Health, Wellness & Ayurvedic Products",MD Rose Patals Choornam 30GM,5,90,90,0,1
01-02-2025,"Grains, Flours & Dals",Wheat Flour 2 kgs,4,140,120,20,1
01-02-2025,Snacks & Ready-to-Eat,PALLI LADDU 200GMS,14,90,70,20,1
01-02-2025,"Grains, Flours & Dals",Yellow jowar .F1 kg,4,110,100,10,1
01-02-2025,Snacks & Ready-to-Eat,VD SAGOPAPAD 150GM,14,55,55,0,1
01-02-2025,"Health, Wellness & Ayurvedic Products",RB Max Protein PERI PERI 60gm,5,45,45,0,1
01-02-2025,"Grains, Flours & Dals",AISHWARYA SP 1KG,4,160,138,22,2
01-02-2025,Oils & Ghee,BUFFALLO GHEE 500ML,9,410,370,40,1
01-02-2025,"Dry Fruits, Nuts & Seeds",Groundnuts 500 gms,2,95,85,10,1
01-02-2025,Sweeteners,YB JAGGERY POWDER 1KG,16,140,140,0,1
01-02-2025,Sweeteners,SUGAR 1KG,16,60,50,10,1
01-02-2025,"Grains, Flours & Dals",DESI CHANA,4,50,50,0,2
01-02-2025,Sweeteners,YB JAGGERY POWDER 500GMS,16,150,150,0,2
01-02-2025,Spices & Seasonings,Vamu 100GM,15,60,50,10,1
01-02-2025,Snacks & Ready-to-Eat,BATANA NGT 70GMS,14,40,40,0,2
01-02-2025,Snacks & Ready-to-Eat,BATANA NGT 70GMS,14,20,20,0,1
01-02-2025,Pooja & Spiritual Items,GD Dhoop Cones 40GM,12,30,30,0,1
01-02-2025,"Grains, Flours & Dals",turdal 500 gms,4,110,100,10,1
01-02-2025,"Grains, Flours & Dals",CHANA DAL 1KG,4,35,30,5,0.25
01-02-2025,"Grains, Flours & Dals",Bombay Rava 500GM,4,35,30,5,1
01-02-2025,"Grains, Flours & Dals",Wheat Rava M 500GM,4,33,30,3,1
01-02-2025,"Grains, Flours & Dals",RAGI FLOUR 500GRMS,4,40,35,5,1
01-02-2025,"Grains, Flours & Dals",Wheat Flour 1 kg,4,70,60,10,1
01-02-2025,Snacks & Ready-to-Eat,NGT CHATPATTA CHANA 90GM,14,25,25,0,1
01-02-2025,"Grains, Flours & Dals",MAAGAANI SP RICE 20 KGS,4,2300,"1,960.00",340,1
01-02-2025,"Grains, Flours & Dals",DR.RICE 5KG,4,600,600,0,1
01-02-2025,Snacks & Ready-to-Eat,PALLI LADDU 200GMS,14,90,70,20,1
31-01-2025,"Dry Fruits, Nuts & Seeds",SATHVI CHIA SEEDS 100GM,2,200,160,40,2
31-01-2025,"Dry Fruits, Nuts & Seeds",SABJA SEEDS 100GM,2,160,140,20,2
31-01-2025,Spices & Seasonings,YB Rock Salt 1KG,15,120,120,0,1
31-01-2025,Snacks & Ready-to-Eat,JUNNU POWDER 100GM,14,140,140,0,2
31-01-2025,"Grains, Flours & Dals",Chittimuthaylu rice 1 kg,4,160,140,20,1
31-01-2025,"Dry Fruits, Nuts & Seeds",MAHA BEERA SEEDS 100GM,2,120,120,0,2
31-01-2025,"Grains, Flours & Dals",DESI CHANA,4,50,50,0,2
31-01-2025,Snacks & Ready-to-Eat,BATANA NGT 70GMS,14,60,60,0,3
31-01-2025,Snacks & Ready-to-Eat,URBAN MARMURA 450GM,14,60,55,5,1
31-01-2025,"Grains, Flours & Dals",Multigrain 1 kg,4,100,85,15,1
31-01-2025,Snacks & Ready-to-Eat,MILLET NOODLES CURRY MASALA,14,129,129,0,1
31-01-2025,Sweeteners,YB Brown Sugar 500GM,16,75,75,0,1
31-01-2025,Snacks & Ready-to-Eat,SF NOODLES CLKASSIC MASALA,14,129,129,0,1
31-01-2025,Spices & Seasonings,DB SAFRON,15,180,180,0,1
31-01-2025,Pooja & Spiritual Items,DASANGAM DHOOP POWDER 50GM,12,43,43,0,1
31-01-2025,Sweeteners,SD DrybFruit Honey 500GM,16,550,550,0,1
31-01-2025,"Health, Wellness & Ayurvedic Products",JAMBU SEED CHOORNAM 100GM,5,80,80,0,1
31-01-2025,"Dry Fruits, Nuts & Seeds",Groundnuts 1 kg,2,95,85,10,0.5
31-01-2025,Spices & Seasonings,Tamarind 250GMS,15,80,65,15,1
31-01-2025,Spices & Seasonings,Gasagasalu 50GM,15,130,110,20,1
31-01-2025,"Grains, Flours & Dals",Red uluvalu 500 gms,4,90,75,15,1
31-01-2025,"Grains, Flours & Dals",Wheat Flour 1 kg,4,70,60,10,1
31-01-2025,"Grains, Flours & Dals",Multigrain 1 kg,4,100,85,15,1
31-01-2025,Oils & Ghee,Castor oil 200 ml,9,100,80,20,1
31-01-2025,"Grains, Flours & Dals",SL Idly Rava 1KG,4,130,110,20,2
31-01-2025,"Grains, Flours & Dals",MAA TEJA RICE BAG 26KG,4,2210,"1,750.00",460,1
31-01-2025,"Grains, Flours & Dals",THICK POHA 500GM,4,40,35,5,1
31-01-2025,Snacks & Ready-to-Eat,PN ORGANIC PUFFED RICE 200GM,14,55,55,0,1
31-01-2025,"Grains, Flours & Dals",PESARA PAPPU 1 KG,4,170,145,25,1
31-01-2025,Snacks & Ready-to-Eat,GB SALT COOKIES,14,60,55,5,1
31-01-2025,"Grains, Flours & Dals",SPLIT BLACK GRAM 500 GM,4,90,85,5,1
31-01-2025,"Grains, Flours & Dals",SINGLE POLISH 1KG,4,325,325,0,5
31-01-2025,"Dry Fruits, Nuts & Seeds",SD Mango cubes 200gm,2,90,90,0,1
31-01-2025,Snacks & Ready-to-Eat,SD FINGER Millet with palm Jaggery 250gm,14,270,270,0,2
31-01-2025,Oils & Ghee,Coconut oil 500 ml,9,220,200,20,1
31-01-2025,Oils & Ghee,Safflower oil 1 L,9,440,400,40,1
31-01-2025,"Grains, Flours & Dals",JOWAR WHITE 1 KG,4,240,210,30,3
31-01-2025,"Health, Wellness & Ayurvedic Products",VITAMIN C,5,125,125,0,1
31-01-2025,"Grains, Flours & Dals",Wheat Flour 2 kgs,4,140,120,20,1
31-01-2025,"Grains, Flours & Dals",DH URAD GOTA 1KG,4,215,190,25,1
31-01-2025,"Dry Fruits, Nuts & Seeds",Groundnuts 500 gms,2,95,85,10,1
31-01-2025,Pooja & Spiritual Items,GD Aiswarya Deepam 700ML,12,195,195,0,1
31-01-2025,Snacks & Ready-to-Eat,SD Little Millet WITH PLAM JAGGERY,14,135,135,0,1
31-01-2025,"Grains, Flours & Dals",Red uluvalu 500 gms,4,90,75,15,1
31-01-2025,"Grains, Flours & Dals",KORRALU (FOXTAIL M) 1KG,4,150,110,40,1
31-01-2025,Oils & Ghee,Groundnut oil 1 L,9,720,660,60,2
31-01-2025,"Grains, Flours & Dals",UDALU (Barnyard millet) 1 kg,4,140,115,25,1
31-01-2025,"Grains, Flours & Dals",SAMALU (Little millet) 1 kg,4,170,130,40,1
31-01-2025,Snacks & Ready-to-Eat,SD Atreyapuram DRY Fruit ghee,14,150,150,0,1
31-01-2025,"Grains, Flours & Dals",RAGULU 1 KG,4,70,60,10,1
31-01-2025,"Grains, Flours & Dals",white Bobarlu 1 KG,4,170,150,20,1
31-01-2025,"Dry Fruits, Nuts & Seeds",SALTED PISTA 250GM,2,400,350,50,1
31-01-2025,Spices & Seasonings,Vamu 100GM,15,60,50,10,1
31-01-2025,"Grains, Flours & Dals",PESARA PAPPU 500GMS,4,85,75,10,1
31-01-2025,"Grains, Flours & Dals",Arikadu ( kodo),4,140,130,10,1
31-01-2025,Pooja & Spiritual Items,GD Dhoop Sticks 26GM,12,20,20,0,1
31-01-2025,"Grains, Flours & Dals",JOWAR YELLOW 1 K,4,100,90,10,1
31-01-2025,"Grains, Flours & Dals",ANDU KORRALU (Browntop.m) 1 kg,4,260,220,40,1
31-01-2025,"Grains, Flours & Dals",Green gram 1 kg,4,150,130,20,1
31-01-2025,"Grains, Flours & Dals",Brown RICE 1KG,4,35,32.5,2.5,0.5
31-01-2025,General Household & Kitchenware,BB BOWL,3,420,399,21,1
31-01-2025,"Grains, Flours & Dals",KORRALU (FOXTAIL M) 1KG,4,150,110,40,1
31-01-2025,"Grains, Flours & Dals",SAMALU (Little millet) 500 gms,4,85,65,20,1
31-01-2025,"Grains, Flours & Dals",UDALU (Barnyard millet) 500 gms,4,70,60,10,1
31-01-2025,Snacks & Ready-to-Eat,NGT CHATPATTA CHANA 90GM,14,25,25,0,1
31-01-2025,"Grains, Flours & Dals",Wheat Flour 1 kg,4,140,120,20,2
31-01-2025,Spices & Seasonings,BLACK JEERA 50 GM,15,45,30,15,1
31-01-2025,"Dry Fruits, Nuts & Seeds",PULMAKHANA 100 GM,2,180,170,10,1
31-01-2025,"Grains, Flours & Dals",SB Javva Wheat Ravva 500GM,4,95,95,0,1
31-01-2025,"Grains, Flours & Dals",RICE FLOUR 500 GM,4,70,56,14,2
31-01-2025,Snacks & Ready-to-Eat,ZEEDI,14,70,70,0,1
31-01-2025,Oils & Ghee,Groundnut oil 5 L,9,1800,"1,600.00",200,1
31-01-2025,"Grains, Flours & Dals",SL Idly Rava 1KG,4,65,55,10,1
31-01-2025,Snacks & Ready-to-Eat,PALLI LADDU 200GMS,14,90,70,20,1
31-01-2025,"Grains, Flours & Dals",Multigrain 1 kg,4,300,255,45,3
31-01-2025,Snacks & Ready-to-Eat,VD VAMUPUSA 175GM,14,60,60,0,1
31-01-2025,Snacks & Ready-to-Eat,VD MURUKU 175GM,14,60,60,0,1
31-01-2025,Snacks & Ready-to-Eat,VD RIBBON PAKODI 175GM,14,60,60,0,1
31-01-2025,General Household & Kitchenware,IRN AMBOLI TAWA 1,3,325,325,0,1
31-01-2025,"Dry Fruits, Nuts & Seeds",Groundnuts 1 kg,2,190,170,20,1
31-01-2025,Spices & Seasonings,SWEET SOUNF,15,20,20,0,1
31-01-2025,Spices & Seasonings,SWEET SOUNF,15,20,20,0,1
31-01-2025,Snacks & Ready-to-Eat,VD ARISELU 5 PIC,14,100,100,0,1
31-01-2025,"Grains, Flours & Dals",Quinova 500 gms,4,110,100,10,1
31-01-2025,"Grains, Flours & Dals",SINGLE POLISH 1KG,4,325,325,0,5
31-01-2025,"Grains, Flours & Dals",PRO ORG MEDIUM POHA 500G,4,78,78,0,1
31-01-2025,Snacks & Ready-to-Eat,BATANA NGT 70GMS,14,60,60,0,3
31-01-2025,"Grains, Flours & Dals",SINGLE POLISH 1KG,4,325,325,0,5
31-01-2025,"Grains, Flours & Dals",DESI CHANA,4,50,50,0,2
31-01-2025,Snacks & Ready-to-Eat,RSC ORANGE 100GMS,14,20,20,0,1
31-01-2025,Snacks & Ready-to-Eat,PALLI LADDU 200GMS,14,90,70,20,1
31-01-2025,"Grains, Flours & Dals",KORRALU (FOXTAIL M) 1KG,4,75,55,20,0.5
31-01-2025,"Grains, Flours & Dals",WHEAT 1 KG,4,30,25,5,0.5
31-01-2025,"Grains, Flours & Dals",BAJRA 1 KG,4,30,25,5,0.5
31-01-2025,"Grains, Flours & Dals",FLOUR CHARGE,4,24,24,0,2
31-01-2025,"Grains, Flours & Dals",JOWAR WHITE 1 KG,4,40,35,5,0.5
31-01-2025,Snacks & Ready-to-Eat,RSC ORANGE 100GMS,14,20,20,0,1
31-01-2025,Snacks & Ready-to-Eat,RINGS 200GM,14,30,30,0,1
31-01-2025,Snacks & Ready-to-Eat,3D PAPAD,14,40,40,0,1
31-01-2025,Snacks & Ready-to-Eat,MORINGA LEAVES PAPAD 200GM,14,90,90,0,1
31-01-2025,Spices & Seasonings,Turmeric powder 250 gms,15,100,75,25,1
31-01-2025,Snacks & Ready-to-Eat,PN ORGANIC PUFFED RICE 200GM,14,110,110,0,2
31-01-2025,Spices & Seasonings,SATHVI ANASAPUVUU 25GM,15,90,65,25,1
31-01-2025,"Grains, Flours & Dals",Red Chana 250GM,4,35,30,5,1
31-01-2025,Spices & Seasonings,DB CRYSTAL SALT 1KG,15,50,50,0,2
31-01-2025,Snacks & Ready-to-Eat,MILLET PANCAKE CHOCOLATE,14,199,199,0,1
31-01-2025,Oils & Ghee,Sesame oil 1 L,9,590,560,30,1
31-01-2025,Spices & Seasonings,Elaichi 25GM,15,145,120,25,1
31-01-2025,"Dry Fruits, Nuts & Seeds",Putnalu 250GM,2,180,152,28,4
31-01-2025,Oils & Ghee,Safflower oil 1 L,9,440,400,40,1
31-01-2025,Spices & Seasonings,Marati Magga 50GM,15,130,110,20,1
31-01-2025,Spices & Seasonings,PRO ORG CUMIN 100G,15,176,176,0,1
31-01-2025,"Grains, Flours & Dals",Green gram 500 gms,4,150,140,10,2
31-01-2025,"Grains, Flours & Dals",SRILATHA RICE RAVVA 500GM,4,35,35,0,1
31-01-2025,Spices & Seasonings,Gasagasalu 50GM,15,260,220,40,2
31-01-2025,"Grains, Flours & Dals",THICK POHA 1KG,4,80,70,10,1
31-01-2025,Spices & Seasonings,Lavangam 50GM,15,60,50,10,1
31-01-2025,"Dry Fruits, Nuts & Seeds",SD Mango cubes 200gm,2,90,90,0,1
31-01-2025,"Grains, Flours & Dals",SH ORGANIC MOONG YELLOW 500GM,4,158,158,0,1
31-01-2025,Pooja & Spiritual Items,BALAJI DESH MERE 220GM,12,150,150,0,1
31-01-2025,Oils & Ghee,Groundnut oil 1 L,9,360,330,30,1
31-01-2025,Pooja & Spiritual Items,GD Dhoop Cones 40GM,12,30,30,0,1
31-01-2025,"Health, Wellness & Ayurvedic Products",MD Triphala Chorrnam 100GM,5,80,80,0,1
31-01-2025,Pooja & Spiritual Items,VRP APOORVA JAVADHU POW,12,35,35,0,1
31-01-2025,Pickles & Cooking Pastes,SD GINGER PICKLE 250GM,11,110,110,0,1
31-01-2025,Oils & Ghee,Groundnut oil 1 L,9,720,660,60,2
31-01-2025,"Grains, Flours & Dals",RAGI FLOUR 1KG,4,80,70,10,1
31-01-2025,"Health, Wellness & Ayurvedic Products",JAMBU SEED CHOORNAM 100GM,5,80,80,0,1
31-01-2025,Pooja & Spiritual Items,GD Dhoop Sticks 26GM,12,20,20,0,1
31-01-2025,"Grains, Flours & Dals",Red Wheat Flour 1 kg,4,140,130,10,1
31-01-2025,"Dry Fruits, Nuts & Seeds",PULMAKHANA 100 GM,2,180,170,10,1
31-01-2025,"Health, Wellness & Ayurvedic Products",BRAHMI CHOORNAM 100GM,5,100,100,0,1
31-01-2025,"Grains, Flours & Dals",Multigrain 1 kg,4,200,170,30,2
31-01-2025,Oils & Ghee,Sesame oil 1 L,9,1770,"1,680.00",90,3
31-01-2025,Personal Care & Cosmetics,REVLON,10,45,45,0,1
31-01-2025,Spices & Seasonings,SWEET SOUNF,15,20,20,0,1
31-01-2025,Spices & Seasonings,Masala Karam 250 gms,15,130,120,10,1
31-01-2025,Spices & Seasonings,Coriander seeds 200 gms,15,48,40,8,1
31-01-2025,Household & Cleaning,TIDE DOUBLE POWER JASMINE &amp;ROSE,6,66,66,0,1
31-01-2025,Spices & Seasonings,DRY MIECHI 200GM,15,80,60,20,1
31-01-2025,Pooja & Spiritual Items,GD KUMKUM 50GM,12,30,30,0,1
31-01-2025,Snacks & Ready-to-Eat,RINGS 200GM,14,60,60,0,2
31-01-2025,Pooja & Spiritual Items,SWASTIK CAMPHOR 10GM,12,20,20,0,1
31-01-2025,Spices & Seasonings,Tamarind 500GM,15,160,130,30,1
31-01-2025,Snacks & Ready-to-Eat,PEANUT CHILLI,14,10,10,0,2
31-01-2025,"Grains, Flours & Dals",FLOUR CHARGE,4,36,36,0,3
31-01-2025,Snacks & Ready-to-Eat,TILLI CHIKKI,14,10,10,0,2
31-01-2025,Snacks & Ready-to-Eat,BATANA NGT 70GMS,14,20,20,0,1
31-01-2025,"Grains, Flours & Dals",RICE FLOUR 500 GM,4,35,28,7,1
31-01-2025,"Health, Wellness & Ayurvedic Products",RB Max Protein DESI MASALA 60gm,5,45,45,0,1
31-01-2025,Milk & Dairy,HRITAGE TOTAL CURD 130GM,7,10,10,0,1
31-01-2025,Spices & Seasonings,GD Turmeric 50GM,15,25,25,0,1
31-01-2025,Snacks & Ready-to-Eat,TILLI CHIKKI,14,10,10,0,2
31-01-2025,Oils & Ghee,Safflower oil 500 ml,9,220,200,20,1
31-01-2025,"Grains, Flours & Dals",Wheat Flour 3 kgs,4,210,180,30,1
31-01-2025,Sweeteners,MISHRI 250 GM,16,35,30,5,1
31-01-2025,"Grains, Flours & Dals",WHITE BATANI,4,40,30,10,1
31-01-2025,"Grains, Flours & Dals",WHEAT 1 KG,4,15,12.5,2.5,0.25
31-01-2025,"Grains, Flours & Dals",RICE FLOUR 500 GM,4,70,56,14,2
31-01-2025,Oils & Ghee,Groundnut oil 5 L,9,1800,"1,600.00",200,1
31-01-2025,"Grains, Flours & Dals",Chana Flour 1 kg,4,140,130,10,1
31-01-2025,Spices & Seasonings,Coconut Powder 250GM,15,90,90,0,1
31-01-2025,Spices & Seasonings,SV Kashmiri Chilli Powder 100GM,15,130,130,0,1
31-01-2025,"Health, Wellness & Ayurvedic Products",RB Peanut butter Peanuts Dark 40g,5,45,45,0,1
31-01-2025,"Dry Fruits, Nuts & Seeds",PLAIN PISTA 250GM,2,660,550,110,1
31-01-2025,"Grains, Flours & Dals",Multigrain 1 kg,4,100,85,15,1
31-01-2025,Snacks & Ready-to-Eat,PN ORGANIC PUFFED RICE 200GM,14,55,55,0,1
31-01-2025,Snacks & Ready-to-Eat,SESAME CHIKKI,14,120,100,20,1
31-01-2025,Snacks & Ready-to-Eat,SALTED PHALLI,14,25,25,0,1
31-01-2025,Sweeteners,YB Brown Sugar 1KG,16,140,140,0,1
31-01-2025,General Household & Kitchenware,MATCH BOX,3,20,20,0,1
31-01-2025,"Grains, Flours & Dals",RAGI FLOUR 1KG,4,80,70,10,1
31-01-2025,Oils & Ghee,Groundnut oil 500ml,9,180,165,15,1
31-01-2025,"Grains, Flours & Dals",Wheat Rava M 1KG,4,65,55,10,1
31-01-2025,Sweeteners,ACHU BELLAM 1KG,16,100,80,20,1
31-01-2025,"Grains, Flours & Dals",turdal 1kg,4,220,195,25,1
31-01-2025,Spices & Seasonings,NUVVULU 250GM,15,100,85,15,1
31-01-2025,Oils & Ghee,Black Sesame oil 1 L,9,440,380,60,1
31-01-2025,"Grains, Flours & Dals",WHEAT 1 KG,4,180,162,18,3
31-01-2025,Snacks & Ready-to-Eat,SATHVI REGIVADA 200GM,14,80,60,20,1
31-01-2025,Sweeteners,YB JAGGERY POWDER 500GMS,16,225,225,0,3
31-01-2025,"Grains, Flours & Dals",PRO SABUDHANA 500GM,4,77,77,0,1
31-01-2025,Pooja & Spiritual Items,GOTHAM AGARABATHI 200GM,12,150,150,0,2
31-01-2025,Oils & Ghee,Coconut oil 500 ml,9,220,200,20,1
31-01-2025,"Grains, Flours & Dals",RED TUDAL 1KG,4,150,140,10,1
31-01-2025,General Household & Kitchenware,VERMI COMPOST MIX,3,30,30,0,1
31-01-2025,Pooja & Spiritual Items,GD Dhoop Sticks 26GM,12,40,40,0,2
31-01-2025,Spices & Seasonings,Turmeric powder 250 gms,15,100,75,25,1
31-01-2025,Sweeteners,YB JAGGERY POWDER 1KG,16,140,140,0,1
31-01-2025,Snacks & Ready-to-Eat,Popcorn Seeds 250GM,14,45,40,5,1
31-01-2025,Oils & Ghee,BUFFALLO GHEE 500ML,9,410,370,40,1
31-01-2025,Snacks & Ready-to-Eat,SS IDLY BATTER 1KG,14,60,60,0,1
31-01-2025,Pickles & Cooking Pastes,SD MESTA PICKLE,11,110,110,0,1
31-01-2025,"Health, Wellness & Ayurvedic Products",SAI DURGA MORINGA LEAVES 100GM,5,75,75,0,1
31-01-2025,"Dry Fruits, Nuts & Seeds",SUNFLOWER SEEDS 250GRM,2,150,130,20,1
31-01-2025,Oils & Ghee,Sesame oil 1 L,9,590,560,30,1
31-01-2025,"Dry Fruits, Nuts & Seeds",WATERMELON SEEDS 250GRM,2,320,280,40,1
31-01-2025,Oils & Ghee,Groundnut oil 1 L,9,360,330,30,1
31-01-2025,Spices & Seasonings,FLAXSEED KARAM,15,75,75,0,1
31-01-2025,"Grains, Flours & Dals",SA WHITE JOWAR RAVA 500GM,4,138,138,0,2
31-01-2025,"Grains, Flours & Dals",MAAGAANI SP RICE 5KGS,4,649,560,89,1
31-01-2025,Snacks & Ready-to-Eat,PALLI LADDU 200GMS,14,90,70,20,1
31-01-2025,Snacks & Ready-to-Eat,SESAME LADDU 200GM,14,100,80,20,1
31-01-2025,"Grains, Flours & Dals",Wheat Flour 1 kg,4,210,180,30,3
31-01-2025,Oils & Ghee,Groundnut oil 1 L,9,2160,"1,980.00",180,6
31-01-2025,Sweeteners,YB Brown Sugar 1KG,16,280,280,0,2
31-01-2025,"Grains, Flours & Dals",White jowar.F 1 kg,4,300,240,60,3
31-01-2025,Spices & Seasonings,Menthulu 250 gms,15,50,45,5,1
31-01-2025,Snacks & Ready-to-Eat,SATHVI MIXED CHIKKI 200GM,14,120,100,20,1
31-01-2025,"Grains, Flours & Dals",FLOUR CHARGE,4,24,24,0,2
31-01-2025,"Grains, Flours & Dals",BAJRA IDLY RAVA 400GM,4,65,65,0,1
31-01-2025,Spices & Seasonings,DB CRYSTAL SALT 1KG,15,25,25,0,1
31-01-2025,Spices & Seasonings,PURO Healthy Salt Crystal 1KG,15,135,135,0,1
31-01-2025,"Grains, Flours & Dals",EM Ragi idli R 500G,4,150,150,0,2
31-01-2025,"Grains, Flours & Dals",BOMBAY RAVA,4,70,55,15,1
31-01-2025,"Grains, Flours & Dals",Em jowar idly R 500G,4,150,150,0,2
31-01-2025,"Grains, Flours & Dals",Wheat Rava M 1KG,4,65,55,10,1
31-01-2025,"Grains, Flours & Dals",WHEAT 1 KG,4,120,100,20,2
31-01-2025,Oils & Ghee,Groundnut oil 1 L,9,1080,990,90,3
31-01-2025,Milk & Dairy,SANGAM TONED MILK 500ML,7,90,90,0,3
31-01-2025,Snacks & Ready-to-Eat,BD LITTLE MILLET NOODLES 200G,14,75,75,0,1
31-01-2025,"Grains, Flours & Dals",SL Idly Rava 1KG,4,65,55,10,1
31-01-2025,"Grains, Flours & Dals",RAGI FLOUR 1KG,4,80,70,10,1
31-01-2025,Spices & Seasonings,SONTI 50GM,15,30,20,10,1
31-01-2025,"Health, Wellness & Ayurvedic Products",RB Max Protein Salt & Caramel Bar 50g,5,75,75,0,1
31-01-2025,"Health, Wellness & Ayurvedic Products",RB Max Protein Choco Berry bar 50g,5,75,75,0,1
31-01-2025,Spices & Seasonings,BLACK JEERA 50 GM,15,45,30,15,1
31-01-2025,Snacks & Ready-to-Eat,SAJJA GAVVALU,14,95,95,0,1
31-01-2025,Sweeteners,YB FOREST HONEY 250GM,16,180,180,0,1
31-01-2025,Personal Care & Cosmetics,DETTOL SANITIZER,10,47,30,17,1
31-01-2025,Oils & Ghee,Coconut oil 500 ml,9,220,200,20,1
31-01-2025,"Grains, Flours & Dals",SPLIT BLACK GRAM 500 GM,4,90,85,5,1
31-01-2025,Spices & Seasonings,AVALU 100GM,15,25,20,5,1
31-01-2025,"Grains, Flours & Dals",Wheat Flour 1 kg,4,70,60,10,1
31-01-2025,"Grains, Flours & Dals",White jowar.F 1 kg,4,100,80,20,1
31-01-2025,"Grains, Flours & Dals",White jowar.F 1 kg,4,200,160,40,2
31-01-2025,"Grains, Flours & Dals",RAGI FLOUR 1KG,4,80,70,10,1
31-01-2025,Sweeteners,GS Organic Jaggery Powder 600GM,16,99,99,0,1
31-01-2025,"Grains, Flours & Dals",RAGI FLOUR 500GRMS,4,40,35,5,1
31-01-2025,Oils & Ghee,Coconut oil 500 ml,9,220,200,20,1
31-01-2025,Sweeteners,YB Brown Sugar 1KG,16,140,140,0,1
31-01-2025,"Grains, Flours & Dals",BOBBARA PAPPU 500GM,4,85,80,5,1
31-01-2025,"Dry Fruits, Nuts & Seeds",Putnalu 250GM,2,45,38,7,1
31-01-2025,Oils & Ghee,Safflower oil 1 L,9,440,400,40,1
31-01-2025,Pooja & Spiritual Items,GD Dhoop Sticks 26GM,12,20,20,0,1
31-01-2025,Oils & Ghee,Groundnut oil 500ml,9,180,165,15,1
31-01-2025,Spices & Seasonings,NUVVULU 250GM,15,100,85,15,1
31-01-2025,"Grains, Flours & Dals",AMMA RICE RAVA 500GRMS,4,42,42,0,1
31-01-2025,"Grains, Flours & Dals",URAD DALL,4,190,170,20,2
31-01-2025,"Grains, Flours & Dals",BARLEY SEEDS 250GMS,4,40,35,5,1
31-01-2025,"Grains, Flours & Dals",SABDANA,4,40,35,5,1
31-01-2025,Oils & Ghee,Groundnut oil 1 L,9,720,660,60,2
31-01-2025,"Grains, Flours & Dals",VL Sabdana 500GM,4,77,77,0,1
31-01-2025,"Grains, Flours & Dals",RAGI FLOUR 500GRMS,4,40,35,5,1
31-01-2025,Oils & Ghee,Safflower oil 1 L,9,440,400,40,1
31-01-2025,"Grains, Flours & Dals",Green gram 500 gms,4,150,140,10,2
31-01-2025,"Grains, Flours & Dals",DH URAD GOTA 1KG,4,215,190,25,1
31-01-2025,"Grains, Flours & Dals",JOWAR UPMA RAVA,4,0,0,0,1
31-01-2025,Spices & Seasonings,SD Garlic Karam Powder 100GM,15,65,65,0,1
31-01-2025,Snacks & Ready-to-Eat,RI Yogurt Berry Oats 35g,14,45,45,0,1
31-01-2025,"Grains, Flours & Dals",EM Ragi idli R 500G,4,75,75,0,1
31-01-2025,"Grains, Flours & Dals",SRILATHA RICE RAVVA 500GM,4,35,35,0,1
31-01-2025,"Health, Wellness & Ayurvedic Products",SAI DURGA MORINGA LEAVES 100GM,5,75,75,0,1
31-01-2025,Spices & Seasonings,NUVVULU 250GM,15,80,65,15,1
31-01-2025,Snacks & Ready-to-Eat,PEANUT CHILLI,14,40,40,0,8
31-01-2025,"Dry Fruits, Nuts & Seeds",SD Mango cubes 100gm,2,90,90,0,2
31-01-2025,Spices & Seasonings,Masala Karam 250 gms,15,130,120,10,1
31-01-2025,Snacks & Ready-to-Eat,BD KODO MILLET NOODLES 200GM,14,75,75,0,1
31-01-2025,"Grains, Flours & Dals",White jowar.F 1 kg,4,100,80,20,1
31-01-2025,Spices & Seasonings,AVALU 100GM,15,25,20,5,1
31-01-2025,Sweeteners,MADHUR SUGAR 1KG,16,65,55,10,1
31-01-2025,"Grains, Flours & Dals",Wheat Rava M 500GM,4,33,30,3,1
31-01-2025,"Grains, Flours & Dals",Em little upma R 500g,4,129,129,0,1
31-01-2025,Snacks & Ready-to-Eat,FOXTAIL NOODLES,14,75,75,0,1
31-01-2025,Sweeteners,MISHRI D,16,40,30,10,1
31-01-2025,Spices & Seasonings,GARAM MASALA 200GM,15,120,110,10,1
31-01-2025,Spices & Seasonings,AV Iodized Salt 1KG,15,28,25,3,1
31-01-2025,Personal Care & Cosmetics,GOW DURBAR NAVA 100GM SOAP,10,40,40,0,1
31-01-2025,Spices & Seasonings,SD IDLY KARAM,15,65,65,0,1
31-01-2025,Oils & Ghee,Groundnut oil 1 L,9,360,330,30,1
31-01-2025,Snacks & Ready-to-Eat,SD Little Millet WITH PLAM JAGGERY,14,135,135,0,1
31-01-2025,"Grains, Flours & Dals",HS JOWAR FLAKES 250GM 1+1,4,119,119,0,1
31-01-2025,Snacks & Ready-to-Eat,SD FINGER Millet with palm Jaggery 250gm,14,135,135,0,1
31-01-2025,Spices & Seasonings,FLAXSEED KARAM,15,75,75,0,1
31-01-2025,Snacks & Ready-to-Eat,SD DrybFruit LADDU WITH DATES 175GM,14,170,170,0,1
31-01-2025,"Grains, Flours & Dals",JOWAR UPMA RAVA,4,0,0,0,1
31-01-2025,"Health, Wellness & Ayurvedic Products",SAI DURGA MORINGA LEAVES 100GM,5,150,150,0,2
31-01-2025,Snacks & Ready-to-Eat,RAJGIRA PEANUT CHIKKI,14,5,5,0,1
31-01-2025,Snacks & Ready-to-Eat,PEANUT CHIKKI 450GM,14,125,125,0,1
31-01-2025,Snacks & Ready-to-Eat,MILK BREAD,14,55,55,0,1
31-01-2025,Beverages,BRU GREEN LABEL 1.2G,1,72,72,0,36
31-01-2025,"Dry Fruits, Nuts & Seeds",SD Mango cubes 100gm,2,45,45,0,1
31-01-2025,"Grains, Flours & Dals",Red Wheat Flour 1 kg,4,140,130,10,1
31-01-2025,Personal Care & Cosmetics,HERBAL BATH POWDER 200GM,10,80,80,0,1
31-01-2025,"Grains, Flours & Dals",RICE FLOUR 1KG,4,70,55,15,1
31-01-2025,Pooja & Spiritual Items,ZED BLACK PREMIUM STICKS 3 IN 1 100G,12,180,180,0,3
31-01-2025,Spices & Seasonings,SD Garlic Karam Powder 100GM,15,65,65,0,1
31-01-2025,Personal Care & Cosmetics,MD Bath Powder 100GM,10,40,40,0,1
31-01-2025,"Grains, Flours & Dals",MELMEKER 250GMS,4,60,45,15,1
31-01-2025,"Grains, Flours & Dals",RAGI FLOUR 1KG,4,80,70,10,1
31-01-2025,"Grains, Flours & Dals",Wheat Rava M 1KG,4,65,55,10,1
31-01-2025,Pooja & Spiritual Items,HERBAL VETIVER STICK 20INC,12,50,50,0,1
31-01-2025,"Grains, Flours & Dals",Red uluvalu 250 gms,4,45,40,5,1
31-01-2025,Spices & Seasonings,AV Iodized Salt 1KG,15,28,25,3,1
31-01-2025,"Health, Wellness & Ayurvedic Products",RB Max Protein Cheese&amp;,5,45,45,0,1
31-01-2025,Spices & Seasonings,Chilli powder 500 gms,15,290,210,80,1
31-01-2025,Oils & Ghee,Coconut oil 500 ml,9,220,200,20,1
31-01-2025,Spices & Seasonings,Turmeric powder 250 gms,15,100,75,25,1
31-01-2025,Spices & Seasonings,pickles chilli .pwdr 500 gms,15,355,325,30,1
31-01-2025,"Grains, Flours & Dals",FLOUR CHARGE,4,42,42,0,3.5
31-01-2025,Sweeteners,MISHRI 250 GM,16,35,30,5,1
31-01-2025,Personal Care & Cosmetics,SANTOOR,10,120,100,20,1
31-01-2025,"Grains, Flours & Dals",CHANA DAL 1KG,4,210,180,30,1.5
31-01-2025,"Grains, Flours & Dals",SL Idly Rava 1KG,4,65,55,10,1
31-01-2025,Snacks & Ready-to-Eat,BB ROASTED VERMICELLY 850GM,14,117,117,0,1
31-01-2025,Spices & Seasonings,PURO Healthy Salt Crystal 1KG,15,135,135,0,1
31-01-2025,Oils & Ghee,Sesame oil 1 L,9,590,560,30,1
31-01-2025,"Grains, Flours & Dals",ANDU KORRALU (Browntop.m) 1 kg,4,520,440,80,2
31-01-2025,"Dry Fruits, Nuts & Seeds",Groundnuts 1 kg,2,190,170,20,1
31-01-2025,Snacks & Ready-to-Eat,SF NOODLES CLKASSIC MASALA,14,258,258,0,2
31-01-2025,Oils & Ghee,Flaxseed oil 500 ml,9,300,270,30,1
31-01-2025,"Grains, Flours & Dals",DH URAD GOTA 1KG,4,430,380,50,2
31-01-2025,Snacks & Ready-to-Eat,MILLET NOODLES CURRY MASALA,14,258,258,0,2
31-01-2025,Snacks & Ready-to-Eat,MAAGAANI M JOWAR PASTA 200GM,14,199,199,0,1
31-01-2025,Oils & Ghee,Groundnut oil 1 L,9,720,660,60,2
31-01-2025,Snacks & Ready-to-Eat,VD PAPPU CHEGODI 200GM,14,60,60,0,1
31-01-2025,Snacks & Ready-to-Eat,PALLI LADDU 200GMS,14,180,140,40,2
31-01-2025,Snacks & Ready-to-Eat,VD MURUKU 175GM,14,60,60,0,1
31-01-2025,Sweeteners,GS Palm Jaggery Powder 400GM,16,360,360,0,2
31-01-2025,Snacks & Ready-to-Eat,SANDWICH BREAD,14,55,55,0,1
31-01-2025,Oils & Ghee,Safflower oil 5 L,9,2200,"1,950.00",250,1
31-01-2025,Oils & Ghee,Groundnut oil 1 L,9,360,330,30,1
31-01-2025,Snacks & Ready-to-Eat,JUNNU POWDER 100GM,14,140,140,0,2
31-01-2025,Oils & Ghee,Safflower oil 1 L,9,440,400,40,1
31-01-2025,"Grains, Flours & Dals",Bombay Rava 500GM,4,35,30,5,1
31-01-2025,Pooja & Spiritual Items,BALAJI KEWDA STICKS 220GM,12,150,150,0,1
31-01-2025,Oils & Ghee,Castor oil 200 ml,9,100,80,20,1
31-01-2025,"Grains, Flours & Dals",Chana Flour 500 gms,4,70,65,5,1
31-01-2025,"Dry Fruits, Nuts & Seeds",PULMAKHANA 100 GM,2,180,170,10,1
31-01-2025,"Grains, Flours & Dals",White jowar.F 1 kg,4,200,160,40,2
31-01-2025,"Health, Wellness & Ayurvedic Products",MH Millets Malt 500GM,5,200,190,10,1
31-01-2025,Snacks & Ready-to-Eat,PEANUT CHIKKI 450GM,14,125,125,0,1
31-01-2025,Snacks & Ready-to-Eat,SATHVI MIXED CHIKKI 200GM,14,120,100,20,1
31-01-2025,Pooja & Spiritual Items,SWASTIK CAMPHORE,12,90,90,0,1
31-01-2025,Snacks & Ready-to-Eat,VD NUVULU PAPAD 200GM,14,200,200,0,2
31-01-2025,"Grains, Flours & Dals",PESARA PAPPU 500GMS,4,85,75,10,1
31-01-2025,Oils & Ghee,Coconut oil 500 ml,9,440,400,40,2
31-01-2025,"Grains, Flours & Dals",DH URAD GOTA 1KG,4,215,190,25,1
31-01-2025,"Grains, Flours & Dals",SL Idly Rava 1KG,4,65,55,10,1
31-01-2025,Oils & Ghee,Groundnut oil 1 L,9,360,330,30,1
31-01-2025,Snacks & Ready-to-Eat,ZEEDI,14,70,70,0,1
31-01-2025,Snacks & Ready-to-Eat,SD Thati thandra 200gm,14,300,300,0,2
31-01-2025,Beverages,ASSAM MASALA TEA,1,199,199,0,1
31-01-2025,Oils & Ghee,Black Sesame oil 500 ml,9,220,190,30,1
31-01-2025,Snacks & Ready-to-Eat,SD Aswagandha with palm Jaggery250Gm,14,135,135,0,1
31-01-2025,Snacks & Ready-to-Eat,BLACK SESAME CHIKKI,14,45,45,0,1
31-01-2025,"Grains, Flours & Dals",URAD DALL,4,95,85,10,1
31-01-2025,"Grains, Flours & Dals",SAMALU (Little millet) 500 gms,4,85,65,20,1
31-01-2025,"Grains, Flours & Dals",UDALU (Barnyard millet) 500 gms,4,70,60,10,1
31-01-2025,General Household & Kitchenware,IRN WDN HDL DOSA TAWA 12,3,265,265,0,1
31-01-2025,"Grains, Flours & Dals",KORRALU (FOXTAIL M) 500GM,4,65,55,10,1
31-01-2025,"Dry Fruits, Nuts & Seeds",PULMAKHANA 100 GM,2,180,170,10,1
31-01-2025,"Dry Fruits, Nuts & Seeds",CASHEW 250GM,2,340,310,30,1
31-01-2025,"Grains, Flours & Dals",Arikalu (kodo),4,70,65,5,1
31-01-2025,"Grains, Flours & Dals",KORRALU (FOXTAIL M) 500GM,4,65,55,10,1
31-01-2025,"Grains, Flours & Dals",Arikalu (kodo),4,70,65,5,1
31-01-2025,Spices & Seasonings,Turmeric powder 250 gms,15,100,75,25,1
31-01-2025,Pooja & Spiritual Items,GD Aiswarya Deepam 700ML,12,195,195,0,1
31-01-2025,Personal Care & Cosmetics,MD Bath Powder 100GM,10,80,80,0,2
31-01-2025,Oils & Ghee,Sesame oil 500ml,9,295,280,15,1
31-01-2025,"Grains, Flours & Dals",Yellow jowar .F1 kg,4,110,100,10,1
31-01-2025,Spices & Seasonings,THOKA MIRYALU 50GM,15,210,180,30,1
31-01-2025,"Dry Fruits, Nuts & Seeds",Groundnuts 1 kg,2,190,170,20,1
31-01-2025,Personal Care & Cosmetics,DETTOL 50ML,10,154,154,0,1
31-01-2025,Pooja & Spiritual Items,GD Aiswarya Deepam 700ML,12,195,195,0,1
31-01-2025,Personal Care & Cosmetics,SANTOOR,10,120,100,20,1
31-01-2025,"Grains, Flours & Dals",split green gram 1 kg,4,150,140,10,1
31-01-2025,Spices & Seasonings,ROYAL SAFFRON,15,125,125,0,1
31-01-2025,Oils & Ghee,Groundnut oil 1 L,9,720,660,60,2
31-01-2025,"Grains, Flours & Dals",RAGI FLOUR 1KG,4,80,70,10,1
31-01-2025,"Grains, Flours & Dals",Wheat Flour 1 kg,4,140,120,20,2
31-01-2025,"Grains, Flours & Dals",HS Ragi upma rava 500 gms,4,70,70,0,1
31-01-2025,Oils & Ghee,Safflower oil 1 L,9,440,400,40,1
31-01-2025,Spices & Seasonings,NUVVULU 250GM,15,80,65,15,1
31-01-2025,Spices & Seasonings,Jeera 100GM,15,50,45,5,1
31-01-2025,Snacks & Ready-to-Eat,SD DrybFruit LADDU WITH DATES 175GM,14,170,170,0,1
31-01-2025,Snacks & Ready-to-Eat,SD Sesame laddu with dates250gm,14,135,135,0,1
31-01-2025,"Grains, Flours & Dals",CHANA DAL 500GM,4,70,60,10,1
31-01-2025,Sweeteners,SUGAR 1KG,16,60,50,10,1
31-01-2025,"Grains, Flours & Dals",Chana Flour 1 kg,4,140,130,10,1
31-01-2025,"Grains, Flours & Dals",SL Idly Rava 1KG,4,65,55,10,1
31-01-2025,Oils & Ghee,Groundnut oil 1 L,9,360,330,30,1
31-01-2025,Spices & Seasonings,NUVVULU 500GM,15,160,130,30,1
31-01-2025,Spices & Seasonings,Tamarind 250GMS,15,80,65,15,1
31-01-2025,Oils & Ghee,Sesame oil 1 L,9,590,560,30,1
31-01-2025,"Grains, Flours & Dals",Em jowar idly R 500G,4,75,75,0,1
31-01-2025,Snacks & Ready-to-Eat,SD Sesame laddu with dates250gm,14,135,135,0,1
31-01-2025,"Grains, Flours & Dals",FLOUR CHARGE,4,12,12,0,1
31-01-2025,"Grains, Flours & Dals",KORRALU (FOXTAIL M) 1KG,4,150,110,40,1
31-01-2025,Snacks & Ready-to-Eat,SD FINGER Millet with palm Jaggery 250gm,14,135,135,0,1
31-01-2025,"Dry Fruits, Nuts & Seeds",YELLOW KISHMISH 250GM,2,130,110,20,1
31-01-2025,Snacks & Ready-to-Eat,SD RAGI GAVVALU,14,95,95,0,1
31-01-2025,Snacks & Ready-to-Eat,SD JOWAR WITH PALM JAGGERY 250GM,14,135,135,0,1
31-01-2025,General Household & Kitchenware,VERMI COMPOST MIX,3,30,30,0,1
31-01-2025,Pooja & Spiritual Items,BALAJI BEL PHOOL DHOOP STICKS 10STK,12,70,70,0,1
31-01-2025,Pooja & Spiritual Items,ZED BLACK PREMIUM STICKS 3 IN 1 100G,12,120,120,0,2
31-01-2025,"Grains, Flours & Dals",RAGI FLOUR 500GRMS,4,40,35,5,1
31-01-2025,Spices & Seasonings,NUVVULU 250GM,15,80,65,15,1
31-01-2025,"Grains, Flours & Dals",DESI CHANA,4,25,25,0,1
31-01-2025,Snacks & Ready-to-Eat,KURNOOL MARMURA,14,70,55,15,1
31-01-2025,Personal Care & Cosmetics,MULTANI MITTI CHOORNAM,10,40,40,0,1
31-01-2025,Oils & Ghee,Groundnut oil 1 L,9,1080,990,90,3
31-01-2025,"Grains, Flours & Dals",Wheat Flour 1 kg,4,420,360,60,6
31-01-2025,"Grains, Flours & Dals",PESARA PAPPU 500GMS,4,85,75,10,1
31-01-2025,Snacks & Ready-to-Eat,BB VERMICELLY 500GM,14,53,53,0,1
31-01-2025,"Grains, Flours & Dals",Green gram 1 kg,4,150,130,20,1
31-01-2025,Snacks & Ready-to-Eat,BB ROASTED VERMICELLY 500GM,14,70,70,0,1
31-01-2025,"Grains, Flours & Dals",turdal 1kg,4,220,195,25,1
31-01-2025,"Grains, Flours & Dals",SINGLE POLISH 1KG,4,325,325,0,5
31-01-2025,"Grains, Flours & Dals",RAGI FLOUR 1KG,4,80,70,10,1
31-01-2025,Snacks & Ready-to-Eat,VD PANIPURI 100GM,14,30,30,0,1
31-01-2025,Snacks & Ready-to-Eat,BB ROASTED VERMICELLY 850GM,14,117,117,0,1
31-01-2025,Milk & Dairy,HERITAGE TOTAL CURD 500GM,7,50,50,0,1
31-01-2025,Snacks & Ready-to-Eat,VD RICE MURUKU 150GM,14,50,50,0,1
31-01-2025,"Grains, Flours & Dals",SA Sprouted Ragi Flour 500GM,4,69,69,0,1
31-01-2025,Oils & Ghee,GANTASALA A2 COW GHEE 250ML,9,299,299,0,1
31-01-2025,Snacks & Ready-to-Eat,TILLI CHIKKI,14,125,125,0,1
31-01-2025,"Health, Wellness & Ayurvedic Products",ORGANIC MORINGA POWER 100GM,5,249,249,0,1
31-01-2025,Snacks & Ready-to-Eat,MORINGA LEAVES PAPAD 200GM,14,90,90,0,1
31-01-2025,Personal Care & Cosmetics,OVAL BODY LOOFAH,10,55,55,0,1
31-01-2025,"Grains, Flours & Dals",MELMEKER 250GMS,4,60,45,15,1
31-01-2025,"Grains, Flours & Dals",Black gram 500 gms,4,75,70,5,1
31-01-2025,"Grains, Flours & Dals",Black uluvalu 500 gms,4,70,70,0,1
31-01-2025,"Grains, Flours & Dals",Arikalu (kodo),4,70,65,5,1
31-01-2025,"Grains, Flours & Dals",KORRALU (FOXTAIL M) 500GM,4,65,55,10,1
31-01-2025,"Grains, Flours & Dals",Red uluvalu 500 gms,4,90,75,15,1
31-01-2025,"Grains, Flours & Dals",Green gram 500 gms,4,75,70,5,1
31-01-2025,"Grains, Flours & Dals",UDALU (Barnyard millet) 500 gms,4,70,60,10,1
31-01-2025,"Grains, Flours & Dals",SAMALU (Little millet) 500 gms,4,85,65,20,1
31-01-2025,"Grains, Flours & Dals",Red Bobarlu 500 gms,4,95,85,10,1
31-01-2025,"Grains, Flours & Dals",ANDU KORRALU (Brown top .mlt) 500,4,130,110,20,1
31-01-2025,"Grains, Flours & Dals",RAGI FLOUR 500GRMS,4,40,35,5,1
31-01-2025,Oils & Ghee,Groundnut oil 1 L,9,360,330,30,1
31-01-2025,"Grains, Flours & Dals",RICE FLOUR 1KG,4,70,55,15,1
31-01-2025,Oils & Ghee,Freedom Rice Bran Oil 1L,9,194,180,14,1
31-01-2025,Spices & Seasonings,RED COPRA 250GMS,15,85,74,11,1
31-01-2025,"Grains, Flours & Dals",Red Wheat Flour 1 kg,4,140,130,10,1
31-01-2025,Spices & Seasonings,PRO ORG CORIANDER WHOLE 100G,15,70,70,0,1
31-01-2025,Spices & Seasonings,Tamarind 250GMS,15,80,65,15,1
31-01-2025,"Grains, Flours & Dals",Wheat Flour 1 kg,4,70,60,10,1
31-01-2025,"Dry Fruits, Nuts & Seeds",Putnalu 250GM,2,45,38,7,1
31-01-2025,Spices & Seasonings,YB PINK ROCK SALT 1KG,15,120,120,0,1
31-01-2025,"Grains, Flours & Dals",Wheat Flour 1 kg,4,70,60,10,1
31-01-2025,Sweeteners,SUGAR 1KG,16,60,50,10,1
31-01-2025,Oils & Ghee,Groundnut oil 5 L,9,1800,"1,600.00",200,1
31-01-2025,Snacks & Ready-to-Eat,urban murmura,14,120,110,10,2
31-01-2025,"Grains, Flours & Dals",MGSUGAR CONTROL RICE 1KG,4,139,139,0,1
31-01-2025,"Grains, Flours & Dals",AISHWARYA SP 1KG,4,80,70,10,1
31-01-2025,"Grains, Flours & Dals",MAAGAANI LOW GI SP 1KG,4,149,149,0,1
31-01-2025,General Household & Kitchenware,TEA CUP 1P,3,180,180,0,4
31-01-2025,General Household & Kitchenware,IRN WDN HDL KADAI 7,3,180,180,0,1
31-01-2025,Oils & Ghee,MUSTARD OIL 100ML,9,100,100,0,1
31-01-2025,"Grains, Flours & Dals",RAGI FLOUR 1KG,4,80,70,10,1
31-01-2025,"Grains, Flours & Dals",HS Multimillet upma r 500g,4,65,65,0,1
31-01-2025,Snacks & Ready-to-Eat,SD Atreyapuram DRY Fruit ghee,14,150,150,0,1
31-01-2025,"Grains, Flours & Dals",Em Foxtail upma r 500 g,4,109,109,0,1
31-01-2025,"Grains, Flours & Dals",SRILATHA RICE RAVVA 500GM,4,35,35,0,1
31-01-2025,Snacks & Ready-to-Eat,ELITE MILK RUSK 200GM,14,35,35,0,1
31-01-2025,"Grains, Flours & Dals",Em jowar idly R 500G,4,75,75,0,1
31-01-2025,Oils & Ghee,Groundnut oil 1 L,9,360,330,30,1
31-01-2025,Sweeteners,GS Organic Jaggery Powder 600GM,16,99,99,0,1
31-01-2025,Spices & Seasonings,PURO Healthy Salt 1KG,15,110,110,0,1
31-01-2025,Oils & Ghee,Castor oil 200 ml,9,100,80,20,1
31-01-2025,Beverages,MARWADI CHAI 100GM,1,150,150,0,2
31-01-2025,Spices & Seasonings,Vamu 100GM,15,120,100,20,2
31-01-2025,Spices & Seasonings,JEERA 250 gms,15,125,105,20,1
31-01-2025,"Grains, Flours & Dals",White jowar.F 1 kg,4,100,80,20,1
31-01-2025,"Grains, Flours & Dals",Red Wheat Flour 1 kg,4,140,130,10,1
31-01-2025,Oils & Ghee,Groundnut oil 1 L,9,360,330,30,1
31-01-2025,"Grains, Flours & Dals",RAGI FLOUR 1KG,4,80,70,10,1
31-01-2025,Oils & Ghee,Sesame oil 1 L,9,590,560,30,1
31-01-2025,"Grains, Flours & Dals",Wheat Flour 1 kg,4,70,60,10,1
31-01-2025,"Grains, Flours & Dals",Multigrain 1 kg,4,100,85,15,1
30-01-2025,"Grains, Flours & Dals",AISHWARYA SP 1KG,4,80,70,10,1
30-01-2025,"Grains, Flours & Dals",Red uluvalu 500 gms,4,180,150,30,2
30-01-2025,"Grains, Flours & Dals",RAGI FLOUR 1KG,4,80,70,10,1
30-01-2025,Snacks & Ready-to-Eat,SD Ginger Candy 100g,14,120,120,0,2
30-01-2025,Snacks & Ready-to-Eat,SESAME LADDU 200GM,14,100,80,20,1
30-01-2025,"Dry Fruits, Nuts & Seeds",Putnalu 250GM,2,45,38,7,1
30-01-2025,Snacks & Ready-to-Eat,SD Sesame laddu with dates250gm,14,135,135,0,1
30-01-2025,"Grains, Flours & Dals",DESI CHANA,4,75,75,0,3
30-01-2025,Personal Care & Cosmetics,Soapnut 500GM,10,120,90,30,1
30-01-2025,Sweeteners,YB JAGGERY POWDER 1KG,16,140,140,0,1
30-01-2025,"Grains, Flours & Dals",Wheat Flour 3 kgs,4,210,180,30,1
30-01-2025,Spices & Seasonings,DRY MIECHI 200GM,15,80,60,20,1
30-01-2025,"Health, Wellness & Ayurvedic Products",MH Millets Malt 500GM,5,200,190,10,1
30-01-2025,"Grains, Flours & Dals",THIN POHA 500GM,4,40,35,5,1
30-01-2025,"Grains, Flours & Dals",RAGI FLOUR 1KG,4,80,70,10,1
30-01-2025,"Grains, Flours & Dals",THICK POHA 500GM,4,40,35,5,1
30-01-2025,Oils & Ghee,Safflower oil 1 L,9,440,400,40,1
30-01-2025,"Grains, Flours & Dals",Wheat Flour 1 kg,4,70,60,10,1
30-01-2025,Pooja & Spiritual Items,BALAJI BEL PHOOL STICKS 90GM,12,60,60,0,1
30-01-2025,Snacks & Ready-to-Eat,SATHVI REGIVADA 200GM,14,80,60,20,1
30-01-2025,"Grains, Flours & Dals",DESI CHANA,4,50,50,0,2
30-01-2025,Snacks & Ready-to-Eat,PEANUT CHILLI,14,30,30,0,6
30-01-2025,Snacks & Ready-to-Eat,URBAN MARMURA 450GM,14,60,55,5,1
30-01-2025,"Grains, Flours & Dals",Wheat Rava M 500GM,4,33,30,3,1
30-01-2025,"Grains, Flours & Dals",Multigrain 1 kg,4,100,85,15,1
30-01-2025,"Grains, Flours & Dals",Wheat Flour 1 kg,4,70,60,10,1
30-01-2025,Oils & Ghee,Coconut oil 1 L,9,880,800,80,2
30-01-2025,Snacks & Ready-to-Eat,MARMURA LADDU,14,80,60,20,1
30-01-2025,Snacks & Ready-to-Eat,MARMURA LADDU,14,80,60,20,1
30-01-2025,Snacks & Ready-to-Eat,URBAN MARMURA 450GM,14,60,55,5,1
30-01-2025,Oils & Ghee,Groundnut oil 1 L,9,720,660,60,2
30-01-2025,Oils & Ghee,Black Sesame oil 1 L,9,880,760,120,2
30-01-2025,"Health, Wellness & Ayurvedic Products",MD Bavanchi Choornam 50GM,5,100,100,0,1
30-01-2025,"Dry Fruits, Nuts & Seeds",SD Mango cubes 100gm,2,45,45,0,1
30-01-2025,"Grains, Flours & Dals",Wheat Flour 1 kg,4,210,180,30,3
30-01-2025,Pooja & Spiritual Items,GD Sree Chandan 50GM,12,50,50,0,1
30-01-2025,"Grains, Flours & Dals",DESI CHANA,4,25,25,0,1
30-01-2025,Snacks & Ready-to-Eat,MARMURA LADDU,14,80,60,20,1
30-01-2025,Pooja & Spiritual Items,GD KUMKUM 50GM,12,30,30,0,1
30-01-2025,"Dry Fruits, Nuts & Seeds",SD Mango cubes 100gm,2,135,135,0,3
30-01-2025,"Grains, Flours & Dals",Urad dall 1 Kg,4,185,170,15,1
30-01-2025,"Dry Fruits, Nuts & Seeds",Groundnuts 1 kg,2,380,340,40,2
30-01-2025,"Grains, Flours & Dals",turdal 1kg,4,220,195,25,1
30-01-2025,Oils & Ghee,Groundnut oil 1 L,9,720,660,60,2
30-01-2025,Snacks & Ready-to-Eat,SD Sesame laddu with dates250gm,14,135,135,0,1
30-01-2025,"Grains, Flours & Dals",White jowar.F 1 kg,4,100,80,20,1
30-01-2025,Snacks & Ready-to-Eat,VD PESARA PAPAD 195GM,14,70,70,0,1
30-01-2025,"Grains, Flours & Dals",Bajra Flour 500 gms,4,35,30,5,1
30-01-2025,"Grains, Flours & Dals",Em jowar idly R 500G,4,75,75,0,1
30-01-2025,"Grains, Flours & Dals",SB Javva Wheat Ravva 500GM,4,95,95,0,1
30-01-2025,"Grains, Flours & Dals",Bajra Flour 1 kg,4,70,60,10,1
30-01-2025,Spices & Seasonings,TM MIRCH POWDER 200GM,15,163,163,0,1
30-01-2025,Spices & Seasonings,Telaga Pindi 500GM,15,80,70,10,1
30-01-2025,"Grains, Flours & Dals",RAGI FLOUR 1KG,4,80,70,10,1
30-01-2025,"Grains, Flours & Dals",JOWAR WHITE 1 KG,4,80,70,10,1
30-01-2025,"Grains, Flours & Dals",HS Jowar upma rava 500 gms,4,65,65,0,1
30-01-2025,"Grains, Flours & Dals",SRILATHA RICE RAVVA 500GM,4,35,35,0,1
30-01-2025,"Grains, Flours & Dals",EM Ragi idli R 500G,4,75,75,0,1
30-01-2025,"Grains, Flours & Dals",Em jowar idly R 500G,4,75,75,0,1
30-01-2025,"Health, Wellness & Ayurvedic Products",MD Aamlaki Choornam 100GM,5,80,80,0,1
30-01-2025,Snacks & Ready-to-Eat,SD Moringa with plam jaggery 250gm,14,135,135,0,1
30-01-2025,Spices & Seasonings,Telaga Pindi 250 GM,15,40,35,5,1
30-01-2025,"Grains, Flours & Dals",SRILATHA RICE RAVVA 500GM,4,35,35,0,1
30-01-2025,Oils & Ghee,Castor oil 500 ml,9,250,200,50,1
30-01-2025,"Health, Wellness & Ayurvedic Products",JAMBU SEED CHOORNAM 100GM,5,80,80,0,1
30-01-2025,Snacks & Ready-to-Eat,VD MINAPA VADIYAM,14,65,65,0,1
30-01-2025,Snacks & Ready-to-Eat,MARMURA LADDU,14,80,60,20,1
30-01-2025,"Grains, Flours & Dals",Em jowar idly R 500G,4,75,75,0,1
30-01-2025,"Grains, Flours & Dals",HS Jowar upma rava 500 gms,4,65,65,0,1
30-01-2025,Spices & Seasonings,SD Garlic Karam Powder 100GM,15,65,65,0,1
30-01-2025,"Grains, Flours & Dals",Wheat Flour 1 kg,4,70,60,10,1
30-01-2025,"Grains, Flours & Dals",SRILATHA RICE RAVVA 500GM,4,35,35,0,1
30-01-2025,"Grains, Flours & Dals",EM Ragi idli R 500G,4,75,75,0,1
30-01-2025,Spices & Seasonings,THREE MANGO RAI 200G,15,42,42,0,1
30-01-2025,Spices & Seasonings,TM MIRCH POWDER 200GM,15,163,163,0,1
30-01-2025,"Grains, Flours & Dals",White jowar.F 500 Gms,4,50,40,10,1
30-01-2025,"Grains, Flours & Dals",JOWAR WHITE 1 KG,4,80,70,10,1
30-01-2025,Snacks & Ready-to-Eat,VD GUMMADI VADIYAM,14,75,75,0,1
30-01-2025,Snacks & Ready-to-Eat,VD MINAPA VADIYAM,14,65,65,0,1
30-01-2025,Snacks & Ready-to-Eat,SD Aswagandha with palm Jaggery250Gm,14,135,135,0,1
30-01-2025,"Grains, Flours & Dals",SAMALU (Little millet) 1 kg,4,170,130,40,1
30-01-2025,"Grains, Flours & Dals",UDALU (Barnyard millet) 1 kg,4,140,115,25,1
30-01-2025,Oils & Ghee,Groundnut oil 1 L,9,360,330,30,1
30-01-2025,"Grains, Flours & Dals",Wheat Flour 1 kg,4,70,60,10,1
30-01-2025,"Grains, Flours & Dals",URAD DALL,4,95,85,10,1
30-01-2025,"Dry Fruits, Nuts & Seeds",Groundnuts 500 gms,2,95,85,10,1
30-01-2025,Pooja & Spiritual Items,DASANGAM DHOOP POWDER 50GM,12,43,43,0,1
30-01-2025,"Grains, Flours & Dals",VGR rice 1 kg,4,350,325,25,5
30-01-2025,Spices & Seasonings,SWEET SOUNF,15,20,20,0,1
30-01-2025,Oils & Ghee,DB CASTOR OIL 100ML,9,75,75,0,1
30-01-2025,"Grains, Flours & Dals",MAATEJA rice 1 kg,4,72,69,3,1
30-01-2025,Milk & Dairy,SANGAM TONED MILK 500ML,7,60,60,0,2
30-01-2025,Spices & Seasonings,THREE MANGO RAI POWDER500GM,15,103,103,0,1
30-01-2025,Sweeteners,GS Palm Jaggery Powder 400GM,16,180,180,0,1
30-01-2025,Oils & Ghee,Groundnut oil 1 L,9,360,330,30,1
30-01-2025,General Household & Kitchenware,VERMI COMPOST MIX,3,30,30,0,1
30-01-2025,Snacks & Ready-to-Eat,RB Choco Delite Almonds Raisins 40g,14,45,45,0,1
30-01-2025,"Grains, Flours & Dals",Wheat Flour 2 kgs,4,140,120,20,1
30-01-2025,"Grains, Flours & Dals",Wheat Flour 2 kgs,4,140,120,20,1
30-01-2025,Spices & Seasonings,SD Garlic Karam Powder 100GM,15,65,65,0,1
30-01-2025,"Grains, Flours & Dals",Idly Rava L 1KG,4,60,50,10,1
30-01-2025,"Grains, Flours & Dals",SL Idly Rava 1KG,4,65,55,10,1
30-01-2025,Sweeteners,ACHUBELLAM 500GM,16,50,40,10,1
30-01-2025,Pooja & Spiritual Items,SWASTIK CAMPHOR 25GM,12,45,45,0,1
30-01-2025,Sweeteners,MISHRI 250 GM,16,35,30,5,1
30-01-2025,Oils & Ghee,Groundnut oil 1 L,9,720,660,60,2
30-01-2025,Personal Care & Cosmetics,KAIPO BRIGHT TP 100GM,10,90,90,0,1
30-01-2025,Oils & Ghee,Castor oil 200 ml,9,100,80,20,1
30-01-2025,"Dry Fruits, Nuts & Seeds",DRIED KIWI 200GM,2,145,130,15,1
30-01-2025,Oils & Ghee,Coconut oil 500 ml,9,220,200,20,1
30-01-2025,Oils & Ghee,Coconut oil 500 ml,9,220,200,20,1
30-01-2025,Oils & Ghee,Groundnut oil 1 L,9,360,330,30,1
30-01-2025,"Health, Wellness & Ayurvedic Products",MXP CHOCO CLASSIC BAR,5,80,80,0,1
30-01-2025,"Health, Wellness & Ayurvedic Products",RB Max Protein Fruit &amp;Nut 50g,5,75,75,0,1
30-01-2025,"Grains, Flours & Dals",Multigrain 1 kg,4,100,85,15,1
30-01-2025,"Dry Fruits, Nuts & Seeds",SD Mango cubes 100gm,2,45,45,0,1
30-01-2025,Snacks & Ready-to-Eat,RAJGIRA PEANUT CHIKKI 450GM,14,125,125,0,1
30-01-2025,Snacks & Ready-to-Eat,VD Pappu Chekkalu 190gm,14,60,60,0,1
30-01-2025,Spices & Seasonings,NUVVULU 250GM,15,100,85,15,1
30-01-2025,"Dry Fruits, Nuts & Seeds",PUMPKIN SEEDS 250GM,2,200,160,40,1
30-01-2025,Oils & Ghee,Sesame oil 1 L,9,590,560,30,1
30-01-2025,Household & Cleaning,VIM 300GM,6,30,30,0,1
30-01-2025,Sweeteners,YB Palm Jaggery 250GM,16,200,200,0,1
30-01-2025,Pooja & Spiritual Items,GD WOODS 150GM,12,110,110,0,1
30-01-2025,"Grains, Flours & Dals",RICE FLOUR 1KG,4,70,55,15,1
30-01-2025,"Grains, Flours & Dals",Black gram 500 gms,4,75,70,5,1
30-01-2025,Oils & Ghee,Sesame oil 1 L,9,590,560,30,1
30-01-2025,"Grains, Flours & Dals",Em jowar idly R 500G,4,75,75,0,1
30-01-2025,"Grains, Flours & Dals",EM Ragi idli R 500G,4,75,75,0,1
30-01-2025,"Grains, Flours & Dals",HS Jowar upma rava 500 gms,4,65,65,0,1
30-01-2025,"Grains, Flours & Dals",HS Ragi upma rava 500 gms,4,70,70,0,1
30-01-2025,Spices & Seasonings,SV Pepper Rasam 100GM,15,85,85,0,1
30-01-2025,Snacks & Ready-to-Eat,SD Moringa with plam jaggery 250gm,14,135,135,0,1
30-01-2025,"Grains, Flours & Dals",SB Javva Wheat Ravva 500GM,4,95,95,0,1
30-01-2025,"Grains, Flours & Dals",HS Multimillet upma r 500g,4,65,65,0,1
30-01-2025,Snacks & Ready-to-Eat,SD JOWAR WITH PALM JAGGERY 250GM,14,135,135,0,1
30-01-2025,"Grains, Flours & Dals",EM Foxtail idli r 500 g,4,109,109,0,1
30-01-2025,"Grains, Flours & Dals",SA YELLOW JOWAR RAVA 500GM,4,95,95,0,1
30-01-2025,"Grains, Flours & Dals",BAJRA IDLY RAVA 400GM,4,65,65,0,1
30-01-2025,"Dry Fruits, Nuts & Seeds",PUMPKIN SEEDS 250GM,2,200,160,40,1
30-01-2025,"Dry Fruits, Nuts & Seeds",WATERMELON SEEDS 250GRM,2,320,280,40,1
30-01-2025,"Grains, Flours & Dals",AISHWARYA SP 1KG,4,800,700,100,10
30-01-2025,Spices & Seasonings,SAJEERA,15,60,40,20,1
30-01-2025,Oils & Ghee,Sesame oil 500ml,9,295,280,15,1
30-01-2025,Oils & Ghee,Groundnut oil 500ml,9,360,330,30,2
30-01-2025,Oils & Ghee,Groundnut oil 1 L,9,360,330,30,1
30-01-2025,Spices & Seasonings,SAJEERA,15,60,40,20,1
30-01-2025,Oils & Ghee,Sesame oil 500ml,9,295,280,15,1
30-01-2025,Personal Care & Cosmetics,DWI ALOEVERA 100GM,10,180,180,0,2
30-01-2025,Spices & Seasonings,PURO Healthy Salt Crystal 1KG,15,135,135,0,1
30-01-2025,Spices & Seasonings,PURO Healthy Salt 1KG,15,110,110,0,1
30-01-2025,"Grains, Flours & Dals",Yellow jowar.F 500 gms,4,55,50,5,1
30-01-2025,"Grains, Flours & Dals",Multigrain 1 kg,4,100,85,15,1
30-01-2025,Oils & Ghee,Coconut oil 1 L,9,440,400,40,1
30-01-2025,"Grains, Flours & Dals",ROXY POORI ATTA 1KG,4,150,150,0,2
30-01-2025,Snacks & Ready-to-Eat,RINGS 200GM,14,60,60,0,2
30-01-2025,General Household & Kitchenware,TEA CUP 1P,3,45,45,0,1
30-01-2025,"Grains, Flours & Dals",THICK POHA 500GM,4,40,35,5,1
30-01-2025,"Grains, Flours & Dals",RAGULU 1 KG,4,35,30,5,0.5
30-01-2025,Snacks & Ready-to-Eat,ID IDLY DOSA BATTER,14,90,90,0,1
30-01-2025,Oils & Ghee,Groundnut oil 1 L,9,360,330,30,1
30-01-2025,Spices & Seasonings,Telaga Pindi 500GM,15,80,70,10,1
30-01-2025,"Health, Wellness & Ayurvedic Products",NEELI LEAF CHOORNAM,5,110,110,0,1
30-01-2025,Oils & Ghee,Safflower oil 1 L,9,440,400,40,1
30-01-2025,Personal Care & Cosmetics,MD Henna Choornam 100GM,10,80,80,0,1
30-01-2025,"Grains, Flours & Dals",Arikalu (kodo),4,70,65,5,1
30-01-2025,"Grains, Flours & Dals",JOWAR YELLOW 1 K,4,50,45,5,0.5
30-01-2025,"Dry Fruits, Nuts & Seeds",PULMAKHANA 100 GM,2,180,170,10,1
30-01-2025,"Grains, Flours & Dals",KORRALU (FOXTAIL M) 500GM,4,65,55,10,1
30-01-2025,Spices & Seasonings,NUVVULU 250GM,15,100,85,15,1
30-01-2025,"Grains, Flours & Dals",RAGULU 1 KG,4,35,30,5,0.5
30-01-2025,"Grains, Flours & Dals",SAMALU (Little millet) 500 gms,4,85,65,20,1
30-01-2025,Spices & Seasonings,Chilli powder 500 gms,15,290,210,80,1
30-01-2025,Spices & Seasonings,Menthulu 250 gms,15,50,45,5,1
30-01-2025,"Grains, Flours & Dals",SPLIT BLACK GRAM 500 GM,4,90,85,5,1
30-01-2025,Household & Cleaning,EXO DISHWASH POWER OF CYCLOZAN,6,15,15,0,1
30-01-2025,Sweeteners,SUGAR 1KG,16,60,50,10,1
30-01-2025,Beverages,3ROSES,1,90,90,0,1
30-01-2025,"Grains, Flours & Dals",Chana Flour 500 gms,4,70,65,5,1
30-01-2025,"Grains, Flours & Dals",KORRALU (FOXTAIL M) 1KG,4,150,110,40,1
30-01-2025,Pooja & Spiritual Items,SWASTIK PURE CAMPHOR 7GM,12,20,20,0,1
30-01-2025,"Grains, Flours & Dals",WHEAT 1 KG,4,120,100,20,2
30-01-2025,Snacks & Ready-to-Eat,VD PANIPURI 100GM,14,30,30,0,1
30-01-2025,Snacks & Ready-to-Eat,urban murmura,14,60,55,5,1
30-01-2025,"Grains, Flours & Dals",THICK POHA 500GM,4,40,35,5,1
30-01-2025,Snacks & Ready-to-Eat,Corn Chips 250GM,14,40,35,5,1
30-01-2025,Snacks & Ready-to-Eat,urban murmura,14,60,55,5,1
30-01-2025,Oils & Ghee,Groundnut oil 1 L,9,360,330,30,1
30-01-2025,"Dry Fruits, Nuts & Seeds",Groundnuts 1 kg,2,190,170,20,1
30-01-2025,Spices & Seasonings,Turmeric powder 250 gms,15,100,75,25,1
30-01-2025,"Dry Fruits, Nuts & Seeds",BLACK KISMIS 250GM,2,175,140,35,1
30-01-2025,Oils & Ghee,Groundnut oil 1 L,9,360,330,30,1
30-01-2025,"Dry Fruits, Nuts & Seeds",PUMPKIN SEEDS 250GM,2,200,160,40,1
30-01-2025,Oils & Ghee,Groundnut oil 1 L,9,360,330,30,1
30-01-2025,Oils & Ghee,Sesame oil 1 L,9,590,560,30,1
30-01-2025,Oils & Ghee,Safflower oil 1 L,9,440,400,40,1
30-01-2025,Sweeteners,YB Palm Jaggery 250GM,16,200,200,0,1
30-01-2025,"Grains, Flours & Dals",Wheat Flour 2 kgs,4,140,120,20,1
30-01-2025,"Grains, Flours & Dals",Multigrain 1 kg,4,100,85,15,1
30-01-2025,"Grains, Flours & Dals",RICE FLOUR 1KG,4,70,55,15,1
30-01-2025,"Dry Fruits, Nuts & Seeds",ALMONDS 250GM,2,280,260,20,1
30-01-2025,"Grains, Flours & Dals",Yellow jowar .F1 kg,4,110,100,10,1
30-01-2025,"Grains, Flours & Dals",Chana Flour 500 gms,4,70,65,5,1
30-01-2025,Snacks & Ready-to-Eat,VD DAHI MIRCHI(SALTED) 100GM,14,45,45,0,1
30-01-2025,Snacks & Ready-to-Eat,VD Pappu Chekkalu 190gm,14,60,60,0,1
30-01-2025,"Grains, Flours & Dals",Yellow jowar .F1 kg,4,110,100,10,1
30-01-2025,Snacks & Ready-to-Eat,Corn Chips 250GM,14,40,35,5,1
30-01-2025,"Grains, Flours & Dals",Multigrain 1 kg,4,100,85,15,1
30-01-2025,Snacks & Ready-to-Eat,VD MURUKU 175GM,14,60,60,0,1
30-01-2025,"Grains, Flours & Dals",HS Jowar upma rava 500 gms,4,65,65,0,1
30-01-2025,"Grains, Flours & Dals",RICE FLOUR 1KG,4,70,55,15,1
30-01-2025,"Dry Fruits, Nuts & Seeds",ALMONDS 250GM,2,280,260,20,1
30-01-2025,Snacks & Ready-to-Eat,BATANA NGT 70GMS,14,40,40,0,2
30-01-2025,"Grains, Flours & Dals",PRO ORG KABULI CHANNA 500GM,4,196,196,0,1
30-01-2025,Pooja & Spiritual Items,BALAJI GArden dhop sticks,12,105,105,0,1
30-01-2025,Pooja & Spiritual Items,BALAJI GUGGAL DHOOP 10STK,12,70,70,0,1
30-01-2025,"Grains, Flours & Dals",KORRALU (FOXTAIL M) 500GM,4,65,55,10,1
30-01-2025,Snacks & Ready-to-Eat,SD RAGI GAVVALU,14,95,95,0,1
30-01-2025,Snacks & Ready-to-Eat,PN ORGANIC PUFFED RICE 200GM,14,55,55,0,1
30-01-2025,Pickles & Cooking Pastes,SD TOMATO PICKLE,11,110,110,0,1
30-01-2025,Pooja & Spiritual Items,BALAJI SANDAL DHOOP STICKS 10STK,12,125,125,0,1
30-01-2025,Pickles & Cooking Pastes,SD MESTA PICKLE,11,110,110,0,1
30-01-2025,Pooja & Spiritual Items,BALAJI SAFFRON DHOOP STICKS 10STK,12,105,105,0,1
30-01-2025,"Grains, Flours & Dals",MAAGAANI LOW GI SP L 1KG,4,1200,"1,050.00",150,10
30-01-2025,"Grains, Flours & Dals",Green gram 1 kg,4,150,130,20,1
30-01-2025,"Health, Wellness & Ayurvedic Products",RB Max Protein Choco chips 55gm,5,50,50,0,1
30-01-2025,"Grains, Flours & Dals",PESARA PAPPU 500GMS,4,85,75,10,1
30-01-2025,"Grains, Flours & Dals",turdal 500 gms,4,110,100,10,1
30-01-2025,"Dry Fruits, Nuts & Seeds",FLAX SEEDS 250GM,2,60,50,10,1
30-01-2025,"Grains, Flours & Dals",COW B RICE BAG 1,4,1600,"1,600.00",0,1
30-01-2025,Spices & Seasonings,Menthulu 250 gms,15,50,45,5,1
30-01-2025,Spices & Seasonings,Jeera 100GM,15,50,45,5,1
30-01-2025,Spices & Seasonings,KALONJI SEEDS,15,90,80,10,1
30-01-2025,"Grains, Flours & Dals",SRILATHA RICE RAVVA 500GM,4,70,70,0,2
30-01-2025,Spices & Seasonings,Elaichi 25GM,15,145,120,25,1
30-01-2025,Snacks & Ready-to-Eat,DOSA BATTER 1KG,14,120,120,0,2
30-01-2025,"Grains, Flours & Dals",CHANA DAL 500GM,4,70,60,10,1
30-01-2025,"Grains, Flours & Dals",Idly Rava L 1KG,4,60,50,10,1
30-01-2025,"Dry Fruits, Nuts & Seeds",KAJU HALF 250GM,2,310,290,20,1
30-01-2025,"Grains, Flours & Dals",CHANA DAL 500GM,4,70,60,10,1
30-01-2025,"Grains, Flours & Dals",Urad dall 1 Kg,4,370,340,30,2
30-01-2025,Spices & Seasonings,Coriander seeds 200 gms,15,48,40,8,1
30-01-2025,"Grains, Flours & Dals",turdal 1kg,4,440,390,50,2
30-01-2025,"Grains, Flours & Dals",SL Idly Rava 1KG,4,65,55,10,1
30-01-2025,"Dry Fruits, Nuts & Seeds",ALMONDS 250GM,2,280,260,20,1
30-01-2025,"Grains, Flours & Dals",Wheat Rava M 500GM,4,33,30,3,1
30-01-2025,"Grains, Flours & Dals",Bombay Rava 500GM,4,35,30,5,1
30-01-2025,Spices & Seasonings,Elaichi 25GM,15,145,120,25,1
30-01-2025,"Dry Fruits, Nuts & Seeds",Putnalu 250GM,2,45,38,7,1
30-01-2025,"Grains, Flours & Dals",BOMBAY RAVA,4,70,55,15,1
30-01-2025,Spices & Seasonings,Avalu small 250 gms,15,60,40,20,1
30-01-2025,"Grains, Flours & Dals",Red Bobarlu 500 gms,4,95,85,10,1
30-01-2025,"Grains, Flours & Dals",Multigrain 1 kg,4,200,170,30,2
30-01-2025,"Grains, Flours & Dals",Wheat Flour 1 kg,4,280,240,40,4
30-01-2025,Oils & Ghee,Safflower oil 1 L,9,440,400,40,1
30-01-2025,"Grains, Flours & Dals",VL Sabdana 500GM,4,77,77,0,1
30-01-2025,Oils & Ghee,Sesame oil 1 L,9,590,560,30,1
30-01-2025,"Grains, Flours & Dals",SABDANA 500GM,4,90,70,20,1
30-01-2025,Oils & Ghee,BUFFALLO GHEE 500ML,9,410,370,40,1
30-01-2025,Pooja & Spiritual Items,SWASTIK CAMPHORE,12,90,90,0,1
30-01-2025,Pooja & Spiritual Items,SWASTIK CAMPHOR 15GM,12,40,40,0,1
30-01-2025,"Grains, Flours & Dals",SL Suji Rava 500GM,4,32,32,0,1
30-01-2025,"Grains, Flours & Dals",SRILALITHA MAIDA FLOUR 500G,4,32,32,0,1
30-01-2025,Oils & Ghee,Groundnut oil 1 L,9,720,660,60,2
30-01-2025,"Grains, Flours & Dals",SB Javva Wheat Ravva 500GM,4,95,95,0,1
30-01-2025,Oils & Ghee,Safflower oil 1 L,9,440,400,40,1
30-01-2025,Spices & Seasonings,Avalu small 250 gms,15,60,40,20,1
30-01-2025,Oils & Ghee,Sesame oil 1 L,9,1180,"1,120.00",60,2
30-01-2025,Spices & Seasonings,JEERA 250 gms,15,125,105,20,1
30-01-2025,Spices & Seasonings,ROYAL SAFFRON 400GRMS,15,65,65,0,1
30-01-2025,Spices & Seasonings,ROYAL SAFFRON,15,125,125,0,1
30-01-2025,"Grains, Flours & Dals",Wheat Rava S 500GM,4,33,30,3,1
30-01-2025,"Grains, Flours & Dals",DISANO ROLED OATS,4,197,197,0,1
30-01-2025,"Grains, Flours & Dals",SB Javva Wheat Ravva 500GM,4,95,95,0,1
30-01-2025,Spices & Seasonings,PURO Healthy Salt 1KG,15,110,110,0,1
30-01-2025,Spices & Seasonings,ROYAL SAFFRON,15,125,125,0,1
30-01-2025,Spices & Seasonings,ROYAL SAFFRON 400GRMS,15,65,65,0,1
30-01-2025,"Grains, Flours & Dals",MELMEKER 250GMS,4,60,45,15,1
30-01-2025,Pooja & Spiritual Items,GD KUMKUM 50GM,12,30,30,0,1
30-01-2025,"Dry Fruits, Nuts & Seeds",PUTNALU 500GMS,2,90,76,14,1
30-01-2025,Spices & Seasonings,ROYAL SAFFRON,15,125,125,0,1
30-01-2025,Spices & Seasonings,RED COPRA 500GM,15,170,148,22,1
30-01-2025,Spices & Seasonings,GD Turmeric 50GM,15,25,25,0,1
30-01-2025,"Dry Fruits, Nuts & Seeds",Putnalu 250GM,2,45,38,7,1
30-01-2025,Snacks & Ready-to-Eat,SD Pumpkin Seeds With Dates 175gm,14,170,170,0,1
30-01-2025,"Grains, Flours & Dals",VGR rice 1 kg,4,1050,975,75,15
30-01-2025,"Grains, Flours & Dals",SINGLE POLISH 1KG,4,325,325,0,5
30-01-2025,Oils & Ghee,Freedom Rice Bran Oil 1L,9,194,180,14,1
30-01-2025,Snacks & Ready-to-Eat,SD Thati thandra 200gm,14,150,150,0,1
30-01-2025,Oils & Ghee,Groundnut oil 1 L,9,360,330,30,1
30-01-2025,Snacks & Ready-to-Eat,PALLI LADDU 200GMS,14,90,70,20,1
30-01-2025,Oils & Ghee,Sesame oil 1 L,9,590,560,30,1
30-01-2025,Oils & Ghee,Groundnut oil 1 L,9,1080,990,90,3
30-01-2025,"Grains, Flours & Dals",split black gram 1 kg,4,180,170,10,1
30-01-2025,"Grains, Flours & Dals",Brown RICE 1KG,4,70,65,5,1
30-01-2025,"Grains, Flours & Dals",Quinova 1 kg,4,220,195,25,1
30-01-2025,"Grains, Flours & Dals",Wheat Flour 1 kg,4,70,60,10,1
30-01-2025,"Grains, Flours & Dals",SAMALU (Little millet) 1 kg,4,170,130,40,1
30-01-2025,"Grains, Flours & Dals",Wheat Rava M 500GM,4,33,30,3,1
30-01-2025,"Grains, Flours & Dals",RICE FLOUR 500 GM,4,105,84,21,3
30-01-2025,"Grains, Flours & Dals",RICE FLOUR 1KG,4,70,55,15,1
30-01-2025,Snacks & Ready-to-Eat,VD Minapa papad 200gm,14,60,60,0,1
30-01-2025,Snacks & Ready-to-Eat,WHOLE WHEAT BREAD,14,55,55,0,1
30-01-2025,Snacks & Ready-to-Eat,Corn Chips 250GM,14,80,70,10,2
30-01-2025,"Grains, Flours & Dals",Wheat Flour 1 kg,4,70,60,10,1
30-01-2025,"Grains, Flours & Dals",Wheat Flour 2 kgs,4,140,120,20,1
30-01-2025,"Grains, Flours & Dals",White jowar.F 1 kg,4,300,240,60,3
30-01-2025,Spices & Seasonings,Telaga Pindi 250 GM,15,40,35,5,1
30-01-2025,Oils & Ghee,Sesame oil 1 L,9,590,560,30,1
30-01-2025,"Grains, Flours & Dals",Wheat Flour 1 kg,4,70,60,10,1
30-01-2025,"Grains, Flours & Dals",Green gram 500 gms,4,75,70,5,1
30-01-2025,Spices & Seasonings,ROYAL SAFFRON,15,125,125,0,1
30-01-2025,"Grains, Flours & Dals",COW B rice 1 kg,4,72,69,3,1
30-01-2025,"Grains, Flours & Dals",CHANA DAL 1KG,4,35,30,5,0.25
30-01-2025,"Grains, Flours & Dals",SINGLE POLISH 1KG,4,65,65,0,1
30-01-2025,Snacks & Ready-to-Eat,PN ORGANIC PUFFED RICE 200GM,14,55,55,0,1
30-01-2025,"Dry Fruits, Nuts & Seeds",Groundnuts 500 gms,2,95,85,10,1
30-01-2025,Spices & Seasonings,Coriander seeds 200 gms,15,48,40,8,1
30-01-2025,Spices & Seasonings,Chilli powder 500 gms,15,290,210,80,1
30-01-2025,"Grains, Flours & Dals",Wheat Flour 1 kg,4,70,60,10,1
30-01-2025,"Grains, Flours & Dals",UDALU (Barnyard millet) 500 gms,4,70,60,10,1
30-01-2025,"Grains, Flours & Dals",White Chana 250 GM,4,60,50,10,1
30-01-2025,"Grains, Flours & Dals",Green gram 500 gms,4,75,70,5,1
30-01-2025,"Grains, Flours & Dals",SAMALU (Little millet) 500 gms,4,85,65,20,1
30-01-2025,"Grains, Flours & Dals",RAGULU 1 KG,4,35,30,5,0.5
30-01-2025,"Grains, Flours & Dals",Quinova 500 gms,4,110,100,10,1
30-01-2025,"Grains, Flours & Dals",BAJRA 1 KG,4,30,25,5,0.5
30-01-2025,"Grains, Flours & Dals",split urad dall 500 gms,4,90,80,10,1
30-01-2025,"Grains, Flours & Dals",Arikalu (kodo),4,70,65,5,1
30-01-2025,Spices & Seasonings,Menthulu 250 gms,15,50,45,5,1
30-01-2025,"Grains, Flours & Dals",Black gram 500 gms,4,75,70,5,1
30-01-2025,Spices & Seasonings,SAJEERA,15,60,40,20,1
30-01-2025,"Dry Fruits, Nuts & Seeds",PUTNALU 500GMS,2,90,76,14,1
30-01-2025,"Dry Fruits, Nuts & Seeds",Groundnuts 500 gms,2,95,85,10,1
30-01-2025,"Grains, Flours & Dals",KORRALU (FOXTAIL M) 500GM,4,65,55,10,1
30-01-2025,"Health, Wellness & Ayurvedic Products",RB Max Protein Choco Berry bar 50g,5,75,75,0,1
30-01-2025,"Grains, Flours & Dals",turdal 500 gms,4,110,100,10,1
30-01-2025,Snacks & Ready-to-Eat,BB VERMICELLI 250GM,14,30,30,0,1
30-01-2025,Personal Care & Cosmetics,COLGATE ACTIVE SALT,10,20,20,0,1
30-01-2025,Spices & Seasonings,Lavangam 50GM,15,60,50,10,1
30-01-2025,"Grains, Flours & Dals",Wheat Flour 1 kg,4,140,120,20,2
30-01-2025,Milk & Dairy,HRITAGE TOTAL CURD 130GM,7,20,20,0,2
30-01-2025,"Grains, Flours & Dals",RED WHEAT 1 KG,4,130,120,10,1
30-01-2025,"Grains, Flours & Dals",SH RED POHA 500GM,4,75,75,0,1
30-01-2025,Snacks & Ready-to-Eat,SD Little Millet WITH PLAM JAGGERY,14,135,135,0,1
30-01-2025,"Grains, Flours & Dals",WHEAT 1 KG,4,60,50,10,1
30-01-2025,"Grains, Flours & Dals",turdal 1kg,4,440,390,50,2
30-01-2025,"Grains, Flours & Dals",SINGLE POLISH 1KG,4,260,260,0,4
30-01-2025,Spices & Seasonings,GREEN SOUNF,15,60,40,20,1
30-01-2025,"Grains, Flours & Dals",THICK POHA 500GM,4,40,35,5,1
30-01-2025,"Grains, Flours & Dals",VGR rice 1 kg,4,70,65,5,1
30-01-2025,"Grains, Flours & Dals",Urad dall 1 Kg,4,370,340,30,2
30-01-2025,"Dry Fruits, Nuts & Seeds",CASHEW 250GM,2,340,310,30,1
30-01-2025,"Grains, Flours & Dals",COW B rice 1 kg,4,216,207,9,3
30-01-2025,"Grains, Flours & Dals",SB Javva Wheat Ravva 500GM,4,95,95,0,1
30-01-2025,"Grains, Flours & Dals",Wheat Flour 1 kg,4,140,120,20,2
30-01-2025,Oils & Ghee,Coconut oil 500 ml,9,440,400,40,2
30-01-2025,Oils & Ghee,Groundnut oil 1 L,9,360,330,30,1
30-01-2025,Oils & Ghee,Groundnut oil 1 L,9,360,330,30,1
30-01-2025,"Grains, Flours & Dals",Chana Flour 500 gms,4,70,65,5,1
30-01-2025,Oils & Ghee,Sesame oil 500ml,9,295,280,15,1
30-01-2025,Oils & Ghee,Mustard oil 500 ml,9,220,195,25,1
30-01-2025,Personal Care & Cosmetics,GAYATHRI KUMKUDUKAYA,10,150,150,0,1
30-01-2025,"Grains, Flours & Dals",RICE FLOUR 1KG,4,140,110,30,2
30-01-2025,"Grains, Flours & Dals",BLACK GRAM 1KG,4,150,140,10,1
30-01-2025,"Grains, Flours & Dals",Yellow jowar .F1 kg,4,110,100,10,1
30-01-2025,"Grains, Flours & Dals",Wheat Flour 1 kg,4,70,60,10,1
30-01-2025,"Grains, Flours & Dals",RAGI FLOUR 1KG,4,80,70,10,1
30-01-2025,Pooja & Spiritual Items,VRP APOORVA JAVADHU POW,12,70,70,0,2
30-01-2025,Snacks & Ready-to-Eat,urban murmura,14,60,55,5,1
30-01-2025,Pooja & Spiritual Items,HAND MADE VOTHULU,12,100,100,0,2
30-01-2025,"Dry Fruits, Nuts & Seeds",Groundnuts 500 gms,2,95,85,10,1
30-01-2025,"Dry Fruits, Nuts & Seeds",BLACK KISMIS 250GM,2,175,140,35,1
30-01-2025,Snacks & Ready-to-Eat,GB SALT COOKIES,14,60,55,5,1
30-01-2025,"Dry Fruits, Nuts & Seeds",PUMPKIN SEEDS 250GM,2,200,160,40,1
30-01-2025,"Dry Fruits, Nuts & Seeds",WATERMELON SEEDS 250GRM,2,320,280,40,1
30-01-2025,Snacks & Ready-to-Eat,urban murmura,14,60,55,5,1
30-01-2025,"Grains, Flours & Dals",Wheat Flour 1 kg,4,70,60,10,1
30-01-2025,"Dry Fruits, Nuts & Seeds",ANJEER 250GM,2,400,360,40,1
30-01-2025,"Dry Fruits, Nuts & Seeds",PLAIN PISTA 250GM,2,660,550,110,1
30-01-2025,Snacks & Ready-to-Eat,NGT CHATPATTA CHANA 90GM,14,50,50,0,2
30-01-2025,"Grains, Flours & Dals",KORRALU (FOXTAIL M) 500GM,4,65,55,10,1
30-01-2025,Snacks & Ready-to-Eat,TILLI CHIKKI,14,125,125,0,1
30-01-2025,Snacks & Ready-to-Eat,SD Aswagandha with palm Jaggery250Gm,14,135,135,0,1
30-01-2025,Pooja & Spiritual Items,JVK SAMBRANI STICK 20PCS,12,40,40,0,1
30-01-2025,Personal Care & Cosmetics,UVIS ALOEVERA GEL,10,149,149,0,1
30-01-2025,Oils & Ghee,cow ghee 500 ml,9,430,390,40,1
30-01-2025,Beverages,BRU GREEN LABEL 200G,1,140,140,0,1
30-01-2025,"Grains, Flours & Dals",PESARA PAPPU 1 KG,4,170,145,25,1
30-01-2025,"Grains, Flours & Dals",SA WHITE JOWAR RAVA 500GM,4,69,69,0,1
30-01-2025,"Grains, Flours & Dals",SAMALU (Little millet) 500 gms,4,85,65,20,1
30-01-2025,Snacks & Ready-to-Eat,SD Moringa with plam jaggery 250gm,14,135,135,0,1
30-01-2025,Spices & Seasonings,Chilli powder 1 kg,15,580,420,160,1
30-01-2025,Snacks & Ready-to-Eat,SD Aswagandha with palm Jaggery250Gm,14,135,135,0,1
30-01-2025,"Grains, Flours & Dals",Chana Flour 500 gms,4,70,65,5,1
30-01-2025,"Grains, Flours & Dals",SPLIT BLACK GRAM 500 GM,4,90,85,5,1
30-01-2025,Snacks & Ready-to-Eat,SD FINGER Millet with palm Jaggery 250gm,14,135,135,0,1
30-01-2025,Snacks & Ready-to-Eat,urban murmura,14,60,55,5,1
30-01-2025,"Dry Fruits, Nuts & Seeds",Putnalu 250GM,2,45,38,7,1
30-01-2025,Household & Cleaning,LIZOL JAQSMINE 500ML,6,116,116,0,1
30-01-2025,Spices & Seasonings,Chilli powder 1 kg,15,580,420,160,1
30-01-2025,Spices & Seasonings,DURGA SALT CRYSTAL 1KG,15,25,25,0,1
30-01-2025,"Grains, Flours & Dals",Wheat Flour 1 kg,4,70,60,10,1
30-01-2025,"Grains, Flours & Dals",Multigrain 1 kg,4,100,85,15,1
30-01-2025,Spices & Seasonings,Chilli powder 1 kg,15,580,420,160,1
30-01-2025,Spices & Seasonings,Turmeric powder 250 gms,15,100,75,25,1
30-01-2025,"Grains, Flours & Dals",DESI CHANA,4,25,25,0,1
30-01-2025,Oils & Ghee,Groundnut oil 1 L,9,360,330,30,1
30-01-2025,Spices & Seasonings,PURO Healthy Salt 1KG,15,110,110,0,1
30-01-2025,Oils & Ghee,Groundnut oil 500ml,9,180,165,15,1
30-01-2025,Spices & Seasonings,DB CRYSTAL SALT 1KG,15,25,25,0,1
30-01-2025,Spices & Seasonings,Masala Karam 250 gms,15,130,120,10,1
30-01-2025,"Grains, Flours & Dals",Quinova 1 kg,4,220,195,25,1
30-01-2025,"Grains, Flours & Dals",Arikadu ( kodo),4,140,130,10,1
30-01-2025,Snacks & Ready-to-Eat,PALLI LADDU 200GMS,14,90,70,20,1
30-01-2025,"Dry Fruits, Nuts & Seeds",PUMPKIN SEEDS 250GM,2,200,160,40,1
30-01-2025,Snacks & Ready-to-Eat,VD SAGOPAPAD 150GM,14,55,55,0,1
30-01-2025,Sweeteners,GS Palm Jaggery Powder 400GM,16,180,180,0,1
29-01-2025,"Grains, Flours & Dals",SL Suji Rava 500GM,4,64,64,0,2
29-01-2025,"Grains, Flours & Dals",DESI CHANA,4,25,25,0,1
29-01-2025,Spices & Seasonings,DRY MIECHI 200GM,15,80,60,20,1
29-01-2025,"Dry Fruits, Nuts & Seeds",Groundnuts 1 kg,2,380,340,40,2
29-01-2025,Snacks & Ready-to-Eat,ELITE MILK RUSK 200GM,14,35,35,0,1
29-01-2025,Snacks & Ready-to-Eat,PALLI LADDU 200GMS,14,90,70,20,1
29-01-2025,"Grains, Flours & Dals",turdal 1kg,4,220,195,25,1
29-01-2025,"Grains, Flours & Dals",RAGI FLOUR 1KG,4,240,210,30,3
29-01-2025,Snacks & Ready-to-Eat,GANTASALA GINGER SNACKS 150GM,14,60,60,0,1
29-01-2025,Beverages,BRU GREEN LABEL 1.2G,1,288,288,0,144
29-01-2025,Spices & Seasonings,SATHVI KARAKAYA 25 GM,15,50,30,20,1
29-01-2025,"Grains, Flours & Dals",Yellow jowar .F1 kg,4,110,100,10,1
29-01-2025,Snacks & Ready-to-Eat,BD PEARL MILLET NOODLES 200G,14,70,70,0,1
29-01-2025,Snacks & Ready-to-Eat,SATHVI PALLI CHIKKI 200GM,14,100,80,20,1
29-01-2025,"Grains, Flours & Dals",RAGI FLOUR 500GRMS,4,40,35,5,1
29-01-2025,Snacks & Ready-to-Eat,VD CORNFLAKES MIXTURE 175GM,14,60,60,0,1
29-01-2025,Snacks & Ready-to-Eat,SALTED PHALLI,14,25,25,0,1
29-01-2025,Snacks & Ready-to-Eat,GB SALT COOKIES,14,60,55,5,1
29-01-2025,Spices & Seasonings,ROYAL SAFFRON 400GRMS,15,65,65,0,1
29-01-2025,"Grains, Flours & Dals",RED TURDAL 500GM,4,75,70,5,1
29-01-2025,"Grains, Flours & Dals",Black gram 500 gms,4,75,70,5,1
29-01-2025,"Grains, Flours & Dals",Green gram 500 gms,4,75,70,5,1
29-01-2025,Snacks & Ready-to-Eat,VD MYSOREPAK 6PIC,14,100,100,0,1
29-01-2025,"Grains, Flours & Dals",URAD DALL,4,95,85,10,1
29-01-2025,"Grains, Flours & Dals",ANDU KORRALU (Brown top .mlt) 500,4,130,110,20,1
29-01-2025,"Grains, Flours & Dals",Red Bobarlu 500 gms,4,95,85,10,1
29-01-2025,"Grains, Flours & Dals",turdal 1kg,4,220,195,25,1
29-01-2025,"Grains, Flours & Dals",Red uluvalu 250 gms,4,45,40,5,1
29-01-2025,Oils & Ghee,BUFFALLO GHEE 500ML,9,410,370,40,1
29-01-2025,Snacks & Ready-to-Eat,RINGS 200GM,14,30,30,0,1
29-01-2025,"Grains, Flours & Dals",SL Idly Rava 1KG,4,65,55,10,1
29-01-2025,"Grains, Flours & Dals",JOWAR UPMA RAVA,4,65,65,0,1
29-01-2025,Snacks & Ready-to-Eat,SD JOWAR WITH PALM JAGGERY 250GM,14,135,135,0,1
29-01-2025,Oils & Ghee,Coconut oil 500 ml,9,220,200,20,1
29-01-2025,Snacks & Ready-to-Eat,BB ROASTED VERMICELLY 850GM,14,117,117,0,1
29-01-2025,"Grains, Flours & Dals",Multigrain 1 kg,4,100,85,15,1
29-01-2025,"Grains, Flours & Dals",RAGI FLOUR 500GRMS,4,40,35,5,1
29-01-2025,Oils & Ghee,BUFFALLO GHEE 500ML,9,410,370,40,1
29-01-2025,Oils & Ghee,Sesame oil 500ml,9,295,280,15,1
29-01-2025,Snacks & Ready-to-Eat,BATANA NGT 70GMS,14,40,40,0,2
29-01-2025,"Grains, Flours & Dals",Multigrain 1 kg,4,200,170,30,2
29-01-2025,Snacks & Ready-to-Eat,SESAME LADDU 200GM,14,100,80,20,1
29-01-2025,"Health, Wellness & Ayurvedic Products",DWI OMU WATER 100ML,5,40,40,0,1
29-01-2025,"Dry Fruits, Nuts & Seeds",FLAX SEEDS 250GM,2,60,50,10,1
29-01-2025,Spices & Seasonings,TM MIRCH POWDER 200GM,15,163,163,0,1
29-01-2025,"Grains, Flours & Dals",Brown rice 5 kgs,4,350,325,25,1
29-01-2025,"Grains, Flours & Dals",RAGI FLOUR 1KG,4,80,70,10,1
29-01-2025,"Grains, Flours & Dals",Wheat Flour 1 kg,4,350,300,50,5
29-01-2025,"Dry Fruits, Nuts & Seeds",Groundnuts 500 gms,2,190,170,20,2
29-01-2025,Snacks & Ready-to-Eat,BD RED RICE NOODLES 200G,14,70,70,0,1
29-01-2025,General Household & Kitchenware,MATCH BOX,3,20,20,0,1
29-01-2025,Sweeteners,NATURAL HONEY 1KG,16,560,480,80,1
29-01-2025,Oils & Ghee,Sesame oil 500ml,9,295,280,15,1
29-01-2025,Snacks & Ready-to-Eat,SD JOWAR WITH PALM JAGGERY 250GM,14,270,270,0,2
29-01-2025,"Dry Fruits, Nuts & Seeds",Groundnuts 500 gms,2,95,85,10,1
29-01-2025,"Grains, Flours & Dals",AISHWARYA SP 1KG,4,160,140,20,2
29-01-2025,"Grains, Flours & Dals",Red Bobarlu 500 gms,4,95,85,10,1
29-01-2025,Snacks & Ready-to-Eat,SD FINGER Millet with palm Jaggery 250gm,14,135,135,0,1
29-01-2025,Sweeteners,ACHUBELLAM 500GM,16,150,120,30,3
29-01-2025,Sweeteners,NATURAL HONEY 1KG,16,560,480,80,1
29-01-2025,Snacks & Ready-to-Eat,VD RICE SAGO PAPAD 150GM,14,55,55,0,1
29-01-2025,Oils & Ghee,Groundnut oil 500ml,9,180,165,15,1
29-01-2025,Snacks & Ready-to-Eat,MARMURA LADDU,14,80,60,20,1
29-01-2025,Oils & Ghee,Sesame oil 500ml,9,295,280,15,1
29-01-2025,Oils & Ghee,Safflower oil 500 ml,9,220,200,20,1
29-01-2025,Snacks & Ready-to-Eat,Pani Poori Chips 250GM,14,50,40,10,1
29-01-2025,"Grains, Flours & Dals",Arikalu (kodo),4,70,65,5,1
29-01-2025,"Grains, Flours & Dals",KORRALU (FOXTAIL M) 500GM,4,65,55,10,1
29-01-2025,"Grains, Flours & Dals",BAJRA 1 KG,4,30,25,5,0.5
29-01-2025,"Dry Fruits, Nuts & Seeds",PUTNALU 500GMS,2,90,76,14,1
29-01-2025,"Grains, Flours & Dals",JOWAR WHITE 1 KG,4,40,35,5,0.5
29-01-2025,"Grains, Flours & Dals",Wheat Rava S 500GM,4,33,30,3,1
29-01-2025,"Grains, Flours & Dals",SINGLE POLISH 1KG,4,130,130,0,2
29-01-2025,"Grains, Flours & Dals",PESARA PAPPU 500GMS,4,85,75,10,1
29-01-2025,Spices & Seasonings,Tamarind 250GMS,15,80,65,15,1
29-01-2025,"Grains, Flours & Dals",UDALU (Barnyard millet) 500 gms,4,70,60,10,1
29-01-2025,Spices & Seasonings,Jeera 100GM,15,50,45,5,1
29-01-2025,"Grains, Flours & Dals",SAMALU (Little millet) 500 gms,4,85,65,20,1
29-01-2025,Milk & Dairy,HERITAGE TOTAL CURD 500GM,7,50,50,0,1
29-01-2025,"Grains, Flours & Dals",Idly Rava L 1KG,4,60,50,10,1
29-01-2025,"Grains, Flours & Dals",BASMATHI RICE 1KG,4,150,135,15,1
29-01-2025,"Dry Fruits, Nuts & Seeds",Groundnuts 500 gms,2,95,85,10,1
29-01-2025,"Grains, Flours & Dals",Red Chana 250GM,4,35,30,5,1
29-01-2025,Snacks & Ready-to-Eat,SD Atreyapuram DRY Fruit ghee,14,150,150,0,1
29-01-2025,Oils & Ghee,Groundnut oil 5 L,9,1800,"1,600.00",200,1
29-01-2025,"Dry Fruits, Nuts & Seeds",PUMPKIN SEEDS 250GM,2,200,160,40,1
29-01-2025,"Grains, Flours & Dals",VGR RICE 5 KGS,4,350,325,25,1
29-01-2025,Spices & Seasonings,NUVVULU 250GM,15,80,65,15,1
29-01-2025,Snacks & Ready-to-Eat,MB MULTIMILLET NOODLES 180GM,14,95,95,0,1
29-01-2025,"Health, Wellness & Ayurvedic Products",RB Max Protein Cheese&amp;,5,45,45,0,1
29-01-2025,"Health, Wellness & Ayurvedic Products",RB Max Protein Chinese Manchurian,5,45,45,0,1
29-01-2025,"Grains, Flours & Dals",Red Bobarlu 500 gms,4,95,85,10,1
29-01-2025,"Grains, Flours & Dals",White Chana 250 GM,4,60,50,10,1
29-01-2025,Oils & Ghee,Safflower oil 1 L,9,440,400,40,1
29-01-2025,Spices & Seasonings,SH CLOVES 30GM,15,95,95,0,1
29-01-2025,Snacks & Ready-to-Eat,RI Yogurt Berry Oats 35g,14,90,90,0,2
29-01-2025,"Grains, Flours & Dals",Wheat Flour 1 kg,4,140,120,20,2
29-01-2025,Snacks & Ready-to-Eat,MARMURA LADDU,14,80,60,20,1
29-01-2025,Spices & Seasonings,AVALU 100GM,15,25,20,5,1
29-01-2025,Spices & Seasonings,SATHVI ANASAPUVUU 25GM,15,90,65,25,1
29-01-2025,Snacks & Ready-to-Eat,RSC ORANGE 100GMS,14,20,20,0,1
29-01-2025,Snacks & Ready-to-Eat,PEANUT CHILLI,14,5,5,0,1
29-01-2025,Spices & Seasonings,SATHVI BIRYANI LEAF 25GM,15,30,20,10,1
29-01-2025,Snacks & Ready-to-Eat,urban murmura,14,120,110,10,2
29-01-2025,"Grains, Flours & Dals",Wheat Rava M 1KG,4,65,55,10,1
29-01-2025,"Grains, Flours & Dals",RAGI FLOUR 1KG,4,80,70,10,1
29-01-2025,Pooja & Spiritual Items,SOSR SWATHHI 365,12,60,60,0,2
29-01-2025,"Grains, Flours & Dals",Wheat Flour 1 kg,4,70,60,10,1
29-01-2025,"Grains, Flours & Dals",Red Wheat Flour 1 kg,4,140,130,10,1
29-01-2025,"Grains, Flours & Dals",AISHWARYA SP 25KG,4,1999,"1,690.00",309,1
29-01-2025,"Grains, Flours & Dals",BASMATHI RICE 1KG,4,150,135,15,1
29-01-2025,Spices & Seasonings,DRY MIECHI 200GM,15,80,60,20,1
29-01-2025,"Grains, Flours & Dals",Yellow jowar .F1 kg,4,110,100,10,1
29-01-2025,Spices & Seasonings,Biryani Leaf 25GM,15,20,20,0,1
29-01-2025,Oils & Ghee,Groundnut oil 1 L,9,720,660,60,2
29-01-2025,"Grains, Flours & Dals",Wheat Flour 1 kg,4,70,60,10,1
29-01-2025,Spices & Seasonings,ROYAL SAFFRON 400GRMS,15,65,65,0,1
29-01-2025,Oils & Ghee,Groundnut oil 1 L,9,360,330,30,1
29-01-2025,"Grains, Flours & Dals",JOWAR YELLOW 1 K,4,50,45,5,0.5
29-01-2025,"Grains, Flours & Dals",Black uluvalu 500 gms,4,90,90,0,1
29-01-2025,"Grains, Flours & Dals",FLOUR CHARGE,4,12,12,0,1
29-01-2025,"Health, Wellness & Ayurvedic Products",MORINGA LEAF POWDER M,5,80,75,5,1
29-01-2025,Snacks & Ready-to-Eat,MARMURA LADDU,14,80,60,20,1
29-01-2025,"Grains, Flours & Dals",RAGI FLOUR 1KG,4,80,70,10,1
29-01-2025,Sweeteners,NATURAL HONEY 1KG,16,560,480,80,1
29-01-2025,"Grains, Flours & Dals",KORRALU (FOXTAIL M) 1KG,4,150,110,40,1
29-01-2025,"Grains, Flours & Dals",Wheat Rava S 1KG,4,65,55,10,1
29-01-2025,"Grains, Flours & Dals",White Chana 250 GM,4,60,50,10,1
29-01-2025,"Dry Fruits, Nuts & Seeds",FLAX SEEDS 250GM,2,60,50,10,1
29-01-2025,Milk & Dairy,ID PANEER,7,135,135,0,1
29-01-2025,Oils & Ghee,Groundnut oil 1 L,9,360,330,30,1
29-01-2025,"Grains, Flours & Dals",Multigrain 1 kg,4,100,85,15,1
29-01-2025,Oils & Ghee,Mustard oil 500 ml,9,220,195,25,1
29-01-2025,Milk & Dairy,SANGAM CURD 450GM,7,38,38,0,1
29-01-2025,Oils & Ghee,Sesame oil 500ml,9,590,560,30,2
29-01-2025,Oils & Ghee,Castor oil 200 ml,9,100,80,20,1
29-01-2025,"Grains, Flours & Dals",Multigrain 1 kg,4,100,85,15,1
29-01-2025,Milk & Dairy,SANGAM TONED MILK 500ML,7,30,30,0,1
29-01-2025,"Grains, Flours & Dals",SINGLE POLISH 1KG,4,325,325,0,5
29-01-2025,"Dry Fruits, Nuts & Seeds",FLAX SEEDS 250GM,2,60,50,10,1
29-01-2025,"Grains, Flours & Dals",SAMALU (Little millet) 500 gms,4,85,65,20,1
29-01-2025,Spices & Seasonings,DRY MIECHI 200GM,15,80,60,20,1
29-01-2025,Spices & Seasonings,DURGA SALT CRYSTAL 1KG,15,25,25,0,1
29-01-2025,Oils & Ghee,Groundnut oil 1 L,9,360,330,30,1
29-01-2025,"Grains, Flours & Dals",VGR rice 1 kg,4,140,130,10,2
29-01-2025,"Grains, Flours & Dals",FLOUR CHARGE,4,55.2,55.2,0,4.6
29-01-2025,"Grains, Flours & Dals",RAGULU 1 KG,4,35,30,5,0.5
29-01-2025,Snacks & Ready-to-Eat,DISANO VERMICELLI 425 GM,14,50,50,0,1
29-01-2025,Snacks & Ready-to-Eat,BATANA NGT 70GMS,14,20,20,0,1
29-01-2025,"Dry Fruits, Nuts & Seeds",Groundnuts 1 kg,2,190,170,20,1
29-01-2025,"Grains, Flours & Dals",FLOUR CHARGE,4,24,24,0,2
29-01-2025,Snacks & Ready-to-Eat,VD DAHI MIRCHI(SALTED) 100GM,14,45,45,0,1
29-01-2025,"Grains, Flours & Dals",RAGI FLOUR 1KG,4,80,70,10,1
29-01-2025,"Grains, Flours & Dals",SL Idly Rava 1KG,4,65,55,10,1
29-01-2025,"Grains, Flours & Dals",Sathya Javva Wheat Rava 500GM,4,95,95,0,1
29-01-2025,Milk & Dairy,SANGAM FULL CREAM MILK 500ML,7,38,38,0,1
29-01-2025,"Grains, Flours & Dals",MAATEJA rice 1 kg,4,144,138,6,2
29-01-2025,Oils & Ghee,Black Sesame oil 1 L,9,440,380,60,1
29-01-2025,"Grains, Flours & Dals",JOWAR WHITE 1 KG,4,80,70,10,1
29-01-2025,Snacks & Ready-to-Eat,ANNAPURNA APPALAM,14,70,70,0,2
29-01-2025,"Grains, Flours & Dals",Chana Flour 1 kg,4,140,130,10,1
29-01-2025,"Grains, Flours & Dals",Multigrain 1 kg,4,100,85,15,1
29-01-2025,Sweeteners,MISHRI 250 GM,16,35,30,5,1
29-01-2025,Pooja & Spiritual Items,OM SAINATH ISOBORNEOL 10GM,12,60,60,0,1
29-01-2025,Sweeteners,YB FOREST HONEY 250GM,16,180,180,0,1
29-01-2025,Oils & Ghee,GANTASALA A2 COW GHEE 250ML,9,299,299,0,1
29-01-2025,Oils & Ghee,Safflower oil 1 L,9,440,400,40,1
29-01-2025,Oils & Ghee,Groundnut oil 1 L,9,360,330,30,1
29-01-2025,"Grains, Flours & Dals",Em Multimillet idli r 500g,4,129,129,0,1
29-01-2025,Spices & Seasonings,NUVVULU 250GM,15,100,85,15,1
29-01-2025,Personal Care & Cosmetics,COCONUT BATH SCRUBBER,10,40,40,0,1
29-01-2025,Snacks & Ready-to-Eat,BATANA NGT 70GMS,14,20,20,0,1
29-01-2025,"Grains, Flours & Dals",SINGLE POLISH 1KG,4,325,325,0,5
29-01-2025,Beverages,MUA COFFEE EXT STRONG 250GM,1,140,140,0,1
29-01-2025,Household & Cleaning,COMFORT EAU DE PARFUM 210ML,6,58,58,0,1
29-01-2025,"Grains, Flours & Dals",HS Multimillet upma r 500g,4,65,65,0,1
29-01-2025,Spices & Seasonings,RED COPRA 500GM,15,170,148,22,1
29-01-2025,Snacks & Ready-to-Eat,urban murmura,14,120,110,10,2
29-01-2025,"Grains, Flours & Dals",Wheat Rava M 500GM,4,66,60,6,2
29-01-2025,"Grains, Flours & Dals",split green gram 1 kg,4,150,140,10,1
29-01-2025,Oils & Ghee,Coconut oil 1 L,9,440,400,40,1
29-01-2025,"Grains, Flours & Dals",Wheat Flour 1 kg,4,140,120,20,2
29-01-2025,Household & Cleaning,LIZOL JAQSMINE 500ML,6,116,116,0,1
29-01-2025,"Grains, Flours & Dals",THICK POHA 500GM,4,80,70,10,2
29-01-2025,Personal Care & Cosmetics,MESWAK 100GM,10,70,70,0,1
29-01-2025,"Grains, Flours & Dals",Red Bobarlu 1 kg,4,190,170,20,1
29-01-2025,"Dry Fruits, Nuts & Seeds",Groundnuts 1 kg,2,380,340,40,2
29-01-2025,"Dry Fruits, Nuts & Seeds",PUTNALU 500GMS,2,90,76,14,1
29-01-2025,"Grains, Flours & Dals",split black gram 1 kg,4,360,340,20,2
29-01-2025,"Grains, Flours & Dals",CHANA DAL 500GM,4,70,60,10,1
29-01-2025,Spices & Seasonings,DURGA SALT CRYSTAL 1KG,15,25,25,0,1
29-01-2025,Personal Care & Cosmetics,DETTOL ORIGINAL,10,99,99,0,1
29-01-2025,"Grains, Flours & Dals",PESARA PAPPU 1 KG,4,170,145,25,1
29-01-2025,"Grains, Flours & Dals",Idly Rava L 1KG,4,60,50,10,1
29-01-2025,"Grains, Flours & Dals",AISHWARYA SP 1KG,4,400,350,50,5
29-01-2025,"Grains, Flours & Dals",White jowar.F 1 kg,4,200,160,40,2
29-01-2025,Spices & Seasonings,DRY MIECHI 200GM,15,80,60,20,1
29-01-2025,Snacks & Ready-to-Eat,SD JOWAR WITH PALM JAGGERY 250GM,14,135,135,0,1
29-01-2025,"Grains, Flours & Dals",HS JOWAR FLAKES 250GM 1+1,4,119,119,0,1
29-01-2025,"Grains, Flours & Dals",ROXY POORI ATTA 1KG,4,75,75,0,1
29-01-2025,"Grains, Flours & Dals",SB Javva Wheat Ravva 500GM,4,190,190,0,2
29-01-2025,"Grains, Flours & Dals",PRO ORG RED POHA 500GM,4,89,89,0,1
29-01-2025,Spices & Seasonings,ER GARAM MASALA,15,52,52,0,1
29-01-2025,Oils & Ghee,Sesame oil 1 L,9,2360,"2,240.00",120,4
29-01-2025,Spices & Seasonings,NUVVULU 250GM,15,80,65,15,1
29-01-2025,"Grains, Flours & Dals",DH URAD GOTA 1KG,4,430,380,50,2
29-01-2025,Spices & Seasonings,Jeera 100GM,15,50,45,5,1
29-01-2025,Sweeteners,YB JAGGERY POWDER 500GMS,16,75,75,0,1
29-01-2025,"Grains, Flours & Dals",SRILALITHA MAIDA FLOUR 500G,4,32,32,0,1
29-01-2025,"Grains, Flours & Dals",CHANA DAL 500GM,4,70,60,10,1
29-01-2025,Sweeteners,SUGAR 1KG,16,120,100,20,2
29-01-2025,"Grains, Flours & Dals",SPLIT BLACK GRAM 500 GM,4,90,85,5,1
29-01-2025,Oils & Ghee,Sesame oil 500ml,9,295,280,15,1
29-01-2025,"Grains, Flours & Dals",FLOUR CHARGE,4,13.2,13.2,0,1.1
29-01-2025,Spices & Seasonings,Menthulu 250 gms,15,50,45,5,1
29-01-2025,Spices & Seasonings,DRY MIECHI 200GM,15,80,60,20,1
29-01-2025,"Grains, Flours & Dals",SL Suji Rava 500GM,4,32,32,0,1
29-01-2025,Beverages,BRU GREEN LABEL 200G,1,280,280,0,2
29-01-2025,Personal Care & Cosmetics,MYSORE SANDAL,10,164,164,0,2
29-01-2025,"Grains, Flours & Dals",turdal 1kg,4,220,195,25,1
29-01-2025,"Grains, Flours & Dals",turdal 500 gms,4,110,100,10,1
29-01-2025,Oils & Ghee,Groundnut oil 1 L,9,1080,990,90,3
29-01-2025,"Grains, Flours & Dals",RICE FLOUR 1KG,4,70,55,15,1
29-01-2025,"Grains, Flours & Dals",turdal 500 gms,4,110,100,10,1
29-01-2025,"Grains, Flours & Dals",URAD DALL,4,95,85,10,1
29-01-2025,"Grains, Flours & Dals",Idly Rava L 1KG,4,60,50,10,1
29-01-2025,"Dry Fruits, Nuts & Seeds",YELLOW KISHMISH 250GM,2,130,110,20,1
29-01-2025,Oils & Ghee,Sesame oil 500ml,9,295,280,15,1
29-01-2025,Spices & Seasonings,Black Till 250GM,15,90,75,15,1
29-01-2025,"Grains, Flours & Dals",CHANA DAL 500GM,4,70,60,10,1
29-01-2025,"Grains, Flours & Dals",KORRALU (FOXTAIL M) 500GM,4,65,55,10,1
29-01-2025,"Dry Fruits, Nuts & Seeds",Groundnuts 1 kg,2,190,170,20,1
29-01-2025,"Grains, Flours & Dals",Wheat Rava M 500GM,4,33,30,3,1
29-01-2025,"Dry Fruits, Nuts & Seeds",Putnalu 250GM,2,45,38,7,1
29-01-2025,"Grains, Flours & Dals",BOMBAY RAVA,4,70,55,15,1
29-01-2025,"Grains, Flours & Dals",SAMALU (Little millet) 500 gms,4,85,65,20,1
29-01-2025,"Grains, Flours & Dals",Green gram 500 gms,4,75,70,5,1
29-01-2025,"Grains, Flours & Dals",MIXED FLOUR,4,220,220,0,1
29-01-2025,"Dry Fruits, Nuts & Seeds",FLAX SEEDS 250GM,2,60,50,10,1
29-01-2025,Oils & Ghee,Groundnut oil 1 L,9,360,330,30,1
29-01-2025,Oils & Ghee,BUFFALLO GHEE 500ML,9,410,370,40,1
29-01-2025,Oils & Ghee,cow ghee 500 ml,9,430,390,40,1
29-01-2025,Oils & Ghee,Black Sesame oil 1 L,9,440,380,60,1
29-01-2025,Oils & Ghee,Groundnut oil 1 L,9,360,330,30,1
29-01-2025,Oils & Ghee,Sesame oil 500ml,9,295,280,15,1
29-01-2025,Oils & Ghee,Safflower oil 1 L,9,440,400,40,1
29-01-2025,Spices & Seasonings,LG 50GM,15,92,92,0,1
29-01-2025,Spices & Seasonings,AVALU 100GM,15,25,20,5,1
29-01-2025,Spices & Seasonings,Tamarind 500GM,15,160,130,30,1
29-01-2025,Spices & Seasonings,DURGA SALT CRYSTAL 1KG,15,50,50,0,2
29-01-2025,"Grains, Flours & Dals",split urad dall 500 gms,4,90,80,10,1
29-01-2025,"Dry Fruits, Nuts & Seeds",Groundnuts 1 kg,2,190,170,20,1
29-01-2025,Spices & Seasonings,SD IDLY KARAM,15,65,65,0,1
29-01-2025,"Grains, Flours & Dals",SL Idly Rava 1KG,4,65,55,10,1
29-01-2025,Oils & Ghee,Groundnut oil 500ml,9,180,165,15,1
29-01-2025,"Grains, Flours & Dals",Wheat Flour 500 gms,4,35,30,5,1
29-01-2025,Spices & Seasonings,PRO ORG MUSTARD SMALL -RAI 200G,15,84,84,0,1
29-01-2025,"Grains, Flours & Dals",EM Ragi idli R 500G,4,150,150,0,2
29-01-2025,Oils & Ghee,Coconut oil 1 L,9,440,400,40,1
29-01-2025,Oils & Ghee,Groundnut oil 5 L,9,1800,"1,600.00",200,1
29-01-2025,"Grains, Flours & Dals",HS Multimillet idly R 500 gms,4,130,130,0,2
29-01-2025,Snacks & Ready-to-Eat,MAAGAANI JOWAR M COOKIES 120GM,14,149,149,0,1
29-01-2025,Sweeteners,Natural Honey 500 gms,16,280,240,40,1
29-01-2025,Oils & Ghee,Groundnut oil 1 L,9,1080,990,90,3
29-01-2025,Oils & Ghee,Groundnut oil 1 L,9,360,330,30,1
29-01-2025,Snacks & Ready-to-Eat,TILLI CHIKKI,14,75,75,0,15
29-01-2025,Spices & Seasonings,Masala Karam 250 gms,15,130,120,10,1
29-01-2025,"Grains, Flours & Dals",EM kodo upma R 500g,4,129,129,0,1
29-01-2025,Snacks & Ready-to-Eat,PUMPKIN CHIKKI 200GM,14,140,120,20,1
29-01-2025,Sweeteners,NATURAL HONEY 250GM,16,150,130,20,1
29-01-2025,Snacks & Ready-to-Eat,VD VAMUPUSA 175GM,14,60,60,0,1
29-01-2025,"Grains, Flours & Dals",WHEAT 1 KG,4,300,250,50,5
29-01-2025,Personal Care & Cosmetics,SAIBOL SKIN,10,43,43,0,1
29-01-2025,Oils & Ghee,Groundnut oil 1 L,9,360,330,30,1
29-01-2025,"Health, Wellness & Ayurvedic Products",DWI EUCALYPTUS 30ML,5,130,130,0,1
29-01-2025,Oils & Ghee,Sesame oil 500ml,9,295,280,15,1
29-01-2025,Spices & Seasonings,SWEET SOUNF,15,20,20,0,1
29-01-2025,"Grains, Flours & Dals",BARLEY SEEDS 250GMS,4,40,35,5,1
29-01-2025,"Grains, Flours & Dals",COW B rice 5 kgs,4,360,345,15,1
29-01-2025,Sweeteners,Mishri 500GM,16,70,60,10,1
29-01-2025,"Grains, Flours & Dals",Chana Flour 500 gms,4,70,65,5,1
29-01-2025,"Grains, Flours & Dals",RAGI FLOUR 1KG,4,80,70,10,1
29-01-2025,"Grains, Flours & Dals",Wheat Flour 1 kg,4,70,60,10,1
29-01-2025,Milk & Dairy,BROWN EGGS 1P,7,154,132,22,11
29-01-2025,Snacks & Ready-to-Eat,PALLI LADDU 200GMS,14,90,70,20,1
29-01-2025,Snacks & Ready-to-Eat,SD Aswagandha with palm Jaggery250Gm,14,135,135,0,1
29-01-2025,Oils & Ghee,BUFFALLO GHEE 500ML,9,410,370,40,1
29-01-2025,Snacks & Ready-to-Eat,RSC ORANGE 100GMS,14,20,20,0,1
29-01-2025,"Grains, Flours & Dals",Red Wheat Flour 1 kg,4,140,130,10,1
29-01-2025,"Grains, Flours & Dals",KORRALU (FOXTAIL M) 1KG,4,150,110,40,1
29-01-2025,General Household & Kitchenware,DOSA TAWA 12,3,265,265,0,1
29-01-2025,"Grains, Flours & Dals",RICE FLOUR 500 GM,4,35,28,7,1
29-01-2025,Snacks & Ready-to-Eat,BATANA NGT 70GMS,14,20,20,0,1
29-01-2025,"Grains, Flours & Dals",DH URAD GOTA 1KG,4,215,190,25,1
29-01-2025,"Grains, Flours & Dals",FLOUR CHARGE,4,66,66,0,5.5
29-01-2025,"Dry Fruits, Nuts & Seeds",PULMAKHANA 100 GM,2,180,170,10,1
29-01-2025,Spices & Seasonings,DURGA SALT CRYSTAL 1KG,15,25,25,0,1
29-01-2025,Spices & Seasonings,DRY MIECHI 200GM,15,80,60,20,1
29-01-2025,"Dry Fruits, Nuts & Seeds",Groundnuts 500 gms,2,95,85,10,1
29-01-2025,Pooja & Spiritual Items,GD Aiswarya Deepam 700ML,12,195,195,0,1
29-01-2025,Spices & Seasonings,Tamarind 250GMS,15,80,65,15,1
29-01-2025,Beverages,RED LABEL 100GM,1,50,50,0,1
29-01-2025,Snacks & Ready-to-Eat,SATHVI REGIVADA 200GM,14,80,60,20,1
29-01-2025,Snacks & Ready-to-Eat,PUMPKIN CHIKKI 200GM,14,140,120,20,1
29-01-2025,"Grains, Flours & Dals",White jowar.F 1 kg,4,100,80,20,1
29-01-2025,Snacks & Ready-to-Eat,VD ARISELU 5 PIC,14,100,100,0,1
29-01-2025,"Dry Fruits, Nuts & Seeds",SD Mango cubes 200gm,2,90,90,0,1
29-01-2025,"Grains, Flours & Dals",ANDU KORRALU (Brown top .mlt) 500,4,130,110,20,1
29-01-2025,"Grains, Flours & Dals",SAMALU (Little millet) 500 gms,4,85,65,20,1
29-01-2025,"Grains, Flours & Dals",UDALU (Barnyard millet) 500 gms,4,70,60,10,1
29-01-2025,"Grains, Flours & Dals",KORRALU (FOXTAIL M) 500GM,4,65,55,10,1
29-01-2025,"Grains, Flours & Dals",Arikalu (kodo),4,70,65,5,1
29-01-2025,"Grains, Flours & Dals",SINGLE POLISH 1KG,4,130,130,0,2
29-01-2025,"Grains, Flours & Dals",Wheat Flour 1 kg,4,140,120,20,2
29-01-2025,Spices & Seasonings,Telaga Pindi 250 GM,15,40,35,5,1
29-01-2025,Sweeteners,GS Organic Jaggery Powder 600GM,16,99,99,0,1
29-01-2025,"Grains, Flours & Dals",RAGI FLOUR 500GRMS,4,40,35,5,1
29-01-2025,Spices & Seasonings,Masala Karam 250 gms,15,130,120,10,1
29-01-2025,Personal Care & Cosmetics,patanjali,10,42,42,0,1
29-01-2025,Spices & Seasonings,Turmeric powder 250 gms,15,100,75,25,1
29-01-2025,Oils & Ghee,Groundnut oil 1 L,9,360,330,30,1
29-01-2025,"Grains, Flours & Dals",turdal 1kg,4,220,195,25,1
29-01-2025,Sweeteners,GS Organic Jaggery Powder 600GM,16,198,198,0,2
29-01-2025,"Grains, Flours & Dals",Multigrain 1 kg,4,200,170,30,2
29-01-2025,"Grains, Flours & Dals",Wheat Flour 1 kg,4,140,120,20,2
29-01-2025,"Grains, Flours & Dals",RAGI FLOUR 500GRMS,4,80,70,10,2
29-01-2025,Sweeteners,SUGAR 1KG,16,60,50,10,1
29-01-2025,Snacks & Ready-to-Eat,ANNAPURNA APPALAM,14,35,35,0,1
29-01-2025,Oils & Ghee,BUFFALLO GHEE 500ML,9,410,370,40,1
29-01-2025,"Grains, Flours & Dals",Wheat Rava S 500GM,4,33,30,3,1
29-01-2025,Oils & Ghee,Groundnut oil 5 L,9,1800,"1,600.00",200,1
29-01-2025,"Grains, Flours & Dals",Wheat Flour 1 kg,4,70,60,10,1
29-01-2025,Snacks & Ready-to-Eat,SD Moringa with plam jaggery 250gm,14,135,135,0,1
29-01-2025,Oils & Ghee,cow ghee 500 ml,9,430,390,40,1
29-01-2025,Oils & Ghee,Flaxseed oil 500 ml,9,300,270,30,1
29-01-2025,"Health, Wellness & Ayurvedic Products",DWI LAVANGA TAILA 20ML,5,60,60,0,1
29-01-2025,"Grains, Flours & Dals",Green gram 1 kg,4,150,130,20,1
29-01-2025,Milk & Dairy,SANGAM TONED MILK 500ML,7,60,60,0,2
29-01-2025,Snacks & Ready-to-Eat,urban murmura,14,60,55,5,1
29-01-2025,"Grains, Flours & Dals",Chana Flour 500 gms,4,70,65,5,1
29-01-2025,"Grains, Flours & Dals",BAJRA 1 KG,4,120,100,20,2
29-01-2025,"Grains, Flours & Dals",White jowar.F 1 kg,4,100,80,20,1
29-01-2025,Spices & Seasonings,Turmeric powder 250 gms,15,200,150,50,2
28-01-2025,"Dry Fruits, Nuts & Seeds",Groundnuts 1 kg,2,190,170,20,1
28-01-2025,Spices & Seasonings,Turmeric powder 250 gms,15,100,75,25,1
28-01-2025,Oils & Ghee,Safflower oil 1 L,9,440,400,40,1
28-01-2025,"Grains, Flours & Dals",SRILATHA RICE RAVVA 500GM,4,35,35,0,1
28-01-2025,Personal Care & Cosmetics,UVIS MULTANI MITTI 200GM,10,90,90,0,1
28-01-2025,"Grains, Flours & Dals",Sathya Javva Wheat Rava 500GM,4,95,95,0,1
28-01-2025,Spices & Seasonings,Chilli powder 1 kg,15,580,420,160,1
28-01-2025,"Grains, Flours & Dals",Wheat Flour 1 kg,4,70,60,10,1
28-01-2025,Personal Care & Cosmetics,SVE TURMERIC SOAP 100GM,10,90,90,0,1
28-01-2025,Personal Care & Cosmetics,DWI ROSE WATER 120ML,10,90,90,0,1
28-01-2025,Milk & Dairy,HERITAGE TOTAL CURD 500GM,7,50,50,0,1
28-01-2025,"Grains, Flours & Dals",SL Idly Rava 1KG,4,65,55,10,1
28-01-2025,"Grains, Flours & Dals",MAAGAANI LOW GI SP L 1KG,4,120,105,15,1
28-01-2025,Milk & Dairy,BROWN EGGS 1P,7,84,72,12,6
28-01-2025,"Grains, Flours & Dals",Sathya Javva Wheat Rava 500GM,4,95,95,0,1
28-01-2025,Spices & Seasonings,Turmeric powder 250 gms,15,400,300,100,4
28-01-2025,Snacks & Ready-to-Eat,SATHVI PALLI CHIKKI 200GM,14,100,80,20,1
28-01-2025,Snacks & Ready-to-Eat,VD JAGGERY GHEE 12PIC,14,180,180,0,1
28-01-2025,"Dry Fruits, Nuts & Seeds",SUNFLOWER SEEDS 250GRM,2,150,130,20,1
28-01-2025,"Dry Fruits, Nuts & Seeds",SD Mango cubes 200gm,2,90,90,0,1
28-01-2025,Snacks & Ready-to-Eat,BELLAM MINAPA SUNADULLU,14,180,180,0,1
28-01-2025,"Dry Fruits, Nuts & Seeds",WATERMELON SEEDS 250GRM,2,320,280,40,1
28-01-2025,Snacks & Ready-to-Eat,SD FINGER Millet with palm Jaggery 250gm,14,135,135,0,1
28-01-2025,Snacks & Ready-to-Eat,COPRA LADDU 200GM,14,100,80,20,1
28-01-2025,Oils & Ghee,Freedom Rice Bran Oil 1L,9,194,180,14,1
28-01-2025,Oils & Ghee,Groundnut oil 1 L,9,360,330,30,1
28-01-2025,Sweeteners,YB JAGGERY POWDER 1KG,16,140,140,0,1
28-01-2025,Beverages,BRU GREEN LABEL 1.2G,1,48,48,0,24
28-01-2025,"Grains, Flours & Dals",BOMBAY RAVA,4,70,55,15,1
28-01-2025,"Grains, Flours & Dals",SABDANA 500GM,4,90,70,20,1
28-01-2025,"Grains, Flours & Dals",THICK POHA 500GM,4,40,35,5,1
28-01-2025,"Grains, Flours & Dals",DH URAD GOTA 1KG,4,215,190,25,1
28-01-2025,Oils & Ghee,Safflower oil 1 L,9,440,400,40,1
28-01-2025,Oils & Ghee,Groundnut oil 1 L,9,360,330,30,1
28-01-2025,"Grains, Flours & Dals",Chana Flour 500 gms,4,70,65,5,1
28-01-2025,"Dry Fruits, Nuts & Seeds",Groundnuts 1 kg,2,190,170,20,1
28-01-2025,Spices & Seasonings,JEERA 250 gms,15,125,105,20,1
28-01-2025,Spices & Seasonings,DRY MIECHI 200GM,15,80,60,20,1
28-01-2025,Spices & Seasonings,Avalu small 250 gms,15,60,40,20,1
28-01-2025,"Grains, Flours & Dals",SL Idly Rava 1KG,4,130,110,20,2
28-01-2025,Oils & Ghee,Groundnut oil 1 L,9,360,330,30,1
28-01-2025,Spices & Seasonings,Coriander seeds 200 gms,15,48,40,8,1
28-01-2025,Spices & Seasonings,Tamarind 500GM,15,320,260,60,2
28-01-2025,"Grains, Flours & Dals",THICK POHA 500GM,4,40,35,5,1
28-01-2025,Oils & Ghee,Coconut oil 1 L,9,440,400,40,1
28-01-2025,Snacks & Ready-to-Eat,SD Aswagandha with palm Jaggery250Gm,14,270,270,0,2
28-01-2025,"Dry Fruits, Nuts & Seeds",Groundnuts 1 kg,2,190,170,20,1
28-01-2025,"Grains, Flours & Dals",SINGLE POLISH 1KG,4,325,325,0,5
28-01-2025,"Grains, Flours & Dals",Green gram 500 gms,4,75,70,5,1
28-01-2025,"Dry Fruits, Nuts & Seeds",SALTED PISTA 250GM,2,400,350,50,1
28-01-2025,"Dry Fruits, Nuts & Seeds",SUNFLOWER SEEDS 250GRM,2,150,130,20,1
28-01-2025,"Dry Fruits, Nuts & Seeds",YELLOW KISHMISH 250GM,2,130,110,20,1
28-01-2025,Snacks & Ready-to-Eat,urban murmura,14,60,55,5,1
28-01-2025,"Dry Fruits, Nuts & Seeds",ALMONDS 250GM,2,280,260,20,1
28-01-2025,Milk & Dairy,BROWN EGGS TRAY 30P,7,360,330,30,1
28-01-2025,Snacks & Ready-to-Eat,GANTASALA KARIVEPAKU SNACKS,14,120,120,0,2
28-01-2025,Snacks & Ready-to-Eat,SD Moringa with plam jaggery 250gm,14,135,135,0,1
28-01-2025,"Grains, Flours & Dals",THICK POHA 500GM,4,40,35,5,1
28-01-2025,Snacks & Ready-to-Eat,VD MURUKU 175GM,14,60,60,0,1
28-01-2025,Snacks & Ready-to-Eat,SATHVI PALLI CHIKKI 200GM,14,100,80,20,1
28-01-2025,General Household & Kitchenware,SIRIDHANYALU BOOK,3,200,180,20,1
28-01-2025,Pooja & Spiritual Items,JVK SAMBRANI STICK 20PCS,12,40,40,0,1
28-01-2025,"Dry Fruits, Nuts & Seeds",SD Mango cubes 100gm,2,45,45,0,1
28-01-2025,Beverages,3ROSES,1,90,90,0,1
28-01-2025,Spices & Seasonings,BLACK JEERA 50 GM,15,90,60,30,2
28-01-2025,Pooja & Spiritual Items,VRP APOORVA JAVADHU POW,12,70,70,0,2
28-01-2025,Snacks & Ready-to-Eat,urban murmura,14,60,55,5,1
28-01-2025,Spices & Seasonings,PURO Healthy Salt 1KG,15,110,110,0,1
28-01-2025,"Grains, Flours & Dals",SA Multi Grain Mix 500GM,4,159,159,0,1
28-01-2025,"Dry Fruits, Nuts & Seeds",PULMAKHANA 100 GM,2,180,170,10,1
28-01-2025,Spices & Seasonings,Turmeric powder 250 gms,15,100,75,25,1
28-01-2025,Snacks & Ready-to-Eat,MARMURA LADDU,14,80,60,20,1
28-01-2025,Oils & Ghee,Sesame oil 500ml,9,295,280,15,1
28-01-2025,"Grains, Flours & Dals",split black gram 1 kg,4,180,170,10,1
28-01-2025,Snacks & Ready-to-Eat,GB SALT COOKIES,14,60,55,5,1
28-01-2025,"Grains, Flours & Dals",Wheat Rava M 1KG,4,130,110,20,2
28-01-2025,"Grains, Flours & Dals",turdal 1kg,4,220,195,25,1
28-01-2025,"Grains, Flours & Dals",SINGLE POLISH 1KG,4,325,325,0,5
28-01-2025,Oils & Ghee,Groundnut oil 1 L,9,360,330,30,1
28-01-2025,"Grains, Flours & Dals",CHANA DAL 1KG,4,140,120,20,1
28-01-2025,"Grains, Flours & Dals",PESARA PAPPU 1 KG,4,170,145,25,1
28-01-2025,"Dry Fruits, Nuts & Seeds",Groundnuts 1 kg,2,190,170,20,1
28-01-2025,"Grains, Flours & Dals",Yellow jowar .F1 kg,4,110,100,10,1
28-01-2025,"Grains, Flours & Dals",White jowar.F 1 kg,4,100,80,20,1
28-01-2025,"Grains, Flours & Dals",white Bobarlu 1 KG,4,170,150,20,1
28-01-2025,"Dry Fruits, Nuts & Seeds",GF KIMIA DATES 500GM,2,310,190,120,1
28-01-2025,"Grains, Flours & Dals",SRILATHA RICE RAVVA 500GM,4,35,35,0,1
28-01-2025,"Grains, Flours & Dals",RAGI FLOUR 500GRMS,4,40,35,5,1
28-01-2025,Pickles & Cooking Pastes,SD MIXED VEG,11,110,110,0,1
28-01-2025,Oils & Ghee,Coconut oil 500 ml,9,220,200,20,1
28-01-2025,"Grains, Flours & Dals",Wheat Flour 1 kg,4,70,60,10,1
28-01-2025,"Dry Fruits, Nuts & Seeds",SD Mango cubes 100gm,2,45,45,0,1
28-01-2025,Milk & Dairy,SANGAM TONED MILK 500ML,7,60,60,0,2
28-01-2025,"Grains, Flours & Dals",RAGI FLOUR 1KG,4,80,70,10,1
28-01-2025,Spices & Seasonings,Jeera 100GM,15,50,45,5,1
28-01-2025,Sweeteners,SUGAR 500 GM,16,30,25,5,1
28-01-2025,Spices & Seasonings,AV Iodized Salt 1KG,15,28,25,3,1
28-01-2025,Snacks & Ready-to-Eat,VD MIXTURE 175 GM,14,60,60,0,1
28-01-2025,"Health, Wellness & Ayurvedic Products",MD Bringaraj Choornam 100GM,5,80,80,0,1
28-01-2025,Pooja & Spiritual Items,BALAJI BEL PHOOL STICKS 90GM,12,60,60,0,1
28-01-2025,Snacks & Ready-to-Eat,SD black sesme laddu with dates 175gm,14,135,135,0,1
28-01-2025,"Grains, Flours & Dals",Sathya Javva Wheat Rava 500GM,4,95,95,0,1
28-01-2025,Sweeteners,MISHRI D,16,40,30,10,1
28-01-2025,Snacks & Ready-to-Eat,TILLI CHIKKI,14,5,5,0,1
28-01-2025,Snacks & Ready-to-Eat,PN ORGANIC PUFFED RICE 200GM,14,55,55,0,1
28-01-2025,Snacks & Ready-to-Eat,RSC ORANGE 100GMS,14,20,20,0,1
28-01-2025,"Health, Wellness & Ayurvedic Products",MH Millets Malt 500GM,5,200,190,10,1
28-01-2025,Oils & Ghee,Groundnut oil 1 L,9,360,330,30,1
28-01-2025,Pooja & Spiritual Items,BALAJI BEL PHOOL DHOOP STICKS 10STK,12,70,70,0,1
28-01-2025,Milk & Dairy,BROWN EGGS 1P,7,84,72,12,6
28-01-2025,Oils & Ghee,Sesame oil 1 L,9,1180,"1,120.00",60,2
28-01-2025,"Grains, Flours & Dals",RAGI FLOUR 500GRMS,4,40,35,5,1
28-01-2025,"Grains, Flours & Dals",SB Javva Wheat Ravva 500GM,4,95,95,0,1
28-01-2025,Oils & Ghee,Groundnut oil 1 L,9,360,330,30,1
28-01-2025,Spices & Seasonings,ROYAL SAFFRON,15,125,125,0,1
28-01-2025,"Grains, Flours & Dals",Chana Flour 500 gms,4,70,65,5,1
28-01-2025,Snacks & Ready-to-Eat,SD Sesame laddu with dates250gm,14,135,135,0,1
28-01-2025,Spices & Seasonings,SAJEERA,15,60,40,20,1
28-01-2025,Spices & Seasonings,DRY MIECHI 200GM,15,80,60,20,1
28-01-2025,Spices & Seasonings,Chilli powder 500 gms,15,290,210,80,1
28-01-2025,Personal Care & Cosmetics,HERBAL BATH POWDER 200GM,10,80,80,0,1
28-01-2025,General Household & Kitchenware,MATCH BOX,3,10,10,0,1
28-01-2025,General Household & Kitchenware,MATCH BOX,3,20,20,0,1
28-01-2025,Pooja & Spiritual Items,GOW DURBAR GEETHA CAMPHOR,12,60,60,0,1
28-01-2025,Pooja & Spiritual Items,GB Bharatha Woods 75GM,12,60,60,0,1
28-01-2025,Spices & Seasonings,DRY MIECHI 200GM,15,80,60,20,1
28-01-2025,"Grains, Flours & Dals",CHANA DAL 500GM,4,70,60,10,1
28-01-2025,Spices & Seasonings,JEERA 250 gms,15,125,105,20,1
28-01-2025,Sweeteners,SUGAR 500 GM,16,30,25,5,1
28-01-2025,Pickles & Cooking Pastes,GINGER AVAKAYA,11,110,110,0,1
28-01-2025,"Grains, Flours & Dals",Bombay Rava 500GM,4,35,30,5,1
28-01-2025,"Grains, Flours & Dals",Green gram 500 gms,4,75,70,5,1
28-01-2025,Oils & Ghee,BUFFALLO GHEE 500ML,9,820,740,80,2
28-01-2025,"Grains, Flours & Dals",Em Multimillet idli r 500g,4,129,129,0,1
28-01-2025,Snacks & Ready-to-Eat,PN ORGANIC PUFFED RICE 200GM,14,55,55,0,1
28-01-2025,"Grains, Flours & Dals",Wheat Flour 1 kg,4,140,120,20,2
28-01-2025,"Grains, Flours & Dals",Multigrain 1 kg,4,100,85,15,1
28-01-2025,Oils & Ghee,Groundnut oil 1 L,9,360,330,30,1
28-01-2025,Milk & Dairy,SANGAM CURD 450GM,7,38,38,0,1
28-01-2025,Milk & Dairy,SANGAM TONED MILK 500ML,7,30,30,0,1
28-01-2025,Snacks & Ready-to-Eat,RAJGIRA PEANUT CHIKKI 450GM,14,125,125,0,1
28-01-2025,Snacks & Ready-to-Eat,GB SALT COOKIES,14,60,55,5,1
28-01-2025,Snacks & Ready-to-Eat,AQUAGRANO DOSA BATTER,14,69,69,0,1
28-01-2025,"Grains, Flours & Dals",Em Little idli R 500g,4,129,129,0,1
28-01-2025,Snacks & Ready-to-Eat,BATANA NGT 70GMS,14,40,40,0,2
28-01-2025,Snacks & Ready-to-Eat,SATHVI REGIVADA 200GM,14,160,120,40,2
28-01-2025,Snacks & Ready-to-Eat,GB SALT COOKIES,14,60,55,5,1
28-01-2025,Snacks & Ready-to-Eat,RSC ORANGE 100GMS,14,20,20,0,1
28-01-2025,Spices & Seasonings,AV Iodized Salt 1KG,15,28,25,3,1
28-01-2025,Pooja & Spiritual Items,HERBAL PATCHOULI STICKS 20INC,12,45,45,0,1
28-01-2025,Spices & Seasonings,TM MIRCH POWDER 200GM,15,163,163,0,1
28-01-2025,Snacks & Ready-to-Eat,PEANUT CHIKKI 450GM,14,125,125,0,1
28-01-2025,Spices & Seasonings,PN ORGANIC PINK SALT 1KG,15,124,124,0,1
28-01-2025,"Grains, Flours & Dals",split green gram 500 gms,4,75,70,5,1
28-01-2025,"Grains, Flours & Dals",SINGHAM 26KG BAG,4,1650,"1,650.00",0,1
28-01-2025,Milk & Dairy,BROWN EGGS TRAY 30P,7,360,330,30,1
28-01-2025,"Dry Fruits, Nuts & Seeds",PUMPKIN SEEDS 250GM,2,200,160,40,1
28-01-2025,"Dry Fruits, Nuts & Seeds",WATERMELON SEEDS 250GRM,2,320,280,40,1
28-01-2025,"Dry Fruits, Nuts & Seeds",YELLOW KISHMISH 250GM,2,130,110,20,1
28-01-2025,"Grains, Flours & Dals",SA WHITE JOWAR RAVA 500GM,4,69,69,0,1
28-01-2025,"Dry Fruits, Nuts & Seeds",BLACK KISMIS 250GM,2,175,140,35,1
28-01-2025,General Household & Kitchenware,VERMI COMPOST MIX,3,30,30,0,1
28-01-2025,"Grains, Flours & Dals",Wheat Flour 1 kg,4,70,60,10,1
28-01-2025,Oils & Ghee,cow ghee 500 ml,9,430,390,40,1
28-01-2025,Snacks & Ready-to-Eat,VD JAGGERY GHEE 12PIC,14,180,180,0,1
28-01-2025,Snacks & Ready-to-Eat,NGT CHATPATTA CHANA 90GM,14,25,25,0,1
28-01-2025,Milk & Dairy,BROWN EGGS 1P,7,112,96,16,8
28-01-2025,"Grains, Flours & Dals",RAGI FLOUR 1KG,4,80,70,10,1
28-01-2025,Oils & Ghee,Groundnut oil 1 L,9,360,330,30,1
28-01-2025,Snacks & Ready-to-Eat,SESAME LADDU 200GM,14,200,160,40,2
28-01-2025,Snacks & Ready-to-Eat,PALLI LADDU 200GMS,14,90,70,20,1
28-01-2025,"Grains, Flours & Dals",Bajra Flour 500 gms,4,35,30,5,1
28-01-2025,"Grains, Flours & Dals",Multigrain 1 kg,4,100,85,15,1
28-01-2025,"Grains, Flours & Dals",RAGI FLOUR 1KG,4,80,70,10,1
28-01-2025,"Grains, Flours & Dals",SINGLE POLISH 1KG,4,65,65,0,1
28-01-2025,"Grains, Flours & Dals",EM Ragi idli R 500G,4,75,75,0,1
28-01-2025,Snacks & Ready-to-Eat,MULTI MILLET COOKIES,14,75,75,0,1
28-01-2025,Personal Care & Cosmetics,INDICA EASY,10,30,30,0,1
28-01-2025,General Household & Kitchenware,BLADE,3,25,25,0,1
28-01-2025,Personal Care & Cosmetics,IND BRINGHA SHAMPOO 100ML,10,135,135,0,1
28-01-2025,Pooja & Spiritual Items,GD SANDAL 150GM,12,110,110,0,1
28-01-2025,Pooja & Spiritual Items,GD Aiswarya Deepam 700ML,12,195,195,0,1
28-01-2025,Pooja & Spiritual Items,BALAJI BEL PHOOL STICKS 90GM,12,60,60,0,1
28-01-2025,"Grains, Flours & Dals",SRILALITHA MAIDA FLOUR 500G,4,32,32,0,1
28-01-2025,Snacks & Ready-to-Eat,MILK BREAD,14,55,55,0,1
28-01-2025,Spices & Seasonings,Tamarind 500GM,15,160,130,30,1
28-01-2025,Spices & Seasonings,Menthulu 250 gms,15,50,45,5,1
28-01-2025,Spices & Seasonings,Avalu small 250 gms,15,120,80,40,2
28-01-2025,Oils & Ghee,Groundnut oil 1 L,9,360,330,30,1
28-01-2025,"Grains, Flours & Dals",MAAGAANI LOW GI SP L 1KG,4,600,525,75,5
28-01-2025,"Grains, Flours & Dals",WHEAT 1 KG,4,120,100,20,2
28-01-2025,"Grains, Flours & Dals",JOWAR WHITE 1 KG,4,80,70,10,1
28-01-2025,"Grains, Flours & Dals",FLOUR CHARGE,4,36,36,0,3
28-01-2025,Snacks & Ready-to-Eat,GANTASALA FLAX SEEDS SPICY,14,90,90,0,1
28-01-2025,Spices & Seasonings,GS Moringa Leaves Spicy Powder 100GM,15,90,90,0,1
28-01-2025,Oils & Ghee,Groundnut oil 1 L,9,360,330,30,1
28-01-2025,"Dry Fruits, Nuts & Seeds",PUMPKIN SEEDS 250GM,2,200,160,40,1
28-01-2025,"Dry Fruits, Nuts & Seeds",ALMONDS 250GM,2,280,260,20,1
28-01-2025,Snacks & Ready-to-Eat,VD RICE SAGO PAPAD 150GM,14,55,55,0,1
28-01-2025,"Dry Fruits, Nuts & Seeds",WATERMELON SEEDS 250GRM,2,320,280,40,1
28-01-2025,Sweeteners,MISHRI 250 GM,16,35,30,5,1
28-01-2025,"Dry Fruits, Nuts & Seeds",CASHEW 250GM,2,340,310,30,1
28-01-2025,"Dry Fruits, Nuts & Seeds",WALLNUTS 250GM,2,320,290,30,1
28-01-2025,"Health, Wellness & Ayurvedic Products",GS Wheat Grass Powder 100GMS,5,349,349,0,1
28-01-2025,Snacks & Ready-to-Eat,KURNOOL MARMURA,14,70,55,15,1
28-01-2025,Snacks & Ready-to-Eat,GB SALT COOKIES,14,60,55,5,1
28-01-2025,"Dry Fruits, Nuts & Seeds",ANJEER 250GM,2,400,360,40,1
28-01-2025,"Grains, Flours & Dals",RED RICE 1KG,4,150,120,30,1
28-01-2025,"Dry Fruits, Nuts & Seeds",SALTED PISTA 250GM,2,400,350,50,1
28-01-2025,"Dry Fruits, Nuts & Seeds",SATHVI CHIA SEEDS 100GM,2,200,160,40,2
28-01-2025,"Dry Fruits, Nuts & Seeds",SUNFLOWER SEEDS 250GRM,2,150,130,20,1
28-01-2025,"Grains, Flours & Dals",ROXY POORI ATTA 1KG,4,150,150,0,2
28-01-2025,"Grains, Flours & Dals",CHANA DAL 1KG,4,140,120,20,1
28-01-2025,"Grains, Flours & Dals",FLOUR CHARGE,4,54,54,0,4.5
28-01-2025,"Grains, Flours & Dals",PLAIN OATS 1KG,4,52.5,52.5,0,0.25
28-01-2025,"Dry Fruits, Nuts & Seeds",MAHA BEERA SEEDS 100GM,2,60,60,0,1
28-01-2025,Oils & Ghee,Castor oil 200 ml,9,100,80,20,1
28-01-2025,Oils & Ghee,Sesame oil 500ml,9,295,280,15,1
28-01-2025,"Grains, Flours & Dals",Chittimuthaylu rice 1 kg,4,160,140,20,1
28-01-2025,Personal Care & Cosmetics,LOREAL FALL RESIST 3X SHAMPOO 82.5ML,10,79,79,0,1
28-01-2025,Beverages,BRU GREEN LABEL 1.2G,1,48,48,0,24
28-01-2025,Oils & Ghee,Safflower oil 500 ml,9,220,200,20,1
28-01-2025,Sweeteners,YB JAGGERY POWDER 500GMS,16,75,75,0,1
28-01-2025,Snacks & Ready-to-Eat,VD MURUKU 175GM,14,60,60,0,1
28-01-2025,"Dry Fruits, Nuts & Seeds",SUNFLOWER SEEDS 250GRM,2,150,130,20,1
28-01-2025,"Grains, Flours & Dals",RICE FLOUR 500 GM,4,35,28,7,1
28-01-2025,Snacks & Ready-to-Eat,MB FOXTAIL MILLET NOODLES 180GM,14,95,95,0,1
28-01-2025,Snacks & Ready-to-Eat,SS IDLY BATTER 1KG,14,60,60,0,1
28-01-2025,General Household & Kitchenware,WOODEN SPOON BIG,3,40,40,0,1
28-01-2025,Pooja & Spiritual Items,GD Aiswarya Deepam 700ML,12,195,195,0,1
28-01-2025,Snacks & Ready-to-Eat,VD RED CHILLI RICEPAPAD 150GM,14,50,50,0,1
28-01-2025,"Grains, Flours & Dals",SL Suji Rava 500GM,4,32,32,0,1
28-01-2025,"Dry Fruits, Nuts & Seeds",YELLOW KISHMISH 250GM,2,130,110,20,1
28-01-2025,Personal Care & Cosmetics,DOVE INTENSE REPAIR SHAMPOO,10,72,72,0,1
28-01-2025,"Grains, Flours & Dals",SRILATHA RICE RAVVA 500GM,4,35,35,0,1
28-01-2025,"Grains, Flours & Dals",Wheat Flour 1 kg,4,70,60,10,1
28-01-2025,Household & Cleaning,HERBAL NATURE CLEAN 100ML,6,75,75,0,1
28-01-2025,Sweeteners,GS Organic Jaggery Powder 600GM,16,99,99,0,1
28-01-2025,Spices & Seasonings,ROYAL SAFFRON,15,125,125,0,1
28-01-2025,Snacks & Ready-to-Eat,SD FINGER Millet with palm Jaggery 250gm,14,135,135,0,1
28-01-2025,Oils & Ghee,Groundnut oil 1 L,9,360,330,30,1
28-01-2025,Spices & Seasonings,Masala Karam 250 gms,15,130,120,10,1
28-01-2025,"Grains, Flours & Dals",CHANA DAL 500GM,4,70,60,10,1
28-01-2025,"Grains, Flours & Dals",FLOUR CHARGE,4,38.4,38.4,0,3.2
28-01-2025,"Dry Fruits, Nuts & Seeds",PULMAKHANA 100 GM,2,180,170,10,1
28-01-2025,"Grains, Flours & Dals",CHANA DAL 500GM,4,70,60,10,1
28-01-2025,"Grains, Flours & Dals",PESARA PAPPU 500GMS,4,85,75,10,1
28-01-2025,Snacks & Ready-to-Eat,DISANO MACARONI 850GM,14,105,105,0,1
28-01-2025,"Dry Fruits, Nuts & Seeds",ALMONDS 250GM,2,280,260,20,1
28-01-2025,"Grains, Flours & Dals",SRILALITHA MAIDA FLOUR 500G,4,32,32,0,1
28-01-2025,Oils & Ghee,Sesame oil 500ml,9,295,280,15,1
28-01-2025,Milk & Dairy,BROWN EGGS 1P,7,84,72,12,6
28-01-2025,Oils & Ghee,Sesame oil 1 L,9,590,560,30,1
28-01-2025,Oils & Ghee,Castor oil 200 ml,9,100,80,20,1
28-01-2025,"Grains, Flours & Dals",SINGHAM 26KG BAG,4,1650,"1,650.00",0,1
28-01-2025,Personal Care & Cosmetics,ORGANIC SPONGE LOOFAH,10,70,70,0,1
28-01-2025,"Grains, Flours & Dals",Wheat Flour 1 kg,4,140,120,20,2
28-01-2025,Personal Care & Cosmetics,GAYATHRI KUMKUDUKAYA,10,150,150,0,1
28-01-2025,"Grains, Flours & Dals",CHANA DAL 500GM,4,70,60,10,1
28-01-2025,Sweeteners,SUGAR 1KG,16,60,50,10,1
28-01-2025,"Grains, Flours & Dals",FLOUR CHARGE,4,15.6,15.6,0,1.3
28-01-2025,Snacks & Ready-to-Eat,BB VERMICELLI 250GM,14,30,30,0,1
28-01-2025,Oils & Ghee,Freedom Rice Bran Oil 1L,9,194,180,14,1
28-01-2025,Spices & Seasonings,GS GARLIC KARAM 100GM,15,75,75,0,1
28-01-2025,"Grains, Flours & Dals",KORRALU (FOXTAIL M) 1KG,4,150,110,40,1
28-01-2025,Spices & Seasonings,SD Curry Leaves Karam Powder 100GM,15,65,65,0,1
28-01-2025,Personal Care & Cosmetics,ROUND LOOFAH,10,65,65,0,1
28-01-2025,Snacks & Ready-to-Eat,SD KODO MILLET WITH PALM JAGGERY,14,135,135,0,1
28-01-2025,Snacks & Ready-to-Eat,SD Little Millet WITH PLAM JAGGERY,14,135,135,0,1
28-01-2025,Spices & Seasonings,SD IDLY KARAM,15,65,65,0,1
28-01-2025,"Grains, Flours & Dals",Quinova 500 gms,4,110,100,10,1
28-01-2025,Spices & Seasonings,Menthulu 250 gms,15,50,45,5,1
28-01-2025,Spices & Seasonings,JEERA 250 gms,15,125,105,20,1
28-01-2025,"Grains, Flours & Dals",Quinova 500 gms,4,110,100,10,1
28-01-2025,Spices & Seasonings,Coriander seeds 200 gms,15,48,40,8,1
28-01-2025,"Grains, Flours & Dals",CHANA DAL 500GM,4,70,60,10,1
28-01-2025,Sweeteners,YB Brown Sugar 500GM,16,75,75,0,1
28-01-2025,"Grains, Flours & Dals",RED TURDAL 500GM,4,75,70,5,1
28-01-2025,"Dry Fruits, Nuts & Seeds",CASHEW 250GM,2,340,310,30,1
28-01-2025,"Grains, Flours & Dals",KORRALU (FOXTAIL M) 500GM,4,65,55,10,1
28-01-2025,Spices & Seasonings,NUVVULU 250GM,15,80,65,15,1
28-01-2025,"Grains, Flours & Dals",RAGI FLOUR 500GRMS,4,40,35,5,1
28-01-2025,"Grains, Flours & Dals",Wheat Flour 500 gms,4,35,30,5,1
28-01-2025,Spices & Seasonings,GREEN SOUNF,15,120,80,40,2
28-01-2025,Sweeteners,MISHRI D,16,40,30,10,1
28-01-2025,Spices & Seasonings,ROYAL SAFFRON,15,125,125,0,1
28-01-2025,"Grains, Flours & Dals",RAJMA 250GM,4,55,45,10,1
28-01-2025,Oils & Ghee,Groundnut oil 1 L,9,360,330,30,1
28-01-2025,"Grains, Flours & Dals",Wheat Rava M 1KG,4,65,55,10,1
28-01-2025,Snacks & Ready-to-Eat,SD Atreyapuram DRY Fruit ghee,14,150,150,0,1
28-01-2025,Snacks & Ready-to-Eat,SATHVI MIXED CHIKKI 200GM,14,120,100,20,1
28-01-2025,"Grains, Flours & Dals",White jowar.F 1 kg,4,100,80,20,1
28-01-2025,Snacks & Ready-to-Eat,TILLI CHIKKI,14,20,20,0,4
28-01-2025,"Grains, Flours & Dals",Yellow jowar .F1 kg,4,110,100,10,1
28-01-2025,"Dry Fruits, Nuts & Seeds",Groundnuts 500 gms,2,95,85,10,1
28-01-2025,Snacks & Ready-to-Eat,RB Choco Delite Almonds Raisins 40g,14,45,45,0,1
28-01-2025,"Grains, Flours & Dals",SRILATHA RICE RAVVA 500GM,4,35,35,0,1
28-01-2025,"Grains, Flours & Dals",Wheat Flour 1 kg,4,210,180,30,3
28-01-2025,Snacks & Ready-to-Eat,SATHVI REGIVADA 200GM,14,80,60,20,1
28-01-2025,"Grains, Flours & Dals",HS Jowar upma rava 500 gms,4,130,130,0,2
28-01-2025,Oils & Ghee,Safflower oil 1 L,9,440,400,40,1
28-01-2025,Oils & Ghee,Groundnut oil 1 L,9,720,660,60,2
28-01-2025,"Grains, Flours & Dals",White jowar.F 1 kg,4,100,80,20,1
28-01-2025,Snacks & Ready-to-Eat,PEANUT CHIKKI 450GM,14,125,125,0,1
28-01-2025,Spices & Seasonings,Tamarind 500GM,15,160,130,30,1
28-01-2025,"Grains, Flours & Dals",Quinova 500 gms,4,110,100,10,1
28-01-2025,Spices & Seasonings,BLACK JEERA 50 GM,15,45,30,15,1
28-01-2025,Spices & Seasonings,PN ORGANIC PINK SALT 1KG,15,124,124,0,1
28-01-2025,"Grains, Flours & Dals",Em Foxtail upma r 500 g,4,218,218,0,2
28-01-2025,"Grains, Flours & Dals",EM kodo upma R 500g,4,129,129,0,1
28-01-2025,"Grains, Flours & Dals",AISHWARYA SP 1KG,4,160,140,20,2
28-01-2025,Snacks & Ready-to-Eat,SD Aswagandha with palm Jaggery250Gm,14,135,135,0,1
28-01-2025,Snacks & Ready-to-Eat,GB SALT COOKIES,14,60,55,5,1
28-01-2025,"Grains, Flours & Dals",Em kodo idli R 500G,4,129,129,0,1
28-01-2025,Snacks & Ready-to-Eat,SD Vamu with palm jaggery 250gm,14,135,135,0,1
28-01-2025,Snacks & Ready-to-Eat,SD Moringa with plam jaggery 250gm,14,135,135,0,1
28-01-2025,"Grains, Flours & Dals",RAGI FLOUR 500GRMS,4,40,35,5,1
28-01-2025,Snacks & Ready-to-Eat,SD barnyard Millet with palm jaggery,14,135,135,0,1
28-01-2025,"Grains, Flours & Dals",Em little upma R 500g,4,258,258,0,2
28-01-2025,"Grains, Flours & Dals",split green gram 1 kg,4,150,140,10,1
28-01-2025,Beverages,GANTASALA TEJ DRY GINGER COFFEE,1,149,149,0,1
28-01-2025,"Grains, Flours & Dals",SL Idly Rava 1KG,4,195,165,30,3
28-01-2025,"Grains, Flours & Dals",CHANA DAL 1KG,4,140,120,20,1
28-01-2025,"Grains, Flours & Dals",RICE FLOUR 1KG,4,70,55,15,1
28-01-2025,"Dry Fruits, Nuts & Seeds",PUTNALU 500GMS,2,90,76,14,1
28-01-2025,"Grains, Flours & Dals",VGR rice 1 kg,4,140,130,10,2
28-01-2025,"Grains, Flours & Dals",Chana Flour 500 gms,4,70,65,5,1
28-01-2025,"Grains, Flours & Dals",SINGHAM 26KG BAG,4,1650,"1,650.00",0,1
28-01-2025,"Grains, Flours & Dals",FLOUR CHARGE,4,12,12,0,1
28-01-2025,"Grains, Flours & Dals",Urad dall 1 Kg,4,185,170,15,1
28-01-2025,"Grains, Flours & Dals",BOMBAY RAVA,4,70,55,15,1
28-01-2025,"Grains, Flours & Dals",Em jowar idly R 500G,4,150,150,0,2
28-01-2025,Spices & Seasonings,Chilli powder 500 gms,15,290,210,80,1
28-01-2025,Oils & Ghee,Sesame oil 1 L,9,590,560,30,1
28-01-2025,Spices & Seasonings,Tamarind 250GMS,15,80,65,15,1
28-01-2025,"Grains, Flours & Dals",SINGLE POLISH 1KG,4,130,130,0,2
28-01-2025,Spices & Seasonings,ROYAL SAFFRON,15,125,125,0,1
28-01-2025,"Grains, Flours & Dals",RICE FLOUR 1KG,4,140,110,30,2
28-01-2025,"Grains, Flours & Dals",VGR rice 1 kg,4,210,195,15,3
28-01-2025,Spices & Seasonings,DRY MIECHI 200GM,15,80,60,20,1
28-01-2025,Sweeteners,Mishri 500GM,16,140,120,20,2
28-01-2025,"Grains, Flours & Dals",Urad dall 1 Kg,4,185,170,15,1
28-01-2025,"Dry Fruits, Nuts & Seeds",Groundnuts 1 kg,2,190,170,20,1
28-01-2025,Oils & Ghee,Safflower oil 1 L,9,1320,"1,200.00",120,3
28-01-2025,Oils & Ghee,Groundnut oil 1 L,9,360,330,30,1
28-01-2025,Snacks & Ready-to-Eat,SD FINGER Millet with palm Jaggery 250gm,14,135,135,0,1
28-01-2025,Snacks & Ready-to-Eat,MILK BREAD,14,55,55,0,1
28-01-2025,Snacks & Ready-to-Eat,SD JOWAR WITH PALM JAGGERY 250GM,14,135,135,0,1
28-01-2025,"Grains, Flours & Dals",RED TURDAL 500GM,4,75,70,5,1
28-01-2025,Snacks & Ready-to-Eat,MARMURA LADDU,14,80,60,20,1
28-01-2025,"Grains, Flours & Dals",White jowar.F 1 kg,4,500,400,100,5
28-01-2025,Pooja & Spiritual Items,JAGI KAYA 25GM,12,80,60,20,1
28-01-2025,"Grains, Flours & Dals",Wheat Flour 1 kg,4,350,300,50,5
28-01-2025,"Grains, Flours & Dals",SA Sprouted Ragi Flour 500GM,4,69,69,0,1
28-01-2025,Spices & Seasonings,Gasagasalu 50GM,15,130,110,20,1
28-01-2025,"Grains, Flours & Dals",AISHWARYA SP 25KG,4,1999,"1,690.00",309,1
28-01-2025,"Grains, Flours & Dals",SA WHITE JOWAR RAVA 500GM,4,138,138,0,2
28-01-2025,Milk & Dairy,BROWN EGGS 1P,7,84,72,12,6
28-01-2025,Pooja & Spiritual Items,BANDA PUVVU 25GM 25GM,12,80,60,20,1
28-01-2025,"Dry Fruits, Nuts & Seeds",SUNFLOWER SEEDS 250GRM,2,150,130,20,1
28-01-2025,"Grains, Flours & Dals",Multigrain 1 kg,4,100,85,15,1
28-01-2025,"Grains, Flours & Dals",Wheat Flour 1 kg,4,140,120,20,2
28-01-2025,"Grains, Flours & Dals",BOMBAY RAVA,4,70,55,15,1
28-01-2025,"Grains, Flours & Dals",White jowar.F 1 kg,4,100,80,20,1
28-01-2025,Spices & Seasonings,BLACK JEERA 50 GM,15,45,30,15,1
28-01-2025,Spices & Seasonings,DRY MIECHI 200GM,15,80,60,20,1
28-01-2025,"Dry Fruits, Nuts & Seeds",WATERMELON SEEDS 250GRM,2,320,280,40,1
28-01-2025,"Dry Fruits, Nuts & Seeds",PUMPKIN SEEDS 250GM,2,200,160,40,1
28-01-2025,Snacks & Ready-to-Eat,VD RED CHILLI RICEPAPAD 150GM,14,50,50,0,1
28-01-2025,Snacks & Ready-to-Eat,BROWN BREAD,14,55,55,0,1
28-01-2025,Milk & Dairy,BROWN EGGS 1P,7,140,120,20,10
28-01-2025,Oils & Ghee,Sesame oil 1 L,9,590,560,30,1
28-01-2025,"Grains, Flours & Dals",Green gram 500 gms,4,75,70,5,1
28-01-2025,"Grains, Flours & Dals",SRILATHA RICE RAVVA 500GM,4,35,35,0,1
28-01-2025,"Grains, Flours & Dals",Em jowar idly R 500G,4,150,150,0,2
28-01-2025,"Grains, Flours & Dals",Wheat Rava M 500GM,4,33,30,3,1
28-01-2025,Snacks & Ready-to-Eat,VD MINAPA VADIYAM,14,65,65,0,1
28-01-2025,Spices & Seasonings,Tamarind 500GM,15,160,130,30,1
28-01-2025,"Grains, Flours & Dals",SABDANA,4,40,35,5,1
28-01-2025,"Grains, Flours & Dals",Yellow jowar .F1 kg,4,110,100,10,1
28-01-2025,Snacks & Ready-to-Eat,VD SAGOPAPAD 150GM,14,55,55,0,1
28-01-2025,Spices & Seasonings,ROYAL SAFFRON 400GRMS,15,65,65,0,1
28-01-2025,Snacks & Ready-to-Eat,VD GUMMADI VADIYAM,14,75,75,0,1
28-01-2025,Oils & Ghee,Groundnut oil 1 L,9,1080,990,90,3
28-01-2025,Spices & Seasonings,PURO Healthy Salt 1KG,15,220,220,0,2
28-01-2025,"Grains, Flours & Dals",CHANA DAL 1KG,4,140,120,20,1
28-01-2025,"Grains, Flours & Dals",RICE FLOUR 1KG,4,70,55,15,1
28-01-2025,"Grains, Flours & Dals",SL Idly Rava 1KG,4,195,165,30,3
28-01-2025,"Grains, Flours & Dals",BOMBAY RAVA,4,70,55,15,1
28-01-2025,"Grains, Flours & Dals",SINGHAM 26KG BAG,4,1650,"1,650.00",0,1
28-01-2025,"Dry Fruits, Nuts & Seeds",PUTNALU 500GMS,2,90,76,14,1
28-01-2025,"Grains, Flours & Dals",Chana Flour 500 gms,4,70,65,5,1
28-01-2025,"Grains, Flours & Dals",SINGLE POLISH 1KG,4,650,650,0,10
28-01-2025,Beverages,GANTASALA TEJ DRY GINGER COFFEE,1,149,149,0,1
28-01-2025,Spices & Seasonings,Tamalapaku Karam Powder 100GM,15,80,80,0,1
28-01-2025,"Grains, Flours & Dals",RAGI FLOUR 1KG,4,80,70,10,1
28-01-2025,"Health, Wellness & Ayurvedic Products",MD Triphala Chorrnam 100GM,5,70,70,0,1
28-01-2025,"Health, Wellness & Ayurvedic Products",AMLA PACHAK,5,100,100,0,1
28-01-2025,"Health, Wellness & Ayurvedic Products",MH Millets Malt 500GM,5,200,190,10,1
28-01-2025,"Grains, Flours & Dals",KORRALU (FOXTAIL M) 500GM,4,65,55,10,1
28-01-2025,"Dry Fruits, Nuts & Seeds",ANJEER 250GM,2,400,360,40,1
28-01-2025,Snacks & Ready-to-Eat,VD VAMUPUSA 175GM,14,60,60,0,1
28-01-2025,Snacks & Ready-to-Eat,ZEEDI,14,70,70,0,1
28-01-2025,Oils & Ghee,Groundnut oil 500ml,9,180,165,15,1
28-01-2025,"Grains, Flours & Dals",COW B rice 1 kg,4,72,69,3,1
28-01-2025,"Grains, Flours & Dals",VGR rice 1 kg,4,70,65,5,1
28-01-2025,Spices & Seasonings,Tamarind 500GM,15,160,130,30,1
28-01-2025,Milk & Dairy,SANGAM TONED MILK 500ML,7,60,60,0,2
28-01-2025,"Dry Fruits, Nuts & Seeds",Groundnuts 500 gms,2,95,85,10,1
28-01-2025,Personal Care & Cosmetics,UVIS HENNA 100GM,10,75,75,0,1
28-01-2025,Household & Cleaning,SURF EXCEL 150GM,6,20,20,0,1
28-01-2025,Snacks & Ready-to-Eat,NGT CHATPATTA CHANA 90GM,14,25,25,0,1
28-01-2025,"Dry Fruits, Nuts & Seeds",Groundnuts 500 gms,2,190,170,20,2
28-01-2025,"Grains, Flours & Dals",SABDANA,4,40,35,5,1
28-01-2025,Household & Cleaning,BORIC POWDER 100GM,6,55,55,0,1
28-01-2025,"Grains, Flours & Dals",RICE FLOUR 500 GM,4,70,56,14,2
28-01-2025,Oils & Ghee,Groundnut oil 1 L,9,360,330,30,1
28-01-2025,Snacks & Ready-to-Eat,BATANA NGT 70GMS,14,20,20,0,1
28-01-2025,Sweeteners,MADHUR SUGAR 1KG,16,65,55,10,1
28-01-2025,"Grains, Flours & Dals",RAGULU 1 KG,4,140,120,20,2
28-01-2025,Pooja & Spiritual Items,GOMATHA AGARBATHI,12,75,75,0,1
28-01-2025,"Grains, Flours & Dals",JOWAR WHITE 1 KG,4,80,70,10,1
28-01-2025,"Grains, Flours & Dals",FLOUR CHARGE,4,132,132,0,11
28-01-2025,Snacks & Ready-to-Eat,SATHVI PALLI CHIKKI 200GM,14,100,80,20,1
28-01-2025,Snacks & Ready-to-Eat,MARMURA LADDU,14,80,60,20,1
28-01-2025,Snacks & Ready-to-Eat,MUTLGRAIN BREAD,14,70,70,0,1
28-01-2025,"Grains, Flours & Dals",Bajra Flour 1 kg,4,70,60,10,1
28-01-2025,Snacks & Ready-to-Eat,SESAME CHIKKI,14,120,100,20,1
28-01-2025,Snacks & Ready-to-Eat,SATHVI PALLI CHIKKI 200GM,14,100,80,20,1
28-01-2025,"Grains, Flours & Dals",Yellow jowar .F1 kg,4,110,100,10,1
28-01-2025,Oils & Ghee,Sesame oil 1 L,9,590,560,30,1
28-01-2025,Pooja & Spiritual Items,GD Aiswarya Deepam 700ML,12,195,195,0,1
28-01-2025,Sweeteners,MADHUR SUGAR 1KG,16,65,55,10,1
28-01-2025,Sweeteners,YB JAGGERY POWDER 500GMS,16,75,75,0,1
28-01-2025,"Grains, Flours & Dals",DH URAD GOTA 1KG,4,215,190,25,1
28-01-2025,"Grains, Flours & Dals",Wheat Flour 1 kg,4,70,60,10,1
28-01-2025,"Dry Fruits, Nuts & Seeds",Groundnuts 1 kg,2,190,170,20,1
28-01-2025,"Health, Wellness & Ayurvedic Products",MD Kasturi Pasupu Choornam 50GM,5,80,80,0,1
28-01-2025,Beverages,GANTASALA GREEN TEA 100GM,1,149,149,0,1
28-01-2025,"Dry Fruits, Nuts & Seeds",SABJA SEEDS 100GM,2,80,70,10,1
28-01-2025,"Grains, Flours & Dals",THICK POHA 500GM,4,40,35,5,1
28-01-2025,"Grains, Flours & Dals",Wheat Flour 1 kg,4,140,120,20,2
28-01-2025,"Grains, Flours & Dals",HS jowar idly rava 500 gms,4,65,65,0,1
28-01-2025,Household & Cleaning,LIZOL FORAL CLEANER,6,116,116,0,1
28-01-2025,Household & Cleaning,VIM TROPICAL LEMON FRESHNESS 250ML,6,55,55,0,1
28-01-2025,Household & Cleaning,VIM 300GM,6,30,30,0,1
28-01-2025,"Grains, Flours & Dals",Urad dall 1 Kg,4,185,170,15,1
28-01-2025,"Grains, Flours & Dals",Green gram 1 kg,4,150,130,20,1
28-01-2025,Spices & Seasonings,Menthulu 250 gms,15,50,45,5,1
28-01-2025,"Grains, Flours & Dals",White jowar.F 1 kg,4,100,80,20,1
28-01-2025,"Grains, Flours & Dals",Em Multimillet idli r 500g,4,129,129,0,1
28-01-2025,Spices & Seasonings,SWEET SOUNF,15,20,20,0,1
28-01-2025,"Grains, Flours & Dals",JOWAR YELLOW 1 K,4,100,90,10,1
28-01-2025,"Grains, Flours & Dals",Em Multimillet upma 500g,4,129,129,0,1
28-01-2025,"Grains, Flours & Dals",SINGLE POLISH 1KG,4,494,494,0,7.6
28-01-2025,"Dry Fruits, Nuts & Seeds",FLAX SEEDS 250GM,2,60,50,10,1
28-01-2025,Snacks & Ready-to-Eat,MILLET NOODLES CURRY MASALA,14,258,258,0,2
28-01-2025,Pooja & Spiritual Items,GD SANDAL 150GM,12,110,110,0,1
28-01-2025,Pooja & Spiritual Items,GD Dhoop Sticks 26GM,12,20,20,0,1
28-01-2025,Milk & Dairy,SANGAM TONED MILK 500ML,7,30,30,0,1
28-01-2025,"Grains, Flours & Dals",White jowar.F 1 kg,4,100,80,20,1
28-01-2025,"Grains, Flours & Dals",BASMATHI RICE 1KG,4,150,135,15,1
28-01-2025,"Grains, Flours & Dals",Yellow jowar.F 500 gms,4,55,50,5,1
28-01-2025,"Grains, Flours & Dals",KORRALU (FOXTAIL M) 500GM,4,65,55,10,1
28-01-2025,"Grains, Flours & Dals",RAGI FLOUR 500GRMS,4,40,35,5,1
28-01-2025,"Grains, Flours & Dals",DOCTOR RICE DIABETIC SFR 1KG,4,120,120,0,1
28-01-2025,Oils & Ghee,BUFFALLO GHEE 500ML,9,410,370,40,1
28-01-2025,"Grains, Flours & Dals",Multigrain 1 kg,4,100,85,15,1
28-01-2025,"Grains, Flours & Dals",VGR rice 1 kg,4,210,195,15,3
28-01-2025,Oils & Ghee,Groundnut oil 1 L,9,720,660,60,2
28-01-2025,Sweeteners,SD PALM JAGGERY 500GM,16,200,200,0,1
28-01-2025,"Grains, Flours & Dals",Sathya Javva Wheat Rava 500GM,4,190,190,0,2
28-01-2025,Oils & Ghee,Safflower oil 1 L,9,880,800,80,2
28-01-2025,"Grains, Flours & Dals",Multigrain 1 kg,4,100,85,15,1
28-01-2025,"Grains, Flours & Dals",SL Idly Rava 1KG,4,65,55,10,1
28-01-2025,Milk & Dairy,BROWN EGGS 1P,7,252,216,36,18
27-01-2025,"Grains, Flours & Dals",Wheat Flour 1 kg,4,210,180,30,3
27-01-2025,Snacks & Ready-to-Eat,Corn Chips 250GM,14,40,35,5,1
27-01-2025,"Grains, Flours & Dals",THICK POHA 1KG,4,80,70,10,1
27-01-2025,Spices & Seasonings,YB Rock Salt 1KG,15,120,120,0,1
27-01-2025,Spices & Seasonings,Chilli powder 500 gms,15,290,210,80,1
27-01-2025,Snacks & Ready-to-Eat,VD CORNFLAKES MIXTURE 175GM,14,60,60,0,1
27-01-2025,"Dry Fruits, Nuts & Seeds",Putnalu 250GM,2,45,38,7,1
27-01-2025,Oils & Ghee,Sesame oil 1 L,9,590,560,30,1
27-01-2025,"Dry Fruits, Nuts & Seeds",PULMAKHANA 100 GM,2,180,170,10,1
27-01-2025,"Grains, Flours & Dals",CHANA DAL 500GM,4,70,60,10,1
27-01-2025,"Grains, Flours & Dals",JOWAR WHITE 1 KG,4,80,70,10,1
27-01-2025,Spices & Seasonings,DRY MIECHI 200GM,15,80,60,20,1
27-01-2025,"Grains, Flours & Dals",split black gram 1 kg,4,180,170,10,1
27-01-2025,"Grains, Flours & Dals",White jowar.F 1 kg,4,100,80,20,1
27-01-2025,"Grains, Flours & Dals",Idly Rava L 1KG,4,60,50,10,1
27-01-2025,Snacks & Ready-to-Eat,BB VERMICELLI 1KG,14,95,90,5,1
27-01-2025,Snacks & Ready-to-Eat,Popcorn Seeds 250GM,14,45,40,5,1
27-01-2025,Snacks & Ready-to-Eat,RINGS 200GM,14,30,30,0,1
27-01-2025,Snacks & Ready-to-Eat,RSC ORANGE 100GMS,14,20,20,0,1
27-01-2025,"Grains, Flours & Dals",White Chana 500GM,4,120,100,20,1
27-01-2025,"Grains, Flours & Dals",Wheat Rava M 1KG,4,65,55,10,1
27-01-2025,"Grains, Flours & Dals",Bajra Flour 1 kg,4,70,60,10,1
27-01-2025,"Grains, Flours & Dals",turdal 1kg,4,220,195,25,1
27-01-2025,"Grains, Flours & Dals",split green gram 1 kg,4,150,140,10,1
27-01-2025,Oils & Ghee,Groundnut oil 5 L,9,1800,"1,600.00",200,1
27-01-2025,Milk & Dairy,BROWN EGGS TRAY 30P,7,360,330,30,1
27-01-2025,"Grains, Flours & Dals",RAGI FLOUR 500GRMS,4,40,35,5,1
27-01-2025,Snacks & Ready-to-Eat,MILK BREAD,14,55,55,0,1
27-01-2025,Milk & Dairy,BROWN EGGS TRAY 30P,7,360,330,30,1
27-01-2025,Oils & Ghee,Groundnut oil 1 L,9,720,660,60,2
27-01-2025,Oils & Ghee,Sesame oil 1 L,9,590,560,30,1
27-01-2025,Oils & Ghee,Safflower oil 1 L,9,880,800,80,2
27-01-2025,"Grains, Flours & Dals",SAMALU (Little millet) 500 gms,4,85,65,20,1
27-01-2025,"Grains, Flours & Dals",KORRALU (FOXTAIL M) 500GM,4,65,55,10,1
27-01-2025,Oils & Ghee,GROUNDNUT OIL 1KG,9,780,720,60,2
27-01-2025,"Dry Fruits, Nuts & Seeds",FLAX SEEDS 250GM,2,60,50,10,1
27-01-2025,"Health, Wellness & Ayurvedic Products",RB Max Protein Choco Almond bar 50g,5,75,75,0,1
27-01-2025,"Grains, Flours & Dals",HS jowar idly rava 500 gms,4,260,260,0,4
27-01-2025,Snacks & Ready-to-Eat,PALLI LADDU 200GMS,14,90,70,20,1
27-01-2025,"Dry Fruits, Nuts & Seeds",YELLOW KISHMISH 250GM,2,130,110,20,1
27-01-2025,"Dry Fruits, Nuts & Seeds",Groundnuts 1 kg,2,190,170,20,1
27-01-2025,"Grains, Flours & Dals",SAMALU (Little millet) 1 kg,4,170,130,40,1
27-01-2025,"Grains, Flours & Dals",SL Idly Rava 1KG,4,65,55,10,1
27-01-2025,Milk & Dairy,BROWN EGGS 1P,7,140,120,20,10
27-01-2025,Spices & Seasonings,ELACHI 25 GM,15,145,120,25,1
27-01-2025,"Grains, Flours & Dals",Wheat Rava M 1KG,4,65,55,10,1
27-01-2025,Oils & Ghee,Groundnut oil 1 L,9,360,330,30,1
27-01-2025,Snacks & Ready-to-Eat,COPRA LADDU 200GM,14,100,80,20,1
27-01-2025,Snacks & Ready-to-Eat,ZEEDI,14,70,70,0,1
27-01-2025,Oils & Ghee,Sesame oil 1 L,9,590,560,30,1
27-01-2025,Oils & Ghee,Safflower oil 1 L,9,440,400,40,1
27-01-2025,Snacks & Ready-to-Eat,PALLI LADDU 200GMS,14,90,70,20,1
27-01-2025,Snacks & Ready-to-Eat,MARMURA LADDU,14,80,60,20,1
27-01-2025,Sweeteners,ACHUBELLAM 500GM,16,50,40,10,1
27-01-2025,Spices & Seasonings,PURO Healthy Salt Crystal 1KG,15,135,135,0,1
27-01-2025,"Grains, Flours & Dals",RED RICE 1KG,4,150,120,30,1
27-01-2025,"Grains, Flours & Dals",URAD DALL,4,95,85,10,1
27-01-2025,"Grains, Flours & Dals",Green gram 500 gms,4,75,70,5,1
27-01-2025,Household & Cleaning,VIM TROPICAL LEMON FRESHNESS 250ML,6,55,55,0,1
27-01-2025,"Grains, Flours & Dals",HS jowar idly rava 500 gms,4,65,65,0,1
27-01-2025,"Grains, Flours & Dals",Wheat Flour 1 kg,4,70,60,10,1
27-01-2025,Oils & Ghee,Safflower oil 1 L,9,440,400,40,1
27-01-2025,"Grains, Flours & Dals",THICK POHA 500GM,4,40,35,5,1
27-01-2025,Spices & Seasonings,NUVVULU 250GM,15,80,65,15,1
27-01-2025,"Grains, Flours & Dals",Quinova 500 gms,4,110,100,10,1
27-01-2025,"Dry Fruits, Nuts & Seeds",Groundnuts 500 gms,2,95,85,10,1
27-01-2025,"Grains, Flours & Dals",YB BLACK RICE 500GM,4,150,150,0,1
27-01-2025,Milk & Dairy,BROWN EGGS TRAY 30P,7,360,330,30,1
27-01-2025,"Grains, Flours & Dals",SH ORGANIC MOONG YELLOW 500GM,4,158,158,0,1
27-01-2025,Snacks & Ready-to-Eat,VD RIBBON PAKODI 175GM,14,60,60,0,1
27-01-2025,Snacks & Ready-to-Eat,VD GUMMADI VADIYAM,14,75,75,0,1
27-01-2025,Snacks & Ready-to-Eat,GANTASALA GINGER CANDY 200GM,14,105,105,0,1
27-01-2025,Oils & Ghee,Groundnut oil 1 L,9,360,330,30,1
27-01-2025,"Grains, Flours & Dals",turdal 1kg,4,220,195,25,1
27-01-2025,Oils & Ghee,SESAME OIL 1KG,9,610,610,0,1
27-01-2025,Oils & Ghee,GROUNDNUT OIL 1KG,9,663,612,51,1.7
27-01-2025,"Grains, Flours & Dals",WHEAT 1 KG,4,180,150,30,3
27-01-2025,"Grains, Flours & Dals",FLOUR CHARGE,4,36,36,0,3
27-01-2025,"Dry Fruits, Nuts & Seeds",SD Mango cubes 100gm,2,45,45,0,1
27-01-2025,"Grains, Flours & Dals",MELMEKER 250GMS,4,60,45,15,1
27-01-2025,Spices & Seasonings,SWEET SOUNF,15,20,20,0,1
27-01-2025,Personal Care & Cosmetics,ORGANIC SPONGE LOOFAH,10,70,70,0,1
27-01-2025,Pooja & Spiritual Items,SOSR SWATHHI 365,12,30,30,0,1
27-01-2025,"Grains, Flours & Dals",turdal 500 gms,4,110,100,10,1
27-01-2025,"Grains, Flours & Dals",RAJMA 250GM,4,55,45,10,1
27-01-2025,"Grains, Flours & Dals",Quinova 500 gms,4,110,100,10,1
27-01-2025,"Health, Wellness & Ayurvedic Products",MH Millets Malt 500GM,5,200,190,10,1
27-01-2025,Spices & Seasonings,Tamarind 500GM,15,160,130,30,1
27-01-2025,"Grains, Flours & Dals",white Bobarlu 500 gms,4,80,75,5,1
27-01-2025,Snacks & Ready-to-Eat,SATHVI REGIVADA 200GM,14,80,60,20,1
27-01-2025,"Grains, Flours & Dals",White Chana 250 GM,4,60,50,10,1
27-01-2025,Oils & Ghee,Sesame oil 1 L,9,590,560,30,1
27-01-2025,Snacks & Ready-to-Eat,VD PAPPU CHEGODI 200GM,14,120,120,0,2
27-01-2025,"Grains, Flours & Dals",White Chana 250 GM,4,60,50,10,1
27-01-2025,Oils & Ghee,Coconut oil 500 ml,9,220,200,20,1
27-01-2025,Snacks & Ready-to-Eat,VD Pappu Chekkalu 190gm,14,60,60,0,1
27-01-2025,Snacks & Ready-to-Eat,SD BLACK GRAM PAPADS,14,80,80,0,1
27-01-2025,Snacks & Ready-to-Eat,SATHVI PALLI CHIKKI 200GM,14,100,80,20,1
27-01-2025,"Grains, Flours & Dals",SINGLE POLISH 1KG,4,325,325,0,5
27-01-2025,Oils & Ghee,Black Sesame oil 1 L,9,440,380,60,1
27-01-2025,Pooja & Spiritual Items,SOSR SWATHHI 365,12,30,30,0,1
27-01-2025,"Grains, Flours & Dals",HS Multimillet upma r 500g,4,130,130,0,2
27-01-2025,"Grains, Flours & Dals",Sathya Javva Wheat Rava 500GM,4,190,190,0,2
27-01-2025,Oils & Ghee,Coconut oil 1 L,9,440,400,40,1
27-01-2025,Oils & Ghee,Safflower oil 1 L,9,440,400,40,1
27-01-2025,"Dry Fruits, Nuts & Seeds",ANJEER 250GM,2,400,360,40,1
27-01-2025,"Dry Fruits, Nuts & Seeds",SUNFLOWER SEEDS 250GRM,2,150,130,20,1
27-01-2025,"Grains, Flours & Dals",Arikadu ( kodo),4,140,130,10,1
27-01-2025,"Grains, Flours & Dals",JOWAR YELLOW 1 K,4,200,180,20,2
27-01-2025,"Dry Fruits, Nuts & Seeds",PULMAKHANA 100 GM,2,180,170,10,1
27-01-2025,"Dry Fruits, Nuts & Seeds",PUMPKIN SEEDS 250GM,2,200,160,40,1
27-01-2025,"Grains, Flours & Dals",KORRALU (FOXTAIL M) 1KG,4,150,110,40,1
27-01-2025,"Grains, Flours & Dals",UDALU (Barnyard millet) 1 kg,4,140,115,25,1
27-01-2025,"Grains, Flours & Dals",SAMALU (Little millet) 1 kg,4,170,130,40,1
27-01-2025,"Grains, Flours & Dals",SINGLE POLISH 1KG,4,325,325,0,5
27-01-2025,Pooja & Spiritual Items,GD Sambrani Cup Dhoop 10 PC,12,96,96,0,1
27-01-2025,Pooja & Spiritual Items,DASANGAM DHOOP POWDER 50GM,12,43,43,0,1
27-01-2025,"Grains, Flours & Dals",AISHWARYA SP 1KG,4,160,140,20,2
27-01-2025,Oils & Ghee,Sesame oil 1 L,9,590,560,30,1
27-01-2025,"Grains, Flours & Dals",Green gram 500 gms,4,75,70,5,1
27-01-2025,Sweeteners,YB Brown Sugar 1KG,16,140,140,0,1
27-01-2025,"Grains, Flours & Dals",KORRALU (FOXTAIL M) 1KG,4,150,110,40,1
27-01-2025,Snacks & Ready-to-Eat,VD MAIDA CHEGODI 175GM,14,60,60,0,1
27-01-2025,"Health, Wellness & Ayurvedic Products",RB FRUITS &amp;seeds Cranberries,5,45,45,0,1
27-01-2025,Snacks & Ready-to-Eat,VD MURUKU 175GM,14,60,60,0,1
27-01-2025,Snacks & Ready-to-Eat,PALLI LADDU 200GMS,14,90,70,20,1
27-01-2025,Milk & Dairy,BROWN EGGS 1P,7,84,72,12,6
27-01-2025,Personal Care & Cosmetics,GA DANT MANJAN TP 50GM,10,60,60,0,1
27-01-2025,Personal Care & Cosmetics,GAYATHRI KUMKUDUKAYA,10,150,150,0,1
27-01-2025,Snacks & Ready-to-Eat,Popcorn Seeds 250GM,14,45,40,5,1
27-01-2025,"Health, Wellness & Ayurvedic Products",RAMA BALM 10ML,5,40,40,0,1
27-01-2025,Spices & Seasonings,Masala Karam 250 gms,15,130,120,10,1
27-01-2025,"Grains, Flours & Dals",SRILALITHA MAIDA FLOUR 500G,4,32,32,0,1
27-01-2025,"Grains, Flours & Dals",Wheat Rava M 1KG,4,65,55,10,1
27-01-2025,"Grains, Flours & Dals",Wheat Flour 1 kg,4,70,60,10,1
27-01-2025,Spices & Seasonings,Jeera 100GM,15,50,45,5,1
27-01-2025,Personal Care & Cosmetics,GA DANT MANJAN TP 50GM,10,60,60,0,1
27-01-2025,Personal Care & Cosmetics,SVE RED SANDAL SOAP 100GM,10,90,90,0,1
27-01-2025,"Dry Fruits, Nuts & Seeds",SD Mango cubes 100gm,2,45,45,0,1
27-01-2025,"Grains, Flours & Dals",SA WHITE JOWAR RAVA 500GM,4,69,69,0,1
27-01-2025,Snacks & Ready-to-Eat,VD SAGOPAPAD 150GM,14,55,55,0,1
27-01-2025,Milk & Dairy,BROWN EGGS TRAY 30P,7,360,330,30,1
27-01-2025,"Grains, Flours & Dals",Em jowar idly R 500G,4,75,75,0,1
27-01-2025,Pooja & Spiritual Items,SS DASANGAM CONE 20PICS,12,45,45,0,1
27-01-2025,"Grains, Flours & Dals",DESI CHANA,4,25,25,0,1
27-01-2025,Spices & Seasonings,Black Till 250GM,15,90,75,15,1
27-01-2025,"Grains, Flours & Dals",RICE FLOUR 500 GM,4,35,28,7,1
27-01-2025,"Grains, Flours & Dals",Wheat Rava M 500GM,4,33,30,3,1
27-01-2025,"Grains, Flours & Dals",WHEAT 1 KG,4,60,50,10,1
27-01-2025,"Grains, Flours & Dals",Bajra Flour 1 kg,4,70,60,10,1
27-01-2025,Snacks & Ready-to-Eat,VD SAGOPAPAD 150GM,14,55,55,0,1
27-01-2025,General Household & Kitchenware,KITCHEN TOWEL,3,60,60,0,1
27-01-2025,"Grains, Flours & Dals",Yellow jowar .F1 kg,4,110,100,10,1
27-01-2025,"Grains, Flours & Dals",DESI CHANA,4,25,25,0,1
27-01-2025,"Grains, Flours & Dals",Wheat Flour 1 kg,4,70,60,10,1
27-01-2025,"Grains, Flours & Dals",Green gram 500 gms,4,75,70,5,1
27-01-2025,"Grains, Flours & Dals",RAGI FLOUR 500GRMS,4,40,35,5,1
27-01-2025,Snacks & Ready-to-Eat,KURNOOL MARMURA,14,70,55,15,1
27-01-2025,"Grains, Flours & Dals",FLOUR CHARGE,4,48,48,0,4
27-01-2025,"Grains, Flours & Dals",SA WHITE JOWAR RAVA 500GM,4,69,69,0,1
27-01-2025,"Grains, Flours & Dals",Em Foxtail upma r 500 g,4,109,109,0,1
27-01-2025,"Grains, Flours & Dals",Em little upma R 500g,4,129,129,0,1
27-01-2025,"Grains, Flours & Dals",SL Idly Rava 1KG,4,65,55,10,1
27-01-2025,"Grains, Flours & Dals",Urad dall 1 Kg,4,185,170,15,1
27-01-2025,"Grains, Flours & Dals",BASMATHI RICE 1KG,4,150,135,15,1
27-01-2025,"Grains, Flours & Dals",Urad dall 1 Kg,4,185,170,15,1
27-01-2025,"Grains, Flours & Dals",Brown RICE 1KG,4,350,325,25,5
27-01-2025,"Grains, Flours & Dals",BOMBAY RAVA,4,70,55,15,1
27-01-2025,"Grains, Flours & Dals",RICE FLOUR 1KG,4,70,55,15,1
27-01-2025,"Grains, Flours & Dals",RAGI FLOUR 1KG,4,80,70,10,1
27-01-2025,Sweeteners,NATURAL HONEY 250GM,16,150,130,20,1
27-01-2025,"Grains, Flours & Dals",FLOUR CHARGE,4,132,132,0,11
27-01-2025,Snacks & Ready-to-Eat,RINGS 200GM,14,30,30,0,1
27-01-2025,Household & Cleaning,HENKO MATIC TP 1KG,6,220,220,0,1
27-01-2025,Snacks & Ready-to-Eat,VD MINAPA VADIYAM,14,65,65,0,1
27-01-2025,Snacks & Ready-to-Eat,VD GUMMADI VADIYAM,14,75,75,0,1
27-01-2025,Spices & Seasonings,Masala Karam 250 gms,15,260,240,20,2
27-01-2025,Snacks & Ready-to-Eat,VD DAHI MIRCHI(SALTED) 100GM,14,45,45,0,1
27-01-2025,Household & Cleaning,LIZOL CITRUS 625ML,6,149,149,0,1
27-01-2025,Snacks & Ready-to-Eat,MAAGAANI M JOWAR PASTA 200GM,14,199,199,0,1
27-01-2025,Snacks & Ready-to-Eat,VD RED CHILLI RICEPAPAD 150GM,14,50,50,0,1
27-01-2025,"Grains, Flours & Dals",RICE FLOUR 500 GM,4,35,28,7,1
27-01-2025,Household & Cleaning,VIM MAHA BAR,6,30,30,0,3
27-01-2025,"Health, Wellness & Ayurvedic Products",MH Baby Food 400GM,5,200,200,0,1
27-01-2025,Household & Cleaning,ROOPERI PITAMBARI SILVER 50ML,6,110,110,0,1
27-01-2025,Oils & Ghee,Coconut oil 500 ml,9,220,200,20,1
27-01-2025,Oils & Ghee,Mustard oil 500 ml,9,220,195,25,1
27-01-2025,Pooja & Spiritual Items,GOMATHA AGARBATHI,12,75,75,0,1
27-01-2025,"Grains, Flours & Dals",Multigrain 1 kg,4,100,85,15,1
27-01-2025,"Health, Wellness & Ayurvedic Products",MD Yashtimadhu Choornam 50GM,5,80,80,0,1
27-01-2025,Snacks & Ready-to-Eat,VD JAGGERY GHEE 12PIC,14,180,180,0,1
27-01-2025,"Health, Wellness & Ayurvedic Products",YB APPLE CIDER VINEGAR500ML,5,500,450,50,1
27-01-2025,Spices & Seasonings,Jeera 100GM,15,50,45,5,1
27-01-2025,Snacks & Ready-to-Eat,ELITE ELAICHI RUSK 200GM,14,35,35,0,1
27-01-2025,"Grains, Flours & Dals",Wheat Flour 1 kg,4,70,60,10,1
27-01-2025,Sweeteners,MISHRI 250 GM,16,35,30,5,1
27-01-2025,Spices & Seasonings,Coriander seeds 200 gms,15,48,40,8,1
27-01-2025,"Grains, Flours & Dals",Idly Rava L 1KG,4,60,50,10,1
27-01-2025,Oils & Ghee,Groundnut oil 1 L,9,360,330,30,1
27-01-2025,Sweeteners,GS Palm Jaggery Powder 400GM,16,180,180,0,1
27-01-2025,Sweeteners,SUGAR 1KG,16,60,50,10,1
27-01-2025,Snacks & Ready-to-Eat,VD ARISELU 5 PIC,14,100,100,0,1
27-01-2025,"Dry Fruits, Nuts & Seeds",Groundnuts 1 kg,2,190,170,20,1
27-01-2025,"Grains, Flours & Dals",White jowar.F 500 Gms,4,50,40,10,1
27-01-2025,Snacks & Ready-to-Eat,Pani Poori Chips 250GM,14,50,40,10,1
27-01-2025,"Grains, Flours & Dals",SB Javva Wheat Ravva 500GM,4,95,95,0,1
27-01-2025,"Grains, Flours & Dals",RICE FLOUR 500 GM,4,35,28,7,1
27-01-2025,"Grains, Flours & Dals",RICE FLOUR 1KG,4,70,55,15,1
27-01-2025,"Grains, Flours & Dals",HS Multimillet idly R 500 gms,4,65,65,0,1
27-01-2025,"Grains, Flours & Dals",YB Red RICE 1 KG,4,150,120,30,1
27-01-2025,"Grains, Flours & Dals",Wheat Flour 1 kg,4,70,60,10,1
27-01-2025,Snacks & Ready-to-Eat,Corn Chips 250GM,14,40,35,5,1
27-01-2025,Snacks & Ready-to-Eat,PALLI LADDU 200GMS,14,90,70,20,1
27-01-2025,"Grains, Flours & Dals",idly/Dosa rice 1 kg,4,70,60,10,1
27-01-2025,"Grains, Flours & Dals",RAGI FLOUR 1KG,4,160,140,20,2
27-01-2025,Oils & Ghee,Groundnut oil 5 L,9,1800,"1,600.00",200,1
27-01-2025,"Grains, Flours & Dals",Chana Flour 1 kg,4,140,130,10,1
27-01-2025,Sweeteners,Natural Honey 500 gms,16,280,240,40,1
27-01-2025,Sweeteners,YB JAGGERY POWDER 500GMS,16,75,75,0,1
27-01-2025,Oils & Ghee,Coconut oil 1 L,9,440,400,40,1
27-01-2025,"Grains, Flours & Dals",Red uluvalu 250 gms,4,45,40,5,1
27-01-2025,Oils & Ghee,Mustard oil 1 L,9,390,390,0,1
27-01-2025,"Grains, Flours & Dals",GROUNDNUT CAKE,4,50,45,5,1
27-01-2025,Spices & Seasonings,PURO Healthy Salt 1KG,15,110,110,0,1
27-01-2025,Oils & Ghee,Groundnut oil 1 L,9,720,660,60,2
27-01-2025,"Grains, Flours & Dals",Black gram 500 gms,4,75,70,5,1
27-01-2025,"Grains, Flours & Dals",KORRALU (FOXTAIL M) 500GM,4,65,55,10,1
27-01-2025,"Grains, Flours & Dals",SESAME CAKE,4,60,50,10,1
27-01-2025,"Grains, Flours & Dals",RAGI FLOUR 500GRMS,4,40,35,5,1
27-01-2025,"Health, Wellness & Ayurvedic Products",MADDI NEEM OIL 100ML,5,110,110,0,1
27-01-2025,Oils & Ghee,Coconut oil 1 L,9,880,800,80,2
27-01-2025,Oils & Ghee,Groundnut oil 500ml,9,180,165,15,1
27-01-2025,"Grains, Flours & Dals",Wheat Rava S 500GM,4,33,30,3,1
27-01-2025,Personal Care & Cosmetics,ORAL B KIDS,10,25,25,0,1
27-01-2025,"Grains, Flours & Dals",SL Idly Rava 1KG,4,260,220,40,4
27-01-2025,"Grains, Flours & Dals",Wheat Rava M 1KG,4,65,55,10,1
27-01-2025,Personal Care & Cosmetics,SVE REETHA KUNKUDUKAYALU,10,199,199,0,1
27-01-2025,"Grains, Flours & Dals",Em jowar idly R 500G,4,150,150,0,2
27-01-2025,Oils & Ghee,Groundnut oil 5 L,9,1800,"1,600.00",200,1
27-01-2025,Personal Care & Cosmetics,HERBAL BATH POWDER 200GM,10,80,80,0,1
27-01-2025,"Grains, Flours & Dals",Idly Rava L 1KG,4,60,50,10,1
27-01-2025,Pooja & Spiritual Items,SWASTIK CAMPHOR 15GM,12,40,40,0,1
27-01-2025,Oils & Ghee,Sesame oil 500ml,9,295,280,15,1
27-01-2025,"Dry Fruits, Nuts & Seeds",PULMAKHANA 100 GM,2,180,170,10,1
27-01-2025,"Grains, Flours & Dals",RED TURDAL 500GM,4,75,70,5,1
27-01-2025,Oils & Ghee,Safflower oil 500 ml,9,220,200,20,1
27-01-2025,"Grains, Flours & Dals",Urad dall 1 Kg,4,185,170,15,1
27-01-2025,"Grains, Flours & Dals",Chittimuthaylu rice 1 kg,4,160,140,20,1
27-01-2025,Milk & Dairy,BROWN EGGS 1P,7,196,168,28,14
27-01-2025,"Grains, Flours & Dals",PESARA PAPPU 500GMS,4,85,75,10,1
27-01-2025,Snacks & Ready-to-Eat,SS IDLY BATTER 1KG,14,60,60,0,1
27-01-2025,Pickles & Cooking Pastes,SD TOMATO PICKLE,11,110,110,0,1
27-01-2025,Oils & Ghee,Sesame oil 500ml,9,295,280,15,1
27-01-2025,"Dry Fruits, Nuts & Seeds",PULMAKHANA 100 GM,2,180,170,10,1
27-01-2025,"Health, Wellness & Ayurvedic Products",MORINGA LEAF POWDER M,5,80,75,5,1
27-01-2025,Pooja & Spiritual Items,MD Havan Saamagri 50GM,12,60,60,0,1
27-01-2025,Snacks & Ready-to-Eat,SF MILLET PANCAKE CLASSIC 150GM,14,199,199,0,1
27-01-2025,Spices & Seasonings,MG Dasa dinasalu 250gm,15,220,220,0,1
27-01-2025,Snacks & Ready-to-Eat,COPRA LADDU 200GM,14,300,240,60,3
27-01-2025,"Grains, Flours & Dals",Bajra Flour 1 kg,4,70,60,10,1
27-01-2025,"Grains, Flours & Dals",turdal 1kg,4,220,195,25,1
27-01-2025,Snacks & Ready-to-Eat,SD High Protein Laddu 175gm,14,190,190,0,1
27-01-2025,Personal Care & Cosmetics,WOW VITAMIN C BODYLOTION 400ML,10,499,499,0,1
27-01-2025,Pooja & Spiritual Items,GD Kailash 60 GM,12,60,60,0,1
27-01-2025,Oils & Ghee,Groundnut oil 5 L,9,1800,"1,600.00",200,1
27-01-2025,Spices & Seasonings,PURO Healthy Salt 1KG,15,110,110,0,1
27-01-2025,"Grains, Flours & Dals",HS JOWAR FLAKES 250GM 1+1,4,119,119,0,1
27-01-2025,Snacks & Ready-to-Eat,COPRA LADDU 200GM,14,100,80,20,1
27-01-2025,"Grains, Flours & Dals",RAGI FLOUR 1KG,4,80,70,10,1
27-01-2025,Spices & Seasonings,SD IDLY KARAM,15,65,65,0,1
27-01-2025,"Health, Wellness & Ayurvedic Products",MD Neem Leaf Choornam 100GM,5,80,80,0,1
27-01-2025,Snacks & Ready-to-Eat,MAAGAANI JOWAR M COOKIES 120GM,14,149,149,0,1
27-01-2025,Snacks & Ready-to-Eat,ANNAPURNA APPALAM,14,35,35,0,1
27-01-2025,Snacks & Ready-to-Eat,SD JOWAR WITH PALM JAGGERY 250GM,14,135,135,0,1
27-01-2025,Snacks & Ready-to-Eat,PASTALICIOUS,14,175,175,0,1
27-01-2025,"Dry Fruits, Nuts & Seeds",Groundnuts 1 kg,2,190,170,20,1
27-01-2025,"Grains, Flours & Dals",Chittimuthaylu rice 1 kg,4,320,280,40,2
27-01-2025,"Dry Fruits, Nuts & Seeds",PULMAKHANA 100 GM,2,180,170,10,1
27-01-2025,Pooja & Spiritual Items,GD JASMINE 75GM,12,60,60,0,1
27-01-2025,Snacks & Ready-to-Eat,VD Minapa papad 200gm,14,60,60,0,1
27-01-2025,"Grains, Flours & Dals",Em jowar idly R 500G,4,150,150,0,2
27-01-2025,Snacks & Ready-to-Eat,RI SPORTS BAR 40G,14,45,45,0,1
27-01-2025,Sweeteners,YB JAGGERY POWDER 500GMS,16,75,75,0,1
27-01-2025,"Grains, Flours & Dals",Multigrain 1 kg,4,200,170,30,2
27-01-2025,Snacks & Ready-to-Eat,VD JAGGERY GHEE 12PIC,14,180,180,0,1
27-01-2025,Spices & Seasonings,PRO ORG CUMIN 100G,15,120,120,0,1
27-01-2025,Milk & Dairy,BROWN EGGS 1P,7,140,120,20,10
27-01-2025,Household & Cleaning,VIM 300GM,6,60,60,0,2
27-01-2025,"Grains, Flours & Dals",DH URAD GOTA 1KG,4,215,190,25,1
27-01-2025,Sweeteners,MADHUR SUGAR 1KG,16,65,55,10,1
27-01-2025,"Grains, Flours & Dals",SL Idly Rava 1KG,4,65,55,10,1
27-01-2025,"Grains, Flours & Dals",Wheat Rava M 500GM,4,33,30,3,1
27-01-2025,Household & Cleaning,EXO STEEL SCRUB,6,15,15,0,1
27-01-2025,Personal Care & Cosmetics,MYSORE SANDAL,10,164,164,0,2
27-01-2025,"Dry Fruits, Nuts & Seeds",PUTNALU 500GMS,2,90,76,14,1
27-01-2025,"Dry Fruits, Nuts & Seeds",Groundnuts 1 kg,2,190,170,20,1
27-01-2025,Snacks & Ready-to-Eat,MILLET PANCAKE CHOCOLATE,14,199,199,0,1
27-01-2025,Spices & Seasonings,Turmeric powder 250 gms,15,100,75,25,1
27-01-2025,"Grains, Flours & Dals",Multigrain 1 kg,4,100,85,15,1
27-01-2025,"Grains, Flours & Dals",RAGI FLOUR 500GRMS,4,40,35,5,1
27-01-2025,Milk & Dairy,BROWN EGGS TRAY 30P,7,360,330,30,1
27-01-2025,Snacks & Ready-to-Eat,MARMURA LADDU,14,80,60,20,1
27-01-2025,"Dry Fruits, Nuts & Seeds",KAJU HALF 250GM,2,310,290,20,1
27-01-2025,"Grains, Flours & Dals",FLOUR CHARGE,4,56.4,56.4,0,4.7
27-01-2025,"Grains, Flours & Dals",RAGULU 1 KG,4,35,30,5,0.5
27-01-2025,"Dry Fruits, Nuts & Seeds",SATHVI CHIA SEEDS 100GM,2,100,80,20,1
27-01-2025,"Health, Wellness & Ayurvedic Products",MH Womens Malt 500GM,5,250,240,10,1
27-01-2025,"Dry Fruits, Nuts & Seeds",DRYDATES YELLOW 250GM,2,135,120,15,1
27-01-2025,Pooja & Spiritual Items,VRP APOORVA JAVADHU POW,12,35,35,0,1
27-01-2025,Oils & Ghee,Groundnut oil 1 L,9,360,330,30,1
27-01-2025,Oils & Ghee,Coconut oil 1 L,9,440,400,40,1
27-01-2025,Oils & Ghee,Sesame oil 1 L,9,590,560,30,1
27-01-2025,"Grains, Flours & Dals",MELMEKER 250GMS,4,60,45,15,1
27-01-2025,"Grains, Flours & Dals",DESI CHANA,4,25,25,0,1
27-01-2025,"Grains, Flours & Dals",SABDANA,4,40,35,5,1
27-01-2025,Snacks & Ready-to-Eat,VD DAHI MIRCHI(SALTED) 100GM,14,45,45,0,1
27-01-2025,"Grains, Flours & Dals",Chittimuthaylu rice 1 kg,4,160,140,20,1
27-01-2025,Spices & Seasonings,pickles chilli .pwdr 500 gms,15,355,325,30,1
27-01-2025,"Grains, Flours & Dals",BASMATHI RICE 1KG,4,150,135,15,1
27-01-2025,"Dry Fruits, Nuts & Seeds",PULMAKHANA 100 GM,2,180,170,10,1
27-01-2025,Snacks & Ready-to-Eat,VD MIXTURE 175 GM,14,60,60,0,1
27-01-2025,Sweeteners,ACHU BELLAM 1KG,16,100,80,20,1
27-01-2025,"Grains, Flours & Dals",RICE FLOUR 500 GM,4,35,28,7,1
27-01-2025,Oils & Ghee,Groundnut oil 1 L,9,720,660,60,2
27-01-2025,Spices & Seasonings,TM MIRCH POWDER 200GM,15,163,163,0,1
27-01-2025,"Grains, Flours & Dals",Wheat Flour 1 kg,4,70,60,10,1
27-01-2025,Spices & Seasonings,Masala Karam 500 gms,15,520,480,40,2
27-01-2025,"Grains, Flours & Dals",FLOUR CHARGE,4,15.6,15.6,0,1.3
27-01-2025,Oils & Ghee,Groundnut oil 1 L,9,360,330,30,1
27-01-2025,"Grains, Flours & Dals",RAGI FLOUR 1KG,4,80,70,10,1
27-01-2025,"Grains, Flours & Dals",RAGI FLOUR 500GRMS,4,40,35,5,1
27-01-2025,"Health, Wellness & Ayurvedic Products",MH Millets Malt 500GM,5,200,190,10,1
27-01-2025,Snacks & Ready-to-Eat,RSC ORANGE 100GMS,14,20,20,0,1
27-01-2025,"Grains, Flours & Dals",Multigrain 1 kg,4,100,85,15,1
27-01-2025,"Grains, Flours & Dals",Wheat Flour 1 kg,4,70,60,10,1
27-01-2025,"Grains, Flours & Dals",PESARA PAPPU 500GMS,4,85,75,10,1
27-01-2025,Spices & Seasonings,NUVVULU 250GM,15,80,65,15,1
27-01-2025,Oils & Ghee,Groundnut oil 1 L,9,360,330,30,1
27-01-2025,"Grains, Flours & Dals",HS JOWAR FLAKES 250GM 1+1,4,119,119,0,1
27-01-2025,Pickles & Cooking Pastes,SD TOMATO PICKLE,11,110,110,0,1
27-01-2025,Spices & Seasonings,Turmeric powder 250 gms,15,100,75,25,1
27-01-2025,Pooja & Spiritual Items,SWASTIK CAMPHORE,12,90,90,0,1
27-01-2025,Milk & Dairy,SANGAM FULL CREAM MILK 500ML,7,38,38,0,1
27-01-2025,Oils & Ghee,Coconut oil 500 ml,9,220,200,20,1
27-01-2025,"Grains, Flours & Dals",SL Idly Rava 1KG,4,65,55,10,1
27-01-2025,"Grains, Flours & Dals",WHEAT 1 KG,4,300,250,50,5
27-01-2025,"Grains, Flours & Dals",Chana Flour 1 kg,4,280,260,20,2
27-01-2025,"Grains, Flours & Dals",SRILALITHA MAIDA FLOUR 500G,4,96,96,0,3
27-01-2025,Spices & Seasonings,RED COPRA 250GMS,15,85,74,11,1
27-01-2025,Beverages,BRU GREEN LABEL 1.2G,1,14,14,0,7
27-01-2025,Spices & Seasonings,Jeera 100GM,15,50,45,5,1
27-01-2025,Oils & Ghee,Sesame oil 1 L,9,1180,"1,120.00",60,2
27-01-2025,Oils & Ghee,Safflower oil 1 L,9,440,400,40,1
27-01-2025,"Grains, Flours & Dals",SRILATHA RICE RAVVA 500GM,4,35,35,0,1
27-01-2025,"Grains, Flours & Dals",RICE FLOUR 500 GM,4,35,28,7,1
27-01-2025,"Grains, Flours & Dals",SL Idly Rava 1KG,4,65,55,10,1
27-01-2025,Oils & Ghee,Groundnut oil 1 L,9,360,330,30,1
27-01-2025,"Grains, Flours & Dals",RAGI FLOUR 500GRMS,4,40,35,5,1
27-01-2025,Snacks & Ready-to-Eat,NGT CHATPATTA CHANA 90GM,14,25,25,0,1
27-01-2025,Snacks & Ready-to-Eat,PALLI LADDU 200GMS,14,90,70,20,1
27-01-2025,"Grains, Flours & Dals",Multigrain 1 kg,4,100,85,15,1
27-01-2025,Spices & Seasonings,YB PINK ROCK SALT 1KG,15,120,120,0,1
27-01-2025,"Grains, Flours & Dals",Green gram 1 kg,4,150,130,20,1
27-01-2025,Sweeteners,YB Brown Sugar 500GM,16,75,75,0,1
27-01-2025,Personal Care & Cosmetics,MD Henna Choornam 100GM,10,80,80,0,1
27-01-2025,"Grains, Flours & Dals",Em Multimillet idli r 500g,4,129,129,0,1
27-01-2025,"Grains, Flours & Dals",PRO SOYA CHUNKS 200G,4,79,79,0,1
27-01-2025,"Grains, Flours & Dals",RAGI FLOUR 500GRMS,4,40,35,5,1
27-01-2025,"Grains, Flours & Dals",FLOUR CHARGE,4,14.4,14.4,0,1.2
27-01-2025,Snacks & Ready-to-Eat,COPRA LADDU 200GM,14,100,80,20,1
27-01-2025,Personal Care & Cosmetics,GOW DURBAR NAVA 100GM SOAP,10,40,40,0,1
27-01-2025,"Grains, Flours & Dals",Green gram 500 gms,4,75,70,5,1
27-01-2025,Sweeteners,NATURAL HONEY 250GM,16,150,130,20,1
27-01-2025,Beverages,GANTASALA GREEN TEA 100GM,1,149,149,0,1
27-01-2025,"Grains, Flours & Dals",white Bobarlu 500 gms,4,80,75,5,1
27-01-2025,"Grains, Flours & Dals",Red Chana 500 GM,4,75,60,15,1
27-01-2025,Snacks & Ready-to-Eat,SATHVI MIXED CHIKKI 200GM,14,120,100,20,1
27-01-2025,"Dry Fruits, Nuts & Seeds",Groundnuts 500 gms,2,190,170,20,2
27-01-2025,"Grains, Flours & Dals",KORRALU (FOXTAIL M) 500GM,4,65,55,10,1
27-01-2025,"Grains, Flours & Dals",RAGULU 1 KG,4,70,60,10,1
27-01-2025,"Grains, Flours & Dals",SAMALU (Little millet) 500 gms,4,85,65,20,1
27-01-2025,"Grains, Flours & Dals",Multigrain 1 kg,4,100,85,15,1
27-01-2025,"Grains, Flours & Dals",SH WHEAT DALIYA 500GM,4,60,60,0,1
27-01-2025,Oils & Ghee,Groundnut oil 1 L,9,360,330,30,1
27-01-2025,"Grains, Flours & Dals",WHEAT 1 KG,4,480,400,80,8
27-01-2025,"Grains, Flours & Dals",FLOUR CHARGE,4,120,120,0,10
27-01-2025,"Grains, Flours & Dals",JOWAR WHITE 1 KG,4,160,140,20,2
27-01-2025,"Grains, Flours & Dals",KORRALU (FOXTAIL M) 500GM,4,65,55,10,1
27-01-2025,Spices & Seasonings,Turmeric powder 250 gms,15,100,75,25,1
27-01-2025,"Health, Wellness & Ayurvedic Products",DWI MADIPHALA 100ML,5,75,75,0,1
27-01-2025,"Health, Wellness & Ayurvedic Products",RAMA BALM 10ML,5,40,40,0,1
27-01-2025,"Grains, Flours & Dals",MELMEKER 250GMS,4,60,45,15,1
27-01-2025,Beverages,BRU GREEN LABEL 1.2G,1,144,144,0,72
27-01-2025,"Grains, Flours & Dals",KORRALU (FOXTAIL M) 500GM,4,65,55,10,1
27-01-2025,"Grains, Flours & Dals",HS JOWAR FLAKES 250GM 1+1,4,59,59,0,1
27-01-2025,"Grains, Flours & Dals",SAMALU (Little millet) 500 gms,4,85,65,20,1
27-01-2025,Oils & Ghee,Sesame oil 1 L,9,1180,"1,120.00",60,2
27-01-2025,"Grains, Flours & Dals",UDALU (Barnyard millet) 500 gms,4,70,60,10,1
27-01-2025,Oils & Ghee,GANTASALA A2 COW GHEE 500ML,9,550,550,0,1
27-01-2025,Pooja & Spiritual Items,SWAATHI GATTI DEEPAM VATTULU,12,30,30,0,1
27-01-2025,Oils & Ghee,Groundnut oil 1 L,9,360,330,30,1
27-01-2025,Snacks & Ready-to-Eat,MARMURA LADDU,14,80,60,20,1
27-01-2025,Snacks & Ready-to-Eat,PALLI LADDU 200GMS,14,90,70,20,1
27-01-2025,"Grains, Flours & Dals",RAGI FLOUR 1KG,4,80,70,10,1
27-01-2025,Milk & Dairy,HERITAGE TOTAL CURD 500GM,7,50,50,0,1
27-01-2025,Spices & Seasonings,ROYAL SAFFRON 400GRMS,15,65,65,0,1
27-01-2025,Milk & Dairy,HERITAGE TONED MILK 500ML,7,31,31,0,1
27-01-2025,"Grains, Flours & Dals",Yellow jowar .F1 kg,4,110,100,10,1
26-01-2025,Milk & Dairy,BROWN EGGS 1P,7,224,192,32,16
26-01-2025,Oils & Ghee,Groundnut oil 1 L,9,360,330,30,1
26-01-2025,"Health, Wellness & Ayurvedic Products",ORGANIC MORINGA POWER 100GM,5,249,249,0,1
26-01-2025,Spices & Seasonings,ROYAL SAFFRON 400GRMS,15,65,65,0,1
26-01-2025,Oils & Ghee,Groundnut oil 1 L,9,720,660,60,2
26-01-2025,Household & Cleaning,GAJANAND BLACK DRAGN 10STI,6,20,20,0,1
26-01-2025,Snacks & Ready-to-Eat,VD JAGGERY GHEE 12PIC,14,180,180,0,1
26-01-2025,"Grains, Flours & Dals",Multigrain 1 kg,4,300,255,45,3
26-01-2025,Snacks & Ready-to-Eat,Corn Chips 250GM,14,40,35,5,1
26-01-2025,"Grains, Flours & Dals",Wheat Flour 1 kg,4,420,360,60,6
26-01-2025,Milk & Dairy,BROWN EGGS 1P,7,84,72,12,6
26-01-2025,"Grains, Flours & Dals",PESARA PAPPU 500GMS,4,85,75,10,1
26-01-2025,Snacks & Ready-to-Eat,MIX MILLET NOODLES,14,75,75,0,1
26-01-2025,Snacks & Ready-to-Eat,BD PEARL MILLET NOODLES 200G,14,70,70,0,1
26-01-2025,Snacks & Ready-to-Eat,BD RED RICE NOODLES 200G,14,70,70,0,1
26-01-2025,Snacks & Ready-to-Eat,RINGS 200GM,14,30,30,0,1
26-01-2025,"Grains, Flours & Dals",Em Foxtail upma r 500 g,4,109,109,0,1
26-01-2025,Snacks & Ready-to-Eat,BD RAGI NOODLES,14,75,75,0,1
26-01-2025,Snacks & Ready-to-Eat,BATANA NGT 70GMS,14,20,20,0,1
26-01-2025,"Grains, Flours & Dals",SINGLE POLISH 1KG,4,130,130,0,2
26-01-2025,Oils & Ghee,Safflower oil 1 L,9,440,400,40,1
26-01-2025,"Grains, Flours & Dals",White Chana 250 GM,4,60,50,10,1
26-01-2025,Beverages,ASSAM ELAICHI TEA,1,199,199,0,1
26-01-2025,Snacks & Ready-to-Eat,VD BOONDI 175GM,14,60,60,0,1
26-01-2025,Oils & Ghee,Sesame oil 500ml,9,295,280,15,1
26-01-2025,"Grains, Flours & Dals",Red Chana 250GM,4,35,30,5,1
26-01-2025,Spices & Seasonings,Tamarind 500GM,15,160,130,30,1
26-01-2025,Snacks & Ready-to-Eat,SATHVI PALLI CHIKKI 200GM,14,100,80,20,1
26-01-2025,Snacks & Ready-to-Eat,VD Pappu Chekkalu 190gm,14,60,60,0,1
26-01-2025,Spices & Seasonings,DRY MIECHI 200GM,15,80,60,20,1
26-01-2025,"Grains, Flours & Dals",RAGI FLOUR 1KG,4,80,70,10,1
26-01-2025,Snacks & Ready-to-Eat,VD MIXTURE 175 GM,14,60,60,0,1
26-01-2025,Spices & Seasonings,Masala Karam 500 gms,15,260,240,20,1
26-01-2025,Oils & Ghee,Coconut oil 1 L,9,440,400,40,1
26-01-2025,Spices & Seasonings,GREEN SOUNF,15,60,40,20,1
26-01-2025,"Grains, Flours & Dals",Green gram 500 gms,4,75,70,5,1
26-01-2025,"Grains, Flours & Dals",AISHWARYA LOW GI RICE 5KG,4,700,525,175,1
26-01-2025,Snacks & Ready-to-Eat,VD DAHI MIRCHI(SALTED) 100GM,14,45,45,0,1
26-01-2025,Personal Care & Cosmetics,WILD STONE MUSK SOAP 125G,10,120,120,0,2
26-01-2025,"Dry Fruits, Nuts & Seeds",Groundnuts 500 gms,2,95,85,10,1
26-01-2025,"Grains, Flours & Dals",Red Chana 250GM,4,35,30,5,1
26-01-2025,"Dry Fruits, Nuts & Seeds",FLAX SEEDS 250GM,2,60,50,10,1
26-01-2025,Spices & Seasonings,Lavangam 50GM,15,60,50,10,1
26-01-2025,Spices & Seasonings,SATHVI BIRYANI LEAF 25GM,15,30,20,10,1
26-01-2025,"Dry Fruits, Nuts & Seeds",GF DATES 500GM,2,156,149,7,1
26-01-2025,Spices & Seasonings,NUVVULU 250GM,15,80,65,15,1
26-01-2025,Oils & Ghee,Safflower oil 1 L,9,440,400,40,1
26-01-2025,"Grains, Flours & Dals",RAGULU 1 KG,4,35,30,5,0.5
26-01-2025,Spices & Seasonings,SAJEERA,15,60,40,20,1
26-01-2025,Spices & Seasonings,Black Till 250GM,15,90,75,15,1
26-01-2025,Snacks & Ready-to-Eat,MARMURA LADDU,14,80,60,20,1
26-01-2025,Spices & Seasonings,DRY MIECHI 200GM,15,80,60,20,1
26-01-2025,"Dry Fruits, Nuts & Seeds",Groundnuts 500 gms,2,95,85,10,1
26-01-2025,"Grains, Flours & Dals",SINGLE POLISH 1KG,4,390,390,0,6
26-01-2025,"Grains, Flours & Dals",Multigrain 1 kg,4,100,85,15,1
26-01-2025,Oils & Ghee,Sesame oil 1 L,9,590,560,30,1
26-01-2025,Oils & Ghee,Safflower oil 1 L,9,880,800,80,2
26-01-2025,Oils & Ghee,Coconut oil 500 ml,9,440,400,40,2
26-01-2025,Oils & Ghee,Sesame oil 1 L,9,590,560,30,1
26-01-2025,"Dry Fruits, Nuts & Seeds",Groundnuts 500 gms,2,95,85,10,1
26-01-2025,"Grains, Flours & Dals",Brown RICE 1KG,4,70,65,5,1
26-01-2025,"Grains, Flours & Dals",Multigrain 1 kg,4,200,170,30,2
26-01-2025,"Grains, Flours & Dals",MAATEJA rice 1 kg,4,288,276,12,4
26-01-2025,Snacks & Ready-to-Eat,VD NUVULU CHEGODI 175GM,14,60,60,0,1
26-01-2025,"Health, Wellness & Ayurvedic Products",MH Millets Malt 500GM,5,200,190,10,1
26-01-2025,Snacks & Ready-to-Eat,VD MURUKU 175GM,14,60,60,0,1
26-01-2025,Spices & Seasonings,Turmeric powder 250 gms,15,100,75,25,1
26-01-2025,Sweeteners,Mishri 500GM,16,70,60,10,1
26-01-2025,"Grains, Flours & Dals",White jowar.F 1 kg,4,200,160,40,2
26-01-2025,General Household & Kitchenware,BB BOWL,3,420,378,42,1
26-01-2025,"Grains, Flours & Dals",SINGLE POLISH 1KG,4,325,325,0,5
26-01-2025,"Dry Fruits, Nuts & Seeds",WATERMELON SEEDS 250GRM,2,320,280,40,1
26-01-2025,"Grains, Flours & Dals",RAGI FLOUR 1KG,4,160,140,20,2
26-01-2025,"Dry Fruits, Nuts & Seeds",PUMPKIN SEEDS 250GM,2,200,160,40,1
26-01-2025,Spices & Seasonings,MD Sonti Powder 50GM,15,80,80,0,1
26-01-2025,Oils & Ghee,Sesame oil 1 L,9,590,560,30,1
26-01-2025,"Health, Wellness & Ayurvedic Products",MD Guduchi Choornam 100GM,5,110,110,0,1
26-01-2025,Spices & Seasonings,KALONJI SEEDS,15,90,80,10,1
26-01-2025,"Health, Wellness & Ayurvedic Products",MD Aamlaki Choornam 100GM,5,80,80,0,1
26-01-2025,Oils & Ghee,Safflower oil 1 L,9,440,400,40,1
26-01-2025,"Dry Fruits, Nuts & Seeds",SUNFLOWER SEEDS 250GRM,2,150,130,20,1
26-01-2025,Oils & Ghee,Safflower oil 1 L,9,440,400,40,1
26-01-2025,Oils & Ghee,Coconut oil 1 L,9,440,400,40,1
26-01-2025,Personal Care & Cosmetics,MESWAK 100GM,10,70,70,0,1
26-01-2025,"Grains, Flours & Dals",HS Jowar upma rava 500 gms,4,65,65,0,1
26-01-2025,"Grains, Flours & Dals",Green gram 500 gms,4,75,70,5,1
26-01-2025,"Grains, Flours & Dals",SL Idly Rava 1KG,4,65,55,10,1
26-01-2025,"Grains, Flours & Dals",SB Javva Wheat Ravva 500GM,4,95,95,0,1
26-01-2025,Beverages,RED LABEL NATURAL CARE 100G,1,65,65,0,1
26-01-2025,"Grains, Flours & Dals",Quinova 1 kg,4,220,195,25,1
26-01-2025,"Grains, Flours & Dals",SRILATHA RICE RAVVA 500GM,4,35,35,0,1
26-01-2025,"Grains, Flours & Dals",HS Multimillet idly R 500 gms,4,65,65,0,1
26-01-2025,General Household & Kitchenware,VERMI COMPOST MIX,3,30,30,0,1
26-01-2025,"Grains, Flours & Dals",Wheat Flour 1 kg,4,70,60,10,1
26-01-2025,"Grains, Flours & Dals",Multigrain 1 kg,4,200,170,30,2
26-01-2025,"Grains, Flours & Dals",SINGLE POLISH 1KG,4,130,130,0,2
26-01-2025,"Grains, Flours & Dals",SB Javva Wheat Ravva 500GM,4,95,95,0,1
26-01-2025,"Grains, Flours & Dals",HS Multimillet idly R 500 gms,4,65,65,0,1
26-01-2025,Personal Care & Cosmetics,ROUND LOOFAH,10,65,65,0,1
26-01-2025,"Grains, Flours & Dals",Red uluvalu 500 gms,4,90,75,15,1
26-01-2025,Spices & Seasonings,NUVVULU 250GM,15,100,85,15,1
26-01-2025,"Grains, Flours & Dals",Black uluvalu 500 gms,4,90,90,0,1
26-01-2025,"Grains, Flours & Dals",HS Jowar upma rava 500 gms,4,65,65,0,1
26-01-2025,Oils & Ghee,Coconut oil 1 L,9,440,400,40,1
26-01-2025,"Health, Wellness & Ayurvedic Products",SAI DURGA MORINGA LEAVES 100GM,5,75,75,0,1
26-01-2025,Snacks & Ready-to-Eat,SATHVI REGIVADA 200GM,14,80,60,20,1
26-01-2025,"Grains, Flours & Dals",Multigrain 1 kg,4,100,85,15,1
26-01-2025,"Grains, Flours & Dals",Em Multimillet upma 500g,4,129,129,0,1
26-01-2025,"Grains, Flours & Dals",URAD DALL,4,95,85,10,1
26-01-2025,Oils & Ghee,Groundnut oil 1 L,9,360,330,30,1
26-01-2025,Snacks & Ready-to-Eat,VD Minapa papad 200gm,14,60,60,0,1
26-01-2025,"Grains, Flours & Dals",CHANA DAL 500GM,4,70,60,10,1
26-01-2025,Spices & Seasonings,DRY MIECHI 200GM,15,80,60,20,1
26-01-2025,"Grains, Flours & Dals",THIN POHA 500GM,4,40,35,5,1
26-01-2025,Spices & Seasonings,DURGA SALT CRYSTAL 1KG,15,25,25,0,1
26-01-2025,Spices & Seasonings,Coriander seeds 200 gms,15,48,40,8,1
26-01-2025,Snacks & Ready-to-Eat,PALLI LADDU 200GMS,14,180,140,40,2
26-01-2025,"Dry Fruits, Nuts & Seeds",GF DATES 500GM,2,156,149,7,1
26-01-2025,Oils & Ghee,Coconut oil 500 ml,9,220,200,20,1
26-01-2025,"Grains, Flours & Dals",Multigrain 1 kg,4,200,170,30,2
26-01-2025,Snacks & Ready-to-Eat,MARMURA LADDU,14,80,60,20,1
26-01-2025,"Dry Fruits, Nuts & Seeds",PUTNALU 500GMS,2,90,76,14,1
26-01-2025,"Grains, Flours & Dals",turdal 500 gms,4,110,100,10,1
26-01-2025,Snacks & Ready-to-Eat,COPRA LADDU 200GM,14,100,80,20,1
26-01-2025,Oils & Ghee,Groundnut oil 1 L,9,360,330,30,1
26-01-2025,Snacks & Ready-to-Eat,VD Pappu Chekkalu 190gm,14,60,60,0,1
26-01-2025,Snacks & Ready-to-Eat,SATHVI PALLI CHIKKI 200GM,14,100,80,20,1
26-01-2025,Snacks & Ready-to-Eat,MARMURA LADDU,14,80,60,20,1
26-01-2025,"Dry Fruits, Nuts & Seeds",SALTED PISTA 250GM,2,400,350,50,1
26-01-2025,"Grains, Flours & Dals",Green gram 500 gms,4,75,70,5,1
26-01-2025,Milk & Dairy,BROWN EGGS 1P,7,168,144,24,12
26-01-2025,Oils & Ghee,Sesame oil 1 L,9,590,560,30,1
26-01-2025,"Health, Wellness & Ayurvedic Products",RB Max Protein Spanish Tomato,5,45,45,0,1
26-01-2025,Snacks & Ready-to-Eat,COPRA LADDU 200GM,14,100,80,20,1
26-01-2025,"Health, Wellness & Ayurvedic Products",RB Max Protein Oats &Raisins 55gm,5,50,50,0,1
26-01-2025,"Grains, Flours & Dals",Wheat Rava M 500GM,4,33,30,3,1
26-01-2025,Pooja & Spiritual Items,OM SAINATH ISOBORNEOL 10GM,12,60,60,0,1
26-01-2025,"Dry Fruits, Nuts & Seeds",Groundnuts 500 gms,2,95,85,10,1
26-01-2025,Snacks & Ready-to-Eat,VD Minapa papad 200gm,14,60,60,0,1
26-01-2025,Snacks & Ready-to-Eat,PALLI LADDU 200GMS,14,90,70,20,1
26-01-2025,"Grains, Flours & Dals",Wheat Flour 1 kg,4,70,60,10,1
26-01-2025,"Dry Fruits, Nuts & Seeds",Putnalu 250GM,2,45,38,7,1
26-01-2025,"Health, Wellness & Ayurvedic Products",AMLAKI CHOORNAM,5,100,100,0,1
26-01-2025,Milk & Dairy,BROWN EGGS 1P,7,84,72,12,6
26-01-2025,Spices & Seasonings,KALONJI SEEDS,15,90,80,10,1
26-01-2025,Oils & Ghee,Sesame oil 500ml,9,295,280,15,1
26-01-2025,Spices & Seasonings,SWEET SOUNF,15,20,20,0,1
26-01-2025,Oils & Ghee,Sesame oil 500ml,9,295,280,15,1
26-01-2025,"Grains, Flours & Dals",White jowar.F 1 kg,4,200,160,40,2
26-01-2025,"Grains, Flours & Dals",Multigrain 1 kg,4,200,170,30,2
26-01-2025,Snacks & Ready-to-Eat,NGT CHATPATTA CHANA 90GM,14,50,50,0,2
26-01-2025,"Grains, Flours & Dals",THICK POHA 500GM,4,40,35,5,1
26-01-2025,"Grains, Flours & Dals",Wheat Flour 2 kgs,4,140,120,20,1
26-01-2025,Oils & Ghee,Safflower oil 1 L,9,440,400,40,1
26-01-2025,Snacks & Ready-to-Eat,BATANA NGT 70GMS,14,40,40,0,2
26-01-2025,"Grains, Flours & Dals",Wheat Rava S 500GM,4,33,30,3,1
26-01-2025,Snacks & Ready-to-Eat,COPRA LADDU 200GM,14,100,80,20,1
26-01-2025,"Grains, Flours & Dals",RAJMA 250GM,4,55,45,10,1
26-01-2025,Snacks & Ready-to-Eat,DOSA BATTER 1KG,14,60,60,0,1
26-01-2025,"Grains, Flours & Dals",Red Chana 500 GM,4,75,60,15,1
26-01-2025,Personal Care & Cosmetics,Soapnut 500GM,10,90,90,0,1
26-01-2025,"Grains, Flours & Dals",BASMATHI RICE 1KG,4,150,135,15,1
26-01-2025,Oils & Ghee,Sesame oil 1 L,9,590,560,30,1
26-01-2025,Oils & Ghee,Groundnut oil 1 L,9,360,330,30,1
26-01-2025,"Health, Wellness & Ayurvedic Products",RB Max Protein Spanish Tomato,5,45,45,0,1
26-01-2025,Snacks & Ready-to-Eat,WHITE SESAME CHIKKI,14,40,40,0,4
26-01-2025,"Grains, Flours & Dals",SB Javva Wheat Ravva 500GM,4,95,95,0,1
26-01-2025,Snacks & Ready-to-Eat,VD ATUKULU MIXTURE 175GM,14,60,60,0,1
26-01-2025,Oils & Ghee,Sesame oil 1 L,9,590,560,30,1
26-01-2025,"Grains, Flours & Dals",RAGI FLOUR 500GRMS,4,40,35,5,1
26-01-2025,"Grains, Flours & Dals",Em Multimillet upma 500g,4,129,129,0,1
26-01-2025,Snacks & Ready-to-Eat,VD BELLAM GAVVALU 200GM,14,60,60,0,1
26-01-2025,Snacks & Ready-to-Eat,BLACK SESAME CHIKKI,14,40,40,0,4
26-01-2025,"Grains, Flours & Dals",SH JOWAR DALIYA,4,65,65,0,1
26-01-2025,"Grains, Flours & Dals",Brown RICE 1KG,4,210,195,15,3
26-01-2025,"Health, Wellness & Ayurvedic Products",RAMA BALM 10ML,5,40,40,0,1
26-01-2025,Personal Care & Cosmetics,MYSORE SANDAL SOAP 75G,10,42,42,0,1
26-01-2025,Spices & Seasonings,SD Curry Leaves Karam Powder 100GM,15,65,65,0,1
26-01-2025,"Grains, Flours & Dals",AS Maize Rava 500GM,4,84,76,8,2
26-01-2025,"Grains, Flours & Dals",Red uluvalu 250 gms,4,45,40,5,1
26-01-2025,"Grains, Flours & Dals",Wheat Flour 1 kg,4,70,60,10,1
26-01-2025,"Grains, Flours & Dals",SINGHAM 26KG BAG,4,1650,"1,650.00",0,1
26-01-2025,Snacks & Ready-to-Eat,MILK BREAD,14,55,55,0,1
26-01-2025,Spices & Seasonings,GS GARLIC KARAM 100GM,15,75,75,0,1
26-01-2025,Pickles & Cooking Pastes,SD RED CHILLI PICKLE,11,110,110,0,1
26-01-2025,Oils & Ghee,Coconut oil 500 ml,9,220,200,20,1
26-01-2025,Pooja & Spiritual Items,GOMATHA AGARBATHI,12,75,75,0,1
26-01-2025,Spices & Seasonings,Vamu 100GM,15,60,50,10,1
26-01-2025,"Grains, Flours & Dals",Wheat Flour 1 kg,4,140,120,20,2
26-01-2025,Spices & Seasonings,GREEN SOUNF,15,60,40,20,1
26-01-2025,Sweeteners,Natural Honey 500 gms,16,280,240,40,1
26-01-2025,Oils & Ghee,Groundnut oil 1 L,9,360,330,30,1
26-01-2025,Pooja & Spiritual Items,SOSR SWATHHI 365,12,30,30,0,1
26-01-2025,"Grains, Flours & Dals",RAGI FLOUR 1KG,4,80,70,10,1
26-01-2025,"Grains, Flours & Dals",Bombay Rava 500GM,4,35,30,5,1
26-01-2025,"Grains, Flours & Dals",Wheat Rava M 1KG,4,65,55,10,1
26-01-2025,"Grains, Flours & Dals",RAGI FLOUR 1KG,4,80,70,10,1
26-01-2025,Snacks & Ready-to-Eat,COPRA LADDU 200GM,14,100,80,20,1
26-01-2025,Beverages,BRU GREEN LABEL 100G,1,65,65,0,1
26-01-2025,Snacks & Ready-to-Eat,SATHVI MIXED CHIKKI 200GM,14,120,100,20,1
26-01-2025,"Dry Fruits, Nuts & Seeds",PULMAKHANA 100 GM,2,180,170,10,1
26-01-2025,"Grains, Flours & Dals",Chana Flour 500 gms,4,70,65,5,1
26-01-2025,Personal Care & Cosmetics,UVIS RED SANDAL SOAP 100GM,10,85,85,0,1
26-01-2025,"Grains, Flours & Dals",Wheat Flour 1 kg,4,140,120,20,2
26-01-2025,Snacks & Ready-to-Eat,SESAME LADDU 200GM,14,100,80,20,1
26-01-2025,Milk & Dairy,BROWN EGGS TRAY 30P,7,360,330,30,1
26-01-2025,"Dry Fruits, Nuts & Seeds",SD Mango cubes 100gm,2,45,45,0,1
26-01-2025,Snacks & Ready-to-Eat,VD Minapa papad 200gm,14,60,60,0,1
26-01-2025,"Dry Fruits, Nuts & Seeds",YELLOW KISHMISH 250GM,2,130,110,20,1
26-01-2025,"Dry Fruits, Nuts & Seeds",GF KIMIA DATES 500GM,2,310,190,120,1
26-01-2025,"Dry Fruits, Nuts & Seeds",PUMPKIN SEEDS 250GM,2,200,160,40,1
26-01-2025,"Grains, Flours & Dals",RAJMA 250GM,4,55,45,10,1
26-01-2025,"Grains, Flours & Dals",RAGI FLOUR 1KG,4,80,70,10,1
26-01-2025,Pooja & Spiritual Items,VRP APOORVA JAVADHU POW,12,35,35,0,1
26-01-2025,"Health, Wellness & Ayurvedic Products",MXP CREAM ONION,5,45,45,0,1
26-01-2025,"Grains, Flours & Dals",MELMEKER 250GMS,4,60,45,15,1
26-01-2025,"Grains, Flours & Dals",Yellow jowar .F1 kg,4,110,100,10,1
26-01-2025,Snacks & Ready-to-Eat,TILLI CHIKKI,14,5,5,0,1
26-01-2025,Pooja & Spiritual Items,GB Bharatha Woods 75GM,12,60,60,0,1
26-01-2025,Snacks & Ready-to-Eat,RSC ORANGE 100GMS,14,20,20,0,1
26-01-2025,"Dry Fruits, Nuts & Seeds",FLAX SEEDS 250GM,2,60,50,10,1
26-01-2025,Oils & Ghee,Groundnut oil 1 L,9,360,330,30,1
26-01-2025,"Grains, Flours & Dals",Wheat Rava M 500GM,4,33,30,3,1
26-01-2025,"Dry Fruits, Nuts & Seeds",WATERMELON SEEDS 250GRM,2,320,280,40,1
26-01-2025,"Dry Fruits, Nuts & Seeds",PUMPKIN SEEDS 250GM,2,200,160,40,1
26-01-2025,Spices & Seasonings,NUVVULU 250GM,15,80,65,15,1
26-01-2025,"Dry Fruits, Nuts & Seeds",SUNFLOWER SEEDS 250GRM,2,150,130,20,1
26-01-2025,Snacks & Ready-to-Eat,RAJGIRA PEANUT CHIKKI,14,5,5,0,1
26-01-2025,"Grains, Flours & Dals",HS jowar idly rava 500 gms,4,65,65,0,1
26-01-2025,Oils & Ghee,Coconut oil 500 ml,9,220,200,20,1
26-01-2025,"Grains, Flours & Dals",Yellow jowar .F1 kg,4,220,200,20,2
26-01-2025,"Grains, Flours & Dals",HS Multimillet idly R 500 gms,4,65,65,0,1
26-01-2025,"Grains, Flours & Dals",Wheat Flour 1 kg,4,140,120,20,2
26-01-2025,Milk & Dairy,BROWN EGGS TRAY 30P,7,360,330,30,1
26-01-2025,Spices & Seasonings,RED COPRA 500GM,15,170,148,22,1
26-01-2025,"Grains, Flours & Dals",Chana Flour 500 gms,4,70,65,5,1
26-01-2025,"Grains, Flours & Dals",Brown RICE 1KG,4,140,130,10,2
26-01-2025,Spices & Seasonings,Turmeric powder 250 gms,15,100,75,25,1
26-01-2025,"Grains, Flours & Dals",SPLIT BLACK GRAM 500 GM,4,90,85,5,1
26-01-2025,"Grains, Flours & Dals",Wheat Flour 1 kg,4,70,60,10,1
26-01-2025,"Grains, Flours & Dals",Multigrain 1 kg,4,100,85,15,1
26-01-2025,"Grains, Flours & Dals",RAGI FLOUR 1KG,4,80,70,10,1
26-01-2025,Snacks & Ready-to-Eat,BATANA NGT 70GMS,14,20,20,0,1
26-01-2025,"Grains, Flours & Dals",SINGLE POLISH 1KG,4,650,650,0,10
26-01-2025,Snacks & Ready-to-Eat,ZEEDI,14,70,70,0,1
26-01-2025,"Grains, Flours & Dals",CORN FLOUR,4,80,70,10,1
26-01-2025,"Grains, Flours & Dals",Chana Flour 500 gms,4,70,65,5,1
26-01-2025,"Grains, Flours & Dals",White jowar.F 1 kg,4,100,80,20,1
26-01-2025,"Grains, Flours & Dals",Wheat Flour 1 kg,4,70,60,10,1
26-01-2025,"Grains, Flours & Dals",VGR RICE 5 KGS,4,350,325,25,1
26-01-2025,"Health, Wellness & Ayurvedic Products",RB Max Protein NUTS &SEEDS 55gm,5,50,50,0,1
26-01-2025,Milk & Dairy,BROWN EGGS TRAY 30P,7,360,330,30,1
26-01-2025,Sweeteners,ACHU BELLAM 1KG,16,100,80,20,1
26-01-2025,"Grains, Flours & Dals",SINGLE POLISH 1KG,4,650,650,0,10
26-01-2025,"Grains, Flours & Dals",Urad dall 1 Kg,4,185,170,15,1
26-01-2025,"Dry Fruits, Nuts & Seeds",Groundnuts 500 gms,2,95,85,10,1
26-01-2025,Snacks & Ready-to-Eat,VD MAIDA CHEGODI 175GM,14,60,60,0,1
26-01-2025,"Grains, Flours & Dals",BAJRA 1 KG,4,60,50,10,1
26-01-2025,Snacks & Ready-to-Eat,BLACK SESAME CHIKKI,14,10,10,0,1
26-01-2025,"Grains, Flours & Dals",PESARA PAPPU 500GMS,4,85,75,10,1
26-01-2025,Snacks & Ready-to-Eat,VD VAMUPUSA 175GM,14,60,60,0,1
26-01-2025,"Grains, Flours & Dals",URAD DALL,4,95,85,10,1
26-01-2025,"Grains, Flours & Dals",Wheat Flour 1 kg,4,70,60,10,1
26-01-2025,"Grains, Flours & Dals",SA Sprouted Ragi Flour 500GM,4,69,69,0,1
26-01-2025,Spices & Seasonings,ROYAL SAFFRON 400GRMS,15,65,65,0,1
26-01-2025,Personal Care & Cosmetics,UVIS LACTO TAN SOAP 100GM,10,99,99,0,1
26-01-2025,"Dry Fruits, Nuts & Seeds",Groundnuts 500 gms,2,95,85,10,1
26-01-2025,"Grains, Flours & Dals",RICE FLOUR 1KG,4,70,55,15,1
26-01-2025,Personal Care & Cosmetics,COLGATE STRONG TEETH,10,20,20,0,1
26-01-2025,Oils & Ghee,Groundnut oil 1 L,9,360,330,30,1
26-01-2025,Snacks & Ready-to-Eat,COPRA LADDU 200GM,14,100,80,20,1
26-01-2025,Oils & Ghee,Safflower oil 1 L,9,440,400,40,1
26-01-2025,Personal Care & Cosmetics,Soapnut 250GM,10,45,45,0,1
26-01-2025,Snacks & Ready-to-Eat,SATHVI REGIVADA 200GM,14,80,60,20,1
26-01-2025,"Dry Fruits, Nuts & Seeds",PULMAKHANA 100 GM,2,180,170,10,1
26-01-2025,Snacks & Ready-to-Eat,VD Minapa papad 200gm,14,60,60,0,1
26-01-2025,"Grains, Flours & Dals",Red Chana 250GM,4,35,30,5,1
26-01-2025,"Dry Fruits, Nuts & Seeds",YELLOW KISHMISH 250GM,2,130,110,20,1
26-01-2025,"Dry Fruits, Nuts & Seeds",PUMPKIN SEEDS 250GM,2,200,160,40,1
26-01-2025,Snacks & Ready-to-Eat,PALLI LADDU 200GMS,14,90,70,20,1
26-01-2025,"Grains, Flours & Dals",Green gram 500 gms,4,75,70,5,1
26-01-2025,"Dry Fruits, Nuts & Seeds",GF DATES 500GM,2,156,149,7,1
26-01-2025,Snacks & Ready-to-Eat,SESAME LADDU 200GM,14,100,80,20,1
26-01-2025,Snacks & Ready-to-Eat,PALLI LADDU 200GMS,14,90,70,20,1
26-01-2025,Snacks & Ready-to-Eat,ZEEDI,14,70,70,0,1
26-01-2025,Spices & Seasonings,Masala Karam 250 gms,15,130,120,10,1
26-01-2025,"Grains, Flours & Dals",BAJRA 1 KG,4,60,50,10,1
26-01-2025,Snacks & Ready-to-Eat,RI SPORTS BAR 40G,14,45,45,0,1
26-01-2025,"Grains, Flours & Dals",Wheat Flour 1 kg,4,70,60,10,1
26-01-2025,"Grains, Flours & Dals",SAMALU (Little millet) 1 kg,4,170,130,40,1
26-01-2025,"Grains, Flours & Dals",KORRALU (FOXTAIL M) 1KG,4,150,110,40,1
26-01-2025,"Grains, Flours & Dals",JOWAR WHITE 1 KG,4,80,70,10,1
26-01-2025,Snacks & Ready-to-Eat,Pani Poori Chips 250GM,14,100,80,20,2
26-01-2025,"Grains, Flours & Dals",Bajra Flour 500 gms,4,35,30,5,1
26-01-2025,"Grains, Flours & Dals",THICK POHA 500GM,4,40,35,5,1
26-01-2025,Spices & Seasonings,EVEREST PANI PURI MASALA 50GM,15,40,40,0,1
26-01-2025,Snacks & Ready-to-Eat,Corn Chips 250GM,14,40,35,5,1
26-01-2025,"Grains, Flours & Dals",RAGI FLOUR 500GRMS,4,40,35,5,1
26-01-2025,Oils & Ghee,Sesame oil 1 L,9,590,560,30,1
26-01-2025,Oils & Ghee,Groundnut oil 1 L,9,1080,990,90,3
26-01-2025,"Grains, Flours & Dals",Wheat Rava M 1KG,4,65,55,10,1
26-01-2025,"Grains, Flours & Dals",RICE FLOUR 1KG,4,70,55,15,1
26-01-2025,Oils & Ghee,Groundnut oil 1 L,9,360,330,30,1
26-01-2025,"Grains, Flours & Dals",SPLIT BLACK GRAM 500 GM,4,90,85,5,1
26-01-2025,"Grains, Flours & Dals",Yellow jowar .F1 kg,4,220,200,20,2
26-01-2025,"Dry Fruits, Nuts & Seeds",SUNFLOWER SEEDS 250GRM,2,300,260,40,2
26-01-2025,"Grains, Flours & Dals",SAMALU (Little millet) 500 gms,4,85,65,20,1
26-01-2025,"Grains, Flours & Dals",SL Idly Rava 1KG,4,65,55,10,1
26-01-2025,Snacks & Ready-to-Eat,SD SESAME PAPAD,14,80,80,0,1
26-01-2025,"Dry Fruits, Nuts & Seeds",Groundnuts 1 kg,2,190,170,20,1
26-01-2025,Snacks & Ready-to-Eat,MARMURA LADDU,14,80,60,20,1
26-01-2025,"Grains, Flours & Dals",SPLIT BLACK GRAM 500 GM,4,90,85,5,1
26-01-2025,"Grains, Flours & Dals",Brown RICE 1KG,4,350,325,25,5
26-01-2025,"Grains, Flours & Dals",MELMEKER 250GMS,4,60,45,15,1
26-01-2025,"Grains, Flours & Dals",Idly Rava L 1KG,4,120,100,20,2
26-01-2025,"Grains, Flours & Dals",split black gram 1 kg,4,180,170,10,1
26-01-2025,"Grains, Flours & Dals",URAD DALL,4,95,85,10,1
26-01-2025,"Grains, Flours & Dals",Quinova 1 kg,4,220,195,25,1
26-01-2025,"Grains, Flours & Dals",BOMBAY RAVA,4,70,55,15,1
26-01-2025,"Grains, Flours & Dals",Wheat Flour 1 kg,4,70,60,10,1
26-01-2025,"Grains, Flours & Dals",Multigrain 1 kg,4,100,85,15,1
26-01-2025,Sweeteners,NATURAL HONEY 1KG,16,560,480,80,1
26-01-2025,"Grains, Flours & Dals",turdal 500 gms,4,110,100,10,1
26-01-2025,"Grains, Flours & Dals",CHANA DAL 1KG,4,280,240,40,2
26-01-2025,"Grains, Flours & Dals",SB Javva Wheat Ravva 500GM,4,190,190,0,2
26-01-2025,"Grains, Flours & Dals",MAAGAANI LOW GI SP L 1KG,4,360,315,45,3
26-01-2025,Snacks & Ready-to-Eat,BB ROASTED VERMICELLY 850GM,14,117,117,0,1
26-01-2025,Beverages,RED LABEL NATURAL CARE 100G,1,65,65,0,1
26-01-2025,Oils & Ghee,Coconut oil 1 L,9,440,400,40,1
26-01-2025,Milk & Dairy,BROWN EGGS 1P,7,280,240,40,20
26-01-2025,"Grains, Flours & Dals",SABDANA 500GM,4,90,70,20,1
26-01-2025,Snacks & Ready-to-Eat,SD barnyard Millet with palm jaggery,14,270,270,0,2
26-01-2025,"Grains, Flours & Dals",BASMATHI RICE 1KG,4,150,135,15,1
26-01-2025,"Grains, Flours & Dals",Brown RICE 1KG,4,210,195,15,3
26-01-2025,Sweeteners,SUGAR 500 GM,16,30,25,5,1
26-01-2025,"Grains, Flours & Dals",SL Suji Rava 500GM,4,32,32,0,1
26-01-2025,Snacks & Ready-to-Eat,VD SAGOPAPAD 150GM,14,55,55,0,1
26-01-2025,Spices & Seasonings,Turmeric powder 250 gms,15,100,75,25,1
26-01-2025,"Grains, Flours & Dals",CHANA DAL 500GM,4,70,60,10,1
26-01-2025,Sweeteners,YB JAGGERY POWDER 1KG,16,140,140,0,1
26-01-2025,"Dry Fruits, Nuts & Seeds",Putnalu 250GM,2,45,38,7,1
26-01-2025,Oils & Ghee,Safflower oil 1 L,9,440,400,40,1
26-01-2025,Oils & Ghee,Sesame oil 1 L,9,590,560,30,1
26-01-2025,Snacks & Ready-to-Eat,SD Thati thandra 200gm,14,150,150,0,1
26-01-2025,"Grains, Flours & Dals",RAJMA 250GM,4,55,45,10,1
26-01-2025,Oils & Ghee,Groundnut oil 500ml,9,180,165,15,1
26-01-2025,"Grains, Flours & Dals",Red Chana 500 GM,4,75,60,15,1
26-01-2025,Spices & Seasonings,ROYAL SAFFRON 400GRMS,15,65,65,0,1
26-01-2025,"Dry Fruits, Nuts & Seeds",Groundnuts 1 kg,2,190,170,20,1
26-01-2025,"Health, Wellness & Ayurvedic Products",RB Max Protein Choco Berry bar 50g,5,75,75,0,1
26-01-2025,Oils & Ghee,Coconut oil 500 ml,9,220,200,20,1
26-01-2025,Oils & Ghee,Safflower oil 5 L,9,2200,"1,950.00",250,1
26-01-2025,"Grains, Flours & Dals",SB Javva Wheat Ravva 500GM,4,190,190,0,2
26-01-2025,Oils & Ghee,Groundnut oil 5 L,9,1800,"1,600.00",200,1
26-01-2025,Oils & Ghee,Sesame oil 5 L,9,2950,"2,750.00",200,1
26-01-2025,Snacks & Ready-to-Eat,VD RICE MURUKU 150GM,14,50,50,0,1
26-01-2025,"Grains, Flours & Dals",Multigrain 1 kg,4,100,85,15,1
26-01-2025,Oils & Ghee,Groundnut oil 1 L,9,360,330,30,1
26-01-2025,Snacks & Ready-to-Eat,SD barnyard Millet with palm jaggery,14,135,135,0,1
26-01-2025,General Household & Kitchenware,MATCH BOX,3,20,20,0,1
26-01-2025,Pooja & Spiritual Items,GD Aiswarya Deepam 700ML,12,390,390,0,2
26-01-2025,Sweeteners,ACHU BELLAM 1KG,16,100,80,20,1
26-01-2025,Pooja & Spiritual Items,GD Aiswarya Deepam 700ML,12,195,195,0,1
26-01-2025,Spices & Seasonings,AV Iodized Salt 1KG,15,56,50,6,2
26-01-2025,Oils & Ghee,Coconut oil 500 ml,9,220,200,20,1
26-01-2025,Oils & Ghee,Safflower oil 1 L,9,440,400,40,1
26-01-2025,"Grains, Flours & Dals",Green gram 500 gms,4,75,70,5,1
26-01-2025,Snacks & Ready-to-Eat,VD PAPPU CHEGODI 200GM,14,60,60,0,1
26-01-2025,Oils & Ghee,GANTASALA A2 COW GHEE 500ML,9,550,550,0,1
26-01-2025,"Dry Fruits, Nuts & Seeds",CASHEW 250GM,2,340,310,30,1
26-01-2025,"Dry Fruits, Nuts & Seeds",YELLOW KISHMISH 250GM,2,130,110,20,1
26-01-2025,"Grains, Flours & Dals",KORRALU (FOXTAIL M) 1KG,4,150,110,40,1
26-01-2025,Milk & Dairy,BROWN EGGS TRAY 30P,7,360,330,30,1
26-01-2025,Snacks & Ready-to-Eat,VD JAGGERY GHEE 250GM,14,180,180,0,1
26-01-2025,Snacks & Ready-to-Eat,SD Thati thandra 200gm,14,150,150,0,1
26-01-2025,Oils & Ghee,Sesame oil 1 L,9,1180,"1,120.00",60,2
26-01-2025,Snacks & Ready-to-Eat,SD Sesame laddu with dates250gm,14,135,135,0,1
26-01-2025,"Grains, Flours & Dals",BARLEY FLOUR 500GM,4,90,80,10,1
26-01-2025,Spices & Seasonings,DRY MIECHI 200GM,15,80,60,20,1
26-01-2025,"Dry Fruits, Nuts & Seeds",KAJU HALF 250GM,2,310,290,20,1
26-01-2025,Pooja & Spiritual Items,BALAJI SANDAL DHOOP STICKS 10STK,12,375,375,0,3
26-01-2025,Sweeteners,SUGAR 1KG,16,120,100,20,2
26-01-2025,Oils & Ghee,Groundnut oil 1 L,9,360,330,30,1
26-01-2025,Spices & Seasonings,AV Iodized Salt 1KG,15,56,50,6,2
26-01-2025,Pooja & Spiritual Items,GD SANDAL 150GM,12,110,110,0,1
26-01-2025,"Grains, Flours & Dals",VGR RICE 5 KGS,4,350,325,25,1
26-01-2025,Oils & Ghee,Safflower oil 1 L,9,440,400,40,1
26-01-2025,Oils & Ghee,Black Sesame oil 1 L,9,440,380,60,1
26-01-2025,Pooja & Spiritual Items,VRP APOORVA JAVADHU POW,12,35,35,0,1
26-01-2025,"Grains, Flours & Dals",split green gram 1 kg,4,150,140,10,1
26-01-2025,"Dry Fruits, Nuts & Seeds",PUMPKIN SEEDS 250GM,2,200,160,40,1
26-01-2025,Pooja & Spiritual Items,VRP APOORVA JAVADHU POW,12,35,35,0,1
26-01-2025,Oils & Ghee,Sesame oil 500ml,9,295,280,15,1
26-01-2025,Spices & Seasonings,ROYAL SAFFRON 400GRMS,15,65,65,0,1
26-01-2025,Oils & Ghee,Sesame oil 500ml,9,295,280,15,1
26-01-2025,Spices & Seasonings,NUVVULU 500GM,15,200,170,30,1
26-01-2025,Milk & Dairy,BROWN EGGS 1P,7,84,72,12,6
26-01-2025,Baking & Cooking Aids,GONDH 50GRMS,0,50,40,10,1
26-01-2025,Spices & Seasonings,Telaga Pindi 250 GM,15,40,35,5,1
26-01-2025,Oils & Ghee,Sesame oil 500ml,9,295,280,15,1
26-01-2025,Snacks & Ready-to-Eat,MARMURA LADDU,14,80,60,20,1
26-01-2025,"Grains, Flours & Dals",ANDU KORRALU (Browntop.m) 1 kg,4,520,440,80,2
26-01-2025,"Grains, Flours & Dals",AISHWARYA SP 1KG,4,160,150,10,2
26-01-2025,Snacks & Ready-to-Eat,VD CORNFLAKES MIXTURE 175GM,14,60,60,0,1
26-01-2025,Snacks & Ready-to-Eat,VD MURUKU 175GM,14,60,60,0,1
26-01-2025,"Grains, Flours & Dals",Quinova 1 kg,4,220,195,25,1
26-01-2025,Personal Care & Cosmetics,NIVEA CREME,10,399,399,0,1
26-01-2025,Milk & Dairy,BROWN EGGS 1P,7,140,120,20,10
26-01-2025,"Grains, Flours & Dals",Green gram 500 gms,4,150,140,10,2
26-01-2025,"Grains, Flours & Dals",Arikadu ( kodo),4,280,260,20,2
26-01-2025,Sweeteners,NATURAL HONEY 1KG,16,560,480,80,1
26-01-2025,"Grains, Flours & Dals",SAMALU (Little millet) 1 kg,4,340,260,80,2
26-01-2025,"Grains, Flours & Dals",UDALU (Barnyard millet) 1 kg,4,280,230,50,2
26-01-2025,"Grains, Flours & Dals",KORRALU (FOXTAIL M) 1KG,4,300,220,80,2
26-01-2025,Oils & Ghee,Safflower oil 5 L,9,2200,"1,950.00",250,1
26-01-2025,Oils & Ghee,Groundnut oil 1 L,9,720,660,60,2
26-01-2025,Spices & Seasonings,PURO Healthy Salt 1KG,15,110,110,0,1
26-01-2025,Oils & Ghee,Safflower oil 1 L,9,880,800,80,2
26-01-2025,Oils & Ghee,Groundnut oil 1 L,9,720,660,60,2
26-01-2025,"Dry Fruits, Nuts & Seeds",Groundnuts 1 kg,2,190,170,20,1
26-01-2025,Oils & Ghee,Safflower oil 1 L,9,880,800,80,2
26-01-2025,Spices & Seasonings,Tamarind 250GMS,15,80,65,15,1
26-01-2025,"Grains, Flours & Dals",RAGULU 1 KG,4,70,60,10,1
26-01-2025,Oils & Ghee,Groundnut oil 1 L,9,360,330,30,1
26-01-2025,Oils & Ghee,Groundnut oil 500ml,9,180,165,15,1
26-01-2025,Oils & Ghee,Groundnut oil 1 L,9,360,330,30,1
26-01-2025,"Dry Fruits, Nuts & Seeds",PUMPKIN SEEDS 250GM,2,200,160,40,1
26-01-2025,"Grains, Flours & Dals",WHEAT 1 KG,4,240,200,40,4
26-01-2025,"Grains, Flours & Dals",SINGLE POLISH 1KG,4,325,325,0,5
26-01-2025,"Health, Wellness & Ayurvedic Products",MD Triphala Chorrnam 100GM,5,80,80,0,1
26-01-2025,"Dry Fruits, Nuts & Seeds",SUNFLOWER SEEDS 250GRM,2,300,260,40,2
26-01-2025,Snacks & Ready-to-Eat,SATHVI REGIVADA 200GM,14,80,60,20,1
26-01-2025,Personal Care & Cosmetics,MD Bath Powder 100GM,10,40,40,0,1
26-01-2025,"Grains, Flours & Dals",BAJRA 1 KG,4,30,25,5,0.5
26-01-2025,"Grains, Flours & Dals",FLOUR CHARGE,4,60,60,0,5
26-01-2025,"Grains, Flours & Dals",JOWAR WHITE 1 KG,4,40,35,5,0.5
26-01-2025,Snacks & Ready-to-Eat,VD DAHI MIRCHI(SALTED) 100GM,14,45,45,0,1
26-01-2025,Snacks & Ready-to-Eat,VD Pappu Chekkalu 190gm,14,60,60,0,1
26-01-2025,Snacks & Ready-to-Eat,VD MINAPA VADIYAM,14,65,65,0,1
26-01-2025,Snacks & Ready-to-Eat,VD NUVULU CHEGODI 175GM,14,60,60,0,1
26-01-2025,"Grains, Flours & Dals",MAAGAANI LOW GI SP L 1KG,4,600,525,75,5
26-01-2025,"Grains, Flours & Dals",Bajra Flour 1 kg,4,70,60,10,1
26-01-2025,"Grains, Flours & Dals",SINGLE POLISH 1KG,4,65,65,0,1
26-01-2025,"Grains, Flours & Dals",SB Javva Wheat Ravva 500GM,4,190,190,0,2
26-01-2025,Snacks & Ready-to-Eat,VD RED CHILLI RICEPAPAD 150GM,14,50,50,0,1
26-01-2025,Snacks & Ready-to-Eat,VD GUMMADI VADIYAM,14,75,75,0,1
26-01-2025,"Grains, Flours & Dals",Yellow jowar.F 500 gms,4,55,50,5,1
26-01-2025,"Grains, Flours & Dals",Wheat Flour 1 kg,4,140,120,20,2
26-01-2025,Snacks & Ready-to-Eat,VD VAMUPUSA 175GM,14,60,60,0,1
26-01-2025,"Grains, Flours & Dals",RAGI FLOUR 500GRMS,4,40,35,5,1
26-01-2025,Oils & Ghee,Safflower oil 1 L,9,440,400,40,1
26-01-2025,"Grains, Flours & Dals",DH URAD GOTA 1KG,4,215,190,25,1
26-01-2025,Oils & Ghee,Sesame oil 1 L,9,590,560,30,1
26-01-2025,"Grains, Flours & Dals",SL Idly Rava 1KG,4,65,55,10,1
26-01-2025,Oils & Ghee,Groundnut oil 1 L,9,360,330,30,1
26-01-2025,Milk & Dairy,BROWN EGGS TRAY 30P,7,360,330,30,1
26-01-2025,"Dry Fruits, Nuts & Seeds",Groundnuts 500 gms,2,95,85,10,1
26-01-2025,Spices & Seasonings,DRY MIECHI 200GM,15,80,60,20,1
26-01-2025,"Grains, Flours & Dals",PESARA PAPPU 1 KG,4,170,145,25,1
26-01-2025,Sweeteners,SUGAR 1KG,16,120,100,20,2
26-01-2025,"Dry Fruits, Nuts & Seeds",KAJU HALF 250GM,2,620,580,40,2
26-01-2025,"Grains, Flours & Dals",FLOUR CHARGE,4,36,36,0,3
26-01-2025,"Grains, Flours & Dals",THIN POHA 500GM,4,40,35,5,1
26-01-2025,Oils & Ghee,Safflower oil 1 L,9,440,400,40,1
26-01-2025,"Grains, Flours & Dals",SOYA BEANS 1KG,4,40,36,4,0.2
26-01-2025,Milk & Dairy,BROWN EGGS TRAY 30P,7,360,330,30,1
26-01-2025,Spices & Seasonings,RED COPRA 500GM,15,170,148,22,1
26-01-2025,Oils & Ghee,Groundnut oil 1 L,9,360,330,30,1
26-01-2025,Spices & Seasonings,AV Iodized Salt 1KG,15,28,25,3,1
26-01-2025,"Grains, Flours & Dals",BOBBARA PAPPU 500GM,4,85,80,5,1
26-01-2025,Spices & Seasonings,DURGA SALT CRYSTAL 1KG,15,25,25,0,1
26-01-2025,Snacks & Ready-to-Eat,GANTASALA GINGER CANDY 200GM,14,105,105,0,1
26-01-2025,"Grains, Flours & Dals",Urad dall 1 Kg,4,185,170,15,1
26-01-2025,Spices & Seasonings,ROYAL SAFFRON 400GRMS,15,130,130,0,2
26-01-2025,"Grains, Flours & Dals",Em Multimillet idli r 500g,4,129,129,0,1
26-01-2025,"Dry Fruits, Nuts & Seeds",SD Mango cubes 100gm,2,45,45,0,1
26-01-2025,"Dry Fruits, Nuts & Seeds",Groundnuts 500 gms,2,95,85,10,1
26-01-2025,Spices & Seasonings,NUVVULU 500GM,15,160,130,30,1
26-01-2025,Spices & Seasonings,SH CASSIA STICKS 50GM,15,75,75,0,1
26-01-2025,Spices & Seasonings,Vamu 100GM,15,60,50,10,1
26-01-2025,"Grains, Flours & Dals",RAGULU 1 KG,4,35,30,5,0.5
26-01-2025,"Grains, Flours & Dals",Wheat Flour 1 kg,4,140,120,20,2
26-01-2025,Oils & Ghee,Sesame oil 1 L,9,590,560,30,1
26-01-2025,Spices & Seasonings,GREEN SOUNF,15,60,40,20,1
26-01-2025,"Grains, Flours & Dals",RAGI FLOUR 500GRMS,4,40,35,5,1
26-01-2025,Spices & Seasonings,NUVVULU 500GM,15,160,130,30,1
26-01-2025,Oils & Ghee,Coconut oil 500 ml,9,220,200,20,1
26-01-2025,Oils & Ghee,Groundnut oil 1 L,9,360,330,30,1
26-01-2025,Oils & Ghee,Groundnut oil 500ml,9,180,165,15,1
26-01-2025,"Grains, Flours & Dals",CHANA DAL 500GM,4,70,60,10,1
26-01-2025,Spices & Seasonings,Coriander seeds 200 gms,15,48,40,8,1
26-01-2025,Spices & Seasonings,DRY MIECHI 200GM,15,80,60,20,1
26-01-2025,Spices & Seasonings,AVALU 100GM,15,25,20,5,1
26-01-2025,Spices & Seasonings,Turmeric powder 250 gms,15,100,75,25,1
26-01-2025,Spices & Seasonings,ROYAL SAFFRON 400GRMS,15,65,65,0,1
26-01-2025,Spices & Seasonings,SAJEERA,15,60,40,20,1
26-01-2025,"Dry Fruits, Nuts & Seeds",PLAIN PISTA 250GM,2,660,550,110,1
26-01-2025,"Grains, Flours & Dals",Wheat Flour 1 kg,4,70,60,10,1
26-01-2025,Oils & Ghee,Groundnut oil 1 L,9,360,330,30,1
26-01-2025,Sweeteners,YB Brown Sugar 1KG,16,140,140,0,1
26-01-2025,"Dry Fruits, Nuts & Seeds",ALMONDS 250GM,2,280,260,20,1
26-01-2025,Oils & Ghee,Freedom Rice Bran Oil 1L,9,388,360,28,2
26-01-2025,Milk & Dairy,BROWN EGGS TRAY 30P,7,360,330,30,1
26-01-2025,"Dry Fruits, Nuts & Seeds",MAHA BEERA SEEDS 100GM,2,60,60,0,1
26-01-2025,Snacks & Ready-to-Eat,TILLI CHIKKI,14,35,35,0,7
26-01-2025,"Dry Fruits, Nuts & Seeds",PULMAKHANA 100 GM,2,180,170,10,1
26-01-2025,Snacks & Ready-to-Eat,MIX MILLET NOODLES,14,75,75,0,1
26-01-2025,"Grains, Flours & Dals",Multigrain 1 kg,4,200,170,30,2
26-01-2025,"Dry Fruits, Nuts & Seeds",SATHVI CHIA SEEDS 100GM,2,100,80,20,1
26-01-2025,Household & Cleaning,VIM TROPICAL LEMON FRESHNESS 250ML,6,55,55,0,1
26-01-2025,"Grains, Flours & Dals",Quinova 1 kg,4,220,195,25,1
26-01-2025,Milk & Dairy,BROWN EGGS TRAY 30P,7,360,330,30,1
26-01-2025,Oils & Ghee,Groundnut oil 1 L,9,360,330,30,1
26-01-2025,"Grains, Flours & Dals",JOWAR WHITE 1 KG,4,80,70,10,1
26-01-2025,Oils & Ghee,Sesame oil 500ml,9,295,280,15,1
26-01-2025,Snacks & Ready-to-Eat,RINGS 200GM,14,30,30,0,1
26-01-2025,Snacks & Ready-to-Eat,VD SAGOPAPAD 150GM,14,55,55,0,1
26-01-2025,Milk & Dairy,BROWN EGGS 1P,7,126,108,18,9
26-01-2025,"Health, Wellness & Ayurvedic Products",RB Max Protein Spanish Tomato,5,45,45,0,1
26-01-2025,Oils & Ghee,Groundnut oil 1 L,9,360,330,30,1
26-01-2025,Oils & Ghee,Safflower oil 1 L,9,440,400,40,1
26-01-2025,Sweeteners,GS Palm Jaggery Powder 400GM,16,180,180,0,1
26-01-2025,"Dry Fruits, Nuts & Seeds",PULMAKHANA 100 GM,2,180,170,10,1
26-01-2025,Milk & Dairy,BROWN EGGS 1P,7,56,48,8,4
26-01-2025,"Grains, Flours & Dals",VGR RICE 5 KGS,4,350,325,25,1
26-01-2025,Snacks & Ready-to-Eat,BELLAM MINAPA SUNADULLU,14,180,180,0,1
26-01-2025,"Grains, Flours & Dals",Brown RICE 1KG,4,140,130,10,2
26-01-2025,Oils & Ghee,Safflower oil 1 L,9,440,400,40,1
26-01-2025,Milk & Dairy,BROWN EGGS TRAY 30P,7,360,330,30,1
26-01-2025,Oils & Ghee,Groundnut oil 1 L,9,360,330,30,1
26-01-2025,Pooja & Spiritual Items,SREE REAL KASTURI STICKS 90GM,12,144,144,0,2
26-01-2025,Oils & Ghee,Groundnut oil 5 L,9,1800,"1,600.00",200,1
26-01-2025,Spices & Seasonings,Chilli powder 500 gms,15,290,210,80,1
26-01-2025,Spices & Seasonings,Turmeric powder 250 gms,15,100,75,25,1
26-01-2025,"Grains, Flours & Dals",Idly Rava L 1KG,4,120,100,20,2
26-01-2025,Oils & Ghee,Coconut oil 1 L,9,440,400,40,1
26-01-2025,Milk & Dairy,HERITAGE TOTAL CURD 500GM,7,100,100,0,2
26-01-2025,Oils & Ghee,BUFFALLO GHEE 500ML,9,410,370,40,1
26-01-2025,"Grains, Flours & Dals",RED TURDAL 500GM,4,75,70,5,1
26-01-2025,Spices & Seasonings,AVALU 100GM,15,25,20,5,1
26-01-2025,Spices & Seasonings,ROYAL SAFFRON 400GRMS,15,65,65,0,1
26-01-2025,Snacks & Ready-to-Eat,VD SANNAPUSA 175GM,14,60,60,0,1
26-01-2025,"Grains, Flours & Dals",White jowar.F 1 kg,4,100,80,20,1
26-01-2025,"Grains, Flours & Dals",THIN POHA 500GM,4,40,35,5,1
26-01-2025,"Dry Fruits, Nuts & Seeds",SALTED PISTA 250GM,2,400,350,50,1
26-01-2025,Spices & Seasonings,Jeera 100GM,15,50,45,5,1
26-01-2025,Milk & Dairy,HRITAGE TOTAL CURD 130GM,7,10,10,0,1
26-01-2025,Spices & Seasonings,Elaichi 25GM,15,145,120,25,1
26-01-2025,"Grains, Flours & Dals",Bombay Rava 500GM,4,35,30,5,1
26-01-2025,Spices & Seasonings,Chilli powder 500 gms,15,290,210,80,1
26-01-2025,"Grains, Flours & Dals",Wheat Flour 1 kg,4,70,60,10,1
26-01-2025,"Grains, Flours & Dals",Em Multimillet upma 500g,4,129,129,0,1
26-01-2025,"Dry Fruits, Nuts & Seeds",WALLNUTS 250GM,2,320,290,30,1
26-01-2025,Snacks & Ready-to-Eat,SATHVI MIXED CHIKKI 200GM,14,120,100,20,1
26-01-2025,Sweeteners,YB JAGGERY POWDER 1KG,16,140,140,0,1
26-01-2025,Milk & Dairy,BROWN EGGS TRAY 30P,7,360,330,30,1
26-01-2025,"Grains, Flours & Dals",RAGI FLOUR 1KG,4,80,70,10,1
26-01-2025,Oils & Ghee,Groundnut oil 1 L,9,1080,990,90,3
26-01-2025,"Grains, Flours & Dals",Multigrain 1 kg,4,300,255,45,3
26-01-2025,Spices & Seasonings,PRO ORG BAY LEAF 50G,15,60,60,0,1
26-01-2025,Personal Care & Cosmetics,BIOTIQUE HERBCOLOR 1N,10,300,300,0,1
26-01-2025,"Dry Fruits, Nuts & Seeds",SATHVI CHIA SEEDS 100GM,2,100,80,20,1
26-01-2025,Snacks & Ready-to-Eat,ELITE ELAICHI RUSK 200GM,14,35,35,0,1
26-01-2025,"Dry Fruits, Nuts & Seeds",GF KIMIA DATES 500GM,2,310,190,120,1
26-01-2025,Oils & Ghee,Safflower oil 1 L,9,440,400,40,1
26-01-2025,"Dry Fruits, Nuts & Seeds",ALMONDS 250GM,2,280,260,20,1
26-01-2025,"Dry Fruits, Nuts & Seeds",PUMPKIN SEEDS 250GM,2,200,160,40,1
26-01-2025,"Dry Fruits, Nuts & Seeds",FLAX SEEDS 250GM,2,60,50,10,1
26-01-2025,Personal Care & Cosmetics,ORGANIC SPONGE LOOFAH,10,70,70,0,1
26-01-2025,"Grains, Flours & Dals",Chana Flour 500 gms,4,70,65,5,1
26-01-2025,"Dry Fruits, Nuts & Seeds",WALLNUTS 250GM,2,320,290,30,1
26-01-2025,"Health, Wellness & Ayurvedic Products",RB Max Protein PERI PERI 60gm,5,45,45,0,1
26-01-2025,"Grains, Flours & Dals",Chittimuthaylu rice 1 kg,4,160,140,20,1
26-01-2025,Oils & Ghee,Sesame oil 500ml,9,295,280,15,1
26-01-2025,"Grains, Flours & Dals",KORRALU (FOXTAIL M) 500GM,4,65,55,10,1
26-01-2025,"Grains, Flours & Dals",JOWAR WHITE 1 KG,4,40,35,5,0.5
26-01-2025,Snacks & Ready-to-Eat,SATHVI PALLI CHIKKI 200GM,14,100,80,20,1
26-01-2025,"Grains, Flours & Dals",SAMALU (Little millet) 500 gms,4,85,65,20,1
26-01-2025,"Grains, Flours & Dals",BOMBAY RAVA,4,70,55,15,1
26-01-2025,"Dry Fruits, Nuts & Seeds",FLAX SEEDS 250GM,2,60,50,10,1
26-01-2025,Oils & Ghee,Groundnut oil 1 L,9,360,330,30,1
26-01-2025,Oils & Ghee,BUFFALLO GHEE 500ML,9,410,370,40,1
26-01-2025,Oils & Ghee,Groundnut oil 1 L,9,720,660,60,2
26-01-2025,"Grains, Flours & Dals",Bombay Rava 500GM,4,35,30,5,1
26-01-2025,"Grains, Flours & Dals",Wheat Flour 1 kg,4,140,120,20,2
26-01-2025,"Grains, Flours & Dals",RAGULU 1 KG,4,105,90,15,1.5
26-01-2025,"Grains, Flours & Dals",BAJRA 1 KG,4,60,50,10,1
26-01-2025,Spices & Seasonings,Turmeric powder 250 gms,15,100,75,25,1
26-01-2025,"Grains, Flours & Dals",JOWAR YELLOW 1 K,4,100,90,10,1
26-01-2025,Oils & Ghee,Black Sesame oil 500 ml,9,220,190,30,1
26-01-2025,Snacks & Ready-to-Eat,VD RICE MURUKU 150GM,14,50,50,0,1
26-01-2025,Milk & Dairy,BROWN EGGS 1P,7,224,192,32,16
26-01-2025,Sweeteners,GS Palm Jaggery Powder 400GM,16,180,180,0,1
26-01-2025,Oils & Ghee,Sesame oil 1 L,9,590,560,30,1
26-01-2025,"Grains, Flours & Dals",HS Jowar upma rava 500 gms,4,65,65,0,1
26-01-2025,"Grains, Flours & Dals",PESARA PAPPU 500GMS,4,85,75,10,1
26-01-2025,"Grains, Flours & Dals",HS jowar idly rava 500 gms,4,195,195,0,3
26-01-2025,Spices & Seasonings,Jeera 100GM,15,50,45,5,1
26-01-2025,"Grains, Flours & Dals",Green gram 1 kg,4,150,130,20,1
26-01-2025,Spices & Seasonings,AVALU 100GM,15,25,20,5,1
26-01-2025,"Grains, Flours & Dals",turdal 1kg,4,220,195,25,1
26-01-2025,Oils & Ghee,Groundnut oil 1 L,9,360,330,30,1
26-01-2025,Oils & Ghee,Sesame oil 1 L,9,590,560,30,1
26-01-2025,Oils & Ghee,Safflower oil 1 L,9,440,400,40,1
26-01-2025,Spices & Seasonings,Menthulu 250 gms,15,50,45,5,1
26-01-2025,Oils & Ghee,Sesame oil 500ml,9,295,280,15,1
26-01-2025,Sweeteners,Natural Honey 500 gms,16,280,240,40,1
26-01-2025,"Grains, Flours & Dals",SL Idly Rava 1KG,4,65,55,10,1
26-01-2025,Oils & Ghee,Groundnut oil 1 L,9,360,330,30,1
26-01-2025,Snacks & Ready-to-Eat,MH Sprouted Ragi Dosa 400GM,14,120,120,0,1
26-01-2025,Oils & Ghee,Sesame oil 1 L,9,590,560,30,1
26-01-2025,Oils & Ghee,Groundnut oil 1 L,9,360,330,30,1
26-01-2025,"Grains, Flours & Dals",Brown RICE 1KG,4,140,130,10,2
26-01-2025,"Grains, Flours & Dals",Red Chana 500 GM,4,75,60,15,1
26-01-2025,"Grains, Flours & Dals",WHITE BATANI,4,40,30,10,1
26-01-2025,Spices & Seasonings,DRY MIECHI 200GM,15,80,60,20,1
26-01-2025,Spices & Seasonings,Coriander seeds 200 gms,15,48,40,8,1
26-01-2025,Sweeteners,SUGAR 1KG,16,60,50,10,1
26-01-2025,Spices & Seasonings,AVALU 100GM,15,25,20,5,1
26-01-2025,"Dry Fruits, Nuts & Seeds",Groundnuts 1 kg,2,190,170,20,1
26-01-2025,Snacks & Ready-to-Eat,SD BLACK GRAM PAPADS,14,80,80,0,1
26-01-2025,Snacks & Ready-to-Eat,BB VERMICELLY 500GM,14,53,53,0,1
26-01-2025,Spices & Seasonings,JEERA 250 gms,15,125,105,20,1
26-01-2025,Pooja & Spiritual Items,SWASTIK CAMPHORE,12,180,180,0,2
26-01-2025,"Grains, Flours & Dals",White Chana 250 GM,4,60,50,10,1
26-01-2025,"Grains, Flours & Dals",DH URAD GOTA 1KG,4,430,380,50,2
26-01-2025,Spices & Seasonings,Vamu 100GM,15,60,50,10,1
26-01-2025,"Grains, Flours & Dals",Multigrain 1 kg,4,100,85,15,1
26-01-2025,Spices & Seasonings,Elaichi 25GM,15,290,240,50,2
26-01-2025,Snacks & Ready-to-Eat,BD BARELY NOODLES 200G,14,70,70,0,1
26-01-2025,"Grains, Flours & Dals",Wheat Flour 1 kg,4,70,60,10,1
26-01-2025,Spices & Seasonings,Gasagasalu 50GM,15,130,110,20,1
26-01-2025,"Grains, Flours & Dals",SB Javva Wheat Ravva 500GM,4,95,95,0,1
26-01-2025,"Grains, Flours & Dals",Bombay Rava 500GM,4,35,30,5,1
26-01-2025,"Grains, Flours & Dals",CHANA DAL 1KG,4,140,120,20,1
26-01-2025,"Grains, Flours & Dals",SOYA BEANS 1KG,4,100,90,10,0.5
26-01-2025,"Grains, Flours & Dals",split green gram 1 kg,4,150,140,10,1
26-01-2025,"Grains, Flours & Dals",turdal 1kg,4,220,195,25,1
26-01-2025,"Grains, Flours & Dals",RAGI FLOUR 1KG,4,80,70,10,1
26-01-2025,Spices & Seasonings,ROYAL SAFFRON,15,250,250,0,2
26-01-2025,Spices & Seasonings,Lavangam 50GM,15,60,50,10,1
26-01-2025,"Grains, Flours & Dals",KORRALU (FOXTAIL M) 1KG,4,150,110,40,1
26-01-2025,"Grains, Flours & Dals",SL Idly Rava 1KG,4,130,110,20,2
26-01-2025,"Grains, Flours & Dals",turdal 1kg,4,220,195,25,1
26-01-2025,"Health, Wellness & Ayurvedic Products",MD Kasturi Pasupu Choornam 50GM,5,80,80,0,1
26-01-2025,"Grains, Flours & Dals",Green gram 1 kg,4,150,130,20,1
26-01-2025,"Grains, Flours & Dals",RAGULU 1 KG,4,70,60,10,1
26-01-2025,Oils & Ghee,Sesame oil 1 L,9,590,560,30,1
26-01-2025,Milk & Dairy,BROWN EGGS TRAY 30P,7,360,330,30,1
26-01-2025,Oils & Ghee,Groundnut oil 1 L,9,360,330,30,1
26-01-2025,"Grains, Flours & Dals",BASMATHI RICE 1KG,4,150,135,15,1
26-01-2025,Snacks & Ready-to-Eat,VD ARISELU 5 PIC,14,100,100,0,1
26-01-2025,Snacks & Ready-to-Eat,COPRA LADDU 200GM,14,100,80,20,1
26-01-2025,"Grains, Flours & Dals",SL Idly Rava 1KG,4,65,55,10,1
26-01-2025,"Grains, Flours & Dals",Wheat Rava S 500GM,4,33,30,3,1
26-01-2025,"Grains, Flours & Dals",Bombay Rava 500GM,4,35,30,5,1
26-01-2025,"Grains, Flours & Dals",RICE FLOUR 1KG,4,140,110,30,2
26-01-2025,"Grains, Flours & Dals",RICE FLOUR 500 GM,4,70,56,14,2
26-01-2025,"Grains, Flours & Dals",Wheat Rava M 500GM,4,33,30,3,1
26-01-2025,Pooja & Spiritual Items,GD Aiswarya Deepam 700ML,12,390,390,0,2
26-01-2025,"Grains, Flours & Dals",RAGI FLOUR 500GRMS,4,40,35,5,1
26-01-2025,"Dry Fruits, Nuts & Seeds",Putnalu 250GM,2,90,76,14,2
26-01-2025,Spices & Seasonings,Vamu 100GM,15,60,50,10,1
26-01-2025,"Grains, Flours & Dals",SRILATHA RICE RAVVA 500GM,4,140,140,0,4
26-01-2025,"Grains, Flours & Dals",THICK POHA 500GM,4,80,70,10,2
26-01-2025,"Grains, Flours & Dals",White Chana 250 GM,4,120,100,20,2
26-01-2025,"Grains, Flours & Dals",PESARA PAPPU 500GMS,4,85,75,10,1
26-01-2025,"Grains, Flours & Dals",Green gram 1 kg,4,300,260,40,2
26-01-2025,"Dry Fruits, Nuts & Seeds",PUTNALU 500GMS,2,90,76,14,1
26-01-2025,Snacks & Ready-to-Eat,KURNOOL MARMURA,14,70,55,15,1
26-01-2025,"Dry Fruits, Nuts & Seeds",Groundnuts 1 kg,2,190,170,20,1
26-01-2025,Spices & Seasonings,DRY MIECHI 200GM,15,80,60,20,1
26-01-2025,"Grains, Flours & Dals",Green Batani 500GM,4,110,90,20,1
26-01-2025,Spices & Seasonings,AVALU 100GM,15,25,20,5,1
26-01-2025,"Grains, Flours & Dals",white Bobarlu 500 gms,4,80,75,5,1
26-01-2025,"Grains, Flours & Dals",CHANA DAL 500GM,4,70,60,10,1
26-01-2025,"Grains, Flours & Dals",Red Chana 500 GM,4,150,120,30,2
26-01-2025,Snacks & Ready-to-Eat,RB Choco Delite Almonds Raisins 40g,14,45,45,0,1
26-01-2025,Spices & Seasonings,JEERA 250 gms,15,125,105,20,1
26-01-2025,"Grains, Flours & Dals",WHITE BATANI 500GM,4,80,60,20,1
26-01-2025,Oils & Ghee,Groundnut oil 1 L,9,720,660,60,2
26-01-2025,Oils & Ghee,Sesame oil 1 L,9,1180,"1,120.00",60,2
26-01-2025,Oils & Ghee,Coconut oil 500 ml,9,220,200,20,1
26-01-2025,"Grains, Flours & Dals",Arikadu ( kodo),4,140,130,10,1
26-01-2025,"Grains, Flours & Dals",SAMALU (Little millet) 1 kg,4,170,130,40,1
26-01-2025,"Grains, Flours & Dals",KORRALU (FOXTAIL M) 1KG,4,150,110,40,1
26-01-2025,"Grains, Flours & Dals",Bajra Flour 1 kg,4,70,60,10,1
26-01-2025,"Grains, Flours & Dals",RAGI FLOUR 1KG,4,80,70,10,1
26-01-2025,Personal Care & Cosmetics,ROUND LOOFAH,10,65,65,0,1
26-01-2025,Sweeteners,YB Brown Sugar 1KG,16,140,140,0,1
26-01-2025,Oils & Ghee,Groundnut oil 500ml,9,180,165,15,1
26-01-2025,Milk & Dairy,BROWN EGGS TRAY 30P,7,360,330,30,1
26-01-2025,Oils & Ghee,Sesame oil 500ml,9,295,280,15,1
26-01-2025,Sweeteners,YB Brown Sugar 500GM,16,75,75,0,1
26-01-2025,Oils & Ghee,Mustard oil 500 ml,9,220,195,25,1
26-01-2025,"Grains, Flours & Dals",Wheat Flour 500 gms,4,35,30,5,1
26-01-2025,"Dry Fruits, Nuts & Seeds",FLAX SEEDS 1KG,2,24,20,4,0.1
26-01-2025,"Grains, Flours & Dals",FLOUR CHARGE,4,48,48,0,4
26-01-2025,"Grains, Flours & Dals",MELMEKER 250GMS,4,60,45,15,1
26-01-2025,Milk & Dairy,HERITAGE TONED MILK 500ML,7,62,62,0,2
26-01-2025,Milk & Dairy,BROWN EGGS 1P,7,140,120,20,10
26-01-2025,Oils & Ghee,Sesame oil 1 L,9,590,560,30,1
26-01-2025,Spices & Seasonings,Tamarind 250GMS,15,80,65,15,1
26-01-2025,"Grains, Flours & Dals",BASMATHI RICE 1KG,4,150,135,15,1
26-01-2025,Spices & Seasonings,DRY MIECHI 200GM,15,80,60,20,1
26-01-2025,Spices & Seasonings,SWEET SOUNF,15,20,20,0,1
26-01-2025,Oils & Ghee,Groundnut oil 1 L,9,360,330,30,1
26-01-2025,Milk & Dairy,BROWN EGGS 1P,7,140,120,20,10
26-01-2025,Spices & Seasonings,Telaga Pindi 250 GM,15,40,35,5,1
26-01-2025,Oils & Ghee,Flaxseed oil 500 ml,9,600,540,60,2
26-01-2025,"Grains, Flours & Dals",Wheat Flour 1 kg,4,140,120,20,2
26-01-2025,Pooja & Spiritual Items,SWASTIK CAMPHOR 10GM,12,20,20,0,1
26-01-2025,"Health, Wellness & Ayurvedic Products",MD Hibiscus Flower Choornam 30GM,5,100,100,0,1
26-01-2025,"Health, Wellness & Ayurvedic Products",MD Bringaraj Choornam 100GM,5,80,80,0,1
26-01-2025,Pooja & Spiritual Items,GD SANDAL 150GM,12,110,110,0,1
26-01-2025,Oils & Ghee,Sesame oil 1 L,9,590,560,30,1
26-01-2025,Snacks & Ready-to-Eat,PALLI LADDU 200GMS,14,90,70,20,1
26-01-2025,"Grains, Flours & Dals",Wheat Flour 1 kg,4,70,60,10,1
26-01-2025,Snacks & Ready-to-Eat,SALTED PHALLI,14,25,25,0,1
26-01-2025,Personal Care & Cosmetics,SANTOOR,10,100,100,0,1
26-01-2025,Beverages,RED LABEL 100GM,1,50,50,0,1
26-01-2025,"Grains, Flours & Dals",Wheat Flour 1 kg,4,70,60,10,1
25-01-2025,Snacks & Ready-to-Eat,SATHVI REGIVADA 200GM,14,80,60,20,1
25-01-2025,"Grains, Flours & Dals",HS BAJRA FLAKES 250GM 1+1,4,119,119,0,1
25-01-2025,Snacks & Ready-to-Eat,FOXTAIL BIS,14,135,135,0,1
25-01-2025,Oils & Ghee,cow ghee 500 ml,9,430,390,40,1
25-01-2025,Oils & Ghee,Safflower oil 1 L,9,440,400,40,1
25-01-2025,"Grains, Flours & Dals",PESARA PAPPU 500GMS,4,85,75,10,1
25-01-2025,Snacks & Ready-to-Eat,VD BELLAM GAVVALU 200GM,14,60,60,0,1
25-01-2025,Snacks & Ready-to-Eat,SD High Protein Laddu 175gm,14,190,190,0,1
25-01-2025,Snacks & Ready-to-Eat,VD ARISELU 5 PIC,14,100,100,0,1
25-01-2025,Snacks & Ready-to-Eat,VD MINAPA VADIYAM,14,65,65,0,1
25-01-2025,Snacks & Ready-to-Eat,RSC ORANGE 100GMS,14,20,20,0,1
25-01-2025,Snacks & Ready-to-Eat,VD GUMMADI VADIYAM,14,75,75,0,1
25-01-2025,Beverages,BRU GREEN LABEL 200G,1,140,140,0,1
25-01-2025,Oils & Ghee,Coconut oil 500 ml,9,220,200,20,1
25-01-2025,"Grains, Flours & Dals",BOMBAY RAVA,4,70,55,15,1
25-01-2025,Personal Care & Cosmetics,HIMALAYA LIP BALM 10GM,10,40,40,0,1
25-01-2025,Spices & Seasonings,TM MIRCH POWDER 200GM,15,163,163,0,1
25-01-2025,"Health, Wellness & Ayurvedic Products",RB Max Protein Spanish Tomato,5,45,45,0,1
25-01-2025,Sweeteners,SD PALM JAGGERY 500GM,16,200,200,0,1
25-01-2025,Household & Cleaning,VIM EXTRA 110GM,6,40,40,0,4
25-01-2025,Snacks & Ready-to-Eat,SATHVI PALLI CHIKKI 200GM,14,100,80,20,1
25-01-2025,Spices & Seasonings,Turmeric powder 250 gms,15,100,75,25,1
25-01-2025,"Grains, Flours & Dals",Urad dall 1 Kg,4,185,170,15,1
25-01-2025,Snacks & Ready-to-Eat,MARMURA LADDU,14,160,120,40,2
25-01-2025,Spices & Seasonings,THOKA MIRYALU 50GM,15,210,180,30,1
25-01-2025,Pooja & Spiritual Items,BANDA PUVVU 25GM 25GM,12,80,60,20,1
25-01-2025,Snacks & Ready-to-Eat,VD CORNFLAKES MIXTURE 175GM,14,60,60,0,1
25-01-2025,"Health, Wellness & Ayurvedic Products",PULIPIRI WARTS REMOVER 9GM,5,125,125,0,1
25-01-2025,Spices & Seasonings,Masala Karam 500 gms,15,520,480,40,2
25-01-2025,Spices & Seasonings,Tamarind 250GMS,15,80,65,15,1
25-01-2025,"Grains, Flours & Dals",THICK POHA 500GM,4,40,35,5,1
25-01-2025,Spices & Seasonings,Gasagasalu 50GM,15,130,110,20,1
25-01-2025,Personal Care & Cosmetics,UVIS MULTANI MITTI 200GM,10,90,90,0,1
25-01-2025,Snacks & Ready-to-Eat,VD PAPPU CHEGODI 200GM,14,60,60,0,1
25-01-2025,Snacks & Ready-to-Eat,SUNNUNDALU 200GM,14,120,100,20,1
25-01-2025,Personal Care & Cosmetics,COLGATE ACTIVE SALT,10,20,20,0,1
25-01-2025,"Grains, Flours & Dals",RAGI FLOUR 500GRMS,4,40,35,5,1
25-01-2025,"Grains, Flours & Dals",Idly Rava L 1KG,4,60,50,10,1
25-01-2025,"Grains, Flours & Dals",Urad dall 1 Kg,4,185,170,15,1
25-01-2025,Milk & Dairy,BROWN EGGS TRAY 30P,7,360,330,30,1
25-01-2025,"Grains, Flours & Dals",RAGI FLOUR 500GRMS,4,40,35,5,1
25-01-2025,Spices & Seasonings,Tamarind 250GMS,15,80,65,15,1
25-01-2025,Snacks & Ready-to-Eat,SATHVI REGIVADA 200GM,14,80,60,20,1
25-01-2025,Oils & Ghee,Safflower oil 500 ml,9,220,200,20,1
25-01-2025,"Health, Wellness & Ayurvedic Products",AMLA PACHAK,5,100,100,0,1
25-01-2025,Pooja & Spiritual Items,999 SINGAPORE DHOOP POW 50GM,12,70,70,0,2
25-01-2025,"Health, Wellness & Ayurvedic Products",RB Max Protein Salt & Caramel Bar 50g,5,150,150,0,2
25-01-2025,Personal Care & Cosmetics,COCONUT BATH SCRUBBER,10,40,40,0,1
25-01-2025,Snacks & Ready-to-Eat,COPRA LADDU 200GM,14,100,80,20,1
25-01-2025,Sweeteners,MISHRI D,16,40,30,10,1
25-01-2025,Spices & Seasonings,Lavangam 50GM,15,60,50,10,1
25-01-2025,"Grains, Flours & Dals",Wheat Flour 1 kg,4,140,120,20,2
25-01-2025,Pooja & Spiritual Items,BANDA PUVVU 25GM 25GM,12,80,60,20,1
25-01-2025,Spices & Seasonings,SAJEERA,15,60,40,20,1
25-01-2025,Spices & Seasonings,Biryani Leaf 25GM,15,30,20,10,1
25-01-2025,Spices & Seasonings,Japatri 25GM,15,100,80,20,1
25-01-2025,Spices & Seasonings,ROYAL SAFFRON 400GRMS,15,130,130,0,2
25-01-2025,"Grains, Flours & Dals",YB CHITTIMUTYALU RICE 1KG,4,200,200,0,1
25-01-2025,Spices & Seasonings,Menthulu 250 gms,15,50,45,5,1
25-01-2025,"Grains, Flours & Dals",White jowar.F 1 kg,4,100,80,20,1
25-01-2025,"Grains, Flours & Dals",BLACK GRAM 1KG,4,150,140,10,1
25-01-2025,"Grains, Flours & Dals",split black gram 1 kg,4,180,170,10,1
25-01-2025,"Grains, Flours & Dals",Wheat Flour 5 kgs,4,350,300,50,1
25-01-2025,"Grains, Flours & Dals",Chana Flour 500 gms,4,70,65,5,1
25-01-2025,"Grains, Flours & Dals",YB RED RICE 500GM,4,75,65,10,1
25-01-2025,Sweeteners,ACHU BELLAM 1KG,16,100,80,20,1
25-01-2025,"Grains, Flours & Dals",split green gram 1 kg,4,150,140,10,1
25-01-2025,"Grains, Flours & Dals",SB Javva Wheat Ravva 500GM,4,95,95,0,1
25-01-2025,Pooja & Spiritual Items,JAGI KAYA 25GM,12,80,60,20,1
25-01-2025,"Grains, Flours & Dals",RICE FLOUR 1KG,4,70,55,15,1
25-01-2025,General Household & Kitchenware,MATCH BOX,3,40,40,0,2
25-01-2025,Pooja & Spiritual Items,VRP APOORVA JAVADHU POW,12,70,70,0,2
25-01-2025,"Grains, Flours & Dals",THICK POHA 500GM,4,40,35,5,1
25-01-2025,"Grains, Flours & Dals",Multigrain 1 kg,4,100,85,15,1
25-01-2025,"Dry Fruits, Nuts & Seeds",SABJA SEEDS 100GM,2,80,70,10,1
25-01-2025,"Grains, Flours & Dals",SRILATHA RICE RAVVA 500GM,4,140,140,0,4
25-01-2025,Milk & Dairy,BROWN EGGS TRAY 30P,7,360,330,30,1
25-01-2025,Oils & Ghee,Groundnut oil 1 L,9,720,660,60,2
25-01-2025,Snacks & Ready-to-Eat,PALLI LADDU 200GMS,14,90,70,20,1
25-01-2025,Oils & Ghee,Safflower oil 1 L,9,440,400,40,1
25-01-2025,Oils & Ghee,Coconut oil 1 L,9,440,400,40,1
25-01-2025,"Grains, Flours & Dals",Multigrain 1 kg,4,200,170,30,2
25-01-2025,"Grains, Flours & Dals",DESI CHANA,4,25,25,0,1
25-01-2025,"Grains, Flours & Dals",Em Multimillet idli r 500g,4,258,258,0,2
25-01-2025,Snacks & Ready-to-Eat,SD Ginger Candy 100g,14,120,120,0,2
25-01-2025,Oils & Ghee,Groundnut oil 1 L,9,720,660,60,2
25-01-2025,"Grains, Flours & Dals",Wheat Flour 1 kg,4,70,60,10,1
25-01-2025,"Grains, Flours & Dals",Multigrain 1 kg,4,300,255,45,3
25-01-2025,"Dry Fruits, Nuts & Seeds",ANJEER 250GM,2,400,360,40,1
25-01-2025,Oils & Ghee,Castor oil 200 ml,9,100,80,20,1
25-01-2025,Personal Care & Cosmetics,DWI SMARA SOAP 100GM,10,225,225,0,3
25-01-2025,"Dry Fruits, Nuts & Seeds",WALLNUTS 250GM,2,320,290,30,1
25-01-2025,Snacks & Ready-to-Eat,SATHVI REGIVADA 200GM,14,80,60,20,1
25-01-2025,"Grains, Flours & Dals",ROXY POORI ATTA 1KG,4,75,75,0,1
25-01-2025,Pooja & Spiritual Items,GD Dhoop Cones 40GM,12,30,30,0,1
25-01-2025,"Health, Wellness & Ayurvedic Products",MORINGA LEAF POWDER M,5,80,75,5,1
25-01-2025,"Grains, Flours & Dals",Wheat Flour 5 kgs,4,350,300,50,1
25-01-2025,Pooja & Spiritual Items,GD Dhoop Sticks 26GM,12,20,20,0,1
25-01-2025,"Grains, Flours & Dals",VGR rice 1 kg,4,70,65,5,1
25-01-2025,"Grains, Flours & Dals",Chana Flour 500 gms,4,70,65,5,1
25-01-2025,"Grains, Flours & Dals",Multigrain 1 kg,4,100,85,15,1
25-01-2025,"Grains, Flours & Dals",RAGI FLOUR 500GRMS,4,80,70,10,2
25-01-2025,"Grains, Flours & Dals",Yellow jowar.F 500 gms,4,55,50,5,1
25-01-2025,Snacks & Ready-to-Eat,VD SAGOPAPAD 150GM,14,55,55,0,1
25-01-2025,"Grains, Flours & Dals",SH WHITE POHA 500GM,4,56,56,0,1
25-01-2025,"Health, Wellness & Ayurvedic Products",RB Max Protein Oats &Raisins 55gm,5,50,50,0,1
25-01-2025,"Health, Wellness & Ayurvedic Products",RB Max Protein NUTS &SEEDS 55gm,5,50,50,0,1
25-01-2025,"Grains, Flours & Dals",SL Idly Rava 1KG,4,65,55,10,1
25-01-2025,"Grains, Flours & Dals",Chana Flour 1 kg,4,140,130,10,1
25-01-2025,"Grains, Flours & Dals",RICE FLOUR 1KG,4,70,55,15,1
25-01-2025,"Grains, Flours & Dals",SINGLE POLISH 1KG,4,325,325,0,5
25-01-2025,"Grains, Flours & Dals",ROXY POORI ATTA 1KG,4,75,75,0,1
25-01-2025,Spices & Seasonings,TATA SALT 1KG,15,60,60,0,2
25-01-2025,"Grains, Flours & Dals",SH TUR DAL 500GM,4,165,165,0,1
25-01-2025,"Grains, Flours & Dals",DH URAD GOTA 1KG,4,215,190,25,1
25-01-2025,Snacks & Ready-to-Eat,SATHVI REGIVADA 200GM,14,80,60,20,1
25-01-2025,Snacks & Ready-to-Eat,VD PAPPU CHEGODI 200GM,14,60,60,0,1
25-01-2025,Oils & Ghee,Coconut oil 500 ml,9,220,200,20,1
25-01-2025,Oils & Ghee,Safflower oil 1 L,9,880,800,80,2
25-01-2025,Snacks & Ready-to-Eat,SD Vamu with palm jaggery 250gm,14,135,135,0,1
25-01-2025,"Grains, Flours & Dals",JOWAR UPMA RAVA,4,0,0,0,1
25-01-2025,Spices & Seasonings,Tamalapaku Karam Powder 100GM,15,80,80,0,1
25-01-2025,"Grains, Flours & Dals",Chana Flour 1 kg,4,140,130,10,1
25-01-2025,"Grains, Flours & Dals",KORRALU (FOXTAIL M) 1KG,4,150,110,40,1
25-01-2025,Snacks & Ready-to-Eat,SATHVI MIXED CHIKKI 200GM,14,120,100,20,1
25-01-2025,"Dry Fruits, Nuts & Seeds",MAHA BEERA SEEDS 100GM,2,60,60,0,1
25-01-2025,"Dry Fruits, Nuts & Seeds",PUTNALU 500GMS,2,90,76,14,1
25-01-2025,Milk & Dairy,SANGAM TONED MILK 500ML,7,30,30,0,1
25-01-2025,"Grains, Flours & Dals",Quinova 1 kg,4,220,195,25,1
25-01-2025,Milk & Dairy,SANGAM FULL CREAM MILK 500ML,7,38,38,0,1
25-01-2025,Sweeteners,ACHUBELLAM 500GM,16,50,40,10,1
25-01-2025,Oils & Ghee,Freedom Rice Bran Oil 1L,9,194,180,14,1
25-01-2025,"Grains, Flours & Dals",RICE FLOUR 500 GM,4,35,28,7,1
25-01-2025,"Grains, Flours & Dals",Chana Flour 500 gms,4,70,65,5,1
25-01-2025,"Grains, Flours & Dals",THICK POHA 500GM,4,40,35,5,1
25-01-2025,Snacks & Ready-to-Eat,Corn Chips 250GM,14,80,70,10,2
25-01-2025,Snacks & Ready-to-Eat,RAJGIRA PEANUT CHIKKI,14,10,10,0,2
25-01-2025,"Grains, Flours & Dals",Wheat Flour 1 kg,4,70,60,10,1
25-01-2025,Snacks & Ready-to-Eat,VD Pappu Chekkalu 190gm,14,60,60,0,1
25-01-2025,Spices & Seasonings,RED COPRA 250GMS,15,85,74,11,1
25-01-2025,"Grains, Flours & Dals",RICE FLOUR 500 GM,4,35,28,7,1
25-01-2025,"Grains, Flours & Dals",RAGI FLOUR 500GRMS,4,80,70,10,2
25-01-2025,Snacks & Ready-to-Eat,SD FLAX SEED APPADALU,14,90,90,0,1
25-01-2025,"Grains, Flours & Dals",split black gram 1 kg,4,180,170,10,1
25-01-2025,"Health, Wellness & Ayurvedic Products",JAMBU SEED CHOORNAM 100GM,5,80,80,0,1
25-01-2025,"Grains, Flours & Dals",Urad dall 1 Kg,4,185,170,15,1
25-01-2025,"Grains, Flours & Dals",Green gram 1 kg,4,150,130,20,1
25-01-2025,"Health, Wellness & Ayurvedic Products",MD Ashwagandha Choornam 100GM,5,170,170,0,1
25-01-2025,"Grains, Flours & Dals",KORRALU (FOXTAIL M) 1KG,4,150,110,40,1
25-01-2025,"Grains, Flours & Dals",SAMALU (Little millet) 1 kg,4,170,130,40,1
25-01-2025,Snacks & Ready-to-Eat,PEANUT CANDY,14,45,45,0,1
25-01-2025,Snacks & Ready-to-Eat,MILLET NOODLES CURRY MASALA,14,129,129,0,1
25-01-2025,Snacks & Ready-to-Eat,PEANUT CHILLI,14,5,5,0,1
25-01-2025,Sweeteners,YB JAGGERY POWDER 1KG,16,140,140,0,1
25-01-2025,Snacks & Ready-to-Eat,FUN TIME CRUNCH,14,45,45,0,1
25-01-2025,Oils & Ghee,Coconut oil 500 ml,9,220,200,20,1
25-01-2025,"Grains, Flours & Dals",HS Jowar upma rava 500 gms,4,130,130,0,2
25-01-2025,"Grains, Flours & Dals",RED WHEAT 1 KG,4,650,650,0,5
25-01-2025,"Grains, Flours & Dals",SINGLE POLISH 1KG,4,325,325,0,5
25-01-2025,"Grains, Flours & Dals",FLOUR CHARGE,4,60,60,0,5
25-01-2025,Snacks & Ready-to-Eat,PEANUT CHILLI,14,35,35,0,7
25-01-2025,Spices & Seasonings,ROYAL SAFFRON 400GRMS,15,65,65,0,1
25-01-2025,Snacks & Ready-to-Eat,SATHVI PALLI CHIKKI 200GM,14,100,80,20,1
25-01-2025,"Grains, Flours & Dals",CHANA DAL 500GM,4,70,60,10,1
25-01-2025,Spices & Seasonings,DRY MIECHI 200GM,15,80,60,20,1
25-01-2025,"Dry Fruits, Nuts & Seeds",Groundnuts 1 kg,2,190,170,20,1
25-01-2025,"Grains, Flours & Dals",Urad dall 1 Kg,4,185,170,15,1
25-01-2025,Snacks & Ready-to-Eat,PALLI LADDU 200GMS,14,90,70,20,1
25-01-2025,Pooja & Spiritual Items,GD Yagnadhara 31PC,12,70,70,0,1
25-01-2025,Snacks & Ready-to-Eat,COPRA LADDU 200GM,14,100,80,20,1
25-01-2025,Snacks & Ready-to-Eat,ZEEDI,14,70,70,0,1
25-01-2025,Snacks & Ready-to-Eat,COPRA LADDU 200GM,14,100,80,20,1
25-01-2025,"Dry Fruits, Nuts & Seeds",WATERMELON SEEDS 250GRM,2,320,280,40,1
25-01-2025,"Dry Fruits, Nuts & Seeds",PUMPKIN SEEDS 250GM,2,200,160,40,1
25-01-2025,Snacks & Ready-to-Eat,BD KODO MILLET NOODLES 200GM,14,75,75,0,1
25-01-2025,Snacks & Ready-to-Eat,Pani Poori Chips 250GM,14,50,40,10,1
25-01-2025,Snacks & Ready-to-Eat,VD DAHI MIRCHI(SALTED) 100GM,14,45,45,0,1
25-01-2025,Snacks & Ready-to-Eat,SH PUFFED RICE 500GM,14,55,55,0,1
25-01-2025,"Dry Fruits, Nuts & Seeds",PULMAKHANA 100 GM,2,180,170,10,1
25-01-2025,"Dry Fruits, Nuts & Seeds",SUNFLOWER SEEDS 250GRM,2,150,130,20,1
25-01-2025,Snacks & Ready-to-Eat,JUNNU POWDER 100GM,14,140,140,0,2
25-01-2025,"Grains, Flours & Dals",RAGI FLOUR 500GRMS,4,40,35,5,1
25-01-2025,Oils & Ghee,Sesame oil 1 L,9,590,560,30,1
25-01-2025,"Grains, Flours & Dals",Multigrain 1 kg,4,100,85,15,1
25-01-2025,Snacks & Ready-to-Eat,NGT CHATPATTA CHANA 90GM,14,25,25,0,1
25-01-2025,"Grains, Flours & Dals",RAGI FLOUR 1KG,4,160,140,20,2
25-01-2025,Snacks & Ready-to-Eat,BD KODO MILLET NOODLES 200GM,14,75,75,0,1
25-01-2025,Oils & Ghee,Safflower oil 1 L,9,440,400,40,1
25-01-2025,Spices & Seasonings,Poonam Mixed Masala 50GM,15,90,90,0,1
25-01-2025,"Grains, Flours & Dals",turdal 500 gms,4,110,100,10,1
25-01-2025,"Grains, Flours & Dals",Wheat Rava M 500GM,4,33,30,3,1
25-01-2025,"Dry Fruits, Nuts & Seeds",ALMONDS 250GM,2,280,260,20,1
25-01-2025,Pooja & Spiritual Items,PACHA KARPURAM 10GM,12,60,60,0,1
25-01-2025,"Grains, Flours & Dals",HS Multimillet upma r 500g,4,65,65,0,1
25-01-2025,Spices & Seasonings,SD IDLY KARAM,15,65,65,0,1
25-01-2025,"Grains, Flours & Dals",SOYA BEANS 1KG,4,50,45,5,0.25
25-01-2025,Snacks & Ready-to-Eat,SF MILLET PANCAKE CLASSIC 150GM,14,119,119,0,1
25-01-2025,Sweeteners,MADHUR SUGAR 1KG,16,65,55,10,1
25-01-2025,"Grains, Flours & Dals",KORRALU (FOXTAIL M) 500GM,4,65,55,10,1
25-01-2025,"Dry Fruits, Nuts & Seeds",SALTED PISTA 250GM,2,400,350,50,1
25-01-2025,Snacks & Ready-to-Eat,SF VERMICELLI,14,139,139,0,1
25-01-2025,Snacks & Ready-to-Eat,SATHVI REGIVADA 200GM,14,80,60,20,1
25-01-2025,"Grains, Flours & Dals",RAGULU 1 KG,4,35,30,5,0.5
25-01-2025,"Grains, Flours & Dals",RAGI FLOUR 500GRMS,4,40,35,5,1
25-01-2025,"Grains, Flours & Dals",Multigrain 1 kg,4,200,170,30,2
25-01-2025,Snacks & Ready-to-Eat,BLACK SESAME CHIKKI,14,40,40,0,4
25-01-2025,"Grains, Flours & Dals",Multigrain 1 kg,4,100,85,15,1
25-01-2025,"Health, Wellness & Ayurvedic Products",RB Max Protein Chinese Manchurian,5,45,45,0,1
25-01-2025,Personal Care & Cosmetics,SVE KHADI CARROT GEL 100GM,10,145,145,0,1
25-01-2025,Personal Care & Cosmetics,SVE PREMIUM WILD TURMEIC 100GM,10,110,110,0,1
25-01-2025,"Grains, Flours & Dals",HS BARLEY FLAKES 250GM 1+1,4,119,119,0,1
25-01-2025,"Grains, Flours & Dals",Red Wheat Flour 1 kg,4,140,130,10,1
25-01-2025,"Grains, Flours & Dals",EM kodo upma R 500g,4,129,129,0,1
25-01-2025,Personal Care & Cosmetics,ORGANIC SPONGE LOOFAH,10,70,70,0,1
25-01-2025,Snacks & Ready-to-Eat,BLACK SESAME CHIKKI,14,5,5,0,1
25-01-2025,Spices & Seasonings,Menthulu 250 gms,15,100,90,10,2
25-01-2025,Spices & Seasonings,Chilli powder 1 kg,15,580,420,160,1
25-01-2025,"Grains, Flours & Dals",Arikadu ( kodo),4,140,130,10,1
25-01-2025,"Grains, Flours & Dals",Quinova 1 kg,4,220,195,25,1
25-01-2025,"Grains, Flours & Dals",SAMALU (Little millet) 1 kg,4,170,130,40,1
25-01-2025,"Grains, Flours & Dals",UDALU (Barnyard millet) 1 kg,4,140,115,25,1
25-01-2025,"Grains, Flours & Dals",KORRALU (FOXTAIL M) 1KG,4,150,110,40,1
25-01-2025,"Grains, Flours & Dals",Brown rice 5 kgs,4,350,325,25,1
25-01-2025,"Grains, Flours & Dals",Red uluvalu 500 gms,4,270,225,45,3
25-01-2025,Sweeteners,MISHRI D,16,40,30,10,1
25-01-2025,Pooja & Spiritual Items,SOSR SWATHHI 365,12,30,30,0,1
25-01-2025,Spices & Seasonings,SAJEERA,15,60,40,20,1
25-01-2025,Sweeteners,MISHRI 250 GM,16,35,30,5,1
25-01-2025,"Dry Fruits, Nuts & Seeds",SD Mango cubes 100gm,2,45,45,0,1
25-01-2025,"Grains, Flours & Dals",Multigrain 1 kg,4,200,170,30,2
25-01-2025,Spices & Seasonings,Chilli powder 1 kg,15,1160,840,320,2
25-01-2025,Spices & Seasonings,Masala Karam 500 gms,15,260,240,20,1
25-01-2025,Oils & Ghee,Sesame oil 1 L,9,1180,"1,120.00",60,2
25-01-2025,"Grains, Flours & Dals",CHANA DAL 1KG,4,140,120,20,1
25-01-2025,Spices & Seasonings,Black Till 250GM,15,270,225,45,3
25-01-2025,Spices & Seasonings,Menthulu 250 gms,15,50,45,5,1
25-01-2025,"Grains, Flours & Dals",Green gram 1 kg,4,150,130,20,1
25-01-2025,"Grains, Flours & Dals",SRILALITHA MAIDA FLOUR 500G,4,32,32,0,1
25-01-2025,"Grains, Flours & Dals",SL Idly Rava 1KG,4,65,55,10,1
25-01-2025,"Grains, Flours & Dals",SL Idly Rava 1KG,4,65,55,10,1
25-01-2025,"Grains, Flours & Dals",FLOUR CHARGE,4,33.6,33.6,0,2.8
25-01-2025,"Dry Fruits, Nuts & Seeds",SD Mango cubes 100gm,2,45,45,0,1
25-01-2025,Snacks & Ready-to-Eat,PEANUT CHILLI,14,5,5,0,1
25-01-2025,Snacks & Ready-to-Eat,MARMURA LADDU,14,80,60,20,1
25-01-2025,Snacks & Ready-to-Eat,VD Pappu Chekkalu 190gm,14,60,60,0,1
25-01-2025,"Health, Wellness & Ayurvedic Products",RB Max Protein Fruit &amp;Nut 50g,5,75,75,0,1
25-01-2025,Snacks & Ready-to-Eat,VD NUVULU CHEGODI 175GM,14,60,60,0,1
25-01-2025,Snacks & Ready-to-Eat,BELLAM MINAPA SUNADULLU,14,180,180,0,1
25-01-2025,Sweeteners,KAMAL JAGGERY 500GM,16,80,80,0,2
25-01-2025,Spices & Seasonings,pickles chilli .pwdr 500 gms,15,355,325,30,1
25-01-2025,Spices & Seasonings,Tamarind 250GMS,15,80,65,15,1
25-01-2025,Spices & Seasonings,Masala Karam 500 gms,15,520,480,40,2
25-01-2025,"Grains, Flours & Dals",Red Bobarlu 1 kg,4,190,170,20,1
25-01-2025,"Grains, Flours & Dals",Wheat Flour 1 kg,4,140,120,20,2
25-01-2025,"Grains, Flours & Dals",SRILATHA RICE RAVVA 500GM,4,70,70,0,2
25-01-2025,Oils & Ghee,Sesame oil 1 L,9,590,560,30,1
25-01-2025,"Grains, Flours & Dals",RICE FLOUR 500 GM,4,35,28,7,1
25-01-2025,"Grains, Flours & Dals",ROXY POORI ATTA 1KG,4,75,75,0,1
25-01-2025,"Grains, Flours & Dals",White Chana 500GM,4,240,200,40,2
25-01-2025,Oils & Ghee,Groundnut oil 1 L,9,360,330,30,1
25-01-2025,"Grains, Flours & Dals",Kandulu 500GM,4,80,70,10,1
25-01-2025,"Grains, Flours & Dals",SL Idly Rava 1KG,4,130,110,20,2
25-01-2025,Snacks & Ready-to-Eat,BB ROASTED VERMICELLY 850GM,14,117,117,0,1
25-01-2025,"Grains, Flours & Dals",Wheat Rava M 500GM,4,33,30,3,1
25-01-2025,"Grains, Flours & Dals",turdal 500 gms,4,110,100,10,1
25-01-2025,"Grains, Flours & Dals",Wheat Rava M 1KG,4,65,55,10,1
25-01-2025,"Dry Fruits, Nuts & Seeds",BLACK KISMIS 250GM,2,175,140,35,1
25-01-2025,"Grains, Flours & Dals",Green Batani 250GM,4,110,90,20,2
25-01-2025,"Grains, Flours & Dals",CHANA DAL 500GM,4,70,60,10,1
25-01-2025,"Grains, Flours & Dals",split black gram 1 kg,4,360,340,20,2
25-01-2025,"Grains, Flours & Dals",Chana Flour 500 gms,4,70,65,5,1
25-01-2025,"Grains, Flours & Dals",WHITE BATANI 500GM,4,80,60,20,1
25-01-2025,"Grains, Flours & Dals",split green gram 500 gms,4,75,70,5,1
25-01-2025,"Grains, Flours & Dals",BASMATHI RICE 1KG,4,150,135,15,1
25-01-2025,"Grains, Flours & Dals",SL Suji Rava 500GM,4,64,64,0,2
25-01-2025,"Grains, Flours & Dals",AISHWARYA SP 25KG,4,1999,"1,825.00",174,1
25-01-2025,"Grains, Flours & Dals",Chittimuthaylu rice 1 kg,4,160,140,20,1
25-01-2025,"Grains, Flours & Dals",Red Chana 250GM,4,35,30,5,1
25-01-2025,"Dry Fruits, Nuts & Seeds",Groundnuts 1 kg,2,190,170,20,1
25-01-2025,Spices & Seasonings,Masala Karam 250 gms,15,130,120,10,1
25-01-2025,Spices & Seasonings,Turmeric powder 250 gms,15,100,75,25,1
25-01-2025,"Grains, Flours & Dals",Bobbara Pappu 1KG,4,180,160,20,1
25-01-2025,"Grains, Flours & Dals",Wheat Rava M 1KG,4,65,55,10,1
25-01-2025,"Grains, Flours & Dals",Bombay Rava 500GM,4,35,30,5,1
25-01-2025,Snacks & Ready-to-Eat,COPRA LADDU 200GM,14,100,80,20,1
25-01-2025,"Grains, Flours & Dals",Wheat Rava M 1KG,4,65,55,10,1
25-01-2025,"Grains, Flours & Dals",Idly Rava L 1KG,4,120,100,20,2
25-01-2025,"Grains, Flours & Dals",MELMEKER 250GMS,4,60,45,15,1
25-01-2025,"Dry Fruits, Nuts & Seeds",Groundnuts 1 kg,2,190,170,20,1
25-01-2025,"Grains, Flours & Dals",JOWAR YELLOW 1 K,4,100,90,10,1
25-01-2025,"Grains, Flours & Dals",White jowar.F 1 kg,4,100,80,20,1
25-01-2025,"Grains, Flours & Dals",Wheat Flour 1 kg,4,70,60,10,1
25-01-2025,"Grains, Flours & Dals",RAGULU 1 KG,4,70,60,10,1
25-01-2025,Snacks & Ready-to-Eat,VD BELLAM GAVVALU 200GM,14,60,60,0,1
25-01-2025,Snacks & Ready-to-Eat,MB FOXTAIL MILLET NOODLES 180GM,14,95,95,0,1
25-01-2025,"Grains, Flours & Dals",FLOUR CHARGE,4,36,36,0,3
25-01-2025,Snacks & Ready-to-Eat,SATHVI MIXED CHIKKI 200GM,14,120,100,20,1
25-01-2025,Snacks & Ready-to-Eat,MB SORGHUM NOODLES 180GM,14,95,95,0,1
25-01-2025,"Grains, Flours & Dals",Multigrain 1 kg,4,100,85,15,1
25-01-2025,Snacks & Ready-to-Eat,PUMPKIN CHIKKI 200GM,14,140,120,20,1
25-01-2025,Snacks & Ready-to-Eat,Sprouted Ragi Biscuits 450GM,14,150,150,0,1
25-01-2025,"Grains, Flours & Dals",THICK POHA 500GM,4,40,35,5,1
25-01-2025,Snacks & Ready-to-Eat,BATANA NGT 70GMS,14,20,20,0,1
25-01-2025,"Health, Wellness & Ayurvedic Products",MXP CHOCO CLASSIC BAR,5,70,70,0,1
25-01-2025,Snacks & Ready-to-Eat,VD RICE SAGO PAPAD 150GM,14,55,55,0,1
25-01-2025,"Grains, Flours & Dals",UDALU (Barnyard millet) 1 kg,4,140,115,25,1
25-01-2025,"Grains, Flours & Dals",SAMALU (Little millet) 1 kg,4,170,130,40,1
25-01-2025,"Grains, Flours & Dals",Chana Flour 500 gms,4,70,65,5,1
25-01-2025,Oils & Ghee,Groundnut oil 1 L,9,720,660,60,2
25-01-2025,Snacks & Ready-to-Eat,COPRA LADDU 200GM,14,100,80,20,1
25-01-2025,Oils & Ghee,Coconut oil 500 ml,9,220,200,20,1
25-01-2025,"Grains, Flours & Dals",RAGULU 1 KG,4,70,60,10,1
25-01-2025,"Grains, Flours & Dals",BAJRA 1 KG,4,60,50,10,1
25-01-2025,"Grains, Flours & Dals",JOWAR WHITE 1 KG,4,80,70,10,1
25-01-2025,Spices & Seasonings,NUVVULU 250GM,15,80,65,15,1
25-01-2025,"Grains, Flours & Dals",THICK POHA 500GM,4,40,35,5,1
25-01-2025,"Grains, Flours & Dals",Wheat Flour 1 kg,4,70,60,10,1
25-01-2025,"Health, Wellness & Ayurvedic Products",RB Max Protein Spanish Tomato,5,45,45,0,1
25-01-2025,Oils & Ghee,Groundnut oil 500ml,9,180,165,15,1
25-01-2025,"Grains, Flours & Dals",JOWAR WHITE 1 KG,4,40,35,5,0.5
25-01-2025,Beverages,BRU GREEN LABEL 1.2G,1,10,10,0,5
25-01-2025,Snacks & Ready-to-Eat,PEANUT CHILLI,14,5,5,0,1
25-01-2025,"Grains, Flours & Dals",Arikalu (kodo),4,70,65,5,1
25-01-2025,"Dry Fruits, Nuts & Seeds",Groundnuts 500 gms,2,95,85,10,1
25-01-2025,Oils & Ghee,Sesame oil 500ml,9,295,280,15,1
25-01-2025,"Grains, Flours & Dals",BARLEY SEEDS 250GMS,4,40,35,5,1
25-01-2025,"Grains, Flours & Dals",Idly Rava L 1KG,4,120,100,20,2
25-01-2025,Spices & Seasonings,Tamarind 250GMS,15,80,65,15,1
25-01-2025,"Grains, Flours & Dals",RICE FLOUR 1KG,4,70,55,15,1
25-01-2025,"Grains, Flours & Dals",Urad dall 1 Kg,4,185,170,15,1
25-01-2025,"Grains, Flours & Dals",FLOUR CHARGE,4,12,12,0,1
25-01-2025,"Grains, Flours & Dals",FLOUR CHARGE,4,18.84,18.84,0,1.57
25-01-2025,Snacks & Ready-to-Eat,RSC ORANGE 100GMS,14,20,20,0,1
25-01-2025,Personal Care & Cosmetics,HERBAL BATH POWDER,10,160,160,0,1
25-01-2025,Oils & Ghee,Sesame oil 1 L,9,590,560,30,1
25-01-2025,Oils & Ghee,Groundnut oil 1 L,9,360,330,30,1
25-01-2025,"Grains, Flours & Dals",VGR RICE bag 1,4,1899,"1,650.00",249,1
25-01-2025,Milk & Dairy,SANGAM FULL CREAM MILK 500ML,7,38,38,0,1
25-01-2025,Milk & Dairy,SANGAM CURD 450GM,7,38,38,0,1
25-01-2025,Spices & Seasonings,Masala Karam 250 gms,15,260,240,20,2
25-01-2025,"Grains, Flours & Dals",White jowar.F 1 kg,4,100,80,20,1
25-01-2025,"Grains, Flours & Dals",Bajra Flour 1 kg,4,70,60,10,1
25-01-2025,"Grains, Flours & Dals",RAGI FLOUR 1KG,4,80,70,10,1
25-01-2025,"Grains, Flours & Dals",RAGI FLOUR 1KG,4,80,70,10,1
25-01-2025,Oils & Ghee,Groundnut oil 1 L,9,720,660,60,2
25-01-2025,"Grains, Flours & Dals",Chana Flour 1 kg,4,140,130,10,1
25-01-2025,"Grains, Flours & Dals",KORRALU (FOXTAIL M) 1KG,4,150,110,40,1
25-01-2025,Oils & Ghee,Sesame oil 1 L,9,1180,"1,120.00",60,2
25-01-2025,"Grains, Flours & Dals",JOWAR WHITE 1 KG,4,80,70,10,1
25-01-2025,"Dry Fruits, Nuts & Seeds",GF KIMIA DATES 500GM,2,310,190,120,1
25-01-2025,Snacks & Ready-to-Eat,OK Pasta Fusilli 400GM,14,120,120,0,1
25-01-2025,Snacks & Ready-to-Eat,MILLET NOODLES CURRY MASALA,14,129,129,0,1
25-01-2025,"Grains, Flours & Dals",BOMBAY RAVA,4,70,55,15,1
25-01-2025,Spices & Seasonings,Jeera 100GM,15,50,45,5,1
25-01-2025,Spices & Seasonings,Elaichi 25GM,15,145,120,25,1
25-01-2025,Spices & Seasonings,Lavangam 50GM,15,60,50,10,1
25-01-2025,Snacks & Ready-to-Eat,BROWN BREAD,14,55,55,0,1
25-01-2025,"Grains, Flours & Dals",Wheat Rava S 500GM,4,33,30,3,1
25-01-2025,"Grains, Flours & Dals",RAGI FLOUR 1KG,4,80,70,10,1
25-01-2025,Spices & Seasonings,TATA SALT 1KG,15,30,30,0,1
25-01-2025,Spices & Seasonings,Coriander seeds 200 gms,15,48,40,8,1
25-01-2025,"Dry Fruits, Nuts & Seeds",YELLOW KISHMISH 250GM,2,130,110,20,1
25-01-2025,Spices & Seasonings,SAJEERA,15,60,40,20,1
25-01-2025,"Dry Fruits, Nuts & Seeds",CASHEW 250GM,2,340,310,30,1
25-01-2025,Spices & Seasonings,Japatri 25GM,15,100,80,20,1
25-01-2025,Spices & Seasonings,SWEET SOUNF,15,20,20,0,1
25-01-2025,Spices & Seasonings,Turmeric powder 250 gms,15,100,75,25,1
25-01-2025,"Health, Wellness & Ayurvedic Products",MH Baby Food 400GM,5,400,400,0,2
25-01-2025,"Dry Fruits, Nuts & Seeds",DRYDATES 250GM,2,150,120,30,1
25-01-2025,Spices & Seasonings,RED COPRA 500GM,15,170,148,22,1
25-01-2025,"Grains, Flours & Dals",PRO ORG KABULI CHANNA 500GM,4,196,196,0,1
25-01-2025,Oils & Ghee,Groundnut oil 5 L,9,1800,"1,600.00",200,1
25-01-2025,"Grains, Flours & Dals",turdal 1kg,4,440,390,50,2
25-01-2025,"Grains, Flours & Dals",SINGLE POLISH 1KG,4,195,195,0,3
25-01-2025,Personal Care & Cosmetics,MESWAK 100GM,10,70,70,0,1
25-01-2025,"Grains, Flours & Dals",SRILATHA RICE RAVVA 500GM,4,35,35,0,1
25-01-2025,Spices & Seasonings,NUVVULU 250GM,15,80,65,15,1
25-01-2025,"Grains, Flours & Dals",THICK POHA 500GM,4,40,35,5,1
25-01-2025,"Grains, Flours & Dals",EM Ragi idli R 500G,4,75,75,0,1
25-01-2025,Snacks & Ready-to-Eat,SD KODO MILLET WITH PALM JAGGERY,14,135,135,0,1
25-01-2025,"Grains, Flours & Dals",EM Ragi upma R 500g,4,75,75,0,1
25-01-2025,Snacks & Ready-to-Eat,SD JOWAR WITH PALM JAGGERY 250GM,14,135,135,0,1
25-01-2025,"Dry Fruits, Nuts & Seeds",SD Mango cubes 100gm,2,45,45,0,1
25-01-2025,Snacks & Ready-to-Eat,RB Choco Delite Almonds Raisins 40g,14,90,90,0,2
25-01-2025,Snacks & Ready-to-Eat,Popcorn Seeds 250GM,14,45,40,5,1
25-01-2025,"Grains, Flours & Dals",Wheat Flour 1 kg,4,70,60,10,1
25-01-2025,"Grains, Flours & Dals",UDALU (Barnyard millet) 500 gms,4,70,60,10,1
25-01-2025,"Grains, Flours & Dals",SAMALU (Little millet) 500 gms,4,85,65,20,1
25-01-2025,Snacks & Ready-to-Eat,SESAME LADDU 200GM,14,100,80,20,1
25-01-2025,Oils & Ghee,Safflower oil 1 L,9,880,800,80,2
25-01-2025,Oils & Ghee,Sesame oil 1 L,9,590,560,30,1
25-01-2025,Snacks & Ready-to-Eat,PALLI LADDU 200GMS,14,180,140,40,2
25-01-2025,Sweeteners,YB JAGGERY POWDER 1KG,16,280,280,0,2
25-01-2025,"Grains, Flours & Dals",RICE FLOUR 500 GM,4,35,28,7,1
25-01-2025,"Grains, Flours & Dals",RAJMA 250GM,4,55,45,10,1
25-01-2025,"Grains, Flours & Dals",RED TUDAL 1KG,4,150,140,10,1
25-01-2025,"Grains, Flours & Dals",WHITE BATANI 500GM,4,80,60,20,1
25-01-2025,Oils & Ghee,Sesame oil 1 L,9,590,560,30,1
25-01-2025,"Dry Fruits, Nuts & Seeds",GF DATES 500GM,2,156,149,7,1
25-01-2025,"Grains, Flours & Dals",HS jowar idly rava 500 gms,4,65,65,0,1
25-01-2025,Snacks & Ready-to-Eat,BATANA NGT 70GMS,14,40,40,0,2
25-01-2025,Beverages,GANTASALA GREEN TEA 100GM,1,149,149,0,1
25-01-2025,Oils & Ghee,Groundnut oil 1 L,9,360,330,30,1
25-01-2025,Personal Care & Cosmetics,UVIS COW GHEE SOAP 100GM,10,85,85,0,1
25-01-2025,Personal Care & Cosmetics,SUNNUPINDI SOAP UVS,10,99,99,0,1
25-01-2025,Personal Care & Cosmetics,MADDI ALOEVERA SHAMPOO 500ML,10,300,300,0,1
25-01-2025,Personal Care & Cosmetics,SVE TURMERIC SOAP 100GM,10,110,110,0,1
25-01-2025,Personal Care & Cosmetics,SVE KHADI ALOEVERA GEL 100GM,10,140,140,0,1
25-01-2025,Personal Care & Cosmetics,GOW DURBAR NAVA 100GM SOAP,10,40,40,0,1
25-01-2025,"Grains, Flours & Dals",HS BARLEY FLAKES 250GM 1+1,4,57,57,0,1
25-01-2025,Pickles & Cooking Pastes,SD GINGER GARLIC PASTE,11,240,240,0,2
25-01-2025,Sweeteners,YB Brown Sugar 500GM,16,75,75,0,1
25-01-2025,Snacks & Ready-to-Eat,OK Pasta Fusilli 400GM,14,240,240,0,2
25-01-2025,Snacks & Ready-to-Eat,SATHVI REGIVADA 200GM,14,80,60,20,1
25-01-2025,Snacks & Ready-to-Eat,SALTED PHALLI,14,65,65,0,1
25-01-2025,Snacks & Ready-to-Eat,SATHVI MIXED CHIKKI 200GM,14,120,100,20,1
25-01-2025,"Grains, Flours & Dals",DOCTOR RICE DIABETIC SFR 1KG,4,600,600,0,5
25-01-2025,Snacks & Ready-to-Eat,ELITE MILK RUSK 200GM,14,35,35,0,1
25-01-2025,"Grains, Flours & Dals",Multigrain 1 kg,4,100,85,15,1
25-01-2025,Sweeteners,SD PALM JAGGERY 500GM,16,200,200,0,1
25-01-2025,Sweeteners,SUGAR 1KG,16,60,50,10,1
25-01-2025,Snacks & Ready-to-Eat,VD VAMUPUSA 175GM,14,60,60,0,1
25-01-2025,Oils & Ghee,Coconut oil 1 L,9,440,400,40,1
25-01-2025,Snacks & Ready-to-Eat,VD RIBBON PAKODI 175GM,14,60,60,0,1
25-01-2025,Snacks & Ready-to-Eat,VD MURUKU 175GM,14,60,60,0,1
25-01-2025,Oils & Ghee,cow ghee 500 ml,9,430,390,40,1
25-01-2025,"Grains, Flours & Dals",BOMBAY RAVA,4,70,55,15,1
25-01-2025,"Grains, Flours & Dals",Arikadu ( kodo),4,140,130,10,1
25-01-2025,"Grains, Flours & Dals",Wheat Flour 1 kg,4,70,60,10,1
25-01-2025,Spices & Seasonings,GREEN SOUNF,15,60,40,20,1
25-01-2025,"Grains, Flours & Dals",Multigrain 1 kg,4,100,85,15,1
25-01-2025,"Grains, Flours & Dals",THICK POHA 500GM,4,40,35,5,1
25-01-2025,"Grains, Flours & Dals",turdal 1kg,4,220,195,25,1
25-01-2025,Sweeteners,MADHUR SUGAR 1KG,16,65,55,10,1
25-01-2025,"Grains, Flours & Dals",KORRALU (FOXTAIL M) 1KG,4,150,110,40,1
25-01-2025,"Grains, Flours & Dals",SAMALU (Little millet) 1 kg,4,170,130,40,1
25-01-2025,Pooja & Spiritual Items,GD Ramayana Sandal 75GM,12,60,60,0,1
25-01-2025,"Grains, Flours & Dals",UDALU (Barnyard millet) 1 kg,4,140,115,25,1
25-01-2025,Spices & Seasonings,CHILLI POWDER,15,290,210,80,1
25-01-2025,Pooja & Spiritual Items,GOW DURBAR GEETHA CAMPHOR,12,60,60,0,1
25-01-2025,Spices & Seasonings,DRY MIECHI 200GM,15,80,60,20,1
25-01-2025,Spices & Seasonings,JEERA 250 gms,15,125,105,20,1
25-01-2025,"Grains, Flours & Dals",CHANA DAL 500GM,4,70,60,10,1
25-01-2025,"Health, Wellness & Ayurvedic Products",RB Nuts& Seeds cashews 35g,5,45,45,0,1
25-01-2025,"Grains, Flours & Dals",Chittimuthaylu rice 1 kg,4,160,140,20,1
25-01-2025,"Grains, Flours & Dals",split black gram 1 kg,4,180,170,10,1
25-01-2025,"Grains, Flours & Dals",split green gram 500 gms,4,75,70,5,1
25-01-2025,"Grains, Flours & Dals",BASMATHI RICE 1KG,4,150,135,15,1
25-01-2025,"Dry Fruits, Nuts & Seeds",PULMAKHANA 100 GM,2,180,170,10,1
25-01-2025,"Grains, Flours & Dals",RED TURDAL 500GM,4,75,70,5,1
25-01-2025,Oils & Ghee,BUFFALLO GHEE 500ML,9,410,370,40,1
25-01-2025,"Dry Fruits, Nuts & Seeds",Groundnuts 1 kg,2,190,170,20,1
25-01-2025,Snacks & Ready-to-Eat,KURNOOL MARMURA,14,70,55,15,1
25-01-2025,Snacks & Ready-to-Eat,VD RICE PAPAD 150GM,14,50,50,0,1
25-01-2025,"Grains, Flours & Dals",KORRALU (FOXTAIL M) 500GM,4,65,55,10,1
25-01-2025,Snacks & Ready-to-Eat,SD BLACK GRAM PAPADS,14,80,80,0,1
25-01-2025,"Grains, Flours & Dals",THICK POHA 500GM,4,40,35,5,1
25-01-2025,"Grains, Flours & Dals",PESARA PAPPU 500GMS,4,85,75,10,1
25-01-2025,"Grains, Flours & Dals",UDALU (Barnyard millet) 500 gms,4,70,60,10,1
25-01-2025,"Grains, Flours & Dals",THICK POHA 500GM,4,40,35,5,1
25-01-2025,"Grains, Flours & Dals",SRILALITHA MAIDA FLOUR 500G,4,64,64,0,2
25-01-2025,Snacks & Ready-to-Eat,SD Moringa with plam jaggery 250gm,14,135,135,0,1
25-01-2025,"Grains, Flours & Dals",VGR RICE bag 1,4,1899,"1,650.00",249,1
25-01-2025,"Dry Fruits, Nuts & Seeds",SD Mango cubes 200gm,2,90,90,0,1
25-01-2025,Oils & Ghee,Groundnut oil 1 L,9,360,330,30,1
25-01-2025,Spices & Seasonings,GREEN SOUNF,15,60,40,20,1
25-01-2025,Milk & Dairy,HERITAGE TONED MILK 500ML,7,31,31,0,1
25-01-2025,Milk & Dairy,HERITAGE TOTAL CURD 500GM,7,50,50,0,1
25-01-2025,Oils & Ghee,Coconut oil 500 ml,9,220,200,20,1
25-01-2025,Pooja & Spiritual Items,GD Bhagavatha Mallika 75GM,12,60,60,0,1
25-01-2025,Personal Care & Cosmetics,GOW DURBAR NAVA 100GM SOAP,10,40,40,0,1
25-01-2025,"Health, Wellness & Ayurvedic Products",MH Millets Malt 500GM,5,200,190,10,1
25-01-2025,Milk & Dairy,SANGAM TONED MILK 500ML,7,30,30,0,1
25-01-2025,Snacks & Ready-to-Eat,ELITE ELAICHI RUSK 200GM,14,35,35,0,1
25-01-2025,Milk & Dairy,SANGAM CURD 450GM,7,38,38,0,1
25-01-2025,Sweeteners,MADHUR SUGAR 1KG,16,65,55,10,1
25-01-2025,Sweeteners,YB Brown Sugar 500GM,16,75,75,0,1
24-01-2025,"Grains, Flours & Dals",Bombay Rava 500GM,4,35,30,5,1
24-01-2025,Oils & Ghee,Groundnut oil 1 L,9,360,330,30,1
24-01-2025,"Grains, Flours & Dals",Sathya Javva Wheat Rava 500GM,4,95,95,0,1
24-01-2025,"Grains, Flours & Dals",PESARA PAPPU 500GMS,4,85,75,10,1
24-01-2025,Snacks & Ready-to-Eat,Sprouted Ragi Biscuits 450GM,14,150,150,0,1
24-01-2025,"Grains, Flours & Dals",RAGULU 1 KG,4,210,180,30,3
24-01-2025,"Grains, Flours & Dals",Multigrain 1 kg,4,100,85,15,1
24-01-2025,Snacks & Ready-to-Eat,SATHVI PALLI CHIKKI 200GM,14,200,160,40,2
24-01-2025,"Grains, Flours & Dals",JOWAR YELLOW 1 K,4,100,90,10,1
24-01-2025,"Dry Fruits, Nuts & Seeds",Groundnuts 1 kg,2,190,170,20,1
24-01-2025,"Grains, Flours & Dals",Brown RICE 1KG,4,70,65,5,1
24-01-2025,"Grains, Flours & Dals",KORRALU (FOXTAIL M) 1KG,4,150,110,40,1
24-01-2025,Snacks & Ready-to-Eat,VD BELLAM GAVVALU 200GM,14,60,60,0,1
24-01-2025,Spices & Seasonings,SREE MARUTHI IDLY KARAM 200GM,15,60,60,0,1
24-01-2025,"Grains, Flours & Dals",Sathya Javva Wheat Rava 500GM,4,95,95,0,1
24-01-2025,"Grains, Flours & Dals",Multigrain 1 kg,4,100,85,15,1
24-01-2025,"Dry Fruits, Nuts & Seeds",FLAX SEEDS 250GM,2,60,50,10,1
24-01-2025,"Grains, Flours & Dals",turdal 500 gms,4,110,100,10,1
24-01-2025,"Grains, Flours & Dals",Urad dall 1 Kg,4,185,170,15,1
24-01-2025,"Grains, Flours & Dals",Red Chana 250GM,4,35,30,5,1
24-01-2025,"Grains, Flours & Dals",SINGLE POLISH 1KG,4,325,325,0,5
24-01-2025,"Health, Wellness & Ayurvedic Products",MD Kasturi Pasupu Choornam 50GM,5,80,80,0,1
24-01-2025,Pooja & Spiritual Items,SIVA JOOTHI 365 DEEPAPU,12,25,25,0,1
24-01-2025,General Household & Kitchenware,MATCH BOX,3,10,10,0,1
24-01-2025,"Dry Fruits, Nuts & Seeds",GF DATES 500GM,2,156,149,7,1
24-01-2025,"Grains, Flours & Dals",THICK POHA 500GM,4,40,35,5,1
24-01-2025,Snacks & Ready-to-Eat,ID IDLY DOSA BATTER,14,90,90,0,1
24-01-2025,Personal Care & Cosmetics,BAMBOO TOOTH BRUSH,10,120,120,0,1
24-01-2025,Pickles & Cooking Pastes,GINGER AVAKAYA,11,110,110,0,1
24-01-2025,Pickles & Cooking Pastes,SD MANGO TOKKU,11,110,110,0,1
24-01-2025,Snacks & Ready-to-Eat,MB MULTIMILLET NOODLES 180GM,14,190,190,0,2
24-01-2025,"Grains, Flours & Dals",idly/Dosa rice 1 kg,4,70,60,10,1
24-01-2025,Milk & Dairy,HERITAGE TOTAL CURD 500GM,7,50,50,0,1
24-01-2025,Snacks & Ready-to-Eat,SD FINGER Millet with palm Jaggery 250gm,14,135,135,0,1
24-01-2025,"Dry Fruits, Nuts & Seeds",SD Mango cubes 100gm,2,45,45,0,1
24-01-2025,"Grains, Flours & Dals",Brown RICE 1KG,4,70,65,5,1
24-01-2025,"Grains, Flours & Dals",Em jowar idly R 500G,4,75,75,0,1
24-01-2025,"Grains, Flours & Dals",COW B rice 5 kgs,4,360,345,15,1
24-01-2025,"Dry Fruits, Nuts & Seeds",FLAX SEEDS 250GM,2,60,50,10,1
24-01-2025,General Household & Kitchenware,MATCH BOX,3,20,20,0,1
24-01-2025,Spices & Seasonings,CHILLI POWDER,15,290,210,80,1
24-01-2025,Oils & Ghee,Groundnut oil 500ml,9,180,165,15,1
24-01-2025,Snacks & Ready-to-Eat,BB VERMICELLY 500GM,14,53,53,0,1
24-01-2025,Spices & Seasonings,Menthulu 250 gms,15,50,45,5,1
24-01-2025,Oils & Ghee,Sesame oil 500ml,9,295,280,15,1
24-01-2025,Snacks & Ready-to-Eat,SATHVI MIXED CHIKKI 200GM,14,120,100,20,1
24-01-2025,Snacks & Ready-to-Eat,VD SAGOPAPAD 150GM,14,55,55,0,1
24-01-2025,Oils & Ghee,Groundnut oil 1 L,9,720,660,60,2
24-01-2025,Snacks & Ready-to-Eat,SD Atreyapuram DRY Fruit ghee,14,150,150,0,1
24-01-2025,Snacks & Ready-to-Eat,BATANA NGT 70GMS,14,60,60,0,3
24-01-2025,"Dry Fruits, Nuts & Seeds",SD Mango cubes 200gm,2,90,90,0,1
24-01-2025,"Grains, Flours & Dals",RAGI FLOUR 1KG,4,80,70,10,1
24-01-2025,Snacks & Ready-to-Eat,BELLAM MINAPA SUNADULLU,14,180,180,0,1
24-01-2025,Snacks & Ready-to-Eat,PALLI LADDU 200GMS,14,90,70,20,1
24-01-2025,Snacks & Ready-to-Eat,VD BELLAM GAVVALU 200GM,14,60,60,0,1
24-01-2025,"Dry Fruits, Nuts & Seeds",GF DATES 500GM,2,156,149,7,1
24-01-2025,"Grains, Flours & Dals",Green gram 1 kg,4,150,130,20,1
24-01-2025,"Grains, Flours & Dals",DESI CHANA,4,25,25,0,1
24-01-2025,"Dry Fruits, Nuts & Seeds",PULMAKHANA 100 GM,2,180,170,10,1
24-01-2025,Snacks & Ready-to-Eat,KURNOOL MARMURA,14,70,55,15,1
24-01-2025,"Grains, Flours & Dals",Yellow jowar .F1 kg,4,110,100,10,1
24-01-2025,Oils & Ghee,Groundnut oil 5 L,9,1800,"1,550.00",250,1
24-01-2025,"Health, Wellness & Ayurvedic Products",RB Max Protein Spanish Tomato,5,135,135,0,3
24-01-2025,"Grains, Flours & Dals",SL Idly Rava 1KG,4,130,110,20,2
24-01-2025,"Grains, Flours & Dals",split green gram 500 gms,4,75,70,5,1
24-01-2025,"Grains, Flours & Dals",Quinova 500 gms,4,110,100,10,1
24-01-2025,"Grains, Flours & Dals",MELMEKER 250GMS,4,60,45,15,1
24-01-2025,Snacks & Ready-to-Eat,MAAGAANI M JOWAR PASTA 200GM,14,199,199,0,1
24-01-2025,Oils & Ghee,Groundnut oil 1 L,9,720,660,60,2
24-01-2025,"Grains, Flours & Dals",SL Idly Rava 1KG,4,65,55,10,1
24-01-2025,Milk & Dairy,SANGAM TONED MILK 500ML,7,120,120,0,4
24-01-2025,"Grains, Flours & Dals",Multigrain 1 kg,4,200,170,30,2
24-01-2025,"Grains, Flours & Dals",Wheat Flour 1 kg,4,140,120,20,2
24-01-2025,"Dry Fruits, Nuts & Seeds",SABJA SEEDS 100GM,2,160,140,20,2
24-01-2025,"Dry Fruits, Nuts & Seeds",GF KIMIA DATES 500GM,2,310,190,120,1
24-01-2025,Sweeteners,NATURAL HONEY 250GM,16,150,130,20,1
24-01-2025,"Grains, Flours & Dals",FLOUR CHARGE,4,42,42,0,3.5
24-01-2025,Pooja & Spiritual Items,GD Dhoop Sticks 26GM,12,20,20,0,1
24-01-2025,Pooja & Spiritual Items,GD Dhoop Cones 40GM,12,30,30,0,1
24-01-2025,General Household & Kitchenware,MATCH BOX,3,20,20,0,1
24-01-2025,Pooja & Spiritual Items,GD SANDAL 150GM,12,110,110,0,1
24-01-2025,Oils & Ghee,Coconut oil 1 L,9,440,400,40,1
24-01-2025,Snacks & Ready-to-Eat,RSC ORANGE 100GMS,14,20,20,0,1
24-01-2025,Snacks & Ready-to-Eat,GB SALT COOKIES,14,60,55,5,1
24-01-2025,Snacks & Ready-to-Eat,SD MASALA GAVVALU 200GM,14,95,95,0,1
24-01-2025,Oils & Ghee,Sesame oil 1 L,9,1180,"1,120.00",60,2
24-01-2025,"Health, Wellness & Ayurvedic Products",RB Max Protein Cheese&amp;,5,45,45,0,1
24-01-2025,"Health, Wellness & Ayurvedic Products",RB Max Protein Fruit &amp;Nut 50g,5,75,75,0,1
24-01-2025,Pooja & Spiritual Items,SWASTIK CAMPHOR 15GM,12,40,40,0,1
24-01-2025,Snacks & Ready-to-Eat,MB MULTIMILLET NOODLES 180GM,14,95,95,0,1
24-01-2025,"Dry Fruits, Nuts & Seeds",Putnalu 250GM,2,45,38,7,1
24-01-2025,"Grains, Flours & Dals",Multigrain 1 kg,4,100,85,15,1
24-01-2025,Snacks & Ready-to-Eat,Corn Chips 250GM,14,40,35,5,1
24-01-2025,"Grains, Flours & Dals",THICK POHA 500GM,4,40,35,5,1
24-01-2025,Spices & Seasonings,PURO Healthy Salt 1KG,15,110,110,0,1
24-01-2025,"Health, Wellness & Ayurvedic Products",RB Max Protein Salt & Caramel Bar 50g,5,75,75,0,1
24-01-2025,"Grains, Flours & Dals",Wheat Rava M 1KG,4,65,55,10,1
24-01-2025,"Grains, Flours & Dals",SA Multi Grain Mix 500GM,4,159,159,0,1
24-01-2025,Pooja & Spiritual Items,GD SANDAL 150GM,12,110,110,0,1
24-01-2025,"Dry Fruits, Nuts & Seeds",KAJU HALF 250GM,2,310,290,20,1
24-01-2025,"Health, Wellness & Ayurvedic Products",RB Nuts& Seeds cashews 35g,5,45,45,0,1
24-01-2025,"Grains, Flours & Dals",Wheat Flour 1 kg,4,70,60,10,1
24-01-2025,Milk & Dairy,SANGAM FULL CREAM MILK 500ML,7,38,38,0,1
24-01-2025,Pooja & Spiritual Items,GD Dhoop Cones 40GM,12,30,30,0,1
24-01-2025,"Grains, Flours & Dals",ROXY POORI ATTA 1KG,4,75,75,0,1
24-01-2025,"Grains, Flours & Dals",Green gram 1 kg,4,150,130,20,1
24-01-2025,Pooja & Spiritual Items,GB Bharatha Woods 75GM,12,60,60,0,1
24-01-2025,Pooja & Spiritual Items,GD Aiswarya Deepam 700ML,12,1560,"1,560.00",0,8
24-01-2025,Oils & Ghee,Groundnut oil 1 L,9,720,660,60,2
24-01-2025,Sweeteners,MISHRI D,16,40,30,10,1
24-01-2025,Milk & Dairy,HRITAGE TOTAL CURD 130GM,7,10,10,0,1
24-01-2025,"Grains, Flours & Dals",SRILATHA RICE RAVVA 500GM,4,35,35,0,1
24-01-2025,Oils & Ghee,Sesame oil 1 L,9,590,560,30,1
24-01-2025,Oils & Ghee,Groundnut oil 1 L,9,360,330,30,1
24-01-2025,Oils & Ghee,Groundnut oil 500ml,9,180,165,15,1
24-01-2025,Snacks & Ready-to-Eat,SD Sesame laddu with dates250gm,14,135,135,0,1
24-01-2025,"Grains, Flours & Dals",MELMEKER 250GMS,4,60,45,15,1
24-01-2025,Pooja & Spiritual Items,BALAJI GUGGAL DHOOP 10STK,12,75,75,0,1
24-01-2025,Snacks & Ready-to-Eat,Pani Poori Chips 250GM,14,50,40,10,1
24-01-2025,Milk & Dairy,HERITAGE TONED MILK 500ML,7,31,31,0,1
24-01-2025,Spices & Seasonings,SWEET SOUNF,15,20,20,0,1
24-01-2025,Snacks & Ready-to-Eat,BATANA NGT 70GMS,14,20,20,0,1
24-01-2025,Spices & Seasonings,GREEN SOUNF,15,60,40,20,1
24-01-2025,"Grains, Flours & Dals",Chana Flour 500 gms,4,70,65,5,1
24-01-2025,Oils & Ghee,Groundnut oil 1 L,9,360,330,30,1
24-01-2025,"Grains, Flours & Dals",Multigrain 1 kg,4,200,170,30,2
24-01-2025,Snacks & Ready-to-Eat,PEANUT CHILLI,14,10,10,0,2
24-01-2025,Spices & Seasonings,Turmeric powder 250 gms,15,100,75,25,1
24-01-2025,Oils & Ghee,Groundnut oil 1 L,9,720,660,60,2
24-01-2025,"Health, Wellness & Ayurvedic Products",MD Bringaraj Choornam 100GM,5,80,80,0,1
24-01-2025,Oils & Ghee,Mustard oil 500 ml,9,220,195,25,1
24-01-2025,Milk & Dairy,HERITAGE TONED MILK 500ML,7,31,31,0,1
24-01-2025,"Grains, Flours & Dals",Wheat Flour 1 kg,4,70,60,10,1
24-01-2025,"Grains, Flours & Dals",Yellow jowar.F 500 gms,4,55,50,5,1
24-01-2025,"Grains, Flours & Dals",Quinova 500 gms,4,110,100,10,1
24-01-2025,Snacks & Ready-to-Eat,PEANUT CHIKKI 450GM,14,125,125,0,1
24-01-2025,"Grains, Flours & Dals",Arikadu ( kodo),4,140,130,10,1
24-01-2025,"Grains, Flours & Dals",KORRALU (FOXTAIL M) 1KG,4,150,110,40,1
24-01-2025,"Grains, Flours & Dals",UDALU (Barnyard millet) 1 kg,4,140,115,25,1
24-01-2025,"Grains, Flours & Dals",SAMALU (Little millet) 1 kg,4,170,130,40,1
24-01-2025,"Grains, Flours & Dals",Wheat Rava M 500GM,4,33,30,3,1
24-01-2025,"Dry Fruits, Nuts & Seeds",PUMPKIN SEEDS 250GM,2,200,160,40,1
24-01-2025,"Grains, Flours & Dals",SAMALU (Little millet) 1 kg,4,170,130,40,1
24-01-2025,Snacks & Ready-to-Eat,SD FINGER Millet with palm Jaggery 250gm,14,135,135,0,1
24-01-2025,"Grains, Flours & Dals",SINGLE POLISH 1KG,4,195,195,0,3
24-01-2025,"Dry Fruits, Nuts & Seeds",ALMONDS 250GM,2,280,260,20,1
24-01-2025,"Dry Fruits, Nuts & Seeds",FLAX SEEDS 250GM,2,60,50,10,1
24-01-2025,Snacks & Ready-to-Eat,GB SALT COOKIES,14,60,55,5,1
24-01-2025,"Grains, Flours & Dals",Yellow jowar .F1 kg,4,110,100,10,1
24-01-2025,Snacks & Ready-to-Eat,SD Moringa with plam jaggery 250gm,14,135,135,0,1
24-01-2025,"Grains, Flours & Dals",Quinova 1 kg,4,220,195,25,1
24-01-2025,"Grains, Flours & Dals",Arikadu ( kodo),4,140,130,10,1
24-01-2025,"Dry Fruits, Nuts & Seeds",SUNFLOWER SEEDS 250GRM,2,150,130,20,1
24-01-2025,"Dry Fruits, Nuts & Seeds",GF DATES 500GM,2,156,149,7,1
24-01-2025,"Grains, Flours & Dals",RED WHEAT 1 KG,4,130,130,0,1
24-01-2025,"Grains, Flours & Dals",SINGLE POLISH 1KG,4,65,65,0,1
24-01-2025,"Grains, Flours & Dals",FLOUR CHARGE,4,15.6,15.6,0,1.3
24-01-2025,"Grains, Flours & Dals",Yellow jowar.F 2 kgs,4,220,200,20,1
24-01-2025,Sweeteners,SH JAGGERY POWDER 500GM,16,320,272,48,4
24-01-2025,"Grains, Flours & Dals",SINGLE POLISH 1KG,4,65,65,0,1
24-01-2025,"Grains, Flours & Dals",MELMEKER 250GMS,4,60,45,15,1
24-01-2025,"Grains, Flours & Dals",Wheat Flour 2 kgs,4,280,240,40,2
24-01-2025,Pooja & Spiritual Items,GD Aiswarya Deepam 700ML,12,195,195,0,1
24-01-2025,Pooja & Spiritual Items,SWASTIK CAMPHOR 15GM,12,40,40,0,1
24-01-2025,"Grains, Flours & Dals",Yellow jowar .F1 kg,4,220,200,20,2
24-01-2025,Pooja & Spiritual Items,SWASTIK CAMPHOR 15GM,12,40,40,0,1
24-01-2025,"Grains, Flours & Dals",RICE FLOUR 1KG,4,70,55,15,1
24-01-2025,Pooja & Spiritual Items,SOSR SWATHHI 365,12,30,30,0,1
24-01-2025,"Grains, Flours & Dals",RAJMA 250GM,4,55,45,10,1
24-01-2025,Oils & Ghee,Coconut oil 500 ml,9,220,200,20,1
24-01-2025,Oils & Ghee,Sesame oil 1 L,9,1180,"1,120.00",60,2
24-01-2025,"Grains, Flours & Dals",RAGI FLOUR 1KG,4,80,70,10,1
24-01-2025,"Grains, Flours & Dals",Chana Flour 1 kg,4,140,130,10,1
24-01-2025,Oils & Ghee,Groundnut oil 1 L,9,720,660,60,2
24-01-2025,"Grains, Flours & Dals",KORRALU (FOXTAIL M) 1KG,4,150,110,40,1
24-01-2025,"Grains, Flours & Dals",JOWAR WHITE 1 KG,4,80,70,10,1
24-01-2025,Snacks & Ready-to-Eat,VD ARISELU 5 PIC,14,100,100,0,1
24-01-2025,"Grains, Flours & Dals",Chana Flour 500 gms,4,70,65,5,1
24-01-2025,"Grains, Flours & Dals",RAGI FLOUR 500GRMS,4,40,35,5,1
24-01-2025,Snacks & Ready-to-Eat,OK MACARONI,14,120,120,0,1
24-01-2025,"Grains, Flours & Dals",Bajra Flour 1 kg,4,175,150,25,2.5
24-01-2025,"Grains, Flours & Dals",RICE FLOUR 500 GM,4,35,28,7,1
24-01-2025,"Grains, Flours & Dals",White jowar.F 500 Gms,4,50,40,10,1
24-01-2025,"Health, Wellness & Ayurvedic Products",RB Max Protein PERI PERI 60gm,5,45,45,0,1
24-01-2025,"Grains, Flours & Dals",White jowar.F 1 kg,4,100,80,20,1
24-01-2025,"Grains, Flours & Dals",Multigrain 1 kg,4,300,255,45,3
24-01-2025,Household & Cleaning,LIZOL JAQSMINE 500ML,6,116,116,0,1
24-01-2025,Household & Cleaning,VIM TROPICAL LEMON FRESHNESS 250ML,6,55,55,0,1
24-01-2025,"Grains, Flours & Dals",RAGI FLOUR 500GRMS,4,40,35,5,1
24-01-2025,Snacks & Ready-to-Eat,WHITE SESAME CHIKKI,14,40,40,0,4
24-01-2025,"Health, Wellness & Ayurvedic Products",MORINGA LEAF POWDER M,5,80,80,0,1
24-01-2025,"Health, Wellness & Ayurvedic Products",JAMBU SEED CHOORNAM 100GM,5,80,80,0,1
24-01-2025,"Grains, Flours & Dals",RAGI FLOUR 500GRMS,4,40,35,5,1
24-01-2025,Oils & Ghee,Sesame oil 1 L,9,590,560,30,1
24-01-2025,Oils & Ghee,Groundnut oil 1 L,9,360,330,30,1
24-01-2025,"Grains, Flours & Dals",SOYA BEANS 1KG,4,40,36,4,0.2
24-01-2025,"Grains, Flours & Dals",WHEAT 1 KG,4,120,100,20,2
24-01-2025,"Grains, Flours & Dals",FLOUR CHARGE,4,28.8,28.8,0,2.4
24-01-2025,"Grains, Flours & Dals",PLAIN OATS 1KG,4,42,42,0,0.2
24-01-2025,"Health, Wellness & Ayurvedic Products",MD Bringaraj Choornam 100GM,5,80,80,0,1
24-01-2025,"Grains, Flours & Dals",Wheat Flour 1 kg,4,70,60,10,1
24-01-2025,"Grains, Flours & Dals",RAGI FLOUR 500GRMS,4,40,35,5,1
24-01-2025,Snacks & Ready-to-Eat,VD RICE PAPAD 150GM,14,50,50,0,1
24-01-2025,Spices & Seasonings,MD Sonti Powder 50GM,15,80,80,0,1
24-01-2025,Spices & Seasonings,GS GARLIC KARAM 100GM,15,75,75,0,1
24-01-2025,Spices & Seasonings,Turmeric powder 1 kg,15,400,300,100,1
24-01-2025,Spices & Seasonings,Turmeric powder 500 gms,15,200,150,50,1
24-01-2025,Oils & Ghee,Safflower oil 1 L,9,880,800,80,2
24-01-2025,Oils & Ghee,BUFFALLO GHEE 500ML,9,410,370,40,1
24-01-2025,"Grains, Flours & Dals",Brown RICE 1KG,4,70,65,5,1
24-01-2025,"Grains, Flours & Dals",Multigrain 2 kgs,4,200,170,30,1
24-01-2025,Spices & Seasonings,Turmeric powder 250 gms,15,100,75,25,1
24-01-2025,"Grains, Flours & Dals",RAGI FLOUR 1KG,4,80,70,10,1
24-01-2025,"Grains, Flours & Dals",Wheat Flour 2 kgs,4,140,120,20,1
24-01-2025,"Grains, Flours & Dals",Multigrain 1 kg,4,220,220,0,1
24-01-2025,Snacks & Ready-to-Eat,PALLI LADDU 200GMS,14,90,70,20,1
24-01-2025,Snacks & Ready-to-Eat,MB MULTIMILLET NOODLES 180GM,14,95,95,0,1
24-01-2025,"Dry Fruits, Nuts & Seeds",Groundnuts 500 gms,2,95,85,10,1
24-01-2025,Snacks & Ready-to-Eat,VD RICE SAGO PAPAD 150GM,14,55,55,0,1
24-01-2025,"Grains, Flours & Dals",Quinova 1 kg,4,440,390,50,2
24-01-2025,Beverages,MARWADI CHAI 100GM,1,75,75,0,1
24-01-2025,Household & Cleaning,SPARK SHINING POWDER,6,12,12,0,1
24-01-2025,Snacks & Ready-to-Eat,VD DAHI MIRCHI(SALTED) 100GM,14,45,45,0,1
24-01-2025,Snacks & Ready-to-Eat,SATHVI PALLI CHIKKI 200GM,14,100,80,20,1
24-01-2025,"Grains, Flours & Dals",White jowar.F 500 Gms,4,50,40,10,1
24-01-2025,"Grains, Flours & Dals",Chana Flour 500 gms,4,70,65,5,1
24-01-2025,Oils & Ghee,Safflower oil 1 L,9,440,400,40,1
24-01-2025,"Grains, Flours & Dals",Bajra Flour 500 gms,4,35,30,5,1
24-01-2025,Oils & Ghee,Sesame oil 1 L,9,590,560,30,1
24-01-2025,"Grains, Flours & Dals",Wheat Flour 1 kg,4,70,60,10,1
24-01-2025,Oils & Ghee,Groundnut oil 1 L,9,360,330,30,1
24-01-2025,Spices & Seasonings,NUVVULU 250GM,15,100,85,15,1
24-01-2025,Oils & Ghee,Groundnut oil 1 L,9,360,330,30,1
24-01-2025,Spices & Seasonings,CHILLI POWDER,15,290,210,80,1
24-01-2025,"Grains, Flours & Dals",RAGI FLOUR 1KG,4,160,140,20,2
24-01-2025,"Grains, Flours & Dals",Chana Flour 500 gms,4,70,65,5,1
24-01-2025,"Grains, Flours & Dals",Red Chana 500 GM,4,75,60,15,1
24-01-2025,Snacks & Ready-to-Eat,Popcorn Seeds 250GM,14,45,40,5,1
24-01-2025,"Grains, Flours & Dals",SPLIT BLACK GRAM 500 GM,4,90,85,5,1
24-01-2025,"Grains, Flours & Dals",Green gram 1 kg,4,150,130,20,1
24-01-2025,"Grains, Flours & Dals",White jowar.F 1 kg,4,100,80,20,1
24-01-2025,Oils & Ghee,Safflower oil 1 L,9,440,400,40,1
24-01-2025,"Grains, Flours & Dals",Multigrain 1 kg,4,200,170,30,2
24-01-2025,Spices & Seasonings,LG 50GM,15,92,92,0,1
24-01-2025,Oils & Ghee,cow ghee 500 ml,9,430,390,40,1
24-01-2025,"Grains, Flours & Dals",BOBBARA PAPPU 500GM,4,85,80,5,1
24-01-2025,"Grains, Flours & Dals",split urad dall 500 gms,4,180,160,20,2
24-01-2025,"Grains, Flours & Dals",MAAGAANI LOW GI SP 1KG,4,525,525,0,5
24-01-2025,"Grains, Flours & Dals",HS JOWAR FLAKES 250GM 1+1,4,119,119,0,1
24-01-2025,"Grains, Flours & Dals",SINGLE POLISH 1KG,4,325,325,0,5
24-01-2025,Snacks & Ready-to-Eat,NGT CHATPATTA CHANA 90GM,14,25,25,0,1
24-01-2025,"Grains, Flours & Dals",MAAGAANI LOW GI SP 1KG,4,105,105,0,1
24-01-2025,Oils & Ghee,Sesame oil 1 L,9,590,560,30,1
24-01-2025,"Grains, Flours & Dals",turdal 500 gms,4,220,200,20,2
24-01-2025,"Grains, Flours & Dals",KORRALU (FOXTAIL M) 1KG,4,150,110,40,1
24-01-2025,"Grains, Flours & Dals",HS jowar idly rava 500 gms,4,130,130,0,2
24-01-2025,"Grains, Flours & Dals",Wheat Flour 1 kg,4,210,180,30,3
24-01-2025,"Grains, Flours & Dals",Brown RICE 1KG,4,140,130,10,2
24-01-2025,"Grains, Flours & Dals",Urad dall 1 Kg,4,370,340,30,2
24-01-2025,Oils & Ghee,Groundnut oil 1 L,9,360,330,30,1
24-01-2025,"Grains, Flours & Dals",SINGLE POLISH 1KG,4,130,130,0,2
24-01-2025,"Grains, Flours & Dals",DISANO OATS 1KG,4,142,142,0,1
24-01-2025,"Grains, Flours & Dals",Wheat Flour 1 kg,4,70,60,10,1
24-01-2025,Snacks & Ready-to-Eat,Corn Chips 250GM,14,40,35,5,1
24-01-2025,"Grains, Flours & Dals",BOMBAY RAVA,4,70,55,15,1
24-01-2025,Snacks & Ready-to-Eat,SD Vamu with palm jaggery 250gm,14,135,135,0,1
24-01-2025,Snacks & Ready-to-Eat,RI SPORTS BAR 40G,14,45,45,0,1
24-01-2025,Oils & Ghee,Safflower oil 1 L,9,880,800,80,2
24-01-2025,"Dry Fruits, Nuts & Seeds",GF DATES 500GM,2,156,149,7,1
24-01-2025,"Health, Wellness & Ayurvedic Products",MXP CHOCO CLASSIC BAR,5,490,490,0,7
24-01-2025,"Health, Wellness & Ayurvedic Products",MXP GRANOLA,5,449,399,50,1
24-01-2025,General Household & Kitchenware,TEA CUP 1P,3,90,90,0,2
24-01-2025,"Dry Fruits, Nuts & Seeds",PULMAKHANA 100 GM,2,180,170,10,1
24-01-2025,"Grains, Flours & Dals",THIN POHA 500GM,4,80,70,10,2
24-01-2025,"Grains, Flours & Dals",BAJRA IDLY RAVA 400GM,4,65,65,0,1
24-01-2025,Snacks & Ready-to-Eat,SATHVI PALLI CHIKKI 200GM,14,100,80,20,1
24-01-2025,Personal Care & Cosmetics,MD Henna Choornam 100GM,10,80,80,0,1
24-01-2025,Oils & Ghee,Safflower oil 1 L,9,440,400,40,1
24-01-2025,Spices & Seasonings,NUVVULU 250GM,15,80,65,15,1
24-01-2025,"Grains, Flours & Dals",Em Multimillet upma 500g,4,129,129,0,1
24-01-2025,Snacks & Ready-to-Eat,SESAME CHIKKI,14,120,100,20,1
24-01-2025,Oils & Ghee,Groundnut oil 1 L,9,360,330,30,1
24-01-2025,"Health, Wellness & Ayurvedic Products",MD Bringaraj Choornam 100GM,5,80,80,0,1
24-01-2025,"Grains, Flours & Dals",Wheat Rava M 500GM,4,33,30,3,1
24-01-2025,"Health, Wellness & Ayurvedic Products",MD Hibiscus Flower Choornam 30GM,5,100,100,0,1
24-01-2025,"Grains, Flours & Dals",SINGLE POLISH 1KG,4,130,130,0,2
24-01-2025,Snacks & Ready-to-Eat,SESAME CHIKKI,14,120,100,20,1
24-01-2025,General Household & Kitchenware,VERMI COMPOST MIX,3,30,30,0,1
24-01-2025,"Grains, Flours & Dals",Multigrain 1 kg,4,100,85,15,1
24-01-2025,"Grains, Flours & Dals",RAGI FLOUR 500GRMS,4,40,35,5,1
24-01-2025,"Grains, Flours & Dals",Multigrain 1 kg,4,100,85,15,1
24-01-2025,Oils & Ghee,Castor oil 200 ml,9,100,80,20,1
24-01-2025,Oils & Ghee,Sesame oil 500ml,9,295,280,15,1
24-01-2025,Snacks & Ready-to-Eat,SALTED PHALLI,14,130,130,0,2
24-01-2025,Personal Care & Cosmetics,MD Soapnut Choornam 100GM,10,80,80,0,1
24-01-2025,"Health, Wellness & Ayurvedic Products",VAMU WATER,5,70,70,0,1
24-01-2025,Spices & Seasonings,MD Sonti Powder 50GM,15,80,80,0,1
24-01-2025,Pooja & Spiritual Items,SWASTIK CAMPHOR 25GM,12,45,45,0,1
24-01-2025,Sweeteners,MISHRI D,16,40,30,10,1
24-01-2025,"Grains, Flours & Dals",SH RED POHA 500GM,4,75,75,0,1
24-01-2025,Oils & Ghee,Groundnut oil 500ml,9,180,165,15,1
24-01-2025,Oils & Ghee,Coconut oil 1 L,9,440,400,40,1
24-01-2025,"Dry Fruits, Nuts & Seeds",CASHEW 250GM,2,340,310,30,1
24-01-2025,"Grains, Flours & Dals",MELMEKER 250GMS,4,60,45,15,1
24-01-2025,Oils & Ghee,Safflower oil 500 ml,9,220,200,20,1
24-01-2025,"Grains, Flours & Dals",BAJRA 1 KG,4,30,25,5,0.5
24-01-2025,"Grains, Flours & Dals",FLOUR CHARGE,4,66,66,0,5.5
24-01-2025,"Grains, Flours & Dals",JOWAR YELLOW 1 K,4,50,45,5,0.5
24-01-2025,"Grains, Flours & Dals",BARLEY SEEDS 250GMS,4,40,35,5,1
24-01-2025,"Grains, Flours & Dals",WHEAT 1 KG,4,240,200,40,4
24-01-2025,"Grains, Flours & Dals",RAGULU 1 KG,4,17.5,15,2.5,0.25
24-01-2025,Spices & Seasonings,Gasagasalu 50GM,15,130,110,20,1
24-01-2025,Milk & Dairy,HERITAGE TONED MILK 500ML,7,31,31,0,1
24-01-2025,Sweeteners,KAMAL JAGGERY 500GM,16,40,40,0,1
24-01-2025,"Grains, Flours & Dals",SL Idly Rava 1KG,4,65,55,10,1
24-01-2025,Oils & Ghee,Groundnut oil 5 L,9,1800,"1,600.00",200,1
24-01-2025,Oils & Ghee,Sesame oil 5 L,9,2950,"2,750.00",200,1
24-01-2025,Snacks & Ready-to-Eat,Pani Poori Chips 250GM,14,50,40,10,1
24-01-2025,"Grains, Flours & Dals",WHITE BATANI,4,40,30,10,1
24-01-2025,Personal Care & Cosmetics,UVIS BLACK HENNA 100GM,10,175,175,0,1
24-01-2025,"Grains, Flours & Dals",JOWAR YELLOW 1 K,4,100,90,10,1
24-01-2025,Misc,HOME LIKES,8,10,10,0,1
24-01-2025,"Grains, Flours & Dals",BAJRA 1 KG,4,60,50,10,1
24-01-2025,Personal Care & Cosmetics,HERBAL ROSE SPRAY 250ML,10,225,225,0,1
24-01-2025,Snacks & Ready-to-Eat,RAJGIRA PEANUT CHIKKI,14,25,25,0,5
24-01-2025,"Grains, Flours & Dals",Red Bobarlu 500 gms,4,95,85,10,1
24-01-2025,Oils & Ghee,Sesame oil 1 L,9,590,560,30,1
24-01-2025,Spices & Seasonings,NUVVULU 250GM,15,80,65,15,1
24-01-2025,"Grains, Flours & Dals",RAGULU 1 KG,4,35,30,5,0.5
24-01-2025,Sweeteners,Natural Honey 500 gms,16,280,240,40,1
24-01-2025,"Grains, Flours & Dals",AS Maize Rava 500GM,4,42,38,4,1
24-01-2025,Oils & Ghee,Groundnut oil 1 L,9,360,330,30,1
24-01-2025,Pooja & Spiritual Items,GD Dhoop Cones 40GM,12,30,30,0,1
24-01-2025,"Grains, Flours & Dals",WHEAT 1 KG,4,60,50,10,1
24-01-2025,General Household & Kitchenware,RED LINE 20GM,3,75,75,0,1
24-01-2025,Household & Cleaning,ROOPERI PITAMBARI SILVER 50ML,6,110,110,0,1
24-01-2025,Oils & Ghee,Groundnut oil 1 L,9,360,330,30,1
24-01-2025,"Grains, Flours & Dals",RICE FLOUR 1KG,4,70,55,15,1
24-01-2025,Snacks & Ready-to-Eat,Pani Poori Chips 250GM,14,50,40,10,1
24-01-2025,Sweeteners,YB JAGGERY POWDER 1KG,16,140,140,0,1
24-01-2025,"Grains, Flours & Dals",VGR rice 1 kg,4,350,325,25,5
24-01-2025,Snacks & Ready-to-Eat,ZEEDI,14,70,70,0,1
24-01-2025,Spices & Seasonings,NUVVULU 500GM,15,200,170,30,1
24-01-2025,"Grains, Flours & Dals",SINGLE POLISH 1KG,4,195,195,0,3
24-01-2025,"Grains, Flours & Dals",RICE FLOUR 500 GM,4,35,28,7,1
24-01-2025,Oils & Ghee,Groundnut oil 1 L,9,720,660,60,2
24-01-2025,"Grains, Flours & Dals",Chana Flour 500 gms,4,70,65,5,1
24-01-2025,Oils & Ghee,Safflower oil 1 L,9,440,400,40,1
24-01-2025,Snacks & Ready-to-Eat,PALLI LADDU 200GMS,14,270,210,60,3
24-01-2025,Snacks & Ready-to-Eat,SATHVI MIXED CHIKKI 200GM,14,240,200,40,2
24-01-2025,Oils & Ghee,Groundnut oil 1 L,9,360,330,30,1
24-01-2025,"Grains, Flours & Dals",White Chana 250 GM,4,60,50,10,1
24-01-2025,Spices & Seasonings,Masala Karam 250 gms,15,130,120,10,1
24-01-2025,Oils & Ghee,Freedom Rice Bran Oil 1L,9,194,180,14,1
24-01-2025,Spices & Seasonings,AV Iodized Salt 1KG,15,56,50,6,2
24-01-2025,Spices & Seasonings,DURGA SALT CRYSTAL 1KG,15,25,25,0,1
24-01-2025,Spices & Seasonings,Turmeric powder 250 gms,15,100,75,25,1
24-01-2025,Oils & Ghee,Coconut oil 1 L,9,440,400,40,1
24-01-2025,Oils & Ghee,Sesame oil 1 L,9,590,560,30,1
24-01-2025,"Grains, Flours & Dals",Wheat Flour 1 kg,4,70,60,10,1
24-01-2025,"Grains, Flours & Dals",split green gram 500 gms,4,75,70,5,1
24-01-2025,Oils & Ghee,Groundnut oil 500ml,9,180,165,15,1
24-01-2025,"Grains, Flours & Dals",HS RAGI FLAKES 250GM 1+1,4,59,59,0,1
24-01-2025,"Grains, Flours & Dals",EM Foxtail idli r 500 g,4,109,109,0,1
24-01-2025,"Grains, Flours & Dals",AISHWARYA SP 1KG,4,80,75,5,1
24-01-2025,"Grains, Flours & Dals",Red Chana 500 GM,4,75,60,15,1
24-01-2025,"Dry Fruits, Nuts & Seeds",PULMAKHANA 100 GM,2,180,170,10,1
23-01-2025,"Grains, Flours & Dals",Multigrain 1 kg,4,100,85,15,1
23-01-2025,Snacks & Ready-to-Eat,SESAME LADDU 200GM,14,100,80,20,1
23-01-2025,"Grains, Flours & Dals",RAGI FLOUR 500GRMS,4,40,35,5,1
23-01-2025,"Grains, Flours & Dals",Wheat Flour 2 kgs,4,140,120,20,1
23-01-2025,Oils & Ghee,Groundnut oil 1 L,9,360,330,30,1
23-01-2025,Snacks & Ready-to-Eat,BB VERMICELLI 1KG,14,95,90,5,1
23-01-2025,"Health, Wellness & Ayurvedic Products",RB Max Protein Fruit &amp;Nut 50g,5,75,75,0,1
23-01-2025,Oils & Ghee,Groundnut oil 1 L,9,360,330,30,1
23-01-2025,"Grains, Flours & Dals",BAJRA IDLY RAVA 400GM,4,65,65,0,1
23-01-2025,"Grains, Flours & Dals",Em Multimillet idli r 500g,4,129,129,0,1
23-01-2025,Snacks & Ready-to-Eat,DOSA BATTER 1KG,14,60,60,0,1
23-01-2025,"Grains, Flours & Dals",EM Foxtail idli r 500 g,4,109,109,0,1
23-01-2025,"Grains, Flours & Dals",MAAGAANI SP RICE 5KGS,4,649,560,89,1
23-01-2025,Snacks & Ready-to-Eat,SATHVI PALLI CHIKKI 200GM,14,100,80,20,1
23-01-2025,Beverages,RED LABEL NATURAL CARE 100G,1,65,65,0,1
23-01-2025,Snacks & Ready-to-Eat,PN ORGANIC PUFFED RICE 200GM,14,55,55,0,1
23-01-2025,Sweeteners,YB Brown Sugar 500GM,16,75,75,0,1
23-01-2025,"Dry Fruits, Nuts & Seeds",FLAX SEEDS 250GM,2,60,50,10,1
23-01-2025,Snacks & Ready-to-Eat,SD barnyard Millet with palm jaggery,14,135,135,0,1
23-01-2025,"Grains, Flours & Dals",Wheat Rava M 1KG,4,65,55,10,1
23-01-2025,"Grains, Flours & Dals",RICE FLOUR 500 GM,4,35,28,7,1
23-01-2025,Oils & Ghee,Groundnut oil 5 L,9,1800,"1,600.00",200,1
23-01-2025,Snacks & Ready-to-Eat,VD ARISELU 5 PIC,14,100,100,0,1
23-01-2025,Snacks & Ready-to-Eat,SD JOWAR WITH PALM JAGGERY 250GM,14,135,135,0,1
23-01-2025,"Grains, Flours & Dals",HS Multimillet upma r 500g,4,65,65,0,1
23-01-2025,"Health, Wellness & Ayurvedic Products",RB Max Protein Jaggery Crunchy,5,175,175,0,1
23-01-2025,"Health, Wellness & Ayurvedic Products",MH Millets Milk Powder 250GM,5,250,250,0,1
23-01-2025,"Health, Wellness & Ayurvedic Products",MH Baby Food 400GM,5,200,200,0,1
23-01-2025,Personal Care & Cosmetics,DWI MULTANI MITTI SOAP 100GM,10,75,75,0,1
23-01-2025,"Grains, Flours & Dals",Wheat Rava M 1KG,4,65,55,10,1
23-01-2025,Snacks & Ready-to-Eat,BB ROASTED VERMICELLY 850GM,14,117,117,0,1
23-01-2025,Oils & Ghee,Groundnut oil 1 L,9,360,330,30,1
23-01-2025,Personal Care & Cosmetics,SUNNUPINDI SOAP UVS,10,99,99,0,1
23-01-2025,Spices & Seasonings,TATA SALT 1KG,15,30,30,0,1
23-01-2025,Sweeteners,SUGAR 1KG,16,60,50,10,1
23-01-2025,Spices & Seasonings,JEERA 250 gms,15,125,105,20,1
23-01-2025,"Dry Fruits, Nuts & Seeds",GF DATES 500GM,2,156,149,7,1
23-01-2025,"Grains, Flours & Dals",Multigrain 1 kg,4,100,85,15,1
23-01-2025,"Health, Wellness & Ayurvedic Products",RB Max Protein Classic Creamy,5,169,169,0,1
23-01-2025,Sweeteners,Natural Honey 500 gms,16,280,240,40,1
23-01-2025,Snacks & Ready-to-Eat,MAAGAANI JOWAR M COOKIES 120GM,14,149,149,0,1
23-01-2025,Snacks & Ready-to-Eat,RAJGIRA PEANUT CHIKKI,14,5,5,0,1
23-01-2025,"Dry Fruits, Nuts & Seeds",Groundnuts 500 gms,2,95,85,10,1
23-01-2025,"Grains, Flours & Dals",MELMEKER 250GMS,4,60,45,15,1
23-01-2025,"Grains, Flours & Dals",Arikalu (kodo),4,70,65,5,1
23-01-2025,Spices & Seasonings,Telaga Pindi 250 GM,15,40,35,5,1
23-01-2025,"Grains, Flours & Dals",SAMALU (Little millet) 500 gms,4,85,65,20,1
23-01-2025,Snacks & Ready-to-Eat,JUNNU POWDER 100GM,14,70,70,0,1
23-01-2025,Oils & Ghee,Safflower oil 1 L,9,440,400,40,1
23-01-2025,Oils & Ghee,Groundnut oil 1 L,9,360,330,30,1
23-01-2025,"Grains, Flours & Dals",Wheat Rava M 1KG,4,65,55,10,1
23-01-2025,"Grains, Flours & Dals",SL Idly Rava 1KG,4,65,55,10,1
23-01-2025,"Grains, Flours & Dals",turdal 1kg,4,220,195,25,1
23-01-2025,"Grains, Flours & Dals",Urad dall 1 Kg,4,185,170,15,1
23-01-2025,Snacks & Ready-to-Eat,DOSA BATTER 1KG,14,60,60,0,1
23-01-2025,"Grains, Flours & Dals",THICK POHA 500GM,4,40,35,5,1
23-01-2025,"Grains, Flours & Dals",DISANO ROLED OATS,4,395,395,0,1
23-01-2025,"Health, Wellness & Ayurvedic Products",MD Neem Leaf Choornam 100GM,5,110,110,0,1
23-01-2025,"Grains, Flours & Dals",FLOUR CHARGE,4,64,64,0,1
23-01-2025,Spices & Seasonings,Turmeric powder 250 gms,15,100,75,25,1
23-01-2025,Spices & Seasonings,SREE MARUTHI IDLY KARAM 200GM,15,60,60,0,1
23-01-2025,Snacks & Ready-to-Eat,VD RIBBON PAKODI 175GM,14,60,60,0,1
23-01-2025,Oils & Ghee,Groundnut oil 1 L,9,360,330,30,1
23-01-2025,Snacks & Ready-to-Eat,PALLI LADDU 200GMS,14,90,70,20,1
23-01-2025,"Grains, Flours & Dals",THICK POHA 500GM,4,40,35,5,1
23-01-2025,Snacks & Ready-to-Eat,VD JAGGERY GHEE 12PIC,14,180,180,0,1
23-01-2025,Milk & Dairy,HRITAGE TOTAL CURD 130GM,7,10,10,0,1
23-01-2025,Milk & Dairy,HERITAGE TONED MILK 500ML,7,31,31,0,1
23-01-2025,Sweeteners,SUGAR 500 GM,16,30,25,5,1
23-01-2025,Pooja & Spiritual Items,SWASTIK CAMPHOR 15GM,12,40,40,0,1
23-01-2025,Beverages,ASSAM MASALA TEA,1,199,199,0,1
23-01-2025,Pooja & Spiritual Items,GD Kailash 60 GM,12,120,120,0,2
23-01-2025,"Grains, Flours & Dals",SINGLE POLISH 1KG,4,650,650,0,10
23-01-2025,Snacks & Ready-to-Eat,VD BELLAM GAVVALU 200GM,14,60,60,0,1
23-01-2025,Spices & Seasonings,GD Turmeric 50GM,15,50,50,0,2
23-01-2025,"Grains, Flours & Dals",Wheat Flour 2 kgs,4,140,120,20,1
23-01-2025,"Grains, Flours & Dals",Chana Flour 500 gms,4,70,65,5,1
23-01-2025,"Grains, Flours & Dals",RICE FLOUR 1KG,4,70,55,15,1
23-01-2025,"Grains, Flours & Dals",turdal 500 gms,4,110,100,10,1
23-01-2025,"Dry Fruits, Nuts & Seeds",Putnalu 250GM,2,45,38,7,1
23-01-2025,"Dry Fruits, Nuts & Seeds",Groundnuts 500 gms,2,95,85,10,1
23-01-2025,"Grains, Flours & Dals",Chana Flour 500 gms,4,70,65,5,1
23-01-2025,"Grains, Flours & Dals",RICE FLOUR 1KG,4,70,55,15,1
23-01-2025,Oils & Ghee,Sesame oil 1 L,9,590,560,30,1
23-01-2025,Snacks & Ready-to-Eat,SATHVI PALLI CHIKKI 200GM,14,100,80,20,1
23-01-2025,Snacks & Ready-to-Eat,VD BOONDI 175GM,14,60,60,0,1
23-01-2025,Snacks & Ready-to-Eat,SD RAGI GAVVALU,14,95,95,0,1
23-01-2025,Oils & Ghee,Black Sesame oil 1 L,9,440,380,60,1
23-01-2025,Oils & Ghee,Groundnut oil 1 L,9,360,330,30,1
23-01-2025,Spices & Seasonings,Vamu 100GM,15,60,50,10,1
23-01-2025,Spices & Seasonings,GREEN SOUNF,15,60,40,20,1
23-01-2025,Snacks & Ready-to-Eat,VD Pappu Chekkalu 190gm,14,60,60,0,1
23-01-2025,Spices & Seasonings,BLACK JEERA 50 GM,15,90,60,30,2
23-01-2025,"Grains, Flours & Dals",Brown RICE 1KG,4,140,130,10,2
23-01-2025,Oils & Ghee,Groundnut oil 1 L,9,720,660,60,2
23-01-2025,Oils & Ghee,Sesame oil 1 L,9,1180,"1,120.00",60,2
23-01-2025,"Grains, Flours & Dals",UDALU (Barnyard millet) 500 gms,4,70,60,10,1
23-01-2025,"Grains, Flours & Dals",Wheat Flour 1 kg,4,140,120,20,2
23-01-2025,Oils & Ghee,Groundnut oil 1 L,9,720,660,60,2
23-01-2025,"Grains, Flours & Dals",Wheat Rava M 500GM,4,33,30,3,1
23-01-2025,"Health, Wellness & Ayurvedic Products",RB Max Protein Fruit &amp;Nut 50g,5,75,75,0,1
23-01-2025,"Grains, Flours & Dals",Sathya Javva Wheat Rava 500GM,4,190,190,0,2
23-01-2025,"Grains, Flours & Dals",SRILATHA RICE RAVVA 500GM,4,70,70,0,2
23-01-2025,"Grains, Flours & Dals",Multigrain 1 kg,4,100,85,15,1
23-01-2025,"Grains, Flours & Dals",Yellow jowar.F 500 gms,4,45,40,5,1
23-01-2025,"Dry Fruits, Nuts & Seeds",Groundnuts 1 kg,2,190,170,20,1
23-01-2025,"Grains, Flours & Dals",RAGI FLOUR 1KG,4,80,70,10,1
23-01-2025,"Grains, Flours & Dals",Bajra Flour 1 kg,4,70,60,10,1
23-01-2025,"Grains, Flours & Dals",White jowar.F 1 kg,4,100,80,20,1
23-01-2025,Snacks & Ready-to-Eat,MILK BREAD,14,55,55,0,1
23-01-2025,Sweeteners,YB JAGGERY POWDER 1KG,16,140,140,0,1
23-01-2025,"Grains, Flours & Dals",Multigrain 1 kg,4,100,85,15,1
23-01-2025,Snacks & Ready-to-Eat,MB MULTIMILLET NOODLES 180GM,14,95,95,0,1
23-01-2025,"Grains, Flours & Dals",RAGI FLOUR 1KG,4,80,70,10,1
23-01-2025,Oils & Ghee,Black Sesame oil 1 L,9,440,380,60,1
23-01-2025,"Health, Wellness & Ayurvedic Products",MH Baby Food 400GM,5,200,200,0,1
23-01-2025,Snacks & Ready-to-Eat,MB FOXTAIL MILLET NOODLES 180GM,14,95,95,0,1
23-01-2025,Sweeteners,NATURAL HONEY 1KG,16,560,480,80,1
23-01-2025,"Health, Wellness & Ayurvedic Products",RB Max Protein Choco Crunchy 500g,5,399,399,0,1
23-01-2025,Snacks & Ready-to-Eat,MB SORGHUM NOODLES 180GM,14,190,190,0,2
23-01-2025,"Grains, Flours & Dals",Wheat Flour 1 kg,4,140,120,20,2
23-01-2025,Oils & Ghee,Sesame oil 1 L,9,590,560,30,1
23-01-2025,Snacks & Ready-to-Eat,MB MULTIMILLET NOODLES 180GM,14,95,95,0,1
23-01-2025,"Grains, Flours & Dals",SABDANA 500GM,4,90,70,20,1
23-01-2025,Snacks & Ready-to-Eat,Corn Chips 250GM,14,80,70,10,2
23-01-2025,Oils & Ghee,Mustard oil 500 ml,9,220,195,25,1
23-01-2025,Spices & Seasonings,SD IDLY KARAM,15,65,65,0,1
23-01-2025,Sweeteners,NATURAL HONEY 1KG,16,560,480,80,1
23-01-2025,Snacks & Ready-to-Eat,VD Pappu Chekkalu 190gm,14,60,60,0,1
23-01-2025,Snacks & Ready-to-Eat,TILLI CHIKKI,14,125,125,0,1
23-01-2025,"Grains, Flours & Dals",WHITE BATANI,4,40,30,10,1
23-01-2025,Snacks & Ready-to-Eat,PEANUT CHILLI,14,20,20,0,4
23-01-2025,Snacks & Ready-to-Eat,Pani Poori Chips 250GM,14,50,40,10,1
23-01-2025,Sweeteners,YB JAGGERY POWDER 500GMS,16,75,75,0,1
23-01-2025,Spices & Seasonings,EVEREST PANI PURI MASALA 50GM,15,40,40,0,1
23-01-2025,Snacks & Ready-to-Eat,BD BARELY NOODLES 200G,14,70,70,0,1
23-01-2025,Snacks & Ready-to-Eat,RAJGIRA PEANUT CHIKKI,14,20,20,0,4
23-01-2025,Snacks & Ready-to-Eat,WHITE SESAME CHIKKI,14,10,10,0,1
23-01-2025,Oils & Ghee,Groundnut oil 1 L,9,360,330,30,1
23-01-2025,Household & Cleaning,VIM MAHA BAR,6,10,10,0,1
23-01-2025,"Grains, Flours & Dals",AS Maize Rava 500GM,4,42,38,4,1
23-01-2025,"Grains, Flours & Dals",HS JOWAR FLAKES 250GM 1+1,4,119,119,0,1
23-01-2025,Snacks & Ready-to-Eat,SD Atreyapuram DRY Fruit ghee,14,150,150,0,1
23-01-2025,Oils & Ghee,Groundnut oil 1 L,9,360,330,30,1
23-01-2025,"Grains, Flours & Dals",KORRALU (FOXTAIL M) 500GM,4,65,55,10,1
23-01-2025,"Health, Wellness & Ayurvedic Products",MD Satavari Choornam 50GM,5,100,100,0,1
23-01-2025,Oils & Ghee,Coconut oil 500 ml,9,220,200,20,1
23-01-2025,Oils & Ghee,Safflower oil 1 L,9,440,400,40,1
23-01-2025,Oils & Ghee,Sesame oil 1 L,9,590,560,30,1
23-01-2025,"Grains, Flours & Dals",RAGI FLOUR 500GRMS,4,40,35,5,1
23-01-2025,"Grains, Flours & Dals",Wheat Flour 1 kg,4,140,120,20,2
23-01-2025,Oils & Ghee,Groundnut oil 1 L,9,360,330,30,1
23-01-2025,Personal Care & Cosmetics,MADDI ALOEVERA SHAMPOO 500ML,10,300,300,0,1
23-01-2025,Snacks & Ready-to-Eat,TILLI CHIKKI,14,30,30,0,6
23-01-2025,"Grains, Flours & Dals",FLOUR CHARGE,4,26.4,26.4,0,2.2
23-01-2025,"Dry Fruits, Nuts & Seeds",Groundnuts 500 gms,2,95,85,10,1
23-01-2025,Oils & Ghee,BUFFALLO GHEE 500ML,9,410,370,40,1
23-01-2025,Spices & Seasonings,SWEET SOUNF,15,20,20,0,1
23-01-2025,Snacks & Ready-to-Eat,PEANUT CHILLI,14,5,5,0,1
23-01-2025,Snacks & Ready-to-Eat,VD RICE MURUKU 150GM,14,50,50,0,1
23-01-2025,"Grains, Flours & Dals",URAD DALL,4,95,85,10,1
23-01-2025,"Grains, Flours & Dals",Multigrain 1 kg,4,100,85,15,1
23-01-2025,"Grains, Flours & Dals",Wheat Flour 1 kg,4,70,60,10,1
23-01-2025,Snacks & Ready-to-Eat,SS IDLY BATTER 1KG,14,60,60,0,1
23-01-2025,"Grains, Flours & Dals",Bombay Rava 500GM,4,35,30,5,1
23-01-2025,Spices & Seasonings,Jeera 100GM,15,50,45,5,1
23-01-2025,Spices & Seasonings,PRO ORG BAY LEAF 50G,15,60,60,0,1
23-01-2025,"Grains, Flours & Dals",Wheat Flour 2 kgs,4,140,120,20,1
23-01-2025,"Grains, Flours & Dals",Wheat Flour 1 kg,4,70,60,10,1
23-01-2025,Snacks & Ready-to-Eat,BELLAM MINAPA SUNADULLU,14,180,180,0,1
23-01-2025,"Grains, Flours & Dals",RAGI FLOUR 1KG,4,160,140,20,2
23-01-2025,Oils & Ghee,Groundnut oil 1 L,9,360,330,30,1
23-01-2025,"Health, Wellness & Ayurvedic Products",RB Max Protein Choco Berry bar 50g,5,75,75,0,1
23-01-2025,"Grains, Flours & Dals",Idly Rava L 1KG,4,60,50,10,1
23-01-2025,Oils & Ghee,Sesame oil 1 L,9,590,560,30,1
23-01-2025,Oils & Ghee,Safflower oil 1 L,9,440,400,40,1
23-01-2025,Spices & Seasonings,NUVVULU 500GM,15,160,130,30,1
23-01-2025,Oils & Ghee,Groundnut oil 1 L,9,720,660,60,2
23-01-2025,Sweeteners,MADHUR SUGAR 1KG,16,65,55,10,1
23-01-2025,"Grains, Flours & Dals",BAJRA 1 KG,4,60,50,10,1
23-01-2025,"Grains, Flours & Dals",RAGI FLOUR 500GRMS,4,40,35,5,1
23-01-2025,Oils & Ghee,Sesame oil 1 L,9,590,560,30,1
23-01-2025,Oils & Ghee,Groundnut oil 1 L,9,360,330,30,1
23-01-2025,Personal Care & Cosmetics,COLGATE STRONG TEETH,10,20,20,0,1
23-01-2025,"Grains, Flours & Dals",Wheat Rava M 1KG,4,65,55,10,1
23-01-2025,Milk & Dairy,SANGAM TONED MILK 500ML,7,60,60,0,2
23-01-2025,Oils & Ghee,Safflower oil 500 ml,9,220,200,20,1
23-01-2025,Spices & Seasonings,Telaga Pindi 250 GM,15,40,35,5,1
23-01-2025,Milk & Dairy,SANGAM FULL CREAM MILK 500ML,7,38,38,0,1
23-01-2025,"Health, Wellness & Ayurvedic Products",MH Millets Malt 1KG,5,400,380,20,1
23-01-2025,Spices & Seasonings,Masala Karam 250 gms,15,130,120,10,1
23-01-2025,"Grains, Flours & Dals",RED TURDAL 500GM,4,75,70,5,1
23-01-2025,"Grains, Flours & Dals",white Bobarlu 500 gms,4,80,75,5,1
23-01-2025,Snacks & Ready-to-Eat,SALTED PHALLI,14,65,65,0,1
23-01-2025,Spices & Seasonings,SWEET SOUNF,15,20,20,0,1
23-01-2025,Spices & Seasonings,SD Curry Leaves Karam Powder 100GM,15,65,65,0,1
23-01-2025,Snacks & Ready-to-Eat,BATANA NGT 70GMS,14,20,20,0,1
23-01-2025,"Grains, Flours & Dals",ROXY POORI ATTA 1KG,4,75,75,0,1
23-01-2025,"Grains, Flours & Dals",JOWAR YELLOW 1 K,4,300,270,30,3
23-01-2025,"Grains, Flours & Dals",CHANA DAL 500GM,4,70,60,10,1
23-01-2025,"Dry Fruits, Nuts & Seeds",PULMAKHANA 100 GM,2,180,170,10,1
23-01-2025,Sweeteners,MISHRI 250 GM,16,35,30,5,1
23-01-2025,Sweeteners,YB JAGGERY POWDER 500GMS,16,75,75,0,1
23-01-2025,"Grains, Flours & Dals",SL Idly Rava 1KG,4,130,110,20,2
23-01-2025,Pooja & Spiritual Items,SST 365 PURE COTTON POOJA,12,30,30,0,1
23-01-2025,Milk & Dairy,SANGAM TONED MILK 500ML,7,90,90,0,3
23-01-2025,"Dry Fruits, Nuts & Seeds",Groundnuts 500 gms,2,95,85,10,1
23-01-2025,"Grains, Flours & Dals",white Bobarlu 500 gms,4,80,75,5,1
23-01-2025,"Grains, Flours & Dals",Red Bobarlu 500 gms,4,95,85,10,1
23-01-2025,"Grains, Flours & Dals",PESARA PAPPU 500GMS,4,85,75,10,1
23-01-2025,Spices & Seasonings,Avalu small 250 gms,15,60,40,20,1
23-01-2025,Personal Care & Cosmetics,Soapnut 250GM,10,60,45,15,1
23-01-2025,Spices & Seasonings,Tamarind 250GMS,15,160,130,30,2
23-01-2025,Spices & Seasonings,Vamu 100GM,15,60,50,10,1
23-01-2025,Sweeteners,NATURAL HONEY 1KG,16,560,480,80,1
23-01-2025,Spices & Seasonings,Menthulu 500 gms,15,100,90,10,1
23-01-2025,Baking & Cooking Aids,Baking Soda 50GM,0,40,30,10,2
23-01-2025,Snacks & Ready-to-Eat,BATANA NGT 70GMS,14,20,20,0,1
23-01-2025,"Grains, Flours & Dals",Wheat Rava M 1KG,4,65,55,10,1
23-01-2025,"Dry Fruits, Nuts & Seeds",DRYDATES 250GM,2,150,120,30,1
23-01-2025,"Grains, Flours & Dals",White jowar.F 1 kg,4,100,80,20,1
23-01-2025,"Grains, Flours & Dals",DESI CHANA,4,50,50,0,2
23-01-2025,"Grains, Flours & Dals",Idly Rava L 1KG,4,60,50,10,1
23-01-2025,"Dry Fruits, Nuts & Seeds",Groundnuts 1 kg,2,190,170,20,1
23-01-2025,Spices & Seasonings,Menthulu 250 gms,15,50,45,5,1
23-01-2025,Spices & Seasonings,JEERA 250 gms,15,125,105,20,1
23-01-2025,"Grains, Flours & Dals",Green gram 1 kg,4,150,130,20,1
23-01-2025,"Grains, Flours & Dals",Yellow jowar .F1 kg,4,110,100,10,1
23-01-2025,Sweeteners,SUGAR 1KG,16,60,50,10,1
23-01-2025,"Grains, Flours & Dals",Chana Flour 500 gms,4,70,65,5,1
23-01-2025,"Grains, Flours & Dals",split green gram 500 gms,4,75,70,5,1
23-01-2025,"Grains, Flours & Dals",Chittimuthaylu rice 1 kg,4,160,140,20,1
23-01-2025,Snacks & Ready-to-Eat,KURNOOL MARMURA,14,70,55,15,1
23-01-2025,Spices & Seasonings,Coriander seeds 200 gms,15,48,40,8,1
23-01-2025,"Grains, Flours & Dals",Red Wheat Flour 1 kg,4,280,260,20,2
23-01-2025,"Health, Wellness & Ayurvedic Products",MXP CREAM ONION,5,45,45,0,1
23-01-2025,Pooja & Spiritual Items,GD KUMKUM 50GM,12,30,30,0,1
23-01-2025,Oils & Ghee,Safflower oil 1 L,9,440,400,40,1
23-01-2025,Spices & Seasonings,GD Turmeric 50GM,15,25,25,0,1
23-01-2025,Pooja & Spiritual Items,SWAATHI GATTI DEEPAM VATTULU,12,30,30,0,1
23-01-2025,Snacks & Ready-to-Eat,MILK BREAD,14,30,30,0,1
23-01-2025,Pooja & Spiritual Items,VRP APOORVA JAVADHU POW,12,35,35,0,1
23-01-2025,Pooja & Spiritual Items,GD Aiswarya Deepam 700ML,12,195,195,0,1
23-01-2025,Snacks & Ready-to-Eat,BROWN BREAD,14,55,55,0,1
23-01-2025,Snacks & Ready-to-Eat,MB PEARL MILLET NOODLES 180GM,14,95,95,0,1
23-01-2025,"Dry Fruits, Nuts & Seeds",YELLOW KISHMISH 250GM,2,130,110,20,1
23-01-2025,"Dry Fruits, Nuts & Seeds",Groundnuts 500 gms,2,95,85,10,1
23-01-2025,Oils & Ghee,Sesame oil 500ml,9,295,280,15,1
23-01-2025,"Grains, Flours & Dals",MELMEKER 250GMS,4,60,45,15,1
23-01-2025,Spices & Seasonings,CHILLI POWDER,15,290,210,80,1
23-01-2025,Snacks & Ready-to-Eat,BATANA NGT 70GMS,14,40,40,0,2
23-01-2025,"Grains, Flours & Dals",RICE FLOUR 500 GM,4,70,56,14,2
23-01-2025,Oils & Ghee,Coconut oil 500 ml,9,220,200,20,1
23-01-2025,"Grains, Flours & Dals",RAGI FLOUR 500GRMS,4,40,35,5,1
23-01-2025,Snacks & Ready-to-Eat,RAJGIRA PEANUT CHIKKI,14,30,30,0,6
23-01-2025,Oils & Ghee,Coconut oil 500 ml,9,220,200,20,1
23-01-2025,"Grains, Flours & Dals",Em jowar idly R 500G,4,75,75,0,1
23-01-2025,"Grains, Flours & Dals",Em Multimillet idli r 500g,4,129,129,0,1
23-01-2025,Pooja & Spiritual Items,GOMATHA AGARBATHI,12,150,150,0,2
23-01-2025,Spices & Seasonings,SH CASSIA STICKS 50GM,15,75,75,0,1
23-01-2025,Snacks & Ready-to-Eat,VD Pappu Chekkalu 190gm,14,120,120,0,2
23-01-2025,Oils & Ghee,Groundnut oil 1 L,9,360,330,30,1
23-01-2025,"Health, Wellness & Ayurvedic Products",MD Orange Peel Choornam 50GM,5,80,80,0,1
23-01-2025,"Health, Wellness & Ayurvedic Products",MD Gandha Karchural Choornam 30GM,5,60,60,0,1
23-01-2025,"Grains, Flours & Dals",Urad dall 1 Kg,4,185,170,15,1
23-01-2025,"Grains, Flours & Dals",Idly Rava L 1KG,4,60,50,10,1
23-01-2025,Sweeteners,SUGAR 1KG,16,60,50,10,1
23-01-2025,"Grains, Flours & Dals",BOMBAY RAVA,4,70,55,15,1
23-01-2025,"Grains, Flours & Dals",turdal 1kg,4,220,195,25,1
23-01-2025,"Grains, Flours & Dals",Wheat Rava M 1KG,4,65,55,10,1
23-01-2025,Spices & Seasonings,DRY MIRCHI 1KG,15,260,260,0,1
23-01-2025,"Grains, Flours & Dals",VGR RICE bag 1,4,1899,"1,650.00",249,1
23-01-2025,Spices & Seasonings,RED COPRA 500GM,15,170,148,22,1
23-01-2025,"Grains, Flours & Dals",JOWAR WHITE 1 KG,4,120,105,15,1.5
23-01-2025,Oils & Ghee,Groundnut oil 5 L,9,1800,"1,600.00",200,1
23-01-2025,"Grains, Flours & Dals",Wheat Flour 1 kg,4,70,60,10,1
23-01-2025,"Grains, Flours & Dals",Multigrain 1 kg,4,300,255,45,3
23-01-2025,"Grains, Flours & Dals",Wheat Flour 1 kg,4,70,60,10,1
23-01-2025,Spices & Seasonings,Turmeric powder 250 gms,15,100,75,25,1
23-01-2025,Pooja & Spiritual Items,GD Sree Chandan 50GM,12,50,50,0,1
23-01-2025,Household & Cleaning,VIM EXTRA 110GM,6,20,20,0,2
23-01-2025,Household & Cleaning,VIM MAHA BAR,6,20,20,0,2
23-01-2025,Oils & Ghee,Groundnut oil 1 L,9,720,660,60,2
23-01-2025,Snacks & Ready-to-Eat,VD ARISELU 5 PIC,14,100,100,0,1
23-01-2025,Snacks & Ready-to-Eat,SATHVI PALLI CHIKKI 200GM,14,100,80,20,1
23-01-2025,Snacks & Ready-to-Eat,GS INSTANT RAGI DOSA MIX,14,99,99,0,1
23-01-2025,Pooja & Spiritual Items,GD Dhoop Sticks 26GM,12,40,40,0,2
23-01-2025,Pooja & Spiritual Items,HAND MADE VOTHULU,12,50,50,0,1
23-01-2025,Pooja & Spiritual Items,GD Kailash 60 GM,12,60,60,0,1
23-01-2025,Pooja & Spiritual Items,GD Dhoop Cones 40GM,12,60,60,0,2
23-01-2025,Personal Care & Cosmetics,GOW DURBAR 75G,10,60,60,0,1
23-01-2025,Pooja & Spiritual Items,GD Sree Chandan 50GM,12,100,100,0,2
23-01-2025,"Grains, Flours & Dals",Bombay Rava 500GM,4,35,30,5,1
23-01-2025,"Grains, Flours & Dals",Wheat Rava M 500GM,4,33,30,3,1
23-01-2025,"Grains, Flours & Dals",White jowar.F 1 kg,4,100,80,20,1
23-01-2025,"Grains, Flours & Dals",Chana Flour 500 gms,4,70,65,5,1
23-01-2025,Personal Care & Cosmetics,MD Soapnut Choornam 100GM,10,80,80,0,1
23-01-2025,Spices & Seasonings,Poonam Mixed Masala 50GM,15,90,90,0,1
23-01-2025,Milk & Dairy,HRITAGE TOTAL CURD 130GM,7,20,20,0,2
23-01-2025,Oils & Ghee,Groundnut oil 1 L,9,360,330,30,1
23-01-2025,General Household & Kitchenware,MATCH BOX,3,20,20,0,1
23-01-2025,Oils & Ghee,Freedom Rice Bran Oil 1L,9,194,180,14,1
23-01-2025,Oils & Ghee,Groundnut oil 5 L,9,1800,"1,600.00",200,1
23-01-2025,"Grains, Flours & Dals",FLOUR CHARGE,4,48,48,0,1
23-01-2025,"Grains, Flours & Dals",Wheat Flour 1 kg,4,70,60,10,1
23-01-2025,"Grains, Flours & Dals",RAGI FLOUR 500GRMS,4,40,35,5,1
23-01-2025,"Grains, Flours & Dals",Multigrain 1 kg,4,200,170,30,2
23-01-2025,Snacks & Ready-to-Eat,BELLAM MINAPA SUNADULLU,14,180,180,0,1
23-01-2025,"Grains, Flours & Dals",Wheat Flour 1 kg,4,70,60,10,1
23-01-2025,Personal Care & Cosmetics,UVIS ALOEVERA GEL,10,149,149,0,1
23-01-2025,"Grains, Flours & Dals",White jowar.F 500 Gms,4,50,40,10,1
23-01-2025,"Grains, Flours & Dals",white Bobarlu 500 gms,4,80,75,5,1
23-01-2025,"Grains, Flours & Dals",FLOUR CHARGE,4,44.4,44.4,0,3.7
23-01-2025,Spices & Seasonings,SONTI 50GM,15,60,40,20,2
23-01-2025,"Grains, Flours & Dals",BAJRA 1 KG,4,60,50,10,1
23-01-2025,Snacks & Ready-to-Eat,SESAME LADDU 200GM,14,100,80,20,1
23-01-2025,"Grains, Flours & Dals",Em kodo idli R 500G,4,129,129,0,1
23-01-2025,"Grains, Flours & Dals",Em Little idli R 500g,4,129,129,0,1
23-01-2025,"Health, Wellness & Ayurvedic Products",MH Millets Malt 1KG,5,800,760,40,2
23-01-2025,Snacks & Ready-to-Eat,GS INSTANT RAGI DOSA MIX,14,99,99,0,1
23-01-2025,"Grains, Flours & Dals",Yellow jowar .F1 kg,4,110,100,10,1
23-01-2025,Snacks & Ready-to-Eat,GS INSTANT KORRA DOSA MIX 400GM,14,120,120,0,1
23-01-2025,"Grains, Flours & Dals",SINGHAM 26KG BAG,4,1650,"1,650.00",0,1
23-01-2025,"Grains, Flours & Dals",EM Foxtail idli r 500 g,4,109,109,0,1
23-01-2025,Oils & Ghee,Safflower oil 1 L,9,440,400,40,1
23-01-2025,Oils & Ghee,Groundnut oil 1 L,9,720,660,60,2
23-01-2025,Spices & Seasonings,YB PINK ROCK SALT 1KG,15,120,120,0,1
23-01-2025,"Dry Fruits, Nuts & Seeds",SATHVI CHIA SEEDS 100GM,2,100,80,20,1
23-01-2025,"Grains, Flours & Dals",RAGI FLOUR 500GRMS,4,40,35,5,1
23-01-2025,"Grains, Flours & Dals",Multigrain 1 kg,4,100,85,15,1
23-01-2025,Oils & Ghee,Sesame oil 1 L,9,590,560,30,1
23-01-2025,Oils & Ghee,Safflower oil 500 ml,9,220,200,20,1
23-01-2025,Snacks & Ready-to-Eat,GS INSTANT KORRA DOSA MIX 400GM,14,120,120,0,1
23-01-2025,Oils & Ghee,Groundnut oil 1 L,9,360,330,30,1
23-01-2025,Oils & Ghee,Groundnut oil 5 L,9,1800,"1,600.00",200,1
23-01-2025,Oils & Ghee,Groundnut oil 1 L,9,720,660,60,2
23-01-2025,Oils & Ghee,Groundnut oil 1 L,9,360,330,30,1
23-01-2025,Milk & Dairy,ID PANEER,7,135,135,0,1
23-01-2025,Personal Care & Cosmetics,SVE KHADI ALOEVERA GEL 200GM,10,270,270,0,1
23-01-2025,"Health, Wellness & Ayurvedic Products",RB Max Protein Jaggery Crunchy,5,175,175,0,1
23-01-2025,General Household & Kitchenware,MATCH BOX,3,20,20,0,1
23-01-2025,"Grains, Flours & Dals",Wheat Flour 1 kg,4,140,120,20,2
23-01-2025,"Grains, Flours & Dals",Multigrain 1 kg,4,500,425,75,5
23-01-2025,Oils & Ghee,Coconut oil 1 L,9,440,400,40,1
23-01-2025,Snacks & Ready-to-Eat,WHOLE WHEAT BREAD,14,55,55,0,1
23-01-2025,Snacks & Ready-to-Eat,GB SALT COOKIES,14,60,55,5,1
23-01-2025,"Grains, Flours & Dals",Yellow jowar .F1 kg,4,220,200,20,2
23-01-2025,Snacks & Ready-to-Eat,SATHVI MIXED CHIKKI 200GM,14,120,100,20,1
23-01-2025,"Dry Fruits, Nuts & Seeds",Groundnuts 1 kg,2,190,170,20,1
23-01-2025,Personal Care & Cosmetics,COLGATE STRONG TEETH,10,20,20,0,1
23-01-2025,"Grains, Flours & Dals",turdal 1kg,4,220,195,25,1
23-01-2025,Personal Care & Cosmetics,STAYFREE DRY-MAX 8UNITS,10,70,70,0,1
23-01-2025,"Grains, Flours & Dals",Green gram 500 gms,4,75,70,5,1
23-01-2025,Oils & Ghee,Safflower oil 1 L,9,440,400,40,1
23-01-2025,"Grains, Flours & Dals",Multigrain 1 kg,4,100,85,15,1
23-01-2025,Spices & Seasonings,Tamarind 500GM,15,160,130,30,1
23-01-2025,Snacks & Ready-to-Eat,SATHVI MIXED CHIKKI 200GM,14,240,200,40,2
23-01-2025,Oils & Ghee,Sesame oil 1 L,9,590,560,30,1
23-01-2025,Snacks & Ready-to-Eat,PUMPKIN CHIKKI 200GM,14,280,240,40,2
23-01-2025,"Grains, Flours & Dals",Multigrain 1 kg,4,100,85,15,1
23-01-2025,"Dry Fruits, Nuts & Seeds",Putnalu 250GM,2,45,38,7,1
23-01-2025,Spices & Seasonings,NUVVULU 500GM,15,200,170,30,1
23-01-2025,Spices & Seasonings,THREE MANGO MIRCH POWDER 500GM,15,475,475,0,1
23-01-2025,Spices & Seasonings,RED COPRA 500GM,15,170,148,22,1
23-01-2025,Sweeteners,MISHRI D,16,40,30,10,1
23-01-2025,Oils & Ghee,Black Sesame oil 500 ml,9,220,190,30,1
23-01-2025,Snacks & Ready-to-Eat,VD Minapa papad 200gm,14,60,60,0,1
23-01-2025,Snacks & Ready-to-Eat,VD MINAPA VADIYAM,14,65,65,0,1
23-01-2025,Oils & Ghee,Groundnut oil 1 L,9,360,330,30,1
23-01-2025,"Grains, Flours & Dals",RAGI FLOUR 1KG,4,80,70,10,1
23-01-2025,"Dry Fruits, Nuts & Seeds",Groundnuts 500 gms,2,95,85,10,1
23-01-2025,"Grains, Flours & Dals",Wheat Flour 1 kg,4,140,120,20,2
23-01-2025,Oils & Ghee,Groundnut oil 1 L,9,720,660,60,2
23-01-2025,"Health, Wellness & Ayurvedic Products",MH Millets Malt 1KG,5,400,380,20,1
23-01-2025,"Grains, Flours & Dals",RAGI FLOUR 1KG,4,80,70,10,1
23-01-2025,"Grains, Flours & Dals",Green gram 500 gms,4,150,140,10,2
23-01-2025,"Grains, Flours & Dals",Multigrain 1 kg,4,100,85,15,1
23-01-2025,"Grains, Flours & Dals",PESARA PAPPU 500GMS,4,85,75,10,1
23-01-2025,"Grains, Flours & Dals",Brown RICE 1KG,4,140,130,10,2
23-01-2025,"Grains, Flours & Dals",BARLEY SEEDS 250GMS,4,40,35,5,1
23-01-2025,"Dry Fruits, Nuts & Seeds",PULMAKHANA 100 GM,2,180,170,10,1
23-01-2025,"Grains, Flours & Dals",Wheat Flour 1 kg,4,70,60,10,1
23-01-2025,Snacks & Ready-to-Eat,PALLI LADDU 200GMS,14,180,140,40,2
23-01-2025,"Grains, Flours & Dals",Em jowar idly R 500G,4,75,75,0,1
23-01-2025,"Grains, Flours & Dals",EM Ragi idli R 500G,4,75,75,0,1
23-01-2025,"Grains, Flours & Dals",SABDANA 500GM,4,90,70,20,1
23-01-2025,Snacks & Ready-to-Eat,BB ROASTED VERMICELLY 500GM,14,70,70,0,1
23-01-2025,Snacks & Ready-to-Eat,BATANA NGT 70GMS,14,40,40,0,2
23-01-2025,"Grains, Flours & Dals",Wheat Rava M 1KG,4,65,55,10,1
23-01-2025,"Grains, Flours & Dals",Wheat Rava M 500GM,4,33,30,3,1
23-01-2025,Snacks & Ready-to-Eat,BD RED RICE NOODLES 200G,14,140,140,0,2
23-01-2025,"Grains, Flours & Dals",Chana Flour 500 gms,4,70,65,5,1
23-01-2025,"Grains, Flours & Dals",SRILALITHA MAIDA FLOUR 500G,4,32,32,0,1
23-01-2025,"Grains, Flours & Dals",Wheat Flour 1 kg,4,70,60,10,1
23-01-2025,Oils & Ghee,Groundnut oil 1 L,9,360,330,30,1
23-01-2025,"Grains, Flours & Dals",KORRALU (FOXTAIL M) 1KG,4,150,110,40,1
23-01-2025,Pooja & Spiritual Items,GD Aiswarya Deepam 700ML,12,195,195,0,1
23-01-2025,"Grains, Flours & Dals",SINGLE POLISH 1KG,4,195,195,0,3
22-01-2025,Spices & Seasonings,Black Till 250GM,15,180,150,30,2
22-01-2025,Sweeteners,GS Palm Jaggery Powder 400GM,16,40,40,0,1
22-01-2025,"Dry Fruits, Nuts & Seeds",CASHEW 250GM,2,340,310,30,1
22-01-2025,Snacks & Ready-to-Eat,SALTED PHALLI,14,260,260,0,4
22-01-2025,"Grains, Flours & Dals",Chana Flour 1 kg,4,280,260,20,2
22-01-2025,Oils & Ghee,Groundnut oil 1 L,9,1440,"1,320.00",120,4
22-01-2025,Oils & Ghee,Coconut oil 500 ml,9,660,600,60,3
22-01-2025,Oils & Ghee,Sesame oil 1 L,9,1180,"1,120.00",60,2
22-01-2025,"Grains, Flours & Dals",Wheat Flour 1 kg,4,140,120,20,2
22-01-2025,"Grains, Flours & Dals",Yellow jowar .F1 kg,4,110,100,10,1
22-01-2025,Spices & Seasonings,YB Rock Salt 1KG,15,240,240,0,2
22-01-2025,Snacks & Ready-to-Eat,BELLAM MINAPA SUNADULLU,14,180,180,0,1
22-01-2025,General Household & Kitchenware,MATCH BOX,3,10,10,0,1
22-01-2025,Oils & Ghee,Sesame oil 1 L,9,590,560,30,1
22-01-2025,"Dry Fruits, Nuts & Seeds",SABJA SEEDS 100GM,2,80,70,10,1
22-01-2025,Spices & Seasonings,NUVVULU 250GM,15,80,65,15,1
22-01-2025,Spices & Seasonings,Elaichi 25GM,15,145,120,25,1
22-01-2025,"Grains, Flours & Dals",SINGLE POLISH 1KG,4,325,325,0,5
22-01-2025,Household & Cleaning,SRI OS BLEACHING POWDER100GM,6,65,65,0,1
22-01-2025,Spices & Seasonings,JEERA 250 gms,15,125,105,20,1
22-01-2025,Spices & Seasonings,Coriander seeds 200 gms,15,96,80,16,2
22-01-2025,Spices & Seasonings,DRY MIECHI 200GM,15,80,60,20,1
22-01-2025,Spices & Seasonings,Menthulu 250 gms,15,50,45,5,1
22-01-2025,Spices & Seasonings,Avalu small 250 gms,15,60,40,20,1
22-01-2025,"Grains, Flours & Dals",Wheat Flour 1 kg,4,70,60,10,1
22-01-2025,Oils & Ghee,Sesame oil 1 L,9,1770,"1,680.00",90,3
22-01-2025,Oils & Ghee,Groundnut oil 1 L,9,720,660,60,2
22-01-2025,Oils & Ghee,Safflower oil 1 L,9,440,400,40,1
22-01-2025,"Grains, Flours & Dals",RAGI FLOUR 500GRMS,4,40,35,5,1
22-01-2025,"Grains, Flours & Dals",Multigrain 1 kg,4,100,85,15,1
22-01-2025,Snacks & Ready-to-Eat,DOSA BATTER 1KG,14,60,60,0,1
22-01-2025,Snacks & Ready-to-Eat,RAJGIRA PEANUT CHIKKI 450GM,14,250,250,0,2
22-01-2025,Snacks & Ready-to-Eat,PEANUT CHIKKI 450GM,14,125,125,0,1
22-01-2025,Spices & Seasonings,SAJEERA,15,60,40,20,1
22-01-2025,Snacks & Ready-to-Eat,VD ARISELU 5 PIC,14,100,100,0,1
22-01-2025,Spices & Seasonings,Japatri 25GM,15,100,80,20,1
22-01-2025,Spices & Seasonings,SONTI 50GM,15,30,20,10,1
22-01-2025,Pooja & Spiritual Items,VRP APOORVA JAVADHU POW,12,35,35,0,1
22-01-2025,Spices & Seasonings,Marati Magga 50GM,15,130,110,20,1
22-01-2025,Sweeteners,GS Palm Jaggery Powder 400GM,16,180,180,0,1
22-01-2025,Snacks & Ready-to-Eat,SESAME LADDU 200GM,14,100,80,20,1
22-01-2025,"Grains, Flours & Dals",Multigrain 1 kg,4,100,85,15,1
22-01-2025,"Grains, Flours & Dals",RAGI FLOUR 500GRMS,4,40,35,5,1
22-01-2025,"Grains, Flours & Dals",Yellow jowar .F1 kg,4,110,100,10,1
22-01-2025,Snacks & Ready-to-Eat,BD RED RICE NOODLES 200G,14,70,70,0,1
22-01-2025,Oils & Ghee,Safflower oil 1 L,9,880,800,80,2
22-01-2025,"Grains, Flours & Dals",Wheat Flour 1 kg,4,70,60,10,1
22-01-2025,Spices & Seasonings,AV Iodized Salt 1KG,15,28,25,3,1
22-01-2025,Oils & Ghee,Groundnut oil 5 L,9,1800,"1,600.00",200,1
22-01-2025,Snacks & Ready-to-Eat,SD Ginger Candy 100g,14,60,60,0,1
22-01-2025,Oils & Ghee,Groundnut oil 1 L,9,360,330,30,1
22-01-2025,"Grains, Flours & Dals",turdal 1kg,4,220,195,25,1
22-01-2025,Snacks & Ready-to-Eat,GANTASALA FLAX SEEDS SPICY,14,90,90,0,1
22-01-2025,Snacks & Ready-to-Eat,SD JOWAR WITH PALM JAGGERY 250GM,14,135,135,0,1
22-01-2025,"Dry Fruits, Nuts & Seeds",Groundnuts 500 gms,2,95,85,10,1
22-01-2025,"Grains, Flours & Dals",POORI ATTA 1KG,4,75,65,10,1
22-01-2025,"Dry Fruits, Nuts & Seeds",Groundnuts 1 kg,2,190,170,20,1
22-01-2025,"Grains, Flours & Dals",Idly Rava L 1KG,4,60,50,10,1
22-01-2025,"Grains, Flours & Dals",Wheat Flour 1 kg,4,70,60,10,1
22-01-2025,"Grains, Flours & Dals",Multigrain 1 kg,4,100,85,15,1
22-01-2025,Pickles & Cooking Pastes,SD MANGO TOKKU,11,110,110,0,1
22-01-2025,Oils & Ghee,cow ghee 500 ml,9,430,390,40,1
22-01-2025,"Grains, Flours & Dals",Wheat Flour 1 kg,4,140,120,20,2
22-01-2025,"Grains, Flours & Dals",turdal 1kg,4,220,195,25,1
22-01-2025,Sweeteners,NATURAL HONEY 250GM,16,150,130,20,1
22-01-2025,"Grains, Flours & Dals",UDALU (Barnyard millet) 500 gms,4,140,120,20,2
22-01-2025,"Grains, Flours & Dals",Arikadu ( kodo),4,140,130,10,1
22-01-2025,"Grains, Flours & Dals",UDALU (Barnyard millet) 1 kg,4,140,115,25,1
22-01-2025,"Grains, Flours & Dals",SAMALU (Little millet) 1 kg,4,170,130,40,1
22-01-2025,"Grains, Flours & Dals",KORRALU (FOXTAIL M) 1KG,4,150,110,40,1
22-01-2025,Spices & Seasonings,DURGA SALT CRYSTAL 1KG,15,25,25,0,1
22-01-2025,"Grains, Flours & Dals",ANDU KORRALU (Browntop.m) 1 kg,4,320,290,30,1
22-01-2025,Oils & Ghee,Sesame oil 500ml,9,295,280,15,1
22-01-2025,Personal Care & Cosmetics,MD Bath Powder 100GM,10,80,80,0,2
22-01-2025,"Grains, Flours & Dals",MAATEJA rice 1 kg,4,144,138,6,2
22-01-2025,"Grains, Flours & Dals",SINGLE POLISH 1KG,4,195,195,0,3
22-01-2025,"Grains, Flours & Dals",KORRALU (FOXTAIL M) 1KG,4,37.5,27.5,10,0.25
22-01-2025,"Grains, Flours & Dals",WHEAT 1 KG,4,180,150,30,3
22-01-2025,"Grains, Flours & Dals",FLOUR CHARGE,4,54,54,0,4.5
22-01-2025,"Grains, Flours & Dals",JOWAR WHITE 1 KG,4,80,70,10,1
22-01-2025,Snacks & Ready-to-Eat,RAJGIRA PEANUT CHIKKI,14,10,10,0,2
22-01-2025,Snacks & Ready-to-Eat,ELITE ELAICHI RUSK 200GM,14,35,35,0,1
22-01-2025,Oils & Ghee,Sesame oil 1 L,9,590,560,30,1
22-01-2025,"Grains, Flours & Dals",Red uluvalu 250 gms,4,45,40,5,1
22-01-2025,Sweeteners,MISHRI 250 GM,16,35,30,5,1
22-01-2025,Spices & Seasonings,ROYAL SAFFRON 400GRMS,15,65,65,0,1
22-01-2025,"Grains, Flours & Dals",Arikalu (kodo),4,70,65,5,1
22-01-2025,Snacks & Ready-to-Eat,SESAME LADDU 200GM,14,100,80,20,1
22-01-2025,"Health, Wellness & Ayurvedic Products",RB Max Protein Spanish Tomato,5,90,90,0,2
22-01-2025,"Health, Wellness & Ayurvedic Products",MD Triphala Chorrnam 100GM,5,60,60,0,1
22-01-2025,"Grains, Flours & Dals",Wheat Rava M 1KG,4,65,55,10,1
22-01-2025,"Grains, Flours & Dals",KORRALU (FOXTAIL M) 500GM,4,65,55,10,1
22-01-2025,"Grains, Flours & Dals",Arikalu (kodo),4,70,65,5,1
22-01-2025,"Grains, Flours & Dals",SAMALU (Little millet) 500 gms,4,85,65,20,1
22-01-2025,"Grains, Flours & Dals",ANDU KORRALU (Brown top .mlt) 500,4,160,145,15,1
22-01-2025,"Grains, Flours & Dals",UDALU (Barnyard millet) 500 gms,4,70,60,10,1
22-01-2025,"Grains, Flours & Dals",Brown RICE 1KG,4,70,65,5,1
22-01-2025,Milk & Dairy,HERITAGE TONED MILK 500ML,7,31,31,0,1
22-01-2025,Oils & Ghee,Groundnut oil 1 L,9,360,330,30,1
22-01-2025,Snacks & Ready-to-Eat,PALLI LADDU 200GMS,14,90,70,20,1
22-01-2025,Oils & Ghee,Safflower oil 1 L,9,440,400,40,1
22-01-2025,"Grains, Flours & Dals",Wheat Flour 1 kg,4,210,180,30,3
22-01-2025,Oils & Ghee,Sesame oil 1 L,9,590,560,30,1
22-01-2025,"Dry Fruits, Nuts & Seeds",GF KIMIA DATES 500GM,2,310,190,120,1
22-01-2025,Oils & Ghee,Coconut oil 500 ml,9,220,200,20,1
22-01-2025,Oils & Ghee,Sesame oil 500ml,9,590,560,30,2
22-01-2025,Oils & Ghee,Groundnut oil 1 L,9,720,660,60,2
22-01-2025,"Grains, Flours & Dals",Red uluvalu 250 gms,4,45,40,5,1
22-01-2025,Misc,NOVA,8,68,68,0,1
22-01-2025,Pooja & Spiritual Items,PACHI KARPURAM 25GM,12,90,90,0,1
22-01-2025,Oils & Ghee,Coconut oil 500 ml,9,220,200,20,1
22-01-2025,Household & Cleaning,VIM TROPICAL LEMON FRESHNESS 250ML,6,55,55,0,1
22-01-2025,Household & Cleaning,ARIEL COMPLETE SEMI-AUTO,6,154,154,0,1
22-01-2025,"Grains, Flours & Dals",Wheat Flour 1 kg,4,70,60,10,1
22-01-2025,"Grains, Flours & Dals",SL Idly Rava 1KG,4,65,55,10,1
22-01-2025,Oils & Ghee,Groundnut oil 1 L,9,360,330,30,1
22-01-2025,Personal Care & Cosmetics,WHISPER CHOICE REGULAR 230MM,10,70,70,0,2
22-01-2025,Personal Care & Cosmetics,PATANJALI ANTI DRANDRUFF 180ML,10,130,130,0,1
22-01-2025,Snacks & Ready-to-Eat,FUN TIME CRUNCH,14,45,45,0,1
22-01-2025,Snacks & Ready-to-Eat,SATHVI MIXED CHIKKI 200GM,14,120,100,20,1
22-01-2025,Spices & Seasonings,ELACHI 25 GM,15,145,120,25,1
22-01-2025,"Grains, Flours & Dals",SL Suji Rava 500GM,4,32,32,0,1
22-01-2025,Snacks & Ready-to-Eat,VD MINAPA SUNNUNDALU 12P,14,180,180,0,1
22-01-2025,"Grains, Flours & Dals",Chana Flour 500 gms,4,70,65,5,1
22-01-2025,Snacks & Ready-to-Eat,PALLI LADDU 200GMS,14,90,70,20,1
22-01-2025,Oils & Ghee,Safflower oil 1 L,9,440,400,40,1
22-01-2025,Spices & Seasonings,NUVVULU 500GM,15,320,260,60,2
22-01-2025,"Dry Fruits, Nuts & Seeds",SUNFLOWER SEEDS 250GRM,2,150,130,20,1
22-01-2025,General Household & Kitchenware,MATCH BOX,3,20,20,0,1
22-01-2025,"Dry Fruits, Nuts & Seeds",PUMPKIN SEEDS 250GM,2,200,160,40,1
22-01-2025,Sweeteners,MISHRI D,16,40,30,10,1
22-01-2025,"Health, Wellness & Ayurvedic Products",MH Millets Malt 500GM,5,200,190,10,1
22-01-2025,"Grains, Flours & Dals",RAGI FLOUR 500GRMS,4,40,35,5,1
22-01-2025,Snacks & Ready-to-Eat,ELITE ELAICHI RUSK 200GM,14,35,35,0,1
22-01-2025,General Household & Kitchenware,RED LINE 20GM,3,75,75,0,1
22-01-2025,"Grains, Flours & Dals",RICE FLOUR 1KG,4,70,55,15,1
22-01-2025,"Dry Fruits, Nuts & Seeds",Groundnuts 500 gms,2,95,85,10,1
22-01-2025,"Grains, Flours & Dals",BLACK GRAM 1KG,4,150,140,10,1
22-01-2025,Spices & Seasonings,DRY MIECHI 200GM,15,80,60,20,1
22-01-2025,"Grains, Flours & Dals",SRILALITHA MAIDA FLOUR 500G,4,32,32,0,1
22-01-2025,Sweeteners,SUGAR 1KG,16,60,50,10,1
22-01-2025,"Dry Fruits, Nuts & Seeds",Groundnuts 500 gms,2,95,85,10,1
22-01-2025,"Grains, Flours & Dals",split black gram 1 kg,4,180,170,10,1
22-01-2025,Spices & Seasonings,Tamarind 500GM,15,160,130,30,1
22-01-2025,Beverages,RED LABEL NATURAL CARE 100G,1,65,65,0,1
22-01-2025,Spices & Seasonings,NUVVULU 250GM,15,80,65,15,1
22-01-2025,Sweeteners,ACHU BELLAM 1KG,16,100,80,20,1
22-01-2025,"Grains, Flours & Dals",SB Javva Wheat Ravva 500GM,4,95,95,0,1
22-01-2025,Household & Cleaning,SPARK PERFUMED HERBAL PYENYLE 1L,6,95,95,0,1
22-01-2025,"Grains, Flours & Dals",Bombay Rava 500GM,4,35,30,5,1
22-01-2025,"Grains, Flours & Dals",RAGI FLOUR 1KG,4,80,70,10,1
22-01-2025,"Grains, Flours & Dals",White jowar .F 2 KGS,4,200,160,40,1
22-01-2025,"Health, Wellness & Ayurvedic Products",DWI OMU WATER 100ML,5,40,40,0,1
22-01-2025,"Health, Wellness & Ayurvedic Products",MADDI NEEM OIL 100ML,5,80,80,0,1
22-01-2025,Personal Care & Cosmetics,HERBAL BATH POWDER,10,160,160,0,1
22-01-2025,"Grains, Flours & Dals",Red Chana 500 GM,4,75,60,15,1
22-01-2025,"Grains, Flours & Dals",RAGI FLOUR 500GRMS,4,80,70,10,2
22-01-2025,"Grains, Flours & Dals",White jowar.F 1 kg,4,200,160,40,2
22-01-2025,"Grains, Flours & Dals",RAGI FLOUR 1KG,4,80,70,10,1
22-01-2025,Oils & Ghee,Black Sesame oil 500 ml,9,220,190,30,1
22-01-2025,Oils & Ghee,Mustard oil 500 ml,9,220,195,25,1
22-01-2025,"Grains, Flours & Dals",Multigrain 1 kg,4,100,85,15,1
22-01-2025,Snacks & Ready-to-Eat,SD Moringa with plam jaggery 250gm,14,135,135,0,1
22-01-2025,Snacks & Ready-to-Eat,VD MINAPA VADIYAM,14,65,65,0,1
22-01-2025,Snacks & Ready-to-Eat,SD RED CHILLY PAPADS,14,80,80,0,1
22-01-2025,Spices & Seasonings,ROYAL SAFFRON 400GRMS,15,130,130,0,2
22-01-2025,"Grains, Flours & Dals",JOWAR WHITE 1 KG,4,160,140,20,2
22-01-2025,"Grains, Flours & Dals",RAGULU 1 KG,4,70,60,10,1
22-01-2025,"Grains, Flours & Dals",SAMALU (Little millet) 500 gms,4,85,65,20,1
22-01-2025,"Grains, Flours & Dals",UDALU (Barnyard millet) 500 gms,4,70,60,10,1
22-01-2025,"Grains, Flours & Dals",Arikalu (kodo),4,70,65,5,1
22-01-2025,Sweeteners,YB Brown Sugar 500GM,16,75,75,0,1
22-01-2025,"Dry Fruits, Nuts & Seeds",CASHEW 250GM,2,340,310,30,1
22-01-2025,"Grains, Flours & Dals",Arikalu (kodo),4,70,65,5,1
22-01-2025,"Grains, Flours & Dals",Idly Rava L 1KG,4,120,100,20,2
22-01-2025,"Dry Fruits, Nuts & Seeds",ROASTED FLAXSEED,2,75,75,0,1
22-01-2025,General Household & Kitchenware,CANDLE,3,30,30,0,1
22-01-2025,Spices & Seasonings,TATA SALT 1KG,15,30,30,0,1
22-01-2025,"Dry Fruits, Nuts & Seeds",Groundnuts 500 gms,2,95,85,10,1
22-01-2025,"Grains, Flours & Dals",KORRALU (FOXTAIL M) 500GM,4,65,55,10,1
22-01-2025,"Grains, Flours & Dals",Urad dall 1 Kg,4,370,340,30,2
22-01-2025,Spices & Seasonings,CHILLI POWDER,15,290,210,80,1
22-01-2025,Sweeteners,MISHRI D,16,40,30,10,1
22-01-2025,Personal Care & Cosmetics,GOW DURBAR 75G,10,60,60,0,1
22-01-2025,Household & Cleaning,GAJANAND BLACK DRAGN 10STI,6,40,40,0,2
22-01-2025,Pooja & Spiritual Items,GD Sree Chandan 50GM,12,50,50,0,1
22-01-2025,"Grains, Flours & Dals",turdal 1kg,4,660,585,75,3
22-01-2025,"Grains, Flours & Dals",UDALU (Barnyard millet) 500 gms,4,70,60,10,1
22-01-2025,"Grains, Flours & Dals",ANDU KORRALU (Brown top .mlt) 500,4,160,145,15,1
22-01-2025,Pooja & Spiritual Items,AMRUTHA SURABHI,12,80,80,0,1
22-01-2025,Oils & Ghee,Coconut oil 500 ml,9,220,200,20,1
22-01-2025,"Grains, Flours & Dals",RAGI FLOUR 500GRMS,4,40,35,5,1
22-01-2025,"Grains, Flours & Dals",EM Ragi idli R 500G,4,75,75,0,1
22-01-2025,"Grains, Flours & Dals",SAMALU (Little millet) 500 gms,4,85,65,20,1
22-01-2025,"Grains, Flours & Dals",JOWAR UPMA RAVA,4,0,0,0,2
22-01-2025,"Grains, Flours & Dals",Em jowar idly R 500G,4,150,150,0,2
22-01-2025,"Grains, Flours & Dals",RAGULU 1 KG,4,17.5,15,2.5,0.25
22-01-2025,"Grains, Flours & Dals",Wheat Flour 1 kg,4,70,60,10,1
22-01-2025,"Grains, Flours & Dals",BAJRA 1 KG,4,15,12.5,2.5,0.25
22-01-2025,"Grains, Flours & Dals",WHEAT 1 KG,4,120,100,20,2
22-01-2025,Oils & Ghee,Mustard oil 500 ml,9,220,195,25,1
22-01-2025,Personal Care & Cosmetics,VASELINE INTENSIVE CARE COCOA GLOW,10,115,115,0,1
22-01-2025,Snacks & Ready-to-Eat,SD Methi laddu with honey 175gm,14,135,135,0,1
22-01-2025,Snacks & Ready-to-Eat,SD FINGER Millet with palm Jaggery 250gm,14,135,135,0,1
22-01-2025,Snacks & Ready-to-Eat,SD Pumpkin Seeds With Dates 175gm,14,170,170,0,1
22-01-2025,Snacks & Ready-to-Eat,SATHVI MIXED CHIKKI 200GM,14,120,100,20,1
22-01-2025,Snacks & Ready-to-Eat,FOXTAIL BIS,14,0,0,0,1
22-01-2025,"Dry Fruits, Nuts & Seeds",Groundnuts 500 gms,2,95,85,10,1
22-01-2025,Spices & Seasonings,Tamarind 500GM,15,160,130,30,1
22-01-2025,"Grains, Flours & Dals",Quinova 500 gms,4,110,100,10,1
22-01-2025,"Grains, Flours & Dals",KORRALU (FOXTAIL M) 500GM,4,65,55,10,1
22-01-2025,"Grains, Flours & Dals",Arikalu (kodo),4,70,65,5,1
22-01-2025,"Grains, Flours & Dals",SAMALU (Little millet) 500 gms,4,85,65,20,1
22-01-2025,Household & Cleaning,VIM MAHA BAR,6,40,40,0,4
22-01-2025,"Grains, Flours & Dals",JOWAR YELLOW 1 K,4,200,180,20,2
22-01-2025,"Dry Fruits, Nuts & Seeds",SABJA SEEDS 100GM,2,80,70,10,1
22-01-2025,Oils & Ghee,Groundnut oil 5 L,9,1800,"1,600.00",200,1
22-01-2025,"Grains, Flours & Dals",VGR rice 1 kg,4,70,65,5,1
22-01-2025,Oils & Ghee,Groundnut oil 1 L,9,720,660,60,2
22-01-2025,"Grains, Flours & Dals",Em Little idli R 500g,4,129,129,0,1
22-01-2025,"Grains, Flours & Dals",turdal 1kg,4,440,390,50,2
22-01-2025,"Grains, Flours & Dals",Wheat Flour 1 kg,4,70,60,10,1
22-01-2025,Spices & Seasonings,Menthulu 250 gms,15,50,45,5,1
22-01-2025,"Grains, Flours & Dals",Yellow jowar.F 500 gms,4,55,50,5,1
22-01-2025,"Grains, Flours & Dals",White jowar.F 1 kg,4,100,80,20,1
22-01-2025,Spices & Seasonings,DB CRYSTAL SALT 1KG,15,25,25,0,1
22-01-2025,"Grains, Flours & Dals",Red Wheat Flour 1 kg,4,140,130,10,1
22-01-2025,Milk & Dairy,SANGAM TONED MILK 500ML,7,90,90,0,3
22-01-2025,"Grains, Flours & Dals",KORRALU (FOXTAIL M) 1KG,4,150,110,40,1
22-01-2025,"Grains, Flours & Dals",VGR RICE bag 1,4,1899,"1,650.00",249,1
22-01-2025,"Grains, Flours & Dals",KORRALU (FOXTAIL M) 500GM,4,65,55,10,1
22-01-2025,"Grains, Flours & Dals",Arikalu (kodo),4,70,65,5,1
22-01-2025,"Grains, Flours & Dals",ANDU KORRALU (Brown top .mlt) 500,4,160,145,15,1
22-01-2025,"Grains, Flours & Dals",UDALU (Barnyard millet) 500 gms,4,70,60,10,1
22-01-2025,"Grains, Flours & Dals",SAMALU (Little millet) 500 gms,4,85,65,20,1
22-01-2025,Spices & Seasonings,NUVVULU 250GM,15,80,65,15,1
22-01-2025,"Dry Fruits, Nuts & Seeds",PUMPKIN SEEDS 250GM,2,200,160,40,1
22-01-2025,"Dry Fruits, Nuts & Seeds",FLAX SEEDS 250GM,2,120,100,20,2
22-01-2025,"Grains, Flours & Dals",Red uluvalu 250 gms,4,45,40,5,1
22-01-2025,"Grains, Flours & Dals",Red Chana 500 GM,4,75,60,15,1
22-01-2025,"Grains, Flours & Dals",DOCTOR RICE DIABETIC SFR 1KG,4,360,360,0,3
22-01-2025,Oils & Ghee,Safflower oil 1 L,9,440,400,40,1
22-01-2025,Snacks & Ready-to-Eat,SESAME LADDU 200GM,14,100,80,20,1
22-01-2025,Household & Cleaning,GOOD KNIGHT GOLD FLASH,6,160,160,0,2
22-01-2025,"Grains, Flours & Dals",BOMBAY RAVA,4,70,55,15,1
22-01-2025,Sweeteners,ACHUBELLAM 500GM,16,50,40,10,1
22-01-2025,Spices & Seasonings,Tamarind 500GM,15,160,130,30,1
22-01-2025,Spices & Seasonings,ROYAL SAFFRON 400GRMS,15,65,65,0,1
22-01-2025,Spices & Seasonings,RED COPRA 250GMS,15,85,74,11,1
22-01-2025,"Grains, Flours & Dals",Chana Flour 500 gms,4,70,65,5,1
22-01-2025,"Grains, Flours & Dals",RICE FLOUR 1KG,4,70,55,15,1
22-01-2025,Snacks & Ready-to-Eat,SD FINGER Millet with palm Jaggery 250gm,14,135,135,0,1
22-01-2025,Personal Care & Cosmetics,COLGATE ACTIVE SALT,10,20,20,0,1
22-01-2025,Snacks & Ready-to-Eat,PEANUT CHILLI,14,50,50,0,10
22-01-2025,Snacks & Ready-to-Eat,TILLI CHIKKI,14,50,50,0,10
22-01-2025,Spices & Seasonings,SWEET SOUNF,15,20,20,0,1
22-01-2025,Snacks & Ready-to-Eat,RSC ORANGE 100GMS,14,20,20,0,1
22-01-2025,"Grains, Flours & Dals",Yellow jowar .F1 kg,4,110,100,10,1
22-01-2025,"Grains, Flours & Dals",Red Wheat Flour 1 kg,4,140,130,10,1
22-01-2025,Oils & Ghee,Sesame oil 1 L,9,590,560,30,1
22-01-2025,Personal Care & Cosmetics,HIMALAYA LIP BALM 10GM,10,40,40,0,1
22-01-2025,"Grains, Flours & Dals",Wheat Flour 1 kg,4,70,60,10,1
22-01-2025,Personal Care & Cosmetics,VASELINE 5GM,10,5,5,0,1
22-01-2025,Snacks & Ready-to-Eat,BATANA NGT 70GMS,14,20,20,0,1
22-01-2025,Snacks & Ready-to-Eat,BB ROASTED VERMICELLY 850GM,14,117,117,0,1
22-01-2025,Pooja & Spiritual Items,GD Dhoop Cones 40GM,12,90,90,0,3
22-01-2025,"Grains, Flours & Dals",BARLEY SEEDS 1KG,4,80,70,10,0.5
22-01-2025,"Health, Wellness & Ayurvedic Products",RB Max Protein Spanish Tomato,5,45,45,0,1
22-01-2025,"Grains, Flours & Dals",BOBBARA PAPPU 500GM,4,85,80,5,1
22-01-2025,Snacks & Ready-to-Eat,VD RED CHILLI RICEPAPAD 150GM,14,50,50,0,1
22-01-2025,Pooja & Spiritual Items,SIVA JOOTHI 365 DEEPAPU,12,175,175,0,7
22-01-2025,Pooja & Spiritual Items,SST 365 PURE COTTON POOJA,12,30,30,0,1
22-01-2025,Pooja & Spiritual Items,DASANGAM DHOOP POWDER 50GM,12,86,86,0,2
22-01-2025,"Health, Wellness & Ayurvedic Products",RB Max Protein Choco Berry bar 50g,5,75,75,0,1
22-01-2025,Personal Care & Cosmetics,DETTOL 50ML,10,154,154,0,1
22-01-2025,"Grains, Flours & Dals",PESARA PAPPU 1 KG,4,170,145,25,1
22-01-2025,Pooja & Spiritual Items,BANDA PUVVU 25GM 25GM,12,80,60,20,1
22-01-2025,Snacks & Ready-to-Eat,Corn Chips 250GM,14,120,105,15,3
22-01-2025,Pooja & Spiritual Items,SS DASANGAM CONE 20PICS,12,45,45,0,1
22-01-2025,Personal Care & Cosmetics,UVIS MULTANI MITTI PW 100GM,10,49,49,0,1
22-01-2025,Snacks & Ready-to-Eat,SATHVI MIXED CHIKKI 200GM,14,120,100,20,1
22-01-2025,Personal Care & Cosmetics,DWIBHASHI GULABA ARKA ROSA WATER,10,60,60,0,1
22-01-2025,Personal Care & Cosmetics,MD Henna Choornam 100GM,10,80,80,0,1
22-01-2025,Spices & Seasonings,AVALU 100GM,15,25,20,5,1
22-01-2025,"Grains, Flours & Dals",DESI CHANA,4,25,25,0,1
22-01-2025,"Health, Wellness & Ayurvedic Products",MD Bringaraj Choornam 100GM,5,80,80,0,1
22-01-2025,"Dry Fruits, Nuts & Seeds",SD Mango cubes 200gm,2,90,90,0,1
22-01-2025,Sweeteners,ACHUBELLAM 500GM,16,100,80,20,2
22-01-2025,"Health, Wellness & Ayurvedic Products",RB Max Protein Spanish Tomato,5,45,45,0,1
22-01-2025,"Grains, Flours & Dals",RICE FLOUR 500 GM,4,35,28,7,1
22-01-2025,Oils & Ghee,Groundnut oil 1 L,9,360,330,30,1
22-01-2025,Snacks & Ready-to-Eat,VD Pappu Chekkalu 190gm,14,120,120,0,2
22-01-2025,"Grains, Flours & Dals",Brown RICE 1KG,4,210,195,15,3
22-01-2025,Spices & Seasonings,ROYAL SAFFRON 400GRMS,15,65,65,0,1
22-01-2025,Spices & Seasonings,Turmeric powder 250 gms,15,100,75,25,1
22-01-2025,"Grains, Flours & Dals",VGR rice 1 kg,4,280,260,20,4
22-01-2025,"Health, Wellness & Ayurvedic Products",RB Max Protein Fruit &amp;Nut 50g,5,75,75,0,1
22-01-2025,Oils & Ghee,Coconut oil 1 L,9,440,400,40,1
22-01-2025,"Grains, Flours & Dals",RAGI FLOUR 500GRMS,4,40,35,5,1
22-01-2025,Oils & Ghee,Castor oil 200 ml,9,200,160,40,2
22-01-2025,"Grains, Flours & Dals",KORRALU (FOXTAIL M) 1KG,4,150,110,40,1
22-01-2025,"Grains, Flours & Dals",SAMALU (Little millet) 1 kg,4,170,130,40,1
22-01-2025,"Grains, Flours & Dals",HS Multimillet idly R 500 gms,4,65,65,0,1
22-01-2025,"Grains, Flours & Dals",ANDU KORRALU (Browntop.m) 1 kg,4,320,290,30,1
22-01-2025,Snacks & Ready-to-Eat,VD PESARA PAPAD 195GM,14,70,70,0,1
22-01-2025,Spices & Seasonings,Coriander seeds 200 gms,15,48,40,8,1
22-01-2025,"Grains, Flours & Dals",Chittimuthaylu rice 1 kg,4,160,140,20,1
22-01-2025,"Grains, Flours & Dals",Yellow jowar .F1 kg,4,220,200,20,2
22-01-2025,Snacks & Ready-to-Eat,SD SESAME PAPAD,14,80,80,0,1
22-01-2025,"Grains, Flours & Dals",Multigrain 1 kg,4,200,170,30,2
22-01-2025,Snacks & Ready-to-Eat,URBAN MARMURA 450GM,14,60,55,5,1
22-01-2025,"Grains, Flours & Dals",RAGI FLOUR 1KG,4,80,70,10,1
22-01-2025,"Grains, Flours & Dals",SINGLE POLISH 1KG,4,325,325,0,5
22-01-2025,Snacks & Ready-to-Eat,Sprouted Ragi Biscuits 450GM,14,150,150,0,1
22-01-2025,Spices & Seasonings,Elaichi 25GM,15,145,120,25,1
22-01-2025,"Dry Fruits, Nuts & Seeds",FLAX SEEDS 250GM,2,60,50,10,1
22-01-2025,Sweeteners,ACHU BELLAM 1KG,16,200,160,40,2
22-01-2025,Sweeteners,ACHUBELLAM 500GM,16,100,80,20,2
22-01-2025,Oils & Ghee,Castor oil 200 ml,9,100,80,20,1
22-01-2025,Oils & Ghee,Sesame oil 1 L,9,590,560,30,1
22-01-2025,"Grains, Flours & Dals",DR.RICE 5KG,4,600,600,0,1
22-01-2025,"Grains, Flours & Dals",Multigrain 1 kg,4,100,85,15,1
22-01-2025,"Grains, Flours & Dals",RAGULU 1 KG,4,70,60,10,1
22-01-2025,Personal Care & Cosmetics,GAYATHRI KUMKUDUKAYA,10,150,150,0,1
22-01-2025,Spices & Seasonings,Tamarind 250GMS,15,80,65,15,1
22-01-2025,"Grains, Flours & Dals",split black gram 1 kg,4,180,170,10,1
22-01-2025,"Grains, Flours & Dals",KORRALU (FOXTAIL M) 500GM,4,65,55,10,1
22-01-2025,"Grains, Flours & Dals",JOWAR WHITE 1 KG,4,80,70,10,1
22-01-2025,Snacks & Ready-to-Eat,VD Minapa papad 200gm,14,60,60,0,1
22-01-2025,Spices & Seasonings,Avalu big 250 gms,15,60,40,20,1
22-01-2025,"Health, Wellness & Ayurvedic Products",UVIS NEEM OIL 100ML,5,120,120,0,1
22-01-2025,Oils & Ghee,Groundnut oil 1 L,9,360,330,30,1
22-01-2025,Snacks & Ready-to-Eat,VD RED CHILLI RICEPAPAD 150GM,14,50,50,0,1
22-01-2025,"Grains, Flours & Dals",Wheat Flour 1 kg,4,140,120,20,2
22-01-2025,Spices & Seasonings,Jeera 100GM,15,50,45,5,1
22-01-2025,"Grains, Flours & Dals",Green gram 500 gms,4,75,70,5,1
22-01-2025,"Grains, Flours & Dals",PESARA PAPPU 500GMS,4,85,75,10,1
22-01-2025,Sweeteners,SUGAR 500 GM,16,30,25,5,1
22-01-2025,Snacks & Ready-to-Eat,RINGS 200GM,14,30,30,0,1
22-01-2025,"Dry Fruits, Nuts & Seeds",Groundnuts 500 gms,2,95,85,10,1
22-01-2025,"Grains, Flours & Dals",Urad dall 1 Kg,4,185,170,15,1
22-01-2025,Spices & Seasonings,Coriander seeds 200 gms,15,48,40,8,1
22-01-2025,Snacks & Ready-to-Eat,GB SALT COOKIES,14,60,55,5,1
22-01-2025,"Grains, Flours & Dals",Brown RICE 1KG,4,70,65,5,1
22-01-2025,"Dry Fruits, Nuts & Seeds",Groundnuts 1 kg,2,190,170,20,1
22-01-2025,"Grains, Flours & Dals",YB RED RICE 500GM,4,75,65,10,1
22-01-2025,"Grains, Flours & Dals",SH RED POHA 500GM,4,75,75,0,1
22-01-2025,"Grains, Flours & Dals",UDALU (Barnyard millet) 1 kg,4,140,115,25,1
22-01-2025,"Grains, Flours & Dals",SAMALU (Little millet) 1 kg,4,170,130,40,1
22-01-2025,"Grains, Flours & Dals",KORRALU (FOXTAIL M) 1KG,4,150,110,40,1
22-01-2025,"Grains, Flours & Dals",Arikadu ( kodo),4,140,130,10,1
22-01-2025,"Dry Fruits, Nuts & Seeds",Groundnuts 500 gms,2,95,85,10,1
22-01-2025,"Grains, Flours & Dals",MAATEJA rice 1 kg,4,72,69,3,1
22-01-2025,"Grains, Flours & Dals",SINGLE POLISH 1KG,4,195,195,0,3
22-01-2025,"Grains, Flours & Dals",SINGLE POLISH 1KG,4,650,650,0,10
22-01-2025,General Household & Kitchenware,MATCH BOX,3,20,20,0,1
22-01-2025,Personal Care & Cosmetics,DABUR RED PASTE 50GM,10,50,50,0,2
22-01-2025,"Grains, Flours & Dals",Green gram 500 gms,4,75,70,5,1
22-01-2025,Spices & Seasonings,Turmeric powder 250 gms,15,100,75,25,1
22-01-2025,"Grains, Flours & Dals",MELMEKER 250GMS,4,60,45,15,1
22-01-2025,"Dry Fruits, Nuts & Seeds",FLAX SEEDS 250GM,2,60,50,10,1
22-01-2025,"Dry Fruits, Nuts & Seeds",PUMPKIN SEEDS 250GM,2,200,160,40,1
22-01-2025,Sweeteners,SD PALM JAGGERY 500GM,16,200,200,0,1
22-01-2025,"Dry Fruits, Nuts & Seeds",SUNFLOWER SEEDS 250GRM,2,150,130,20,1
22-01-2025,"Grains, Flours & Dals",Wheat Flour 1 kg,4,70,60,10,1
22-01-2025,Spices & Seasonings,DURGA SALT CRYSTAL 1KG,15,50,50,0,2
22-01-2025,Spices & Seasonings,PURO Healthy Salt 1KG,15,110,110,0,1
22-01-2025,"Dry Fruits, Nuts & Seeds",PUMPKIN SEEDS 250GM,2,200,160,40,1
22-01-2025,Snacks & Ready-to-Eat,RAJGIRA PEANUT CHIKKI,14,5,5,0,1
22-01-2025,"Grains, Flours & Dals",MELMEKER 250GMS,4,60,45,15,1
22-01-2025,"Dry Fruits, Nuts & Seeds",PULMAKHANA 100 GM,2,180,170,10,1
22-01-2025,"Grains, Flours & Dals",White jowar.F 1 kg,4,100,80,20,1
22-01-2025,"Grains, Flours & Dals",RICE FLOUR 1KG,4,70,55,15,1
22-01-2025,"Grains, Flours & Dals",Red Bobarlu 500 gms,4,95,85,10,1
22-01-2025,"Grains, Flours & Dals",RAGULU 1 KG,4,17.5,15,2.5,0.25
22-01-2025,"Grains, Flours & Dals",Wheat Flour 1 kg,4,140,120,20,2
22-01-2025,Spices & Seasonings,Chilli powder 500 gms,15,290,210,80,1
22-01-2025,Spices & Seasonings,Tamarind 250GMS,15,80,65,15,1
22-01-2025,Spices & Seasonings,RED COPRA 250GMS,15,85,74,11,1
22-01-2025,"Grains, Flours & Dals",SL Idly Rava 1KG,4,65,55,10,1
22-01-2025,Oils & Ghee,Groundnut oil 1 L,9,360,330,30,1
22-01-2025,"Grains, Flours & Dals",HS jowar idly rava 500 gms,4,65,65,0,1
22-01-2025,"Grains, Flours & Dals",Green gram 500 gms,4,75,70,5,1
22-01-2025,"Grains, Flours & Dals",Wheat Flour 1 kg,4,210,180,30,3
22-01-2025,Oils & Ghee,GROUNDNUT OIL 1KG,9,1170,"1,050.00",120,3
22-01-2025,Snacks & Ready-to-Eat,BATANA NGT 70GMS,14,20,20,0,1
22-01-2025,"Grains, Flours & Dals",DESI CHANA,4,25,25,0,1
22-01-2025,"Grains, Flours & Dals",White jowar.F 1 kg,4,100,80,20,1
22-01-2025,"Grains, Flours & Dals",Arikalu (kodo),4,70,65,5,1
22-01-2025,"Grains, Flours & Dals",Quinova 500 gms,4,110,100,10,1
22-01-2025,"Grains, Flours & Dals",KORRALU (FOXTAIL M) 500GM,4,65,55,10,1
22-01-2025,"Grains, Flours & Dals",SAMALU (Little millet) 500 gms,4,170,130,40,2
22-01-2025,"Grains, Flours & Dals",UDALU (Barnyard millet) 1 kg,4,140,115,25,1
22-01-2025,"Grains, Flours & Dals",RAJMA 250GM,4,55,45,10,1
22-01-2025,Pooja & Spiritual Items,BALAJI KASTURI DHOOP STICKS,12,70,70,0,1
22-01-2025,Oils & Ghee,Groundnut oil 1 L,9,360,330,30,1
22-01-2025,Snacks & Ready-to-Eat,SATHVI PALLI CHIKKI 200GM,14,100,80,20,1
22-01-2025,"Grains, Flours & Dals",JOWAR YELLOW 1 K,4,50,45,5,0.5
22-01-2025,"Dry Fruits, Nuts & Seeds",Groundnuts 1 kg,2,190,170,20,1
22-01-2025,"Grains, Flours & Dals",Red Chana 250GM,4,35,30,5,1
22-01-2025,Spices & Seasonings,Black Till 250GM,15,90,75,15,1
22-01-2025,Personal Care & Cosmetics,MARGO,10,225,180,45,1
22-01-2025,"Grains, Flours & Dals",Green Batani 500GM,4,110,90,20,1
22-01-2025,Spices & Seasonings,KALONJI SEEDS,15,90,80,10,1
22-01-2025,"Dry Fruits, Nuts & Seeds",SALTED PISTA 250GM,2,400,350,50,1
22-01-2025,Snacks & Ready-to-Eat,PALLI LADDU 200GMS,14,90,70,20,1
22-01-2025,Oils & Ghee,Coconut oil 500 ml,9,220,200,20,1
22-01-2025,Snacks & Ready-to-Eat,PUMPKIN CHIKKI 200GM,14,140,120,20,1
22-01-2025,Spices & Seasonings,Jeera 100GM,15,50,45,5,1
22-01-2025,"Grains, Flours & Dals",SA YELLOW JOWAR RAVA 500GM,4,95,95,0,1
22-01-2025,"Grains, Flours & Dals",Brown RICE 1KG,4,140,130,10,2
22-01-2025,Oils & Ghee,Freedom Rice Bran Oil 1L,9,194,180,14,1
21-01-2025,Spices & Seasonings,Chilli powder 500 gms,15,290,210,80,1
21-01-2025,Spices & Seasonings,Chilli powder 250 gms,15,145,105,40,1
21-01-2025,Snacks & Ready-to-Eat,BROWN BREAD ZERO MAIDA 400GM,14,60,60,0,1
21-01-2025,"Grains, Flours & Dals",VGR rice 1 kg,4,140,130,10,2
21-01-2025,"Dry Fruits, Nuts & Seeds",PULMAKHANA 100 GM,2,180,170,10,1
21-01-2025,"Grains, Flours & Dals",Brown RICE 1KG,4,70,65,5,1
21-01-2025,Oils & Ghee,Safflower oil 1 L,9,440,400,40,1
21-01-2025,Snacks & Ready-to-Eat,SATHVI REGIVADA 200GM,14,80,60,20,1
21-01-2025,Oils & Ghee,Sesame oil 1 L,9,590,560,30,1
21-01-2025,Snacks & Ready-to-Eat,RINGS 200GM,14,30,30,0,1
21-01-2025,Spices & Seasonings,Chilli powder 250 gms,15,145,105,40,1
21-01-2025,Snacks & Ready-to-Eat,VD Pappu Chekkalu 190gm,14,60,60,0,1
21-01-2025,Personal Care & Cosmetics,HERBAL BATH POWDER 200GM,10,80,80,0,1
21-01-2025,Snacks & Ready-to-Eat,VD NUVULU CHEGODI 175GM,14,60,60,0,1
21-01-2025,Spices & Seasonings,SD IDLY KARAM,15,65,65,0,1
21-01-2025,Spices & Seasonings,GROUNDNUT KARAM POWDER,15,65,65,0,1
21-01-2025,Snacks & Ready-to-Eat,SD Moringa with plam jaggery 250gm,14,135,135,0,1
21-01-2025,Spices & Seasonings,SD Redgram Karam Powder 100GM,15,65,65,0,1
21-01-2025,Snacks & Ready-to-Eat,SS IDLY BATTER 1KG,14,60,60,0,1
21-01-2025,Oils & Ghee,Safflower oil 1 L,9,440,400,40,1
21-01-2025,"Grains, Flours & Dals",SRILATHA RICE RAVVA 500GM,4,35,35,0,1
21-01-2025,Spices & Seasonings,Telaga Pindi 250 GM,15,40,35,5,1
21-01-2025,"Grains, Flours & Dals",POORI ATTA 1KG,4,75,75,0,1
21-01-2025,"Grains, Flours & Dals",White jowar.F 1 kg,4,100,80,20,1
21-01-2025,"Grains, Flours & Dals",VGR rice 1 kg,4,805,747.5,57.5,11.5
21-01-2025,"Health, Wellness & Ayurvedic Products",DWI LAVANGA TAILA 20ML,5,60,60,0,1
21-01-2025,"Grains, Flours & Dals",Chana Flour 500 gms,4,140,130,10,2
21-01-2025,"Grains, Flours & Dals",Wheat Flour 1 kg,4,140,120,20,2
21-01-2025,"Grains, Flours & Dals",Multigrain 1 kg,4,300,255,45,3
21-01-2025,Oils & Ghee,Safflower oil 1 L,9,440,400,40,1
21-01-2025,Snacks & Ready-to-Eat,RAJGIRA PEANUT CHIKKI,14,5,5,0,1
21-01-2025,Spices & Seasonings,Turmeric powder 250 gms,15,100,75,25,1
21-01-2025,"Grains, Flours & Dals",SINGLE POLISH 1KG,4,260,260,0,4
21-01-2025,"Grains, Flours & Dals",Yellow jowar .F1 kg,4,110,100,10,1
21-01-2025,"Dry Fruits, Nuts & Seeds",SATHVI CHIA SEEDS 100GM,2,100,80,20,1
21-01-2025,Sweeteners,NATURAL HONEY 250GM,16,150,130,20,1
21-01-2025,Personal Care & Cosmetics,MESWAK 100GM,10,70,70,0,1
21-01-2025,Sweeteners,YB FOREST HONEY 250GM,16,180,180,0,1
21-01-2025,Sweeteners,YB FOREST HONEY 250GM,16,180,180,0,1
21-01-2025,Spices & Seasonings,Turmeric powder 250 gms,15,100,75,25,1
21-01-2025,Oils & Ghee,Groundnut oil 1 L,9,720,660,60,2
21-01-2025,Snacks & Ready-to-Eat,SESAME CHIKKI,14,120,100,20,1
21-01-2025,Snacks & Ready-to-Eat,PALLI LADDU 200GMS,14,180,140,40,2
21-01-2025,Snacks & Ready-to-Eat,PUMPKIN CHIKKI 200GM,14,140,120,20,1
21-01-2025,"Grains, Flours & Dals",CHANA DAL 500GM,4,70,60,10,1
21-01-2025,Snacks & Ready-to-Eat,SS IDLY BATTER 1KG,14,60,60,0,1
21-01-2025,"Grains, Flours & Dals",turdal 500 gms,4,110,100,10,1
21-01-2025,"Dry Fruits, Nuts & Seeds",WALLNUTS 250GM,2,320,290,30,1
21-01-2025,"Grains, Flours & Dals",CHANA DAL 500GM,4,70,60,10,1
21-01-2025,"Grains, Flours & Dals",White jowar.F 1 kg,4,300,240,60,3
21-01-2025,Oils & Ghee,Safflower oil 1 L,9,440,400,40,1
21-01-2025,Personal Care & Cosmetics,DABUR RED PASTE 50GM,10,25,25,0,1
21-01-2025,"Grains, Flours & Dals",RAGI FLOUR 500GRMS,4,40,35,5,1
21-01-2025,"Grains, Flours & Dals",Brown RICE 1KG,4,140,130,10,2
21-01-2025,Snacks & Ready-to-Eat,PUMPKIN CHIKKI 200GM,14,140,120,20,1
21-01-2025,"Grains, Flours & Dals",RAGI FLOUR 1KG,4,80,70,10,1
21-01-2025,Snacks & Ready-to-Eat,SATHVI REGIVADA 200GM,14,320,240,80,4
21-01-2025,"Dry Fruits, Nuts & Seeds",GF KIMIA DATES 500GM,2,310,190,120,1
21-01-2025,Oils & Ghee,Sesame oil 500ml,9,295,280,15,1
21-01-2025,"Grains, Flours & Dals",SINGLE POLISH 1KG,4,130,130,0,2
21-01-2025,Snacks & Ready-to-Eat,SD FINGER Millet with palm Jaggery 250gm,14,135,135,0,1
21-01-2025,"Grains, Flours & Dals",Wheat Flour 1 kg,4,70,60,10,1
21-01-2025,"Grains, Flours & Dals",White jowar.F 1 kg,4,100,80,20,1
21-01-2025,"Grains, Flours & Dals",FLOUR CHARGE,4,48,48,0,4
21-01-2025,"Grains, Flours & Dals",WHEAT 1 KG,4,150,125,25,2.5
21-01-2025,Oils & Ghee,Groundnut oil 1 L,9,360,330,30,1
21-01-2025,"Grains, Flours & Dals",SINGLE POLISH 1KG,4,97.5,97.5,0,1.5
21-01-2025,"Grains, Flours & Dals",Yellow jowar.F 500 gms,4,55,50,5,1
21-01-2025,"Dry Fruits, Nuts & Seeds",BLACK KISMIS 250GM,2,175,140,35,1
21-01-2025,"Grains, Flours & Dals",Wheat Rava M 500GM,4,33,30,3,1
21-01-2025,"Grains, Flours & Dals",SL Idly Rava 1KG,4,65,55,10,1
21-01-2025,"Grains, Flours & Dals",SINGLE POLISH 1KG,4,325,325,0,5
21-01-2025,Sweeteners,YB Brown Sugar 1KG,16,140,140,0,1
21-01-2025,"Grains, Flours & Dals",THICK POHA 1KG,4,80,70,10,1
21-01-2025,"Grains, Flours & Dals",SH TUR DAL 500GM,4,165,165,0,1
21-01-2025,"Dry Fruits, Nuts & Seeds",Putnalu 250GM,2,45,38,7,1
21-01-2025,"Grains, Flours & Dals",Red Chana 250GM,4,35,30,5,1
21-01-2025,"Dry Fruits, Nuts & Seeds",DRYDATES YELLOW 250GM,2,135,120,15,1
21-01-2025,"Dry Fruits, Nuts & Seeds",PUMPKIN SEEDS 250GM,2,200,160,40,1
21-01-2025,Snacks & Ready-to-Eat,BATANA NGT 70GMS,14,20,20,0,1
21-01-2025,Household & Cleaning,VIM EXTRA 110GM,6,10,10,0,1
21-01-2025,Oils & Ghee,Mustard oil 500 ml,9,220,195,25,1
21-01-2025,"Grains, Flours & Dals",Wheat Flour 1 kg,4,210,180,30,3
21-01-2025,Snacks & Ready-to-Eat,SESAME LADDU 200GM,14,100,80,20,1
21-01-2025,Snacks & Ready-to-Eat,PALLI LADDU 200GMS,14,90,70,20,1
21-01-2025,Spices & Seasonings,Elaichi 25GM,15,145,120,25,1
21-01-2025,Oils & Ghee,Sesame oil 1 L,9,590,560,30,1
21-01-2025,Snacks & Ready-to-Eat,BATANA NGT 70GMS,14,40,40,0,2
21-01-2025,Oils & Ghee,Groundnut oil 1 L,9,360,330,30,1
21-01-2025,"Grains, Flours & Dals",SINGLE POLISH 1KG,4,130,130,0,2
21-01-2025,"Grains, Flours & Dals",SA Multi Grain Mix 500GM,4,159,159,0,1
21-01-2025,"Grains, Flours & Dals",SINGLE POLISH 1KG,4,325,325,0,5
21-01-2025,"Grains, Flours & Dals",SINGHAM 26KG BAG,4,1650,"1,650.00",0,1
21-01-2025,"Grains, Flours & Dals",CHANA DAL 500GM,4,70,60,10,1
21-01-2025,"Grains, Flours & Dals",Green gram 500 gms,4,75,70,5,1
21-01-2025,"Grains, Flours & Dals",PESARA PAPPU 500GMS,4,85,75,10,1
21-01-2025,"Dry Fruits, Nuts & Seeds",Putnalu 250GM,2,45,38,7,1
21-01-2025,Spices & Seasonings,Chilli powder 500 gms,15,290,210,80,1
21-01-2025,"Grains, Flours & Dals",FLOUR CHARGE,4,75,75,0,1
21-01-2025,"Dry Fruits, Nuts & Seeds",FLAX SEEDS 250GM,2,60,50,10,1
21-01-2025,Oils & Ghee,Groundnut oil 1 L,9,720,660,60,2
21-01-2025,Spices & Seasonings,DRY MIECHI 200GM,15,80,60,20,1
21-01-2025,Pooja & Spiritual Items,GD Dhoop Sticks 26GM,12,40,40,0,2
21-01-2025,Pooja & Spiritual Items,GD Dhoop Sticks 26GM,12,40,40,0,2
21-01-2025,"Grains, Flours & Dals",SRILATHA RICE RAVVA 500GM,4,70,70,0,2
21-01-2025,Snacks & Ready-to-Eat,JUNNU POWDER 100GM,14,70,70,0,1
21-01-2025,"Grains, Flours & Dals",SB Javva Wheat Ravva 500GM,4,190,190,0,2
21-01-2025,Snacks & Ready-to-Eat,BATANA NGT 70GMS,14,20,20,0,1
21-01-2025,Oils & Ghee,Groundnut oil 1 L,9,720,660,60,2
21-01-2025,"Grains, Flours & Dals",DESI CHANA,4,25,25,0,1
21-01-2025,Snacks & Ready-to-Eat,NGT CHATPATTA CHANA 90GM,14,25,25,0,1
21-01-2025,Oils & Ghee,Safflower oil 1 L,9,440,400,40,1
21-01-2025,"Health, Wellness & Ayurvedic Products",RB Max Protein Chinese Manchurian,5,45,45,0,1
21-01-2025,"Grains, Flours & Dals",EM Ragi idli R 500G,4,75,75,0,1
21-01-2025,Snacks & Ready-to-Eat,NGT CHATPATTA CHANA 90GM,14,20,20,0,1
21-01-2025,"Grains, Flours & Dals",DESI CHANA,4,25,25,0,1
21-01-2025,Snacks & Ready-to-Eat,SATHVI MIXED CHIKKI 200GM,14,120,100,20,1
21-01-2025,Snacks & Ready-to-Eat,PN ORGANIC PUFFED RICE 200GM,14,55,55,0,1
21-01-2025,General Household & Kitchenware,ODONIL AIR FRESHENER MYSTIC,3,160,160,0,2
21-01-2025,Sweeteners,MISHRI 250 GM,16,35,30,5,1
21-01-2025,Personal Care & Cosmetics,SEV TULASI SOAP 100GM,10,90,90,0,1
21-01-2025,"Dry Fruits, Nuts & Seeds",YELLOW KISHMISH 250GM,2,130,110,20,1
21-01-2025,Sweeteners,KAMAL JAGGERY 500GM,16,40,40,0,1
21-01-2025,"Grains, Flours & Dals",SINGLE POLISH 1KG,4,650,650,0,10
21-01-2025,"Dry Fruits, Nuts & Seeds",ALMONDS 250GM,2,280,260,20,1
21-01-2025,"Grains, Flours & Dals",SRILATHA RICE RAVVA 500GM,4,70,70,0,2
21-01-2025,"Dry Fruits, Nuts & Seeds",SALTED PISTA 250GM,2,400,350,50,1
21-01-2025,"Grains, Flours & Dals",Bombay Rava 500GM,4,35,30,5,1
21-01-2025,"Grains, Flours & Dals",Wheat Rava M 1KG,4,65,55,10,1
21-01-2025,Beverages,BRU GREEN LABEL 1.2G,1,8,8,0,4
21-01-2025,Milk & Dairy,SANGAM TONED MILK 500ML,7,60,60,0,2
21-01-2025,"Dry Fruits, Nuts & Seeds",Groundnuts 1 kg,2,190,170,20,1
21-01-2025,Spices & Seasonings,ROYAL SAFFRON,15,125,125,0,1
21-01-2025,Spices & Seasonings,NUVVULU 250GM,15,160,130,30,2
21-01-2025,"Grains, Flours & Dals",Multigrain 1 kg,4,100,85,15,1
21-01-2025,"Grains, Flours & Dals",MAAGAANI SP RICE 20 KGS,4,2300,"1,960.00",340,1
21-01-2025,"Grains, Flours & Dals",BASMATHI RICE 1KG,4,150,135,15,1
21-01-2025,Snacks & Ready-to-Eat,SALTED PHALLI,14,130,130,0,2
21-01-2025,Snacks & Ready-to-Eat,SD JOWAR WITH PALM JAGGERY 250GM,14,270,270,0,2
21-01-2025,Snacks & Ready-to-Eat,VD RICE SAGO PAPAD 150GM,14,55,55,0,1
21-01-2025,Milk & Dairy,ID PANEER,7,135,135,0,1
21-01-2025,"Grains, Flours & Dals",MAATEJA rice 1 kg,4,216,207,9,3
21-01-2025,"Grains, Flours & Dals",RAGI FLOUR 1KG,4,80,70,10,1
21-01-2025,Oils & Ghee,DB CASTOR OIL 100ML,9,130,130,0,1
21-01-2025,"Dry Fruits, Nuts & Seeds",FLAX SEEDS 250GM,2,120,100,20,2
21-01-2025,"Dry Fruits, Nuts & Seeds",ALMONDS 250GM,2,280,260,20,1
21-01-2025,Spices & Seasonings,Menthulu 500 gms,15,100,90,10,1
21-01-2025,Spices & Seasonings,Vamu 100GM,15,120,100,20,2
21-01-2025,"Grains, Flours & Dals",Wheat Flour 1 kg,4,70,60,10,1
21-01-2025,Spices & Seasonings,TATA SALT 1KG,15,30,30,0,1
21-01-2025,"Grains, Flours & Dals",JOWAR WHITE 1 KG,4,80,70,10,1
21-01-2025,"Grains, Flours & Dals",split black gram 1 kg,4,180,170,10,1
21-01-2025,"Grains, Flours & Dals",Green gram 1 kg,4,300,260,40,2
21-01-2025,"Dry Fruits, Nuts & Seeds",PULMAKHANA 100 GM,2,180,170,10,1
21-01-2025,Spices & Seasonings,JEERA 250 gms,15,125,105,20,1
21-01-2025,"Grains, Flours & Dals",Red Chana 500 GM,4,75,60,15,1
21-01-2025,Milk & Dairy,SANGAM TONED MILK 500ML,7,60,60,0,2
21-01-2025,Spices & Seasonings,DRY MIECHI 200GM,15,160,120,40,2
21-01-2025,"Grains, Flours & Dals",White jowar.F 1 kg,4,100,80,20,1
21-01-2025,"Grains, Flours & Dals",turdal 1kg,4,440,390,50,2
21-01-2025,"Grains, Flours & Dals",Wheat Rava M 1KG,4,130,110,20,2
21-01-2025,Pooja & Spiritual Items,SIVA JOOTHI 365 DEEPAPU,12,50,50,0,2
21-01-2025,Pooja & Spiritual Items,VRP APOORVA JAVADHU POW,12,35,35,0,1
21-01-2025,Spices & Seasonings,Tamarind 250GMS,15,80,65,15,1
21-01-2025,"Grains, Flours & Dals",Wheat Flour 1 kg,4,70,60,10,1
21-01-2025,"Grains, Flours & Dals",DH URAD GOTA 1KG,4,430,380,50,2
21-01-2025,"Grains, Flours & Dals",AISHWARYA SP 1KG,4,80,75,5,1
21-01-2025,"Grains, Flours & Dals",AISHWARYA SP 1KG,4,160,150,10,2
21-01-2025,"Grains, Flours & Dals",VYS.SP RICE 1 KG,4,280,260,20,4
21-01-2025,Oils & Ghee,Coconut oil 500 ml,9,220,200,20,1
21-01-2025,Sweeteners,ACHUBELLAM 500GM,16,50,40,10,1
21-01-2025,"Grains, Flours & Dals",RAGI FLOUR 1KG,4,80,70,10,1
21-01-2025,Snacks & Ready-to-Eat,JUNNU POWDER 100GM,14,70,70,0,1
21-01-2025,Oils & Ghee,GROUNDNUT OIL 1KG,9,1050,"1,050.00",0,3
21-01-2025,Oils & Ghee,GROUNDNUT OIL 1KG,9,1750,"1,750.00",0,5
21-01-2025,Oils & Ghee,Groundnut oil 1 L,9,360,330,30,1
21-01-2025,"Grains, Flours & Dals",HS Multimillet idly R 500 gms,4,130,130,0,2
21-01-2025,Household & Cleaning,TIDE DOUBLE POWER JASMINE &amp;ROSE,6,66,66,0,1
21-01-2025,"Grains, Flours & Dals",SL Suji Rava 500GM,4,32,32,0,1
21-01-2025,Snacks & Ready-to-Eat,VD Minapa papad 200gm,14,60,60,0,1
21-01-2025,"Grains, Flours & Dals",Yellow jowar .F1 kg,4,110,100,10,1
21-01-2025,"Grains, Flours & Dals",Sathya Javva Wheat Rava 500GM,4,95,95,0,1
21-01-2025,Snacks & Ready-to-Eat,RI SPORTS BAR 40G,14,45,45,0,1
21-01-2025,"Grains, Flours & Dals",Wheat Flour 1 kg,4,70,60,10,1
21-01-2025,Oils & Ghee,Safflower oil 1 L,9,440,400,40,1
21-01-2025,"Grains, Flours & Dals",HS jowar idly rava 500 gms,4,65,65,0,1
21-01-2025,"Grains, Flours & Dals",Multigrain 1 kg,4,100,85,15,1
21-01-2025,"Grains, Flours & Dals",Em jowar idly R 500G,4,75,75,0,1
21-01-2025,"Grains, Flours & Dals",UDALU (Barnyard millet) 500 gms,4,70,60,10,1
21-01-2025,"Grains, Flours & Dals",KORRALU (FOXTAIL M) 1KG,4,150,110,40,1
21-01-2025,Personal Care & Cosmetics,HERBAL BATH POWDER 200GM,10,80,80,0,1
21-01-2025,"Grains, Flours & Dals",UDALU (Barnyard millet) 1 kg,4,280,230,50,2
21-01-2025,Oils & Ghee,Groundnut oil 1 L,9,720,660,60,2
21-01-2025,Oils & Ghee,Coconut oil 500 ml,9,220,200,20,1
21-01-2025,Snacks & Ready-to-Eat,PALLI LADDU 200GMS,14,90,70,20,1
21-01-2025,Oils & Ghee,Groundnut oil 1 L,9,1080,990,90,3
21-01-2025,"Grains, Flours & Dals",RAGI FLOUR 1KG,4,240,210,30,3
21-01-2025,"Dry Fruits, Nuts & Seeds",Groundnuts 1 kg,2,190,170,20,1
21-01-2025,"Grains, Flours & Dals",Bajra Flour 1 kg,4,140,120,20,2
21-01-2025,Spices & Seasonings,SONTI 50GM,15,30,20,10,1
21-01-2025,Spices & Seasonings,Chilli powder 500 gms,15,290,210,80,1
21-01-2025,Snacks & Ready-to-Eat,VD MINAPA SUNNUNDALU 12P,14,180,180,0,1
21-01-2025,Spices & Seasonings,DB CRYSTAL SALT 1KG,15,25,25,0,1
21-01-2025,"Grains, Flours & Dals",WHEAT 1 KG,4,240,200,40,4
21-01-2025,Spices & Seasonings,AV Iodized Salt 1KG,15,28,25,3,1
21-01-2025,Sweeteners,MADHUR SUGAR 1KG,16,65,55,10,1
21-01-2025,Spices & Seasonings,Tamarind 500GM,15,160,130,30,1
21-01-2025,"Dry Fruits, Nuts & Seeds",Groundnuts 1 kg,2,190,170,20,1
21-01-2025,Spices & Seasonings,Chilli powder 500 gms,15,290,210,80,1
21-01-2025,"Grains, Flours & Dals",SL Idly Rava 1KG,4,65,55,10,1
21-01-2025,Spices & Seasonings,TATA SALT 1KG,15,30,30,0,1
21-01-2025,"Grains, Flours & Dals",THICK POHA 500GM,4,40,35,5,1
21-01-2025,"Grains, Flours & Dals",BOMBAY RAVA,4,70,55,15,1
21-01-2025,Oils & Ghee,Groundnut oil 1 L,9,360,330,30,1
21-01-2025,"Grains, Flours & Dals",Wheat Rava M 1KG,4,65,55,10,1
21-01-2025,"Grains, Flours & Dals",HS Multimillet idly R 500 gms,4,65,65,0,1
21-01-2025,Oils & Ghee,BUFFALLO GHEE 500ML,9,410,370,40,1
21-01-2025,Oils & Ghee,Sesame oil 500ml,9,295,280,15,1
21-01-2025,"Grains, Flours & Dals",Wheat Flour 1 kg,4,210,180,30,3
21-01-2025,Spices & Seasonings,Avalu small 250 gms,15,60,40,20,1
21-01-2025,"Dry Fruits, Nuts & Seeds",Putnalu 250GM,2,45,38,7,1
21-01-2025,"Grains, Flours & Dals",SB Javva Wheat Ravva 500GM,4,95,95,0,1
21-01-2025,Sweeteners,SD PALM JAGGERY 500GM,16,200,200,0,1
21-01-2025,"Grains, Flours & Dals",turdal 500 gms,4,110,100,10,1
21-01-2025,"Grains, Flours & Dals",SL Idly Rava 1KG,4,65,55,10,1
21-01-2025,Sweeteners,Mishri 500GM,16,70,60,10,1
21-01-2025,"Dry Fruits, Nuts & Seeds",Groundnuts 500 gms,2,95,85,10,1
21-01-2025,Oils & Ghee,Sesame oil 500ml,9,295,280,15,1
21-01-2025,Spices & Seasonings,JEERA 250 gms,15,125,105,20,1
21-01-2025,"Grains, Flours & Dals",FLOUR CHARGE,4,12,12,0,1
21-01-2025,"Grains, Flours & Dals",CHANA DAL 500GM,4,70,60,10,1
21-01-2025,"Grains, Flours & Dals",PESARA PAPPU 500GMS,4,85,75,10,1
21-01-2025,"Grains, Flours & Dals",BOMBAY RAVA,4,70,55,15,1
21-01-2025,"Dry Fruits, Nuts & Seeds",SH GROUNDNUT 500GM,2,489,390,99,3
21-01-2025,"Grains, Flours & Dals",SH SONAMASURI BROWN RICE 1KG,4,250,250,0,2
21-01-2025,Spices & Seasonings,SH TAMARIND SEEDLESS 500GM,15,520,520,0,2
21-01-2025,"Grains, Flours & Dals",PN ORGANIC KALA CHANA 500GM,4,119,119,0,1
21-01-2025,Household & Cleaning,LIZOL JAQSMINE 500ML,6,232,232,0,2
21-01-2025,"Grains, Flours & Dals",THIN POHA 500GM,4,80,70,10,2
21-01-2025,Spices & Seasonings,Miriyalu 50GM,15,200,160,40,2
21-01-2025,Spices & Seasonings,Coriander seeds 200 gms,15,48,40,8,1
21-01-2025,"Grains, Flours & Dals",SH WHITE POHA 500GM,4,75,75,0,1
21-01-2025,Spices & Seasonings,DRY MIECHI 200GM,15,80,60,20,1
21-01-2025,Personal Care & Cosmetics,DETTOL 50ML,10,154,154,0,1
21-01-2025,"Dry Fruits, Nuts & Seeds",CASHEW 250GM,2,340,310,30,1
21-01-2025,Personal Care & Cosmetics,COW DURBAR 7 HERBS SHAMPOO,10,250,250,0,2
21-01-2025,Oils & Ghee,Groundnut oil 1 L,9,360,330,30,1
21-01-2025,Sweeteners,YB Brown Sugar 1KG,16,140,140,0,1
21-01-2025,Personal Care & Cosmetics,SANTOOR,10,100,100,0,1
21-01-2025,"Grains, Flours & Dals",White jowar.F 1 kg,4,100,80,20,1
21-01-2025,"Dry Fruits, Nuts & Seeds",FLAX SEEDS 1KG,2,480,360,120,2
21-01-2025,"Grains, Flours & Dals",Wheat Flour 1 kg,4,140,120,20,2
21-01-2025,Oils & Ghee,Coconut oil 500 ml,9,220,200,20,1
21-01-2025,Personal Care & Cosmetics,HERBAL BATH POWDER 200GM,10,80,80,0,1
21-01-2025,Oils & Ghee,Groundnut oil 500ml,9,180,165,15,1
21-01-2025,Snacks & Ready-to-Eat,VD MURUKU 175GM,14,60,60,0,1
21-01-2025,Snacks & Ready-to-Eat,VD VAMUPUSA 175GM,14,60,60,0,1
21-01-2025,Oils & Ghee,GANTASALA A2 COW GHEE 500ML,9,550,550,0,1
21-01-2025,Oils & Ghee,Coconut oil 1 L,9,440,400,40,1
21-01-2025,Oils & Ghee,Sesame oil 1 L,9,1180,"1,120.00",60,2
21-01-2025,"Dry Fruits, Nuts & Seeds",FLAX SEEDS 1KG,2,120,100,20,0.5
21-01-2025,Oils & Ghee,Groundnut oil 1 L,9,720,660,60,2
21-01-2025,Oils & Ghee,Groundnut oil 1 L,9,360,330,30,1
21-01-2025,"Grains, Flours & Dals",Wheat Flour 1 kg,4,70,60,10,1
21-01-2025,"Grains, Flours & Dals",Yellow jowar .F1 kg,4,110,100,10,1
21-01-2025,"Grains, Flours & Dals",VGR rice 1 kg,4,350,325,25,5
21-01-2025,Snacks & Ready-to-Eat,SD VAMU APPADALU 200GM,14,80,80,0,1
21-01-2025,Snacks & Ready-to-Eat,VD RED CHILLI RICEPAPAD 150GM,14,50,50,0,1
21-01-2025,"Dry Fruits, Nuts & Seeds",PUMPKIN SEEDS 250GM,2,200,160,40,1
21-01-2025,Personal Care & Cosmetics,JOHNOSONS BABY OIL 50ML,10,70,70,0,1
21-01-2025,Snacks & Ready-to-Eat,SUNNUNDALU,14,100,100,0,1
21-01-2025,"Dry Fruits, Nuts & Seeds",Groundnuts 1 kg,2,190,170,20,1
21-01-2025,Spices & Seasonings,LG 50GM,15,92,92,0,1
21-01-2025,Oils & Ghee,Safflower oil 1 L,9,440,400,40,1
21-01-2025,Oils & Ghee,Coconut oil 500 ml,9,220,200,20,1
21-01-2025,"Grains, Flours & Dals",SRILATHA RICE RAVVA 500GM,4,35,35,0,1
21-01-2025,"Grains, Flours & Dals",SL Idly Rava 1KG,4,65,55,10,1
21-01-2025,Oils & Ghee,Groundnut oil 500ml,9,180,165,15,1
21-01-2025,"Grains, Flours & Dals",Sathya Javva Wheat Rava 500GM,4,95,95,0,1
21-01-2025,"Grains, Flours & Dals",AISHWARYA SP 1KG,4,456,427.5,28.5,5.7
21-01-2025,Spices & Seasonings,Coriander seeds 200 gms,15,48,40,8,1
21-01-2025,"Grains, Flours & Dals",Idly Rava L 1KG,4,180,150,30,3
21-01-2025,"Grains, Flours & Dals",SINGLE POLISH 1KG,4,65,65,0,1
21-01-2025,"Grains, Flours & Dals",CHANA DAL 1KG,4,140,120,20,1
21-01-2025,"Grains, Flours & Dals",BOMBAY RAVA,4,70,55,15,1
21-01-2025,Personal Care & Cosmetics,MULTANI MITTI CHOORNAM,10,40,40,0,1
21-01-2025,Oils & Ghee,Coconut oil 500 ml,9,220,200,20,1
21-01-2025,"Health, Wellness & Ayurvedic Products",SAI DURGA MORINGA LEAVES 100GM,5,75,75,0,1
21-01-2025,"Health, Wellness & Ayurvedic Products",MD Fenugreek Choornam 100GM,5,80,80,0,1
21-01-2025,"Dry Fruits, Nuts & Seeds",SD Mango cubes 200gm,2,180,180,0,2
21-01-2025,Oils & Ghee,Groundnut oil 1 L,9,360,330,30,1
21-01-2025,"Grains, Flours & Dals",Wheat Rava M 1KG,4,65,55,10,1
21-01-2025,"Grains, Flours & Dals",RICE FLOUR 1KG,4,70,55,15,1
21-01-2025,Snacks & Ready-to-Eat,BB ROASTED VERMICELLY 500GM,14,70,70,0,1
21-01-2025,"Grains, Flours & Dals",Bombay Rava 500GM,4,70,60,10,2
21-01-2025,Spices & Seasonings,NUVVULU 250GM,15,80,65,15,1
21-01-2025,Spices & Seasonings,Tamarind 250GMS,15,80,65,15,1
21-01-2025,"Grains, Flours & Dals",Wheat Flour 1 kg,4,140,120,20,2
21-01-2025,"Grains, Flours & Dals",SRILALITHA MAIDA FLOUR 500G,4,32,32,0,1
21-01-2025,"Grains, Flours & Dals",White jowar.F 1 kg,4,200,160,40,2
21-01-2025,Oils & Ghee,Groundnut oil 5 L,9,1800,"1,600.00",200,1
21-01-2025,Sweeteners,YB Brown Sugar 1KG,16,140,140,0,1
21-01-2025,"Grains, Flours & Dals",HS Multimillet idly R 500 gms,4,65,65,0,1
21-01-2025,"Grains, Flours & Dals",SPLIT BLACK GRAM 500 GM,4,90,85,5,1
21-01-2025,"Grains, Flours & Dals",split green gram 500 gms,4,75,70,5,1
21-01-2025,Spices & Seasonings,ROYAL SAFFRON 400GRMS,15,130,130,0,2
21-01-2025,"Grains, Flours & Dals",HS jowar idly rava 500 gms,4,65,65,0,1
21-01-2025,Pooja & Spiritual Items,SS DASANGAM CONE 20PICS,12,45,45,0,1
21-01-2025,Spices & Seasonings,ER GARAM MASALA,15,20,20,0,4
21-01-2025,"Grains, Flours & Dals",Em jowar idly R 500G,4,150,150,0,2
21-01-2025,Spices & Seasonings,NUVVULU 250GM,15,80,65,15,1
21-01-2025,Spices & Seasonings,SREE MARUTHI IDLY KARAM 200GM,15,60,60,0,1
21-01-2025,"Grains, Flours & Dals",RAGI FLOUR 500GRMS,4,40,35,5,1
21-01-2025,Spices & Seasonings,SATHVI BIRYANI LEAF 25GM,15,30,20,10,1
21-01-2025,"Grains, Flours & Dals",SL Idly Rava 1KG,4,65,55,10,1
21-01-2025,"Grains, Flours & Dals",KORRALU (FOXTAIL M) 1KG,4,150,110,40,1
21-01-2025,"Grains, Flours & Dals",HS JOWAR FLAKES 250GM 1+1,4,119,59,60,1
21-01-2025,Snacks & Ready-to-Eat,HS Ragi biscuits,14,50,50,0,1
21-01-2025,"Grains, Flours & Dals",SAMALU (Little millet) 1 kg,4,170,130,40,1
21-01-2025,"Grains, Flours & Dals",White jowar.F 1 kg,4,100,80,20,1
21-01-2025,"Grains, Flours & Dals",Red Chana 250GM,4,35,30,5,1
21-01-2025,Snacks & Ready-to-Eat,VD DAHI MIRCHI(SALTED) 100GM,14,45,45,0,1
21-01-2025,Spices & Seasonings,DRY MIECHI 200GM,15,80,60,20,1
21-01-2025,"Grains, Flours & Dals",MELMEKER 250GMS,4,60,45,15,1
21-01-2025,Pooja & Spiritual Items,JVK SAMBRANI STICK 20PCS,12,40,40,0,1
21-01-2025,Personal Care & Cosmetics,MYSORE SANDAL SOAP 75G,10,84,84,0,2
21-01-2025,"Grains, Flours & Dals",Chana Flour 500 gms,4,70,65,5,1
21-01-2025,"Grains, Flours & Dals",white Bobarlu 500 gms,4,80,75,5,1
21-01-2025,Oils & Ghee,Sesame oil 1 L,9,1770,"1,680.00",90,3
21-01-2025,Oils & Ghee,Safflower oil 1 L,9,1320,"1,200.00",120,3
21-01-2025,Snacks & Ready-to-Eat,URBAN MARMURA 450GM,14,60,55,5,1
21-01-2025,"Grains, Flours & Dals",YB Red RICE 1 KG,4,150,120,30,1
21-01-2025,Oils & Ghee,Groundnut oil 1 L,9,1080,990,90,3
21-01-2025,"Grains, Flours & Dals",YB BLACK RICE 500GM,4,300,300,0,2
21-01-2025,Oils & Ghee,Groundnut oil 1 L,9,360,330,30,1
21-01-2025,"Grains, Flours & Dals",Em jowar idly R 500G,4,75,75,0,1
21-01-2025,Spices & Seasonings,SREE MARUTHI IDLY KARAM 200GM,15,60,60,0,1
21-01-2025,"Grains, Flours & Dals",Multigrain 1 kg,4,100,85,15,1
21-01-2025,Snacks & Ready-to-Eat,PALLI LADDU 200GMS,14,90,70,20,1
21-01-2025,"Grains, Flours & Dals",Wheat Flour 1 kg,4,70,60,10,1
21-01-2025,"Dry Fruits, Nuts & Seeds",PUTNALU 500GMS,2,180,152,28,2
21-01-2025,"Grains, Flours & Dals",SL Idly Rava 1KG,4,195,165,30,3
21-01-2025,Oils & Ghee,Groundnut oil 1 L,9,720,660,60,2
21-01-2025,"Grains, Flours & Dals",RICE FLOUR 1KG,4,70,55,15,1
21-01-2025,"Grains, Flours & Dals",RAGI FLOUR 500GRMS,4,40,35,5,1
21-01-2025,"Grains, Flours & Dals",VYS.SP RICE 1 KG,4,84,78,6,1.2
21-01-2025,"Grains, Flours & Dals",ANDU KORRALU (Brown top .mlt) 500,4,160,145,15,1
21-01-2025,"Grains, Flours & Dals",Arikadu ( kodo),4,140,130,10,1
21-01-2025,"Grains, Flours & Dals",UDALU (Barnyard millet) 1 kg,4,140,115,25,1
21-01-2025,"Grains, Flours & Dals",KORRALU (FOXTAIL M) 1KG,4,150,110,40,1
21-01-2025,"Grains, Flours & Dals",SAMALU (Little millet) 1 kg,4,170,130,40,1
21-01-2025,Spices & Seasonings,CHILLI POWDER,15,290,210,80,1
21-01-2025,Personal Care & Cosmetics,VETIVER BATH SCRUB,10,50,50,0,1
21-01-2025,"Grains, Flours & Dals",SA YELLOW JOWAR RAVA 500GM,4,570,570,0,6
21-01-2025,"Grains, Flours & Dals",SA WHITE JOWAR RAVA 500GM,4,138,138,0,2
21-01-2025,"Health, Wellness & Ayurvedic Products",BRAHMI CHOORNAM 100GM,5,100,100,0,1
21-01-2025,"Grains, Flours & Dals",RAGI FLOUR 1KG,4,80,70,10,1
21-01-2025,Oils & Ghee,cow ghee 500 ml,9,430,390,40,1
21-01-2025,Oils & Ghee,Coconut oil 1 L,9,440,400,40,1
21-01-2025,Oils & Ghee,Sesame oil 500ml,9,295,280,15,1
21-01-2025,Snacks & Ready-to-Eat,VD GUMMADI VADIYAM,14,150,150,0,2
21-01-2025,Oils & Ghee,Coconut oil 1 L,9,440,400,40,1
21-01-2025,Oils & Ghee,Groundnut oil 1 L,9,360,330,30,1
21-01-2025,"Grains, Flours & Dals",Multigrain 1 kg,4,200,170,30,2
21-01-2025,Snacks & Ready-to-Eat,SESAME LADDU 200GM,14,100,80,20,1
21-01-2025,Snacks & Ready-to-Eat,SATHVI MIXED CHIKKI 200GM,14,120,100,20,1
21-01-2025,Milk & Dairy,HERITAGE TONED MILK 500ML,7,62,62,0,2
21-01-2025,Milk & Dairy,SANGAM FULL CREAM MILK 500ML,7,38,38,0,1
21-01-2025,"Grains, Flours & Dals",Wheat Flour 1 kg,4,70,60,10,1
21-01-2025,Oils & Ghee,Groundnut oil 1 L,9,360,330,30,1
21-01-2025,"Grains, Flours & Dals",BARLEY SEEDS 250GMS,4,40,35,5,1
21-01-2025,"Dry Fruits, Nuts & Seeds",YELLOW KISHMISH 250GM,2,130,110,20,1
21-01-2025,"Grains, Flours & Dals",split urad dall 500 gms,4,90,80,10,1
20-01-2025,Personal Care & Cosmetics,MD Henna Choornam 100GM,10,80,80,0,1
20-01-2025,Snacks & Ready-to-Eat,Sprouted Ragi Biscuits 450GM,14,150,150,0,1
20-01-2025,"Grains, Flours & Dals",KORRALU (FOXTAIL M) 1KG,4,225,165,60,1.5
20-01-2025,"Grains, Flours & Dals",White Chana 500GM,4,120,100,20,1
20-01-2025,Sweeteners,YB Brown Sugar 1KG,16,140,140,0,1
20-01-2025,"Grains, Flours & Dals",SB Javva Wheat Ravva 500GM,4,95,95,0,1
20-01-2025,Sweeteners,SD PALM JAGGERY 500GM,16,200,200,0,1
20-01-2025,"Grains, Flours & Dals",SPLIT BLACK GRAM 500 GM,4,90,85,5,1
20-01-2025,"Grains, Flours & Dals",EM Foxtail idli r 500 g,4,109,109,0,1
20-01-2025,"Dry Fruits, Nuts & Seeds",Groundnuts 1 kg,2,190,170,20,1
20-01-2025,Milk & Dairy,BROWN EGGS 1P,7,140,120,20,10
20-01-2025,"Grains, Flours & Dals",RAGI FLOUR 500GRMS,4,40,35,5,1
20-01-2025,"Health, Wellness & Ayurvedic Products",MD Ashwagandha Choornam 100GM,5,170,170,0,1
20-01-2025,Oils & Ghee,Groundnut oil 500ml,9,180,165,15,1
20-01-2025,"Grains, Flours & Dals",Chana Flour 500 gms,4,70,65,5,1
20-01-2025,Sweeteners,SD DrybFruit Honey 500GM,16,550,550,0,1
20-01-2025,"Grains, Flours & Dals",RED TURDAL 500GM,4,75,70,5,1
20-01-2025,"Grains, Flours & Dals",VYS.SP RICE 1 KG,4,210,195,15,3
20-01-2025,Snacks & Ready-to-Eat,VD JAGGERY GHEE 12PIC,14,180,180,0,1
20-01-2025,Milk & Dairy,BROWN EGGS 1P,7,70,60,10,5
20-01-2025,Snacks & Ready-to-Eat,BLACK SESAME CHIKKI,14,10,10,0,1
20-01-2025,Personal Care & Cosmetics,MD Bath Powder 100GM,10,40,40,0,1
20-01-2025,Snacks & Ready-to-Eat,BD RED RICE NOODLES 200G,14,70,70,0,1
20-01-2025,"Grains, Flours & Dals",VGR rice 1 kg,4,70,65,5,1
20-01-2025,Personal Care & Cosmetics,SVE TURMERIC SOAP 100GM,10,90,90,0,1
20-01-2025,"Dry Fruits, Nuts & Seeds",Groundnuts 1 kg,2,190,170,20,1
20-01-2025,"Grains, Flours & Dals",Idly Rava L 1KG,4,60,50,10,1
20-01-2025,Milk & Dairy,BROWN EGGS 1P,7,84,72,12,6
20-01-2025,"Health, Wellness & Ayurvedic Products",MADDI NEEM OIL 100ML,5,100,80,20,1
20-01-2025,Milk & Dairy,BROWN EGGS 1P,7,84,72,12,6
20-01-2025,"Grains, Flours & Dals",DESI CHANA,4,60,60,0,3
20-01-2025,Spices & Seasonings,Menthulu 250 gms,15,50,45,5,1
20-01-2025,"Dry Fruits, Nuts & Seeds",DRYDATES YELLOW 250GM,2,135,120,15,1
20-01-2025,Oils & Ghee,Groundnut oil 5 L,9,1800,"1,600.00",200,1
20-01-2025,Snacks & Ready-to-Eat,BELLAM MINAPA SUNADULLU,14,180,180,0,1
20-01-2025,Pooja & Spiritual Items,SREE REAL KASTURI STICKS 90GM,12,72,72,0,1
20-01-2025,Snacks & Ready-to-Eat,VD PAPPU CHEGODI 200GM,14,60,60,0,1
20-01-2025,Snacks & Ready-to-Eat,VD MURUKU 175GM,14,120,120,0,2
20-01-2025,Oils & Ghee,cow ghee 500 ml,9,430,390,40,1
20-01-2025,Snacks & Ready-to-Eat,VD MYSOREPAK 6PIC,14,100,100,0,1
20-01-2025,Snacks & Ready-to-Eat,VD JAGGERY GHEE 12PIC,14,180,180,0,1
20-01-2025,Snacks & Ready-to-Eat,PALLI LADDU 200GMS,14,90,70,20,1
20-01-2025,Snacks & Ready-to-Eat,VD VAMUPUSA 175GM,14,120,120,0,2
20-01-2025,Oils & Ghee,GANTASALA A2 COW GHEE 500ML,9,550,550,0,1
20-01-2025,Snacks & Ready-to-Eat,SALTED PHALLI,14,130,130,0,2
20-01-2025,Snacks & Ready-to-Eat,VD Pappu Chekkalu 190gm,14,120,120,0,2
20-01-2025,Snacks & Ready-to-Eat,VD BOONDI 175GM,14,120,120,0,2
20-01-2025,Spices & Seasonings,Miriyalu 50GM,15,100,80,20,1
20-01-2025,Spices & Seasonings,DURGA SALT CRYSTAL 1KG,15,100,100,0,4
20-01-2025,Spices & Seasonings,Lavangam 50GM,15,60,50,10,1
20-01-2025,Pooja & Spiritual Items,JAGI KAYA 25GM,12,80,60,20,1
20-01-2025,"Grains, Flours & Dals",Multigrain 1 kg,4,300,255,45,3
20-01-2025,"Grains, Flours & Dals",UDALU (Barnyard millet) 500 gms,4,70,60,10,1
20-01-2025,Spices & Seasonings,YB Rock Salt 1KG,15,120,120,0,1
20-01-2025,"Grains, Flours & Dals",SRILATHA RICE RAVVA 500GM,4,35,35,0,1
20-01-2025,Spices & Seasonings,Telaga Pindi 250 GM,15,40,35,5,1
20-01-2025,"Grains, Flours & Dals",Wheat Flour 1 kg,4,70,60,10,1
20-01-2025,Spices & Seasonings,DURGA SALT CRYSTAL 1KG,15,25,25,0,1
20-01-2025,"Grains, Flours & Dals",PESARA PAPPU 1 KG,4,170,145,25,1
20-01-2025,"Dry Fruits, Nuts & Seeds",Groundnuts 500 gms,2,95,85,10,1
20-01-2025,Personal Care & Cosmetics,MARGO,10,35,35,0,1
20-01-2025,"Grains, Flours & Dals",UDALU (Barnyard millet) 1 kg,4,140,115,25,1
20-01-2025,"Grains, Flours & Dals",turdal 500 gms,4,110,100,10,1
20-01-2025,"Grains, Flours & Dals",turdal 1kg,4,220,195,25,1
20-01-2025,"Grains, Flours & Dals",HS RAGI Idly rava 500 gms,4,70,70,0,1
20-01-2025,"Grains, Flours & Dals",KORRALU WHOLE,4,60,50,10,2
20-01-2025,"Grains, Flours & Dals",SL Idly Rava 1KG,4,130,110,20,2
20-01-2025,Spices & Seasonings,Turmeric powder 250 gms,15,200,150,50,2
20-01-2025,Spices & Seasonings,CHILLI POWDER,15,290,210,80,1
20-01-2025,Oils & Ghee,Groundnut oil 1 L,9,720,660,60,2
20-01-2025,"Grains, Flours & Dals",SINGLE POLISH 1KG,4,325,325,0,5
20-01-2025,Oils & Ghee,Groundnut oil 1 L,9,360,330,30,1
20-01-2025,Personal Care & Cosmetics,DETTOL ORIGINAL LIQUID HAND WASH,10,154.59,154.59,0,1
20-01-2025,Snacks & Ready-to-Eat,DOSA BATTER 1KG,14,60,60,0,1
20-01-2025,Personal Care & Cosmetics,DWIBHASHI GULABA ARKA ROSA WATER,10,60,60,0,1
20-01-2025,Snacks & Ready-to-Eat,URBAN MARMURA 450GM,14,60,55,5,1
20-01-2025,"Grains, Flours & Dals",RAGI FLOUR 1KG,4,80,70,10,1
20-01-2025,"Grains, Flours & Dals",SB Javva Wheat Ravva 500GM,4,380,380,0,4
20-01-2025,Spices & Seasonings,KALONJI SEEDS,15,90,80,10,1
20-01-2025,"Grains, Flours & Dals",Wheat Flour 1 kg,4,70,60,10,1
20-01-2025,Oils & Ghee,Sesame oil 1 L,9,1180,"1,120.00",60,2
20-01-2025,"Grains, Flours & Dals",Multigrain 1 kg,4,100,85,15,1
20-01-2025,"Grains, Flours & Dals",UDALU (Barnyard millet) 500 gms,4,70,60,10,1
20-01-2025,"Grains, Flours & Dals",SAMALU (Little millet) 500 gms,4,85,65,20,1
20-01-2025,"Grains, Flours & Dals",ANDU KORRALU (Brown top .mlt) 500,4,160,145,15,1
20-01-2025,"Grains, Flours & Dals",Arikalu (kodo),4,70,65,5,1
20-01-2025,Personal Care & Cosmetics,KAIPO ACT CHARCOAL TP 100G,10,90,90,0,1
20-01-2025,Personal Care & Cosmetics,KHADI ACTIVATED CHARCOAL SOAP,10,160,160,0,2
20-01-2025,"Grains, Flours & Dals",Wheat Flour 1 kg,4,140,120,20,2
20-01-2025,Personal Care & Cosmetics,SVE MULTANI MITTI SOAP 100GM,10,90,90,0,1
20-01-2025,Personal Care & Cosmetics,MD Bath Powder 100GM,10,40,40,0,1
20-01-2025,Sweeteners,YB Brown Sugar 1KG,16,420,420,0,3
20-01-2025,Pickles & Cooking Pastes,GINGER AVAKAYA,11,110,110,0,1
20-01-2025,Pickles & Cooking Pastes,SD RED CHILLI PICKLE,11,110,110,0,1
20-01-2025,Oils & Ghee,cow ghee 500 ml,9,860,780,80,2
20-01-2025,Snacks & Ready-to-Eat,SALTED PHALLI,14,65,65,0,1
20-01-2025,Snacks & Ready-to-Eat,DOSA BATTER 1KG,14,60,60,0,1
20-01-2025,Snacks & Ready-to-Eat,SANDWICH BREAD,14,55,55,0,1
20-01-2025,"Grains, Flours & Dals",Wheat Rava M 1KG,4,65,55,10,1
20-01-2025,Snacks & Ready-to-Eat,JUNNU POWDER 100GM,14,70,70,0,1
20-01-2025,"Grains, Flours & Dals",PRO SABUDHANA 500GM,4,89,89,0,1
20-01-2025,"Grains, Flours & Dals",turdal 1kg,4,220,195,25,1
20-01-2025,"Dry Fruits, Nuts & Seeds",DIANUTS 500GM,2,120,120,0,1
20-01-2025,Spices & Seasonings,DURGA SALT CRYSTAL 1KG,15,50,50,0,2
20-01-2025,Spices & Seasonings,DRY MIECHI 200GM,15,160,120,40,2
20-01-2025,Snacks & Ready-to-Eat,RAGI LADDU,14,120,120,0,1
20-01-2025,Oils & Ghee,cow ghee 500 ml,9,430,390,40,1
20-01-2025,Milk & Dairy,HERITAGE CURD,7,48,48,0,1
20-01-2025,Snacks & Ready-to-Eat,MP CHOCO ALMOND COOKIE,14,60,60,0,1
20-01-2025,Oils & Ghee,Castor oil 200 ml,9,200,160,40,2
20-01-2025,Snacks & Ready-to-Eat,VD Pappu Chekkalu 190gm,14,60,60,0,1
20-01-2025,Snacks & Ready-to-Eat,PALLI LADDU 200GMS,14,90,70,20,1
20-01-2025,Snacks & Ready-to-Eat,SESAME LADDU 200GM,14,100,80,20,1
20-01-2025,"Dry Fruits, Nuts & Seeds",GF DATES 500GM,2,156,149,7,1
20-01-2025,Snacks & Ready-to-Eat,TILLI CHIKKI,14,125,125,0,1
20-01-2025,"Grains, Flours & Dals",RAGI FLOUR 1KG,4,80,70,10,1
20-01-2025,"Grains, Flours & Dals",Multigrain 1 kg,4,100,85,15,1
20-01-2025,Snacks & Ready-to-Eat,RAJGIRA PEANUT CHIKKI 450GM,14,125,125,0,1
20-01-2025,Snacks & Ready-to-Eat,SALTED PHALLI,14,65,65,0,1
20-01-2025,"Grains, Flours & Dals",RAGI FLOUR 500GRMS,4,40,35,5,1
20-01-2025,Oils & Ghee,Groundnut oil 500ml,9,360,330,30,2
20-01-2025,Oils & Ghee,Black Sesame oil 500 ml,9,880,760,120,4
20-01-2025,Snacks & Ready-to-Eat,PEANUT CHILLI,14,15,15,0,3
20-01-2025,Snacks & Ready-to-Eat,RAJGIRA PEANUT CHIKKI,14,10,10,0,2
20-01-2025,Snacks & Ready-to-Eat,SD black sesme laddu with dates 175gm,14,135,135,0,1
20-01-2025,"Health, Wellness & Ayurvedic Products",MADDI MUSCLE OIL PAIN 100ML,5,540,540,0,2
20-01-2025,Snacks & Ready-to-Eat,SD FINGER Millet with palm Jaggery 250gm,14,135,135,0,1
20-01-2025,Snacks & Ready-to-Eat,SD Aswagandha with palm Jaggery250Gm,14,135,135,0,1
20-01-2025,Spices & Seasonings,DRY MIECHI 200GM,15,80,60,20,1
20-01-2025,"Dry Fruits, Nuts & Seeds",SUNFLOWER SEEDS 250GRM,2,150,130,20,1
20-01-2025,Oils & Ghee,Safflower oil 1 L,9,440,400,40,1
20-01-2025,"Health, Wellness & Ayurvedic Products",ORGANIC MORINGA POWER 100GM,5,249,249,0,1
20-01-2025,Oils & Ghee,Groundnut oil 1 L,9,720,660,60,2
20-01-2025,Milk & Dairy,BROWN EGGS 1P,7,168,144,24,12
20-01-2025,"Grains, Flours & Dals",Wheat Flour 1 kg,4,210,180,30,3
20-01-2025,Snacks & Ready-to-Eat,VD MURUKU 175GM,14,120,120,0,2
20-01-2025,"Grains, Flours & Dals",Red Bobarlu 500 gms,4,95,85,10,1
20-01-2025,"Grains, Flours & Dals",Multigrain 1 kg,4,100,85,15,1
20-01-2025,Personal Care & Cosmetics,NEEM COMB,10,150,150,0,1
20-01-2025,Household & Cleaning,VIM EXTRA 110GM,6,60,60,0,6
20-01-2025,Snacks & Ready-to-Eat,BATANA NGT 70GMS,14,20,20,0,1
20-01-2025,"Grains, Flours & Dals",DESI CHANA,4,25,25,0,1
20-01-2025,"Grains, Flours & Dals",White jowar.F 1 kg,4,100,80,20,1
20-01-2025,"Grains, Flours & Dals",white Bobarlu 500 gms,4,80,75,5,1
20-01-2025,Oils & Ghee,DWI SESAME OIL 100ML,9,100,100,0,1
20-01-2025,"Grains, Flours & Dals",Yellow jowar.F 500 gms,4,55,50,5,1
20-01-2025,"Grains, Flours & Dals",FLOUR CHARGE,4,48,48,0,4
20-01-2025,"Grains, Flours & Dals",Sathya Javva Wheat Rava 500GM,4,95,95,0,1
20-01-2025,Spices & Seasonings,ROYAL SAFFRON 400GRMS,15,65,65,0,1
20-01-2025,"Grains, Flours & Dals",Wheat Flour 5 kgs,4,350,300,50,1
20-01-2025,"Grains, Flours & Dals",MELMEKER 250GMS,4,60,45,15,1
20-01-2025,"Grains, Flours & Dals",SRILALITHA MAIDA FLOUR 500G,4,32,32,0,1
20-01-2025,"Grains, Flours & Dals",Bombay Rava 500GM,4,35,30,5,1
20-01-2025,"Grains, Flours & Dals",Wheat Flour 1 kg,4,140,120,20,2
20-01-2025,Snacks & Ready-to-Eat,SATHVI PALLI CHIKKI 200GM,14,200,160,40,2
20-01-2025,Snacks & Ready-to-Eat,ELITE MILK RUSK 200GM,14,35,35,0,1
20-01-2025,"Grains, Flours & Dals",VYS.SP RICE 1 KG,4,140,130,10,2
20-01-2025,Oils & Ghee,Coconut oil 500 ml,9,220,200,20,1
20-01-2025,Snacks & Ready-to-Eat,JUNNU POWDER 100GM,14,70,70,0,1
20-01-2025,"Grains, Flours & Dals",PESARA PAPPU 500GMS,4,85,75,10,1
20-01-2025,"Grains, Flours & Dals",Wheat Flour 1 kg,4,140,120,20,2
20-01-2025,Spices & Seasonings,Avalu small 250 gms,15,60,40,20,1
20-01-2025,"Dry Fruits, Nuts & Seeds",FLAX SEEDS 250GM,2,60,50,10,1
20-01-2025,"Grains, Flours & Dals",turdal 1kg,4,220,195,25,1
20-01-2025,Spices & Seasonings,ROYAL SAFFRON 400GRMS,15,130,130,0,2
20-01-2025,Spices & Seasonings,Biryani Leaf 25GM,15,30,30,0,1
20-01-2025,"Grains, Flours & Dals",SRILALITHA MAIDA FLOUR 500G,4,32,32,0,1
20-01-2025,"Grains, Flours & Dals",Wheat Flour 1 kg,4,140,120,20,2
20-01-2025,Snacks & Ready-to-Eat,NGT CHATPATTA CHANA 90GM,14,25,25,0,1
20-01-2025,"Grains, Flours & Dals",Wheat Flour 1 kg,4,140,120,20,2
20-01-2025,Spices & Seasonings,Turmeric powder 250 gms,15,100,75,25,1
20-01-2025,"Grains, Flours & Dals",BARLEY SEEDS 250GMS,4,40,35,5,1
20-01-2025,Spices & Seasonings,AVALU 100GM,15,25,20,5,1
20-01-2025,Spices & Seasonings,CHILLI POWDER,15,290,210,80,1
20-01-2025,"Grains, Flours & Dals",RAGI FLOUR 500GRMS,4,40,35,5,1
20-01-2025,Sweeteners,NATURAL HONEY 250GM,16,150,130,20,1
20-01-2025,Oils & Ghee,cow ghee 500 ml,9,430,390,40,1
20-01-2025,Spices & Seasonings,Menthulu 500 gms,15,100,90,10,1
20-01-2025,Household & Cleaning,VIM EXTRA 110GM,6,30,30,0,3
20-01-2025,Sweeteners,YB Brown Sugar 1KG,16,140,140,0,1
20-01-2025,"Grains, Flours & Dals",CHANA DAL 500GM,4,70,60,10,1
20-01-2025,Spices & Seasonings,ELACHI 25 GM,15,145,120,25,1
20-01-2025,Snacks & Ready-to-Eat,VD MINAPA VADIYAM,14,65,65,0,1
20-01-2025,Spices & Seasonings,Miriyalu 50GM,15,100,80,20,1
20-01-2025,Snacks & Ready-to-Eat,SATHVI MIXED CHIKKI 200GM,14,120,100,20,1
20-01-2025,Snacks & Ready-to-Eat,VD Pappu Chekkalu 190gm,14,60,60,0,1
20-01-2025,"Grains, Flours & Dals",SAMALU (Little millet) 500 gms,4,85,65,20,1
20-01-2025,Oils & Ghee,Coconut oil 500 ml,9,220,200,20,1
20-01-2025,"Grains, Flours & Dals",HS Ragi upma rava 500 gms,4,70,70,0,1
20-01-2025,"Grains, Flours & Dals",HS JOWAR FLAKES 250GM 1+1,4,119,59,60,1
20-01-2025,Sweeteners,MADHUR SUGAR 1KG,16,65,55,10,1
20-01-2025,Pooja & Spiritual Items,SST 365 PURE COTTON POOJA,12,30,30,0,1
20-01-2025,Milk & Dairy,ID PANEER,7,135,135,0,1
20-01-2025,Spices & Seasonings,AVALU 100GM,15,25,20,5,1
20-01-2025,Household & Cleaning,SURF EXCEL MATIC TL 500ML,6,130,130,0,1
20-01-2025,Sweeteners,YB Brown Sugar 500GM,16,75,75,0,1
20-01-2025,Spices & Seasonings,Turmeric powder 250 gms,15,280,280,0,4
20-01-2025,Snacks & Ready-to-Eat,ANNAPURNA APPALAM,14,35,35,0,1
20-01-2025,"Grains, Flours & Dals",Chana Flour 500 gms,4,70,65,5,1
20-01-2025,Pooja & Spiritual Items,BANDA PUVVU 25GM 25GM,12,80,60,20,1
20-01-2025,Snacks & Ready-to-Eat,SESAME LADDU 200GM,14,100,80,20,1
20-01-2025,Household & Cleaning,VIM TROPICAL LEMON FRESHNESS 250ML,6,110,110,0,2
20-01-2025,Pooja & Spiritual Items,BALAJI BEL PHOOL STICKS 90GM,12,60,60,0,1
20-01-2025,Milk & Dairy,BROWN EGGS 1P,7,112,96,16,8
20-01-2025,Oils & Ghee,Safflower oil 1 L,9,440,400,40,1
20-01-2025,"Grains, Flours & Dals",MIXED FLOUR,4,220,220,0,1
20-01-2025,"Grains, Flours & Dals",RAGI FLOUR 1KG,4,80,70,10,1
20-01-2025,"Health, Wellness & Ayurvedic Products",MD Triphala Chorrnam 100GM,5,80,80,0,1
20-01-2025,"Health, Wellness & Ayurvedic Products",RB Max Protein Chinese Manchurian,5,45,45,0,1
20-01-2025,"Dry Fruits, Nuts & Seeds",GF DATES 500GM,2,156,149,7,1
20-01-2025,Snacks & Ready-to-Eat,VD VAMUPUSA 175GM,14,60,60,0,1
20-01-2025,Snacks & Ready-to-Eat,VD MURUKU 175GM,14,60,60,0,1
20-01-2025,Snacks & Ready-to-Eat,VD RICE MURUKU 150GM,14,50,50,0,1
20-01-2025,"Grains, Flours & Dals",Wheat Flour 1 kg,4,140,120,20,2
20-01-2025,Snacks & Ready-to-Eat,VD RIBBON PAKODI 175GM,14,60,60,0,1
20-01-2025,Oils & Ghee,Sesame oil 1 L,9,590,560,30,1
20-01-2025,Snacks & Ready-to-Eat,FUN TIME CRUNCH,14,45,45,0,1
20-01-2025,Beverages,BISLERI 100ml,1,10,10,0,1
20-01-2025,Snacks & Ready-to-Eat,VD BOONDI 175GM,14,60,60,0,1
20-01-2025,Snacks & Ready-to-Eat,VD Minapa papad 200gm,14,60,60,0,1
20-01-2025,Snacks & Ready-to-Eat,RINGS 200GM,14,30,30,0,1
20-01-2025,Snacks & Ready-to-Eat,GANTASALA GINGER CANDY 200GM,14,105,105,0,1
20-01-2025,Snacks & Ready-to-Eat,VD MAIDA CHEGODI 175GM,14,60,60,0,1
20-01-2025,Snacks & Ready-to-Eat,VD ARISELU 5 PIC,14,100,100,0,1
20-01-2025,Snacks & Ready-to-Eat,SD Sesame laddu with dates250gm,14,135,135,0,1
20-01-2025,Snacks & Ready-to-Eat,PEANUT CANDY,14,90,90,0,2
20-01-2025,Oils & Ghee,Groundnut oil 1 L,9,360,330,30,1
20-01-2025,Milk & Dairy,BROWN EGGS 1P,7,168,144,24,12
20-01-2025,Personal Care & Cosmetics,SEV TULASI SOAP 100GM,10,90,90,0,1
20-01-2025,Snacks & Ready-to-Eat,VD MINAPA VADIYAM,14,65,65,0,1
20-01-2025,Snacks & Ready-to-Eat,ANNAPURNA APPALAM,14,70,70,0,2
20-01-2025,"Grains, Flours & Dals",Chana Flour 500 gms,4,140,130,10,2
20-01-2025,Spices & Seasonings,MD Sonti Powder 50GM,15,80,80,0,1
20-01-2025,"Grains, Flours & Dals",RICE FLOUR 1KG,4,70,55,15,1
20-01-2025,Oils & Ghee,Groundnut oil 500ml,9,180,165,15,1
20-01-2025,Pooja & Spiritual Items,VRP APOORVA JAVADHU POW,12,70,70,0,2
20-01-2025,Pooja & Spiritual Items,AMRUTHA SURABHI,12,80,80,0,1
20-01-2025,Milk & Dairy,BROWN EGGS 1P,7,210,180,30,15
20-01-2025,"Grains, Flours & Dals",Multigrain 1 kg,4,300,255,45,3
20-01-2025,"Grains, Flours & Dals",split black gram 1 kg,4,180,170,10,1
20-01-2025,Sweeteners,MADHUR SUGAR 1KG,16,65,55,10,1
20-01-2025,General Household & Kitchenware,RED LINE 20GM,3,75,75,0,1
20-01-2025,Snacks & Ready-to-Eat,VD DRY FRUIT PUTHAREKULU,14,120,120,0,1
20-01-2025,"Grains, Flours & Dals",RICE FLOUR 1KG,4,70,55,15,1
20-01-2025,Sweeteners,ACHUBELLAM 500GM,16,50,40,10,1
20-01-2025,"Grains, Flours & Dals",THICK POHA 500GM,4,40,35,5,1
20-01-2025,Snacks & Ready-to-Eat,NGT CHATPATTA CHANA 90GM,14,25,25,0,1
20-01-2025,"Dry Fruits, Nuts & Seeds",Groundnuts 500 gms,2,95,85,10,1
20-01-2025,Sweeteners,YB FOREST HONEY 250GM,16,180,180,0,1
20-01-2025,Pickles & Cooking Pastes,SD MINT PUDINA PICKLE,11,110,110,0,1
20-01-2025,"Grains, Flours & Dals",Black uluvalu 250 gms,4,35,35,0,1
20-01-2025,"Dry Fruits, Nuts & Seeds",PUTNALU 500GMS,2,90,76,14,1
20-01-2025,"Grains, Flours & Dals",DESI CHANA,4,25,25,0,1
20-01-2025,Snacks & Ready-to-Eat,VD Pappu Chekkalu 190gm,14,60,60,0,1
20-01-2025,"Grains, Flours & Dals",turdal 1kg,4,220,195,25,1
20-01-2025,"Grains, Flours & Dals",Wheat Rava M 1KG,4,65,55,10,1
20-01-2025,"Grains, Flours & Dals",turdal 500 gms,4,110,100,10,1
20-01-2025,"Grains, Flours & Dals",Wheat Flour 1 kg,4,140,120,20,2
20-01-2025,"Grains, Flours & Dals",Multigrain 1 kg,4,200,170,30,2
20-01-2025,Snacks & Ready-to-Eat,SATHVI REGIVADA 200GM,14,80,60,20,1
20-01-2025,Oils & Ghee,Groundnut oil 500ml,9,180,165,15,1
20-01-2025,Snacks & Ready-to-Eat,SH PUFFED RICE 500GM,14,112,112,0,1
20-01-2025,Oils & Ghee,Safflower oil 500 ml,9,220,200,20,1
20-01-2025,"Grains, Flours & Dals",VYS.SP RICE 1 KG,4,350,325,25,5
20-01-2025,"Grains, Flours & Dals",SRILATHA RICE RAVVA 500GM,4,70,70,0,2
20-01-2025,Spices & Seasonings,NUVVULU 250GM,15,80,65,15,1
20-01-2025,Sweeteners,NATURAL HONEY 250GM,16,150,130,20,1
20-01-2025,Snacks & Ready-to-Eat,SD SESAME PAPAD,14,80,80,0,1
20-01-2025,"Grains, Flours & Dals",Idly Rava L 1KG,4,120,100,20,2
20-01-2025,Beverages,3ROSES,1,90,90,0,1
20-01-2025,"Grains, Flours & Dals",CHANA DAL 500GM,4,70,60,10,1
20-01-2025,Beverages,ASSAM ELAICHI TEA,1,199,199,0,1
20-01-2025,"Dry Fruits, Nuts & Seeds",CASHEW 250GM,2,340,310,30,1
20-01-2025,Oils & Ghee,Groundnut oil 1 L,9,360,330,30,1
20-01-2025,"Grains, Flours & Dals",UDALU (Barnyard millet) 1 kg,4,140,115,25,1
20-01-2025,"Grains, Flours & Dals",Arikadu ( kodo),4,140,130,10,1
20-01-2025,"Grains, Flours & Dals",DH URAD GOTA 1KG,4,430,380,50,2
20-01-2025,Oils & Ghee,Sesame oil 1 L,9,590,560,30,1
20-01-2025,"Grains, Flours & Dals",Wheat Flour 1 kg,4,70,60,10,1
20-01-2025,Snacks & Ready-to-Eat,VD MINAPA VADIYAM,14,65,65,0,1
20-01-2025,Sweeteners,YB JAGGERY POWDER 1KG,16,140,140,0,1
20-01-2025,"Dry Fruits, Nuts & Seeds",SD Mango cubes 200gm,2,90,90,0,1
20-01-2025,"Health, Wellness & Ayurvedic Products",MH Millets Malt 1KG,5,400,380,20,1
20-01-2025,Snacks & Ready-to-Eat,SATHVI REGIVADA 200GM,14,80,60,20,1
20-01-2025,Personal Care & Cosmetics,TRESEMME KS KERATIN SMOOTH,10,80,80,0,1
20-01-2025,Snacks & Ready-to-Eat,PALLI LADDU 200GMS,14,180,140,40,2
20-01-2025,Sweeteners,YB JAGGERY POWDER 500GMS,16,150,150,0,2
20-01-2025,Household & Cleaning,VIM TROPICAL LEMON FRESHNESS 250ML,6,55,55,0,1
20-01-2025,"Grains, Flours & Dals",RAGULU 1 KG,4,17.5,15,2.5,0.25
20-01-2025,Snacks & Ready-to-Eat,MB MULTIMILLET NOODLES 180GM,14,95,95,0,1
20-01-2025,"Grains, Flours & Dals",WHEAT 1 KG,4,15,12.5,2.5,0.25
20-01-2025,"Dry Fruits, Nuts & Seeds",SD Mango cubes 200gm,2,90,90,0,1
20-01-2025,Spices & Seasonings,ROYAL SAFFRON,15,125,125,0,1
20-01-2025,Spices & Seasonings,TM MIRCH POWDER 200GM,15,163,163,0,1
20-01-2025,Snacks & Ready-to-Eat,BATANA NGT 70GMS,14,80,80,0,4
20-01-2025,"Grains, Flours & Dals",SL Idly Rava 1KG,4,65,55,10,1
20-01-2025,"Grains, Flours & Dals",VGR RICE bag 1,4,1899,"1,650.00",249,1
20-01-2025,"Grains, Flours & Dals",Wheat Rava M 1KG,4,65,55,10,1
20-01-2025,Household & Cleaning,GAJANAND BLACK DRAGN 10STI,6,40,40,0,2
20-01-2025,"Grains, Flours & Dals",turdal 1kg,4,220,195,25,1
20-01-2025,Oils & Ghee,Groundnut oil 1 L,9,360,330,30,1
20-01-2025,"Grains, Flours & Dals",Wheat Flour 1 kg,4,140,120,20,2
20-01-2025,"Dry Fruits, Nuts & Seeds",PUTNALU 500GMS,2,90,76,14,1
20-01-2025,"Dry Fruits, Nuts & Seeds",Groundnuts 500 gms,2,95,85,10,1
20-01-2025,"Grains, Flours & Dals",Urad dall 1 Kg,4,185,170,15,1
20-01-2025,Snacks & Ready-to-Eat,BB VERMICELLI 1KG,14,95,90,5,1
20-01-2025,Spices & Seasonings,AVALU 100GM,15,25,20,5,1
20-01-2025,"Grains, Flours & Dals",CHANA DAL 500GM,4,70,60,10,1
20-01-2025,"Grains, Flours & Dals",Urad dall 1 Kg,4,185,170,15,1
20-01-2025,"Dry Fruits, Nuts & Seeds",Groundnuts 1 kg,2,190,170,20,1
20-01-2025,Oils & Ghee,Groundnut oil 1 L,9,720,660,60,2
20-01-2025,Oils & Ghee,Coconut oil 500 ml,9,220,200,20,1
20-01-2025,"Grains, Flours & Dals",JOWAR UPMA RAVA,4,0,0,0,1
20-01-2025,Oils & Ghee,Safflower oil 1 L,9,440,400,40,1
20-01-2025,"Grains, Flours & Dals",Em jowar idly R 500G,4,75,75,0,1
20-01-2025,"Grains, Flours & Dals",EM Ragi idli R 500G,4,75,75,0,1
20-01-2025,"Grains, Flours & Dals",Urad dall 1 Kg,4,185,170,15,1
20-01-2025,"Grains, Flours & Dals",SL Idly Rava 1KG,4,65,55,10,1
20-01-2025,Oils & Ghee,Coconut oil 500 ml,9,220,200,20,1
20-01-2025,"Grains, Flours & Dals",THIN POHA 500GM,4,40,35,5,1
20-01-2025,"Dry Fruits, Nuts & Seeds",ROASTED FLAXSEED,2,75,75,0,1
20-01-2025,Spices & Seasonings,Tamarind 250GMS,15,80,65,15,1
20-01-2025,Oils & Ghee,Coconut oil 500 ml,9,220,200,20,1
20-01-2025,Snacks & Ready-to-Eat,TILLI CHIKKI,14,125,125,0,1
20-01-2025,"Health, Wellness & Ayurvedic Products",AMLA PACHAK,5,100,100,0,1
20-01-2025,Oils & Ghee,Coconut oil 500 ml,9,220,200,20,1
20-01-2025,"Grains, Flours & Dals",VYS.SP RICE 1 KG,4,350,325,25,5
20-01-2025,Snacks & Ready-to-Eat,VD MYSOREPAK 6PIC,14,100,100,0,1
20-01-2025,"Grains, Flours & Dals",RAGI FLOUR 500GRMS,4,40,35,5,1
20-01-2025,Spices & Seasonings,Turmeric powder 250 gms,15,200,150,50,2
20-01-2025,"Dry Fruits, Nuts & Seeds",Groundnuts 500 gms,2,95,85,10,1
20-01-2025,"Grains, Flours & Dals",DESI CHANA,4,25,25,0,1
20-01-2025,Snacks & Ready-to-Eat,BATANA NGT 70GMS,14,20,20,0,1
20-01-2025,Spices & Seasonings,SD IDLY KARAM,15,65,65,0,1
20-01-2025,"Grains, Flours & Dals",VYS.SP RICE 1 KG,4,560,520,40,8
20-01-2025,"Grains, Flours & Dals",Wheat Flour 1 kg,4,70,60,10,1
20-01-2025,"Grains, Flours & Dals",RAGI FLOUR 500GRMS,4,40,35,5,1
20-01-2025,"Grains, Flours & Dals",Multigrain 1 kg,4,100,85,15,1
20-01-2025,"Grains, Flours & Dals",VL Sabdana 500GM,4,77,77,0,1
20-01-2025,Oils & Ghee,Sesame oil 500ml,9,590,560,30,2
20-01-2025,"Grains, Flours & Dals",BARLEY SEEDS 1KG,4,16,14,2,0.1
20-01-2025,Personal Care & Cosmetics,HERBAL BATH POWDER 200GM,10,80,80,0,1
20-01-2025,Snacks & Ready-to-Eat,SD Atreyapuram DRY Fruit ghee,14,150,150,0,1
20-01-2025,Personal Care & Cosmetics,MULTANI MITTI CHOORNAM,10,40,40,0,1
20-01-2025,"Grains, Flours & Dals",Wheat Flour 1 kg,4,140,120,20,2
20-01-2025,Snacks & Ready-to-Eat,SATHVI REGIVADA 200GM,14,80,60,20,1
20-01-2025,Oils & Ghee,Groundnut oil 1 L,9,720,660,60,2
20-01-2025,Oils & Ghee,Groundnut oil 1 L,9,720,660,60,2
20-01-2025,Oils & Ghee,Castor oil 200 ml,9,100,80,20,1
20-01-2025,Spices & Seasonings,RED COPRA 250GMS,15,85,74,11,1
20-01-2025,Personal Care & Cosmetics,ORGANIC SPONGE LOOFAH,10,70,70,0,1
20-01-2025,"Dry Fruits, Nuts & Seeds",MAHA BEERA SEEDS 100GM,2,60,60,0,1
20-01-2025,Spices & Seasonings,Coriander seeds 200 gms,15,48,40,8,1
20-01-2025,"Grains, Flours & Dals",split black gram 1 kg,4,180,170,10,1
20-01-2025,"Dry Fruits, Nuts & Seeds",Groundnuts 1 kg,2,190,170,20,1
20-01-2025,General Household & Kitchenware,GOOD HOME,3,15,15,0,1
20-01-2025,"Grains, Flours & Dals",FLOUR CHARGE,4,36,36,0,3
20-01-2025,"Grains, Flours & Dals",RAGI FLOUR 500GRMS,4,40,35,5,1
20-01-2025,"Grains, Flours & Dals",RAGULU 1 KG,4,70,60,10,1
20-01-2025,Pooja & Spiritual Items,SWAATHI GATTI DEEPAM VATTULU,12,30,30,0,1
20-01-2025,Personal Care & Cosmetics,SANTOOR,10,100,100,0,1
20-01-2025,Pooja & Spiritual Items,VRP APOORVA JAVADHU POW,12,35,35,0,1
20-01-2025,Pooja & Spiritual Items,GD SANDAL 150GM,12,110,110,0,1
20-01-2025,Pooja & Spiritual Items,SWASTIK CAMPHOR 25GM,12,45,45,0,1
20-01-2025,Oils & Ghee,Groundnut oil 1 L,9,720,660,60,2
20-01-2025,Snacks & Ready-to-Eat,PALLI LADDU 200GMS,14,90,70,20,1
20-01-2025,Snacks & Ready-to-Eat,SESAME LADDU 200GM,14,100,80,20,1
20-01-2025,Oils & Ghee,GANTASALA A2 COW GHEE 500ML,9,550,550,0,1
20-01-2025,Snacks & Ready-to-Eat,RI Yogurt Berry Oats 35g,14,90,90,0,2
20-01-2025,Oils & Ghee,Coconut oil 1 L,9,440,400,40,1
20-01-2025,"Grains, Flours & Dals",DESI CHANA,4,25,25,0,1
20-01-2025,"Grains, Flours & Dals",Arikalu (kodo),4,70,65,5,1
20-01-2025,"Grains, Flours & Dals",UDALU (Barnyard millet) 500 gms,4,70,60,10,1
20-01-2025,"Grains, Flours & Dals",RAGULU 1 KG,4,70,60,10,1
20-01-2025,Spices & Seasonings,Telaga Pindi 250 GM,15,40,35,5,1
20-01-2025,"Dry Fruits, Nuts & Seeds",SUNFLOWER SEEDS 250GRM,2,150,130,20,1
20-01-2025,"Dry Fruits, Nuts & Seeds",PUMPKIN SEEDS 250GM,2,200,160,40,1
20-01-2025,"Dry Fruits, Nuts & Seeds",FLAX SEEDS 250GM,2,60,50,10,1
20-01-2025,"Dry Fruits, Nuts & Seeds",WATERMELON SEEDS 250GRM,2,320,280,40,1
20-01-2025,Oils & Ghee,Groundnut oil 1 L,9,360,330,30,1
20-01-2025,Snacks & Ready-to-Eat,BATANA NGT 70GMS,14,40,40,0,2
20-01-2025,"Grains, Flours & Dals",SINGLE POLISH 1KG,4,325,325,0,5
20-01-2025,Oils & Ghee,Groundnut oil 500ml,9,180,165,15,1
20-01-2025,"Grains, Flours & Dals",turdal 1kg,4,220,195,25,1
20-01-2025,"Grains, Flours & Dals",Wheat Rava M 1KG,4,65,55,10,1
20-01-2025,Sweeteners,YB Brown Sugar 500GM,16,75,75,0,1
20-01-2025,Spices & Seasonings,RED COPRA 250GMS,15,85,74,11,1
20-01-2025,Personal Care & Cosmetics,KAIPO ACT CHARCOAL TP 100G,10,90,90,0,1
20-01-2025,"Dry Fruits, Nuts & Seeds",Putnalu 250GM,2,45,38,7,1
20-01-2025,"Grains, Flours & Dals",SABDANA 500GM,4,90,70,20,1
20-01-2025,"Grains, Flours & Dals",Wheat Flour 1 kg,4,210,180,30,3
20-01-2025,Spices & Seasonings,SREE MARUTHI IDLY KARAM 200GM,15,60,60,0,1
20-01-2025,"Dry Fruits, Nuts & Seeds",SD Mango cubes 200gm,2,90,90,0,1
20-01-2025,Snacks & Ready-to-Eat,SD FINGER Millet with palm Jaggery 250gm,14,135,135,0,1
20-01-2025,Pooja & Spiritual Items,SOSR SWATHHI 365,12,30,30,0,1
20-01-2025,General Household & Kitchenware,GOOD HOME,3,15,15,0,1
20-01-2025,"Grains, Flours & Dals",Brown RICE 1KG,4,350,325,25,5
20-01-2025,Snacks & Ready-to-Eat,RAJGIRA PEANUT CHIKKI,14,50,50,0,10
20-01-2025,"Dry Fruits, Nuts & Seeds",ALMONDS 250GM,2,280,260,20,1
20-01-2025,Oils & Ghee,Groundnut oil 1 L,9,360,330,30,1
20-01-2025,Spices & Seasonings,ROYAL SAFFRON 400GRMS,15,65,65,0,1
20-01-2025,"Grains, Flours & Dals",BAJRA 1 KG,4,60,50,10,1
20-01-2025,Oils & Ghee,Coconut oil 500 ml,9,220,200,20,1
20-01-2025,Snacks & Ready-to-Eat,Sprouted Ragi Biscuits 450GM,14,150,150,0,1
20-01-2025,"Dry Fruits, Nuts & Seeds",SATHVI CHIA SEEDS 100GM,2,100,80,20,1
20-01-2025,Oils & Ghee,cow ghee 500 ml,9,430,390,40,1
20-01-2025,"Grains, Flours & Dals",Wheat Flour 1 kg,4,70,60,10,1
20-01-2025,Snacks & Ready-to-Eat,VD BELLAM GAVVALU 200GM,14,60,60,0,1
20-01-2025,Snacks & Ready-to-Eat,ELITE MILK RUSK 200GM,14,35,35,0,1
20-01-2025,Spices & Seasonings,Elaichi 25GM,15,145,120,25,1
20-01-2025,Snacks & Ready-to-Eat,VD MINAPA VADIYAM,14,65,65,0,1
20-01-2025,"Grains, Flours & Dals",Urad dall 1 Kg,4,185,170,15,1
20-01-2025,"Grains, Flours & Dals",RED TURDAL 500GM,4,75,70,5,1
20-01-2025,"Grains, Flours & Dals",Idly Rava L 1KG,4,60,50,10,1
20-01-2025,"Grains, Flours & Dals",EM kodo upma R 500g,4,258,258,0,2
20-01-2025,Oils & Ghee,Groundnut oil 500ml,9,180,165,15,1
20-01-2025,Oils & Ghee,Coconut oil 500 ml,9,220,200,20,1
20-01-2025,"Grains, Flours & Dals",SRILATHA RICE RAVVA 500GM,4,35,35,0,1
20-01-2025,"Grains, Flours & Dals",SINGLE POLISH 1KG,4,325,325,0,5
20-01-2025,"Grains, Flours & Dals",HS Multimillet idly R 500 gms,4,65,65,0,1
20-01-2025,"Dry Fruits, Nuts & Seeds",DIANUTS 500GM,2,120,120,0,1
20-01-2025,Oils & Ghee,Castor oil 200 ml,9,100,80,20,1
20-01-2025,Oils & Ghee,Coconut oil 500 ml,9,220,200,20,1
20-01-2025,Oils & Ghee,Safflower oil 1 L,9,880,800,80,2
20-01-2025,Oils & Ghee,Coconut oil 1 L,9,440,400,40,1
20-01-2025,Oils & Ghee,Groundnut oil 1 L,9,360,330,30,1
20-01-2025,Sweeteners,GS JAGGERY NUGGETS 500GM,16,120,120,0,1
20-01-2025,"Grains, Flours & Dals",PRO ORG MEDIUM POHA 500G,4,78,78,0,1
20-01-2025,"Grains, Flours & Dals",PRO NATURE CHANNA DAL500GM,4,124,124,0,1
20-01-2025,"Grains, Flours & Dals",Bombay Rava 500GM,4,35,30,5,1
20-01-2025,Oils & Ghee,Groundnut oil 1 L,9,360,330,30,1
20-01-2025,Snacks & Ready-to-Eat,BB ROASTED VERMICELLY 500GM,14,70,70,0,1
20-01-2025,Spices & Seasonings,TM MIRCH POWDER 200GM,15,163,163,0,1
20-01-2025,"Grains, Flours & Dals",Urad dall 1 Kg,4,185,170,15,1
20-01-2025,"Dry Fruits, Nuts & Seeds",CASHEW 250GM,2,340,310,30,1
20-01-2025,"Grains, Flours & Dals",Idly Rava L 1KG,4,60,50,10,1
20-01-2025,General Household & Kitchenware,ODONIL SANDAL BOQUET 220ML,3,169,169,0,1
20-01-2025,General Household & Kitchenware,ODONIL ROSE GARDEN 220ML,3,169,169,0,1
20-01-2025,"Dry Fruits, Nuts & Seeds",SH GROUNDNUT 500GM,2,163,130,33,1
20-01-2025,Household & Cleaning,LIZOL JAQSMINE 500ML,6,116,116,0,1
20-01-2025,Oils & Ghee,Safflower oil 1 L,9,440,400,40,1
20-01-2025,"Grains, Flours & Dals",AISHWARYA SP 5KG,4,800,800,0,2
20-01-2025,"Grains, Flours & Dals",Arikalu (kodo),4,70,65,5,1
20-01-2025,"Grains, Flours & Dals",VGR rice 1 kg,4,140,130,10,2
20-01-2025,"Grains, Flours & Dals",KORRALU (FOXTAIL M) 500GM,4,65,55,10,1
20-01-2025,Oils & Ghee,Groundnut oil 1 L,9,360,330,30,1
20-01-2025,"Grains, Flours & Dals",RAGI FLOUR 1KG,4,80,70,10,1
20-01-2025,"Grains, Flours & Dals",VYS.SP RICE 1 KG,4,140,130,10,2
20-01-2025,"Grains, Flours & Dals",SAMALU (Little millet) 500 gms,4,85,65,20,1
20-01-2025,"Grains, Flours & Dals",Wheat Flour 2 kgs,4,140,120,20,1
20-01-2025,"Grains, Flours & Dals",RICE FLOUR 1KG,4,70,55,15,1
20-01-2025,Milk & Dairy,SANGAM TONED MILK 500ML,7,60,60,0,2
20-01-2025,"Grains, Flours & Dals",VYS.SP RICE 1 KG,4,280,260,20,4
20-01-2025,Spices & Seasonings,Tamarind 250GMS,15,80,65,15,1
20-01-2025,"Grains, Flours & Dals",Green gram 500 gms,4,75,70,5,1
20-01-2025,Oils & Ghee,Black Sesame oil 500 ml,9,440,380,60,2
20-01-2025,Milk & Dairy,BROWN EGGS TRAY 30P,7,360,330,30,1
20-01-2025,"Grains, Flours & Dals",turdal 1kg,4,440,390,50,2
20-01-2025,Oils & Ghee,Groundnut oil 1 L,9,360,330,30,1
20-01-2025,"Dry Fruits, Nuts & Seeds",PUTNALU 500GMS,2,90,76,14,1
20-01-2025,Oils & Ghee,Groundnut oil 1 L,9,720,660,60,2
20-01-2025,Spices & Seasonings,PURO Healthy Salt 1KG,15,110,110,0,1
20-01-2025,"Grains, Flours & Dals",FLOUR CHARGE,4,12,12,0,1
20-01-2025,"Grains, Flours & Dals",Chana Flour 500 gms,4,70,65,5,1
20-01-2025,"Dry Fruits, Nuts & Seeds",PULMAKHANA 100 GM,2,180,170,10,1
20-01-2025,"Grains, Flours & Dals",White jowar.F 1 kg,4,200,160,40,2
20-01-2025,"Dry Fruits, Nuts & Seeds",SUNFLOWER SEEDS 250GRM,2,150,130,20,1
20-01-2025,"Dry Fruits, Nuts & Seeds",ALMONDS 250GM,2,280,260,20,1
20-01-2025,"Dry Fruits, Nuts & Seeds",PUMPKIN SEEDS 250GM,2,200,160,40,1
20-01-2025,"Dry Fruits, Nuts & Seeds",DRYDATES 250GM,2,300,240,60,2
20-01-2025,"Dry Fruits, Nuts & Seeds",WATERMELON SEEDS 250GRM,2,320,280,40,1
20-01-2025,"Grains, Flours & Dals",Chana Flour 1 kg,4,140,130,10,1
20-01-2025,Milk & Dairy,SANGAM CURD 450GM,7,38,38,0,1
20-01-2025,Oils & Ghee,Groundnut oil 1 L,9,360,330,30,1
20-01-2025,"Grains, Flours & Dals",Wheat Flour 1 kg,4,70,60,10,1
20-01-2025,Milk & Dairy,BROWN EGGS 1P,7,70,60,10,5
20-01-2025,Milk & Dairy,BROWN EGGS 1P,7,84,72,12,6
20-01-2025,Milk & Dairy,HRITAGE TONED MILK 500ML,7,30,30,0,1
20-01-2025,Snacks & Ready-to-Eat,VD RICE MURUKU 150GM,14,50,50,0,1
20-01-2025,Oils & Ghee,Groundnut oil 1 L,9,360,330,30,1
20-01-2025,Milk & Dairy,SANGAM CURD 450GM,7,38,38,0,1
20-01-2025,"Grains, Flours & Dals",Wheat Flour 1 kg,4,140,120,20,2
20-01-2025,Milk & Dairy,BROWN EGGS 1P,7,84,72,12,6
20-01-2025,"Dry Fruits, Nuts & Seeds",Groundnuts 1 kg,2,190,170,20,1
20-01-2025,Snacks & Ready-to-Eat,MILK BREAD,14,55,55,0,1
20-01-2025,Oils & Ghee,Coconut oil 500 ml,9,220,200,20,1
20-01-2025,"Grains, Flours & Dals",turdal 1kg,4,220,195,25,1
20-01-2025,"Grains, Flours & Dals",SH RED POHA 500GM,4,75,75,0,1
20-01-2025,"Grains, Flours & Dals",Wheat Rava M 1KG,4,65,55,10,1
20-01-2025,"Dry Fruits, Nuts & Seeds",PULMAKHANA 100 GM,2,180,170,10,1
20-01-2025,"Grains, Flours & Dals",BOMBAY RAVA,4,70,55,15,1
20-01-2025,Oils & Ghee,Safflower oil 1 L,9,440,400,40,1
20-01-2025,Milk & Dairy,BROWN EGGS 1P,7,210,180,30,15
20-01-2025,Snacks & Ready-to-Eat,ELITE ELAICHI RUSK 200GM,14,35,35,0,1
19-01-2025,"Grains, Flours & Dals",Multigrain 1 kg,4,200,170,30,2
19-01-2025,Spices & Seasonings,YB PINK ROCK SALT 1KG,15,120,120,0,1
19-01-2025,"Grains, Flours & Dals",DR.RICE 5KG,4,600,600,0,1
19-01-2025,Sweeteners,GS Palm Jaggery Powder 400GM,16,180,180,0,1
19-01-2025,Baking & Cooking Aids,GONDH 50GRMS,0,40,40,0,1
19-01-2025,Spices & Seasonings,Turmeric powder 250 gms,15,100,75,25,1
19-01-2025,"Grains, Flours & Dals",MAAGAANI SP RICE 5KGS,4,649,560,89,1
19-01-2025,Personal Care & Cosmetics,OVAL BODY LOOFAH,10,55,55,0,1
19-01-2025,Personal Care & Cosmetics,GA DANT MANJAN TP 50GM,10,60,60,0,1
19-01-2025,Personal Care & Cosmetics,GAYATHRI KUMKUDUKAYA,10,150,150,0,1
19-01-2025,"Grains, Flours & Dals",SRILATHA RICE RAVVA 500GM,4,35,35,0,1
19-01-2025,"Grains, Flours & Dals",Em Multimillet upma 500g,4,129,129,0,1
19-01-2025,"Grains, Flours & Dals",Sathya Javva Wheat Rava 500GM,4,95,95,0,1
19-01-2025,"Health, Wellness & Ayurvedic Products",RB Max Protein Fruit &amp;Nut 50g,5,75,75,0,1
19-01-2025,Snacks & Ready-to-Eat,MILK BREAD,14,30,30,0,1
19-01-2025,"Grains, Flours & Dals",Wheat Flour 1 kg,4,140,120,20,2
19-01-2025,"Grains, Flours & Dals",Sathya Javva Wheat Rava 500GM,4,95,95,0,1
19-01-2025,Spices & Seasonings,TM MIRCH POWDER 200GM,15,163,163,0,1
19-01-2025,"Grains, Flours & Dals",FLOUR CHARGE,4,100.8,100.8,0,8.4
19-01-2025,Spices & Seasonings,SV Oregano 15GM,15,110,110,0,1
19-01-2025,"Grains, Flours & Dals",UDALU (Barnyard millet) 500 gms,4,70,60,10,1
19-01-2025,Oils & Ghee,Sesame oil 1 L,9,590,560,30,1
19-01-2025,Snacks & Ready-to-Eat,SD Vamu with palm jaggery 250gm,14,135,135,0,1
19-01-2025,"Health, Wellness & Ayurvedic Products",MD Aamlaki Choornam 100GM,5,80,80,0,1
19-01-2025,Spices & Seasonings,Telaga Pindi 500GM,15,80,70,10,1
19-01-2025,Spices & Seasonings,SARVA GARLIC &amp;HERB 50GM,15,120,120,0,1
19-01-2025,"Grains, Flours & Dals",Bajra Flour 1 kg,4,140,120,20,2
19-01-2025,Snacks & Ready-to-Eat,SD KODO MILLET WITH PALM JAGGERY,14,135,135,0,1
19-01-2025,Oils & Ghee,Groundnut oil 1 L,9,360,330,30,1
19-01-2025,"Grains, Flours & Dals",RAGI FLOUR 1KG,4,160,140,20,2
19-01-2025,Oils & Ghee,Groundnut oil 1 L,9,720,660,60,2
19-01-2025,Spices & Seasonings,Japatri 25GM,15,100,80,20,1
19-01-2025,"Dry Fruits, Nuts & Seeds",YELLOW KISHMISH 250GM,2,130,110,20,1
19-01-2025,"Grains, Flours & Dals",split black gram 1 kg,4,180,170,10,1
19-01-2025,Spices & Seasonings,MM Kasuri Methi 25GM,15,30,30,0,1
19-01-2025,"Grains, Flours & Dals",Wheat Flour 1 kg,4,70,60,10,1
19-01-2025,"Dry Fruits, Nuts & Seeds",SATHVI CHIA SEEDS 100GM,2,100,80,20,1
19-01-2025,Oils & Ghee,Coconut oil 1 L,9,440,400,40,1
19-01-2025,Spices & Seasonings,Miriyalu 50GM,15,100,80,20,1
19-01-2025,Snacks & Ready-to-Eat,COPRA LADDU 200GM,14,100,80,20,1
19-01-2025,Oils & Ghee,Groundnut oil 1 L,9,360,330,30,1
19-01-2025,Milk & Dairy,BROWN EGGS 1P,7,168,144,24,12
19-01-2025,"Grains, Flours & Dals",RAGI FLOUR 500GRMS,4,40,35,5,1
19-01-2025,"Grains, Flours & Dals",Green gram 500 gms,4,75,70,5,1
19-01-2025,"Grains, Flours & Dals",White jowar.F 1 kg,4,100,80,20,1
19-01-2025,"Grains, Flours & Dals",SPLIT BLACK GRAM 500 GM,4,90,85,5,1
19-01-2025,"Grains, Flours & Dals",turdal 1kg,4,220,195,25,1
19-01-2025,"Grains, Flours & Dals",HS Multimillet idly R 500 gms,4,65,65,0,1
19-01-2025,Spices & Seasonings,SATHVI BIRYANI LEAF 25GM,15,30,20,10,1
19-01-2025,"Grains, Flours & Dals",HS Multimillet upma r 500g,4,65,65,0,1
19-01-2025,Personal Care & Cosmetics,HERBAL BATH POWDER 200GM,10,80,80,0,1
19-01-2025,Snacks & Ready-to-Eat,SD Vamu with palm jaggery 250gm,14,135,135,0,1
19-01-2025,Oils & Ghee,Sesame oil 500ml,9,295,280,15,1
19-01-2025,Spices & Seasonings,Dalchin Rolls 50GM,15,45,45,0,1
19-01-2025,Snacks & Ready-to-Eat,SD JOWAR WITH PALM JAGGERY 250GM,14,135,135,0,1
19-01-2025,Sweeteners,YB Brown Sugar 500GM,16,75,75,0,1
19-01-2025,Snacks & Ready-to-Eat,URBAN MARMURA 450GM,14,60,55,5,1
19-01-2025,Milk & Dairy,BROWN EGGS 1P,7,112,96,16,8
19-01-2025,Sweeteners,GS Organic Jaggery Powder 600GM,16,693,693,0,7
19-01-2025,Snacks & Ready-to-Eat,SALTED PHALLI,14,65,65,0,1
19-01-2025,"Grains, Flours & Dals",White jowar.F 1 kg,4,100,80,20,1
19-01-2025,General Household & Kitchenware,WOODEN SPOON BIG,3,80,80,0,2
19-01-2025,Milk & Dairy,BROWN EGGS TRAY 30P,7,360,330,30,1
19-01-2025,Milk & Dairy,BROWN EGGS 1P,7,168,144,24,12
19-01-2025,"Grains, Flours & Dals",Em Multimillet upma 500g,4,129,129,0,1
19-01-2025,"Grains, Flours & Dals",Multigrain 1 kg,4,100,85,15,1
19-01-2025,"Grains, Flours & Dals",FLOUR CHARGE,4,51.6,51.6,0,4.3
19-01-2025,"Grains, Flours & Dals",Multigrain 1 kg,4,100,85,15,1
19-01-2025,"Grains, Flours & Dals",Wheat Flour 1 kg,4,70,60,10,1
19-01-2025,Oils & Ghee,Groundnut oil 1 L,9,720,660,60,2
19-01-2025,Milk & Dairy,SANGAM TONED MILK 500ML,7,90,90,0,3
19-01-2025,"Grains, Flours & Dals",White jowar.F 1 kg,4,100,80,20,1
19-01-2025,Oils & Ghee,Coconut oil 500 ml,9,220,200,20,1
19-01-2025,Milk & Dairy,ID PANEER,7,135,135,0,1
19-01-2025,Oils & Ghee,Groundnut oil 1 L,9,720,660,60,2
19-01-2025,Spices & Seasonings,SWEET SOUNF,15,20,20,0,1
19-01-2025,Snacks & Ready-to-Eat,RSC ORANGE 100GMS,14,20,20,0,1
19-01-2025,Snacks & Ready-to-Eat,BLACK SESAME CHIKKI,14,20,20,0,2
19-01-2025,Oils & Ghee,Safflower oil 1 L,9,440,400,40,1
19-01-2025,Personal Care & Cosmetics,KHADI MIX FRUIT SOAP 125GM,10,80,80,0,1
19-01-2025,"Grains, Flours & Dals",Multigrain 1 kg,4,100,85,15,1
19-01-2025,Milk & Dairy,SANGAM FULL CREAM MILK 500ML,7,38,38,0,1
19-01-2025,Personal Care & Cosmetics,SVE MULTANI MITTI SOAP 100GM,10,90,90,0,1
19-01-2025,Pooja & Spiritual Items,GD Dhoop Cones 40GM,12,30,30,0,1
19-01-2025,Pooja & Spiritual Items,GD SANDAL 150GM,12,110,110,0,1
19-01-2025,"Grains, Flours & Dals",Idly Rava L 1KG,4,60,50,10,1
19-01-2025,Personal Care & Cosmetics,NEEM SOAP 100GM,10,100,100,0,1
19-01-2025,Spices & Seasonings,Tamarind 500GM,15,160,130,30,1
19-01-2025,"Grains, Flours & Dals",Multigrain 1 kg,4,100,85,15,1
19-01-2025,"Grains, Flours & Dals",HS jowar idly rava 500 gms,4,65,65,0,1
19-01-2025,Spices & Seasonings,Chilli powder 500 gms,15,870,630,240,3
19-01-2025,Oils & Ghee,Safflower oil 1 L,9,440,400,40,1
19-01-2025,Spices & Seasonings,Jeera 100GM,15,100,90,10,2
19-01-2025,Sweeteners,MISHRI 250 GM,16,35,30,5,1
19-01-2025,"Grains, Flours & Dals",White jowar.F 1 kg,4,100,80,20,1
19-01-2025,Spices & Seasonings,Coriander seeds 200 gms,15,48,40,8,1
19-01-2025,"Dry Fruits, Nuts & Seeds",PULMAKHANA 100 GM,2,180,170,10,1
19-01-2025,"Dry Fruits, Nuts & Seeds",ROASTED FLAXSEED,2,150,150,0,2
19-01-2025,"Grains, Flours & Dals",DISANO ROLED OATS,4,197,197,0,1
19-01-2025,"Dry Fruits, Nuts & Seeds",DRYDATES YELLOW 250GM,2,135,120,15,1
19-01-2025,Oils & Ghee,Groundnut oil 1 L,9,720,660,60,2
19-01-2025,Oils & Ghee,Black Sesame oil 500 ml,9,220,190,30,1
19-01-2025,"Grains, Flours & Dals",PRO SOYA CHUNKS 200G,4,79,79,0,1
19-01-2025,Spices & Seasonings,Lavangam 50GM,15,60,50,10,1
19-01-2025,Spices & Seasonings,YB PINK ROCK SALT 1KG,15,120,120,0,1
19-01-2025,Pooja & Spiritual Items,VRP APOORVA JAVADHU POW,12,35,35,0,1
19-01-2025,Snacks & Ready-to-Eat,BB ROASTED VERMICELLY 500GM,14,70,70,0,1
19-01-2025,Personal Care & Cosmetics,Soapnut 500GM,10,120,90,30,1
19-01-2025,Sweeteners,Mishri 500GM,16,70,60,10,1
19-01-2025,Pooja & Spiritual Items,DASANGAM DHOOP POWDER 50GM,12,43,43,0,1
19-01-2025,Oils & Ghee,MUSTARD OIL 100ML,9,100,100,0,1
19-01-2025,Spices & Seasonings,ER GARAM MASALA,15,5,5,0,1
19-01-2025,Snacks & Ready-to-Eat,URBAN MARMURA 450GM,14,60,55,5,1
19-01-2025,Spices & Seasonings,MM CHAT MASALA,15,44,44,0,1
19-01-2025,Personal Care & Cosmetics,HERBAL BATH POWDER 200GM,10,160,160,0,2
19-01-2025,Spices & Seasonings,PUTNALA KARAM POWDER 100GM,15,65,65,0,1
19-01-2025,Oils & Ghee,Coconut oil 500 ml,9,220,200,20,1
19-01-2025,"Grains, Flours & Dals",SAMALU (Little millet) 500 gms,4,85,65,20,1
19-01-2025,Sweeteners,NATURAL HONEY 250GM,16,150,130,20,1
19-01-2025,"Grains, Flours & Dals",Wheat Flour 1 kg,4,140,120,20,2
19-01-2025,"Grains, Flours & Dals",SRILATHA RICE RAVVA 500GM,4,70,70,0,2
19-01-2025,"Grains, Flours & Dals",THICK POHA 500GM,4,40,35,5,1
19-01-2025,Snacks & Ready-to-Eat,SD RED CHILLY PAPADS,14,80,80,0,1
19-01-2025,"Grains, Flours & Dals",Yellow jowar .F1 kg,4,110,100,10,1
19-01-2025,"Grains, Flours & Dals",White jowar.F 1 kg,4,100,80,20,1
19-01-2025,"Grains, Flours & Dals",Wheat Flour 1 kg,4,70,60,10,1
19-01-2025,"Dry Fruits, Nuts & Seeds",SABJA SEEDS 100GM,2,80,70,10,1
19-01-2025,"Dry Fruits, Nuts & Seeds",Groundnuts 1 kg,2,190,170,20,1
19-01-2025,"Dry Fruits, Nuts & Seeds",Groundnuts 500 gms,2,190,170,20,2
19-01-2025,"Grains, Flours & Dals",Brown RICE 1KG,4,1295,"1,202.50",92.5,18.5
19-01-2025,"Grains, Flours & Dals",Wheat Flour 1 kg,4,70,60,10,1
19-01-2025,"Grains, Flours & Dals",BOMBAY RAVA,4,70,55,15,1
19-01-2025,"Dry Fruits, Nuts & Seeds",PLAIN PISTA 250GM,2,660,550,110,1
19-01-2025,Snacks & Ready-to-Eat,Sprouted Ragi Biscuits 450GM,14,150,150,0,1
19-01-2025,"Grains, Flours & Dals",Multigrain 1 kg,4,100,85,15,1
19-01-2025,Snacks & Ready-to-Eat,SD JOWAR WITH PALM JAGGERY 250GM,14,135,135,0,1
19-01-2025,"Dry Fruits, Nuts & Seeds",Groundnuts 500 gms,2,95,85,10,1
19-01-2025,"Grains, Flours & Dals",MELMEKER 250GMS,4,60,45,15,1
19-01-2025,"Grains, Flours & Dals",SAMALU (Little millet) 1 kg,4,170,130,40,1
19-01-2025,Snacks & Ready-to-Eat,PALLI LADDU 200GMS,14,90,70,20,1
19-01-2025,Snacks & Ready-to-Eat,SESAME LADDU 200GM,14,100,80,20,1
19-01-2025,"Dry Fruits, Nuts & Seeds",SUNFLOWER SEEDS 250GRM,2,150,130,20,1
19-01-2025,Oils & Ghee,Safflower oil 1 L,9,880,800,80,2
19-01-2025,Snacks & Ready-to-Eat,SESAME LADDU 200GM,14,100,80,20,1
19-01-2025,"Dry Fruits, Nuts & Seeds",SATHVI CHIA SEEDS 100GM,2,100,80,20,1
19-01-2025,"Dry Fruits, Nuts & Seeds",PLAIN PISTA 250GM,2,660,550,110,1
19-01-2025,Oils & Ghee,cow ghee 500 ml,9,430,390,40,1
19-01-2025,Spices & Seasonings,SREE MARUTHI IDLY KARAM 200GM,15,120,120,0,2
19-01-2025,"Grains, Flours & Dals",SRILATHA RICE RAVVA 500GM,4,70,70,0,2
19-01-2025,Personal Care & Cosmetics,SVE PREMIUM PAPAYA SOAP 100GM,10,220,220,0,2
19-01-2025,Snacks & Ready-to-Eat,PALLI LADDU 200GMS,14,90,70,20,1
19-01-2025,"Dry Fruits, Nuts & Seeds",ALMONDS 250GM,2,280,260,20,1
19-01-2025,"Grains, Flours & Dals",SOYA BEANS 1KG,4,100,90,10,0.5
19-01-2025,Oils & Ghee,Groundnut oil 1 L,9,720,660,60,2
19-01-2025,Sweeteners,Natural Honey 500 gms,16,560,480,80,2
19-01-2025,Milk & Dairy,SANGAM CURD 450GM,7,38,38,0,1
19-01-2025,"Grains, Flours & Dals",RAJMA 250GM,4,55,45,10,1
19-01-2025,"Grains, Flours & Dals",Wheat Rava M 1KG,4,65,55,10,1
19-01-2025,"Grains, Flours & Dals",turdal 1kg,4,220,195,25,1
19-01-2025,"Grains, Flours & Dals",White Chana 500GM,4,120,100,20,1
19-01-2025,Snacks & Ready-to-Eat,SD Little Millet WITH PLAM JAGGERY,14,135,135,0,1
19-01-2025,"Grains, Flours & Dals",MELMEKER 250GMS,4,60,45,15,1
19-01-2025,Snacks & Ready-to-Eat,SD Sesame laddu with dates250gm,14,135,135,0,1
19-01-2025,"Grains, Flours & Dals",white Bobarlu 500 gms,4,80,75,5,1
19-01-2025,"Grains, Flours & Dals",Green gram 1 kg,4,300,260,40,2
19-01-2025,"Grains, Flours & Dals",KORRALU (FOXTAIL M) 500GM,4,65,55,10,1
19-01-2025,"Grains, Flours & Dals",PESARA PAPPU 1 KG,4,170,145,25,1
19-01-2025,Snacks & Ready-to-Eat,VD MINAPA VADIYAM,14,65,65,0,1
19-01-2025,"Dry Fruits, Nuts & Seeds",WALNUT ROUND 250GM,2,320,280,40,1
19-01-2025,"Grains, Flours & Dals",EM kodo upma R 500g,4,129,129,0,1
19-01-2025,"Dry Fruits, Nuts & Seeds",WALLNUTS 250GM,2,320,290,30,1
19-01-2025,"Dry Fruits, Nuts & Seeds",Groundnuts 500 gms,2,95,85,10,1
19-01-2025,"Grains, Flours & Dals",split black gram 1 kg,4,180,170,10,1
19-01-2025,Snacks & Ready-to-Eat,VD DAHI MIRCHI(SALTED) 100GM,14,45,45,0,1
19-01-2025,Snacks & Ready-to-Eat,KHARJURAM DRY FRUIT LADDU,14,180,180,0,1
19-01-2025,Spices & Seasonings,Japatri 25GM,15,100,80,20,1
19-01-2025,"Grains, Flours & Dals",RED TUDAL 1KG,4,150,140,10,1
19-01-2025,Snacks & Ready-to-Eat,VD GUMMADI VADIYAM,14,75,75,0,1
19-01-2025,Personal Care & Cosmetics,DETTOL SANITIZER,10,47,30,17,1
19-01-2025,"Grains, Flours & Dals",Multigrain 1 kg,4,200,170,30,2
19-01-2025,"Grains, Flours & Dals",Multigrain 1 kg,4,100,85,15,1
19-01-2025,Spices & Seasonings,Miriyalu 50GM,15,100,80,20,1
19-01-2025,"Dry Fruits, Nuts & Seeds",Groundnuts 500 gms,2,95,85,10,1
19-01-2025,"Grains, Flours & Dals",Em Multimillet idli r 500g,4,129,129,0,1
19-01-2025,Spices & Seasonings,KALONJI SEEDS,15,90,80,10,1
19-01-2025,Snacks & Ready-to-Eat,COPRA LADDU 200GM,14,100,80,20,1
19-01-2025,Sweeteners,YB Brown Sugar 1KG,16,140,140,0,1
19-01-2025,"Grains, Flours & Dals",JOWAR WHITE 1 KG,4,40,35,5,0.5
19-01-2025,"Grains, Flours & Dals",MULTIGRAIN 5.4,4,440,440,0,1
19-01-2025,"Grains, Flours & Dals",RAGULU 1 KG,4,70,60,10,1
19-01-2025,Oils & Ghee,Groundnut oil 500ml,9,180,165,15,1
19-01-2025,"Grains, Flours & Dals",RICE FLOUR 1KG,4,70,55,15,1
19-01-2025,"Grains, Flours & Dals",Chana Flour 500 gms,4,70,65,5,1
19-01-2025,Oils & Ghee,Coconut oil 500 ml,9,220,200,20,1
19-01-2025,"Grains, Flours & Dals",Wheat Flour 1 kg,4,140,120,20,2
19-01-2025,"Grains, Flours & Dals",Wheat Flour 1 kg,4,140,120,20,2
19-01-2025,"Grains, Flours & Dals",Wheat Flour 2 kgs,4,140,120,20,1
19-01-2025,"Grains, Flours & Dals",Wheat Flour 1 kg,4,70,60,10,1
19-01-2025,"Grains, Flours & Dals",RAGI FLOUR 500GRMS,4,40,35,5,1
19-01-2025,"Grains, Flours & Dals",BOMBAY RAVA,4,70,55,15,1
19-01-2025,Snacks & Ready-to-Eat,SESAME LADDU 200GM,14,100,80,20,1
19-01-2025,"Grains, Flours & Dals",Sathya Javva Wheat Rava 500GM,4,95,95,0,1
19-01-2025,Spices & Seasonings,Coriander seeds 200 gms,15,48,40,8,1
19-01-2025,Oils & Ghee,Sesame oil 500ml,9,295,280,15,1
19-01-2025,Spices & Seasonings,Tamarind 500GM,15,160,130,30,1
19-01-2025,"Grains, Flours & Dals",Urad dall 1 Kg,4,370,340,30,2
19-01-2025,Spices & Seasonings,SWEET SOUNF,15,20,20,0,1
19-01-2025,Spices & Seasonings,ROYAL SAFFRON 400GRMS,15,65,65,0,1
19-01-2025,"Grains, Flours & Dals",Chana Flour 500 gms,4,70,65,5,1
19-01-2025,"Dry Fruits, Nuts & Seeds",Groundnuts 500 gms,2,95,85,10,1
19-01-2025,"Grains, Flours & Dals",PESARA PAPPU 1 KG,4,170,145,25,1
19-01-2025,"Grains, Flours & Dals",RICE FLOUR 1KG,4,70,55,15,1
19-01-2025,"Grains, Flours & Dals",Multigrain 1 kg,4,100,85,15,1
19-01-2025,"Grains, Flours & Dals",RAGI FLOUR 500GRMS,4,40,35,5,1
19-01-2025,"Grains, Flours & Dals",Bajra Flour 500 gms,4,35,30,5,1
19-01-2025,Oils & Ghee,Sesame oil 1 L,9,590,560,30,1
19-01-2025,"Grains, Flours & Dals",WHEAT 1 KG,4,120,100,20,2
19-01-2025,Oils & Ghee,Groundnut oil 1 L,9,360,330,30,1
19-01-2025,"Grains, Flours & Dals",JOWAR YELLOW 1 K,4,50,45,5,0.5
19-01-2025,"Grains, Flours & Dals",BAJRA 1 KG,4,30,25,5,0.5
19-01-2025,"Grains, Flours & Dals",Yellow jowar.F 500 gms,4,55,50,5,1
19-01-2025,"Grains, Flours & Dals",FLOUR CHARGE,4,66,66,0,5.5
19-01-2025,Snacks & Ready-to-Eat,MP CHOCO ALMOND COOKIE,14,60,60,0,1
19-01-2025,Milk & Dairy,BROWN EGGS 1P,7,336,288,48,24
19-01-2025,Oils & Ghee,Groundnut oil 1 L,9,360,330,30,1
19-01-2025,"Health, Wellness & Ayurvedic Products",RB Max Protein Soft &Chewy 55gm,5,50,50,0,1
19-01-2025,"Grains, Flours & Dals",RAGI FLOUR 1KG,4,80,70,10,1
19-01-2025,Oils & Ghee,Sesame oil 1 L,9,1180,"1,120.00",60,2
19-01-2025,Snacks & Ready-to-Eat,VD JAGGERY GHEE 12PIC,14,180,180,0,1
19-01-2025,Sweeteners,GS Palm Jaggery Powder 400GM,16,180,180,0,1
19-01-2025,Oils & Ghee,Safflower oil 500 ml,9,220,200,20,1
19-01-2025,Pooja & Spiritual Items,GD KUMKUM 50GM,12,30,30,0,1
19-01-2025,Snacks & Ready-to-Eat,VD GUMMADI VADIYAM,14,75,75,0,1
19-01-2025,Pooja & Spiritual Items,VRP APOORVA JAVADHU POW,12,35,35,0,1
19-01-2025,Personal Care & Cosmetics,KHADI Neem Anti Dandruff Shampoo,10,199,199,0,1
19-01-2025,Snacks & Ready-to-Eat,SD Moringa with plam jaggery 250gm,14,135,135,0,1
19-01-2025,Personal Care & Cosmetics,UVIS MULTANI MITTI PW 100GM,10,98,98,0,2
19-01-2025,Personal Care & Cosmetics,UVIS ROSE WATER,10,75,75,0,1
19-01-2025,Snacks & Ready-to-Eat,SD Flax seeds with dates 250gm,14,135,135,0,1
19-01-2025,Personal Care & Cosmetics,DWI ALOEVERA 100GM,10,90,90,0,1
19-01-2025,Personal Care & Cosmetics,KHADI ACTIVATED CHARCOAL SOAP,10,80,80,0,1
19-01-2025,Snacks & Ready-to-Eat,SD Bajra with palm Jaggery 250gm,14,135,135,0,1
19-01-2025,Snacks & Ready-to-Eat,GANTASALA GINGER CANDY 200GM,14,105,105,0,1
19-01-2025,Personal Care & Cosmetics,MADDI HIBISCUS HAIR SHAMPOO 500ML,10,300,300,0,1
19-01-2025,Snacks & Ready-to-Eat,RAGI LADDU,14,120,120,0,1
19-01-2025,Oils & Ghee,Groundnut oil 1 L,9,360,330,30,1
19-01-2025,"Grains, Flours & Dals",Wheat Rava M 500GM,4,33,30,3,1
19-01-2025,Snacks & Ready-to-Eat,PEANUT CHILLI,14,10,10,0,2
19-01-2025,Snacks & Ready-to-Eat,NGT CHATPATTA CHANA 90GM,14,25,25,0,1
19-01-2025,"Grains, Flours & Dals",Multigrain 1 kg,4,100,85,15,1
19-01-2025,"Grains, Flours & Dals",RAGI FLOUR 1KG,4,80,70,10,1
19-01-2025,"Dry Fruits, Nuts & Seeds",PUMPKIN SEEDS 250GM,2,200,160,40,1
19-01-2025,"Grains, Flours & Dals",RAJMA 250GM,4,55,45,10,1
19-01-2025,Oils & Ghee,Groundnut oil 1 L,9,360,330,30,1
19-01-2025,Snacks & Ready-to-Eat,BATANA NGT 70GMS,14,20,20,0,1
19-01-2025,"Health, Wellness & Ayurvedic Products",DWI EUCALYPTUS 8ML,5,80,80,0,1
19-01-2025,"Grains, Flours & Dals",SAMALU (Little millet) 500 gms,4,85,65,20,1
19-01-2025,"Grains, Flours & Dals",UDALU (Barnyard millet) 500 gms,4,70,60,10,1
19-01-2025,"Grains, Flours & Dals",White Chana 250 GM,4,60,50,10,1
19-01-2025,"Grains, Flours & Dals",SPLIT BLACK GRAM 500 GM,4,90,85,5,1
19-01-2025,"Grains, Flours & Dals",Arikalu (kodo),4,70,65,5,1
19-01-2025,"Grains, Flours & Dals",KORRALU (FOXTAIL M) 500GM,4,65,55,10,1
19-01-2025,"Grains, Flours & Dals",WHITE BATANI 500GM,4,80,60,20,1
19-01-2025,Sweeteners,MISHRI 250 GM,16,35,30,5,1
19-01-2025,Oils & Ghee,GANTASALA A2 COW GHEE 250ML,9,299,299,0,1
19-01-2025,Spices & Seasonings,Elaichi 25GM,15,145,120,25,1
19-01-2025,Sweeteners,NATURAL HONEY 250GM,16,150,130,20,1
19-01-2025,"Health, Wellness & Ayurvedic Products",MD Vasa Choornam 30GM,5,80,80,0,1
19-01-2025,Beverages,MUA COFFEE EXT STRONG 250GM,1,140,140,0,1
19-01-2025,Oils & Ghee,Groundnut oil 1 L,9,360,330,30,1
19-01-2025,"Health, Wellness & Ayurvedic Products",MD Hibiscus Flower Choornam 30GM,5,100,100,0,1
19-01-2025,Oils & Ghee,Groundnut oil 1 L,9,360,330,30,1
19-01-2025,Oils & Ghee,Coconut oil 500 ml,9,220,200,20,1
19-01-2025,Snacks & Ready-to-Eat,SD Moringa with plam jaggery 250gm,14,135,135,0,1
19-01-2025,"Grains, Flours & Dals",PESARA PAPPU 500GMS,4,85,75,10,1
19-01-2025,"Grains, Flours & Dals",HS Multimillet idly R 500 gms,4,65,65,0,1
19-01-2025,"Dry Fruits, Nuts & Seeds",SD Mango cubes 200gm,2,90,90,0,1
19-01-2025,"Grains, Flours & Dals",Wheat Rava M 1KG,4,65,55,10,1
19-01-2025,"Grains, Flours & Dals",SPLIT BLACK GRAM 500 GM,4,90,85,5,1
19-01-2025,"Grains, Flours & Dals",Green gram 1 kg,4,150,130,20,1
19-01-2025,"Grains, Flours & Dals",Wheat Flour 1 kg,4,70,60,10,1
19-01-2025,"Grains, Flours & Dals",RICE FLOUR 1KG,4,70,55,15,1
19-01-2025,Oils & Ghee,Groundnut oil 5 L,9,1800,"1,600.00",200,1
19-01-2025,Spices & Seasonings,SATHVI BIRYANI LEAF 25GM,15,30,20,10,1
19-01-2025,Spices & Seasonings,Lavangam 50GM,15,60,50,10,1
19-01-2025,Spices & Seasonings,SAJEERA,15,60,40,20,1
19-01-2025,"Dry Fruits, Nuts & Seeds",PULMAKHANA 100 GM,2,180,170,10,1
19-01-2025,Spices & Seasonings,Marati Magga 50GM,15,130,110,20,1
19-01-2025,Spices & Seasonings,SREE MARUTHI IDLY KARAM 200GM,15,60,60,0,1
19-01-2025,"Grains, Flours & Dals",SRILATHA RICE RAVVA 500GM,4,35,35,0,1
19-01-2025,"Dry Fruits, Nuts & Seeds",Putnalu 250GM,2,45,38,7,1
19-01-2025,"Grains, Flours & Dals",RAGI FLOUR 500GRMS,4,40,35,5,1
19-01-2025,Pooja & Spiritual Items,GD Aiswarya Deepam 700ML,12,195,195,0,1
19-01-2025,Sweeteners,ACHU BELLAM 1KG,16,100,80,20,1
19-01-2025,"Grains, Flours & Dals",Wheat Rava M 500GM,4,33,30,3,1
19-01-2025,"Grains, Flours & Dals",Bombay Rava 500GM,4,35,30,5,1
19-01-2025,Spices & Seasonings,AV Iodized Salt 1KG,15,28,25,3,1
19-01-2025,Sweeteners,Mishri 500GM,16,70,60,10,1
19-01-2025,"Grains, Flours & Dals",SRILALITHA MAIDA FLOUR 500G,4,64,64,0,2
19-01-2025,"Grains, Flours & Dals",Urad dall 1 Kg,4,185,170,15,1
19-01-2025,"Dry Fruits, Nuts & Seeds",Groundnuts 500 gms,2,95,85,10,1
19-01-2025,Snacks & Ready-to-Eat,DISANO MACARONI 400GM,14,55,55,0,1
19-01-2025,Oils & Ghee,Sesame oil 500ml,9,295,280,15,1
19-01-2025,"Grains, Flours & Dals",Wheat Flour 1 kg,4,140,120,20,2
19-01-2025,Oils & Ghee,Safflower oil 1 L,9,440,400,40,1
19-01-2025,Oils & Ghee,Groundnut oil 1 L,9,360,330,30,1
19-01-2025,Oils & Ghee,Groundnut oil 1 L,9,360,330,30,1
19-01-2025,"Grains, Flours & Dals",SINGHAM 26KG BAG,4,1650,"1,650.00",0,1
19-01-2025,Snacks & Ready-to-Eat,VD PESARA PAPAD 195GM,14,70,70,0,1
19-01-2025,"Grains, Flours & Dals",Urad dall 1 Kg,4,185,170,15,1
19-01-2025,"Grains, Flours & Dals",JOWAR WHITE 1 KG,4,80,70,10,1
19-01-2025,"Grains, Flours & Dals",BAJRA 1 KG,4,60,50,10,1
19-01-2025,Spices & Seasonings,Black Till 250GM,15,180,150,30,2
19-01-2025,Pickles & Cooking Pastes,SD TOMATO PICKLE,11,110,110,0,1
19-01-2025,"Grains, Flours & Dals",PESARA PAPPU 1 KG,4,170,145,25,1
19-01-2025,Spices & Seasonings,SAJEERA,15,60,40,20,1
19-01-2025,"Dry Fruits, Nuts & Seeds",YELLOW KISHMISH 250GM,2,130,110,20,1
19-01-2025,"Dry Fruits, Nuts & Seeds",CASHEW 250GM,2,340,310,30,1
19-01-2025,Spices & Seasonings,ROYAL SAFFRON,15,125,125,0,1
19-01-2025,Snacks & Ready-to-Eat,SD Thati thandra 200gm,14,150,150,0,1
19-01-2025,"Grains, Flours & Dals",SH RED POHA 500GM,4,75,75,0,1
19-01-2025,"Grains, Flours & Dals",CHANA DAL 1KG,4,140,120,20,1
19-01-2025,Oils & Ghee,Groundnut oil 1 L,9,360,330,30,1
19-01-2025,Spices & Seasonings,Elaichi 25GM,15,145,120,25,1
19-01-2025,"Dry Fruits, Nuts & Seeds",SALTED PISTA 250GM,2,400,350,50,1
19-01-2025,Snacks & Ready-to-Eat,PALLI LADDU 200GMS,14,90,70,20,1
19-01-2025,Spices & Seasonings,LG 50GM,15,92,92,0,1
19-01-2025,Spices & Seasonings,Gasagasalu 50GM,15,130,110,20,1
19-01-2025,"Grains, Flours & Dals",SRILALITHA MAIDA FLOUR 500G,4,32,32,0,1
19-01-2025,Oils & Ghee,A2 BUFFALO GHEE 250ML,9,299,299,0,1
19-01-2025,"Grains, Flours & Dals",Chana Flour 1 kg,4,140,130,10,1
19-01-2025,Snacks & Ready-to-Eat,Corn Chips 250GM,14,160,140,20,4
19-01-2025,"Grains, Flours & Dals",THICK POHA 1KG,4,80,70,10,1
19-01-2025,Spices & Seasonings,Telaga Pindi 250 GM,15,40,35,5,1
19-01-2025,"Grains, Flours & Dals",FLOUR CHARGE,4,18,18,0,1.5
19-01-2025,Milk & Dairy,SANGAM TONED MILK 500ML,7,30,30,0,1
19-01-2025,Snacks & Ready-to-Eat,Corn Chips 250GM,14,40,35,5,1
19-01-2025,Sweeteners,YB JAGGERY POWDER 500GMS,16,75,75,0,1
19-01-2025,"Grains, Flours & Dals",RAGI FLOUR 500GRMS,4,40,35,5,1
19-01-2025,"Grains, Flours & Dals",Multigrain 1 kg,4,100,85,15,1
19-01-2025,"Grains, Flours & Dals",white Bobarlu 500 gms,4,80,75,5,1
19-01-2025,Milk & Dairy,SANGAM TONED MILK 500ML,7,30,30,0,1
19-01-2025,"Grains, Flours & Dals",Yellow jowar .F1 kg,4,110,100,10,1
19-01-2025,Snacks & Ready-to-Eat,BLACK SESAME CHIKKI,14,5,5,0,1
19-01-2025,"Dry Fruits, Nuts & Seeds",FLAX SEEDS 250GM,2,60,50,10,1
19-01-2025,"Grains, Flours & Dals",Wheat Flour 1 kg,4,70,60,10,1
19-01-2025,"Grains, Flours & Dals",RAGI FLOUR 500GRMS,4,40,35,5,1
19-01-2025,Oils & Ghee,Mustard oil 500 ml,9,220,195,25,1
19-01-2025,"Health, Wellness & Ayurvedic Products",RB Max Protein Classic Creamy,5,169,169,0,1
19-01-2025,Personal Care & Cosmetics,NM DEEP IMPACT,10,240,216,24,1
19-01-2025,"Grains, Flours & Dals",MELMEKER 250GMS,4,60,45,15,1
19-01-2025,Snacks & Ready-to-Eat,PEANUT CHILLI,14,10,10,0,2
19-01-2025,Spices & Seasonings,AVALU 100GM,15,25,20,5,1
19-01-2025,"Grains, Flours & Dals",CHANA DAL 500GM,4,70,60,10,1
19-01-2025,Oils & Ghee,Coconut oil 500 ml,9,220,200,20,1
19-01-2025,Sweeteners,ACHU BELLAM 1KG,16,100,80,20,1
19-01-2025,General Household & Kitchenware,MATCH BOX,3,40,40,0,2
19-01-2025,Oils & Ghee,Groundnut oil 1 L,9,360,330,30,1
19-01-2025,"Dry Fruits, Nuts & Seeds",PULMAKHANA 100 GM,2,180,170,10,1
19-01-2025,"Grains, Flours & Dals",BAJRA 1 KG,4,60,50,10,1
19-01-2025,"Grains, Flours & Dals",JOWAR YELLOW 1 K,4,100,90,10,1
19-01-2025,"Grains, Flours & Dals",SAMALU (Little millet) 500 gms,4,85,65,20,1
19-01-2025,"Grains, Flours & Dals",THICK POHA 500GM,4,40,35,5,1
19-01-2025,"Grains, Flours & Dals",Green gram 500 gms,4,75,70,5,1
19-01-2025,"Grains, Flours & Dals",Em Little idli R 500g,4,129,129,0,1
19-01-2025,"Grains, Flours & Dals",DESI CHANA,4,25,25,0,1
19-01-2025,"Grains, Flours & Dals",SH WHITE POHA 500GM,4,75,75,0,1
19-01-2025,"Dry Fruits, Nuts & Seeds",Groundnuts 1 kg,2,190,170,20,1
19-01-2025,"Grains, Flours & Dals",Urad dall 1 Kg,4,370,340,30,2
19-01-2025,"Dry Fruits, Nuts & Seeds",Groundnuts 1 kg,2,190,170,20,1
19-01-2025,"Grains, Flours & Dals",Wheat Flour 1 kg,4,70,60,10,1
19-01-2025,Snacks & Ready-to-Eat,VD PANIPURI 100GM,14,30,30,0,1
19-01-2025,Snacks & Ready-to-Eat,Corn Chips 250GM,14,40,35,5,1
19-01-2025,"Grains, Flours & Dals",Em jowar idly R 500G,4,150,150,0,2
19-01-2025,"Grains, Flours & Dals",Multigrain 1 kg,4,200,170,30,2
19-01-2025,"Grains, Flours & Dals",Arikadu ( kodo),4,140,130,10,1
19-01-2025,"Grains, Flours & Dals",JOWAR YELLOW 1 K,4,100,90,10,1
19-01-2025,"Grains, Flours & Dals",SA YELLOW JOWAR RAVA 500GM,4,95,95,0,1
19-01-2025,"Grains, Flours & Dals",YB NAVARA RICE 500GM,4,100,100,0,1
19-01-2025,"Grains, Flours & Dals",RAGI FLOUR 1KG,4,80,70,10,1
19-01-2025,"Grains, Flours & Dals",Em Little idli R 500g,4,129,129,0,1
19-01-2025,Oils & Ghee,Groundnut oil 1 L,9,720,660,60,2
19-01-2025,Snacks & Ready-to-Eat,SATHVI REGIVADA 200GM,14,80,60,20,1
19-01-2025,"Grains, Flours & Dals",FLOUR CHARGE,4,20.4,20.4,0,1.7
19-01-2025,"Dry Fruits, Nuts & Seeds",SD Mango cubes 100gm,2,45,45,0,1
19-01-2025,Oils & Ghee,Safflower oil 500 ml,9,220,200,20,1
19-01-2025,Oils & Ghee,Sesame oil 500ml,9,295,280,15,1
19-01-2025,"Grains, Flours & Dals",Green gram 1 kg,4,150,130,20,1
19-01-2025,Spices & Seasonings,Coconut Powder 250GM,15,90,70,20,1
19-01-2025,"Grains, Flours & Dals",Em little upma R 500g,4,129,129,0,1
19-01-2025,Spices & Seasonings,Telaga Pindi 250 GM,15,40,35,5,1
19-01-2025,"Grains, Flours & Dals",RAGI FLOUR 500GRMS,4,40,35,5,1
19-01-2025,Baking & Cooking Aids,GONDH 50GRMS,0,50,40,10,1
19-01-2025,"Health, Wellness & Ayurvedic Products",MD Rose Patals Choornam 30GM,5,90,90,0,1
19-01-2025,"Grains, Flours & Dals",Wheat Flour 1 kg,4,70,60,10,1
19-01-2025,Personal Care & Cosmetics,GA DANT MANJAN TP 50GM,10,60,60,0,1
19-01-2025,Snacks & Ready-to-Eat,Corn Chips 250GM,14,160,140,20,4
19-01-2025,Sweeteners,PN ORGANIC BROWN SUGAR 500GM,16,78,78,0,1
19-01-2025,"Grains, Flours & Dals",Yellow jowar .F1 kg,4,110,100,10,1
19-01-2025,"Grains, Flours & Dals",CHANA DAL 500GM,4,70,60,10,1
19-01-2025,"Health, Wellness & Ayurvedic Products",MH Millets Malt 500GM,5,200,190,10,1
19-01-2025,Snacks & Ready-to-Eat,VD SAGOPAPAD 150GM,14,55,55,0,1
19-01-2025,Snacks & Ready-to-Eat,VD DAHI MIRCHI(SALTED) 100GM,14,45,45,0,1
19-01-2025,Snacks & Ready-to-Eat,RINGS 200GM,14,30,30,0,1
19-01-2025,"Health, Wellness & Ayurvedic Products",PULIPIRI WARTS REMOVER 9GM,5,125,125,0,1
19-01-2025,"Grains, Flours & Dals",Multigrain 1 kg,4,200,170,30,2
19-01-2025,"Health, Wellness & Ayurvedic Products",MADDI MUSCLE OIL PAIN 100ML,5,270,270,0,1
19-01-2025,Personal Care & Cosmetics,DWI ROSE WATER 120ML,10,90,90,0,1
19-01-2025,Snacks & Ready-to-Eat,VD RICE SAGO PAPAD 150GM,14,55,55,0,1
19-01-2025,Oils & Ghee,DWI VATADATEL 50ML,9,155,155,0,1
19-01-2025,Snacks & Ready-to-Eat,VD GUMMADI VADIYAM,14,75,75,0,1
19-01-2025,Snacks & Ready-to-Eat,VD DAHI MIRCHI(SALTED) 100GM,14,45,45,0,1
19-01-2025,Snacks & Ready-to-Eat,Sprouted Ragi Biscuits 450GM,14,150,150,0,1
19-01-2025,Milk & Dairy,BROWN EGGS TRAY 30P,7,720,660,60,2
19-01-2025,"Dry Fruits, Nuts & Seeds",DRYDATES YELLOW 250GM,2,135,120,15,1
19-01-2025,Oils & Ghee,Groundnut oil 500ml,9,180,165,15,1
19-01-2025,"Grains, Flours & Dals",Idly Rava L 1KG,4,60,50,10,1
19-01-2025,Spices & Seasonings,Coriander seeds 200 gms,15,48,40,8,1
19-01-2025,Household & Cleaning,RIN ANTIBAC NEEM EXTRACT 1KG,6,126,126,0,1
19-01-2025,"Dry Fruits, Nuts & Seeds",PULMAKHANA 100 GM,2,180,170,10,1
19-01-2025,Personal Care & Cosmetics,MYSORE SANDAL,10,164,164,0,2
19-01-2025,"Dry Fruits, Nuts & Seeds",Groundnuts 1 kg,2,190,170,20,1
19-01-2025,General Household & Kitchenware,GOOD HOME,3,15,15,0,1
19-01-2025,"Grains, Flours & Dals",BOMBAY RAVA,4,70,55,15,1
19-01-2025,"Grains, Flours & Dals",turdal 500 gms,4,110,100,10,1
19-01-2025,Oils & Ghee,Freedom Rice Bran Oil 1L,9,388,360,28,2
19-01-2025,Spices & Seasonings,TM MIRCH POWDER 200GM,15,163,163,0,1
19-01-2025,Oils & Ghee,Groundnut oil 1 L,9,360,330,30,1
19-01-2025,Pooja & Spiritual Items,GOMATHA AGARBATHI,12,150,150,0,2
19-01-2025,"Grains, Flours & Dals",BOMBAY RAVA,4,70,55,15,1
19-01-2025,Snacks & Ready-to-Eat,SATHVI REGIVADA 200GM,14,80,60,20,1
19-01-2025,Personal Care & Cosmetics,HIMALAYA LIP BALM 10GM,10,40,40,0,1
19-01-2025,"Grains, Flours & Dals",SA Sprouted Ragi Flour 500GM,4,69,69,0,1
19-01-2025,Spices & Seasonings,Turmeric powder 250 gms,15,100,75,25,1
19-01-2025,Snacks & Ready-to-Eat,VD PANIPURI 100GM,14,30,30,0,1
19-01-2025,Spices & Seasonings,Lavangam 50GM,15,60,50,10,1
19-01-2025,"Grains, Flours & Dals",Chana Flour 1 kg,4,140,130,10,1
19-01-2025,Oils & Ghee,Groundnut oil 1 L,9,360,330,30,1
19-01-2025,"Grains, Flours & Dals",RAGI FLOUR 1KG,4,80,70,10,1
19-01-2025,"Grains, Flours & Dals",RICE FLOUR 1KG,4,140,110,30,2
19-01-2025,Oils & Ghee,Safflower oil 1 L,9,1320,"1,200.00",120,3
19-01-2025,Oils & Ghee,Sesame oil 1 L,9,590,560,30,1
19-01-2025,"Grains, Flours & Dals",RED WHEAT 1 KG,4,240,240,0,2
19-01-2025,"Grains, Flours & Dals",Wheat Flour 1 kg,4,70,60,10,1
19-01-2025,"Grains, Flours & Dals",Wheat Flour 2 kgs,4,140,120,20,1
19-01-2025,"Dry Fruits, Nuts & Seeds",Groundnuts 1 kg,2,190,170,20,1
19-01-2025,Oils & Ghee,Mustard oil 1 L,9,880,800,80,2
19-01-2025,Oils & Ghee,Safflower oil 1 L,9,880,800,80,2
19-01-2025,Sweeteners,YB JAGGERY POWDER 500GMS,16,75,75,0,1
19-01-2025,"Grains, Flours & Dals",CHANA DAL 500GM,4,70,60,10,1
19-01-2025,Spices & Seasonings,Coriander seeds 200 gms,15,48,40,8,1
19-01-2025,"Grains, Flours & Dals",SABDANA,4,40,35,5,1
19-01-2025,Snacks & Ready-to-Eat,VD RICE SAGO PAPAD 150GM,14,55,55,0,1
19-01-2025,Snacks & Ready-to-Eat,SALTED PHALLI,14,25,25,0,1
19-01-2025,Spices & Seasonings,MM CHAT MASALA,15,44,44,0,1
19-01-2025,"Grains, Flours & Dals",White jowar.F 1 kg,4,400,320,80,4
19-01-2025,"Grains, Flours & Dals",Chana Flour 500 gms,4,70,65,5,1
19-01-2025,"Dry Fruits, Nuts & Seeds",Groundnuts 1 kg,2,190,170,20,1
19-01-2025,Spices & Seasonings,Coriander seeds 200 gms,15,48,40,8,1
19-01-2025,"Grains, Flours & Dals",Idly Rava L 1KG,4,60,50,10,1
19-01-2025,"Grains, Flours & Dals",SA WHITE JOWAR RAVA 500GM,4,138,138,0,2
19-01-2025,"Grains, Flours & Dals",White jowar.F 1 kg,4,100,80,20,1
19-01-2025,"Grains, Flours & Dals",Urad dall 1 Kg,4,185,170,15,1
19-01-2025,"Dry Fruits, Nuts & Seeds",PULMAKHANA 100 GM,2,180,170,10,1
19-01-2025,"Grains, Flours & Dals",Arikadu ( kodo),4,140,130,10,1
19-01-2025,"Grains, Flours & Dals",Multigrain 1 kg,4,100,85,15,1
19-01-2025,Spices & Seasonings,Jeera 100GM,15,100,90,10,2
19-01-2025,"Grains, Flours & Dals",SAMALU (Little millet) 1 kg,4,170,130,40,1
19-01-2025,"Dry Fruits, Nuts & Seeds",FLAX SEEDS 250GM,2,60,50,10,1
19-01-2025,"Grains, Flours & Dals",Bajra Flour 1 kg,4,70,60,10,1
19-01-2025,"Grains, Flours & Dals",UDALU (Barnyard millet) 1 kg,4,140,115,25,1
19-01-2025,"Grains, Flours & Dals",RAGI FLOUR 1KG,4,80,70,10,1
19-01-2025,"Grains, Flours & Dals",split green gram 1 kg,4,150,140,10,1
19-01-2025,"Grains, Flours & Dals",RAGI FLOUR 1KG,4,80,70,10,1
19-01-2025,Beverages,GANTASALA GREEN TEA 100GM,1,149,149,0,1
19-01-2025,"Grains, Flours & Dals",DISANO ROLED OATS,4,190,190,0,1
19-01-2025,Snacks & Ready-to-Eat,MB PEARL MILLET NOODLES 180GM,14,95,95,0,1
19-01-2025,Snacks & Ready-to-Eat,RINGS 200GM,14,30,30,0,1
19-01-2025,Snacks & Ready-to-Eat,VD SAGOPAPAD 150GM,14,55,55,0,1
19-01-2025,"Grains, Flours & Dals",SRILATHA RICE RAVVA 500GM,4,35,35,0,1
19-01-2025,Sweeteners,GS Organic Jaggery Powder 600GM,16,198,198,0,2
19-01-2025,Snacks & Ready-to-Eat,SD Moringa with plam jaggery 250gm,14,135,135,0,1
19-01-2025,Snacks & Ready-to-Eat,PALLI LADDU 200GMS,14,90,70,20,1
19-01-2025,"Grains, Flours & Dals",Em Multimillet upma 500g,4,129,129,0,1
19-01-2025,Oils & Ghee,Sesame oil 1 L,9,590,560,30,1
19-01-2025,Spices & Seasonings,KALONJI SEEDS,15,90,80,10,1
19-01-2025,Oils & Ghee,Coconut oil 500 ml,9,220,200,20,1
19-01-2025,"Health, Wellness & Ayurvedic Products",MD Bringaraj Choornam 100GM,5,80,80,0,1
19-01-2025,"Dry Fruits, Nuts & Seeds",FLAX SEEDS 250GM,2,60,50,10,1
19-01-2025,"Grains, Flours & Dals",DESI CHANA,4,50,50,0,2
19-01-2025,"Dry Fruits, Nuts & Seeds",Groundnuts 1 kg,2,190,170,20,1
19-01-2025,"Grains, Flours & Dals",Wheat Flour 1 kg,4,210,180,30,3
19-01-2025,Milk & Dairy,HRITAGE TONED MILK 500ML,7,30,30,0,1
19-01-2025,Milk & Dairy,SANGAM TONED MILK 500ML,7,60,60,0,2
19-01-2025,Milk & Dairy,TOTAL CURD 50GMS,7,10,10,0,1
19-01-2025,"Grains, Flours & Dals",BASMATHI RICE 1KG,4,300,270,30,2
19-01-2025,Spices & Seasonings,SATHVI ANASAPUVUU 25GM,15,90,65,25,1
19-01-2025,Spices & Seasonings,Japatri 25GM,15,100,80,20,1
19-01-2025,"Grains, Flours & Dals",Red Chana 500 GM,4,75,60,15,1
19-01-2025,Snacks & Ready-to-Eat,VD Minapa papad 200gm,14,60,60,0,1
19-01-2025,"Grains, Flours & Dals",Idly Rava L 1KG,4,60,50,10,1
19-01-2025,Spices & Seasonings,SAJEERA,15,60,40,20,1
19-01-2025,Spices & Seasonings,Black Till 250GM,15,90,75,15,1
19-01-2025,Spices & Seasonings,Gasagasalu 50GM,15,130,110,20,1
19-01-2025,Spices & Seasonings,PRO ORG BAY LEAF 50G,15,60,60,0,1
19-01-2025,"Grains, Flours & Dals",VYS.SP RICE 1 KG,4,140,130,10,2
19-01-2025,"Grains, Flours & Dals",Multigrain 1 kg,4,100,85,15,1
19-01-2025,"Grains, Flours & Dals",Red Bobarlu 1 kg,4,190,170,20,1
19-01-2025,Spices & Seasonings,Jeera 100GM,15,50,45,5,1
19-01-2025,Spices & Seasonings,CHILLI POWDER,15,290,210,80,1
19-01-2025,"Grains, Flours & Dals",turdal 1kg,4,220,195,25,1
19-01-2025,Snacks & Ready-to-Eat,BATANA NGT 70GMS,14,80,80,0,4
19-01-2025,"Grains, Flours & Dals",Wheat Rava M 1KG,4,130,110,20,2
19-01-2025,Snacks & Ready-to-Eat,URBAN MARMURA 450GM,14,60,55,5,1
19-01-2025,Oils & Ghee,Groundnut oil 1 L,9,360,330,30,1
19-01-2025,Oils & Ghee,Safflower oil 500 ml,9,220,200,20,1
19-01-2025,"Grains, Flours & Dals",CORN FLOUR,4,80,70,10,1
19-01-2025,"Grains, Flours & Dals",Wheat Flour 1 kg,4,70,60,10,1
19-01-2025,Snacks & Ready-to-Eat,PALLI LADDU 200GMS,14,90,70,20,1
19-01-2025,Oils & Ghee,Sesame oil 1 L,9,590,560,30,1
19-01-2025,"Grains, Flours & Dals",VYS.SP RICE 1 KG,4,700,650,50,10
19-01-2025,Snacks & Ready-to-Eat,BATANA NGT 70GMS,14,20,20,0,1
19-01-2025,Oils & Ghee,Castor oil 200 ml,9,100,80,20,1
19-01-2025,Snacks & Ready-to-Eat,RSC ORANGE 100GMS,14,20,20,0,1
19-01-2025,Snacks & Ready-to-Eat,RINGS 200GM,14,30,30,0,1
19-01-2025,"Health, Wellness & Ayurvedic Products",MD Aamlaki Choornam 100GM,5,80,80,0,1
19-01-2025,"Health, Wellness & Ayurvedic Products",MD Palleru Choornam 100GM,5,110,110,0,1
19-01-2025,"Health, Wellness & Ayurvedic Products",MD Guduchi Choornam 100GM,5,110,110,0,1
19-01-2025,Sweeteners,ACHU BELLAM 1KG,16,100,80,20,1
19-01-2025,"Health, Wellness & Ayurvedic Products",MD Punarnava Choornam 50GM,5,200,200,0,2
19-01-2025,"Grains, Flours & Dals",Em Little idli R 500g,4,129,129,0,1
19-01-2025,Oils & Ghee,Groundnut oil 1 L,9,360,330,30,1
19-01-2025,"Grains, Flours & Dals",EM Foxtail idli r 500 g,4,109,109,0,1
19-01-2025,Oils & Ghee,cow ghee 500 ml,9,430,390,40,1
19-01-2025,Personal Care & Cosmetics,SVE REETHA KUNKUDUKAYALU,10,199,199,0,1
19-01-2025,"Grains, Flours & Dals",UNPOLISHED TURDALL 1KG,4,240,220,20,1
19-01-2025,"Grains, Flours & Dals",RAJMA 500GM,4,90,90,0,1
19-01-2025,Personal Care & Cosmetics,Khadi Shikakai With Amla Shampoo 200,10,199,199,0,1
19-01-2025,Snacks & Ready-to-Eat,BATANA NGT 70GMS,14,60,60,0,3
19-01-2025,"Grains, Flours & Dals",White Chana 500GM,4,120,100,20,1
19-01-2025,"Grains, Flours & Dals",SA YELLOW JOWAR RAVA 500GM,4,95,95,0,1
19-01-2025,"Dry Fruits, Nuts & Seeds",Groundnuts 500 gms,2,95,85,10,1
19-01-2025,"Grains, Flours & Dals",Multigrain 1 kg,4,100,85,15,1
19-01-2025,Oils & Ghee,Groundnut oil 1 L,9,360,330,30,1
19-01-2025,Oils & Ghee,Groundnut oil 1 L,9,360,330,30,1
19-01-2025,"Grains, Flours & Dals",CHANA DAL 500GM,4,70,60,10,1
19-01-2025,Spices & Seasonings,DRY MIECHI 200GM,15,80,60,20,1
19-01-2025,"Grains, Flours & Dals",split black gram 1 kg,4,180,170,10,1
19-01-2025,Oils & Ghee,Sesame oil 1 L,9,590,560,30,1
19-01-2025,"Grains, Flours & Dals",SAMALU (Little millet) 500 gms,4,85,65,20,1
19-01-2025,"Grains, Flours & Dals",Em Multimillet upma 500g,4,129,129,0,1
19-01-2025,"Dry Fruits, Nuts & Seeds",PUMPKIN SEEDS 250GM,2,200,160,40,1
19-01-2025,"Grains, Flours & Dals",Em Multimillet idli r 500g,4,129,129,0,1
19-01-2025,Pooja & Spiritual Items,BALAJI KEWDA DHOOP STICKS 10STK,12,70,70,0,1
19-01-2025,"Grains, Flours & Dals",RAGULU 1 KG,4,70,60,10,1
19-01-2025,Spices & Seasonings,Jeera 100GM,15,50,45,5,1
19-01-2025,"Grains, Flours & Dals",RED TURDAL 500GM,4,75,70,5,1
19-01-2025,"Grains, Flours & Dals",BARLEY SEEDS 250GMS,4,40,35,5,1
19-01-2025,Spices & Seasonings,AVALU 100GM,15,25,20,5,1
19-01-2025,Personal Care & Cosmetics,VETIVER BATH SCRUB,10,50,50,0,1
19-01-2025,"Grains, Flours & Dals",DH URAD GOTA 1KG,4,215,190,25,1
19-01-2025,"Grains, Flours & Dals",Wheat Flour 1 kg,4,70,60,10,1
19-01-2025,Snacks & Ready-to-Eat,RI SPORTS BAR 40G,14,45,45,0,1
19-01-2025,Spices & Seasonings,Jeera 100GM,15,50,45,5,1
19-01-2025,"Dry Fruits, Nuts & Seeds",Groundnuts 1 kg,2,190,170,20,1
19-01-2025,Oils & Ghee,Groundnut oil 1 L,9,360,330,30,1
19-01-2025,General Household & Kitchenware,RED LINE 20GM,3,75,75,0,1
19-01-2025,Oils & Ghee,Sesame oil 500ml,9,295,280,15,1
19-01-2025,Oils & Ghee,Safflower oil 1 L,9,440,400,40,1
19-01-2025,Snacks & Ready-to-Eat,Corn Chips 250GM,14,40,35,5,1
19-01-2025,"Grains, Flours & Dals",RAGULU 1 KG,4,70,60,10,1
19-01-2025,Snacks & Ready-to-Eat,ZEEDI,14,70,70,0,1
19-01-2025,Oils & Ghee,Coconut oil 500 ml,9,220,200,20,1
19-01-2025,"Grains, Flours & Dals",Wheat Flour 1 kg,4,630,540,90,9
19-01-2025,Personal Care & Cosmetics,MYSORE SANDAL,10,138,138,0,2
19-01-2025,"Grains, Flours & Dals",SH WHITE POHA 500GM,4,75,75,0,1
19-01-2025,Misc,NOVA,8,68,68,0,1
19-01-2025,"Grains, Flours & Dals",RAGI FLOUR 1KG,4,80,70,10,1
19-01-2025,Milk & Dairy,BROWN EGGS TRAY 30P,7,360,330,30,1
19-01-2025,"Grains, Flours & Dals",Bombay Rava 500GM,4,35,30,5,1
19-01-2025,"Grains, Flours & Dals",THICK POHA 1KG,4,80,70,10,1
19-01-2025,"Grains, Flours & Dals",THIN POHA 500GM,4,40,35,5,1
19-01-2025,Oils & Ghee,Groundnut oil 1 L,9,360,330,30,1
19-01-2025,Oils & Ghee,Sesame oil 1 L,9,590,560,30,1
19-01-2025,Baking & Cooking Aids,GONDH 50GRMS,0,70,70,0,1
19-01-2025,Pooja & Spiritual Items,GD Aiswarya Deepam 700ML,12,195,195,0,1
19-01-2025,Oils & Ghee,Groundnut oil 1 L,9,360,330,30,1
19-01-2025,Spices & Seasonings,DRY MIECHI 200GM,15,80,60,20,1
19-01-2025,Snacks & Ready-to-Eat,NGT CHATPATTA CHANA 90GM,14,50,50,0,2
19-01-2025,"Grains, Flours & Dals",SAMALU (Little millet) 500 gms,4,85,65,20,1
19-01-2025,"Grains, Flours & Dals",RAGULU 1 KG,4,17.5,15,2.5,0.25
19-01-2025,Snacks & Ready-to-Eat,Corn Chips 250GM,14,40,35,5,1
19-01-2025,Pooja & Spiritual Items,VRP APOORVA JAVADHU POW,12,35,35,0,1
19-01-2025,"Grains, Flours & Dals",HS JOWAR FLAKES 250GM 1+1,4,119,119,0,1
19-01-2025,"Grains, Flours & Dals",Arikalu (kodo),4,70,65,5,1
19-01-2025,Snacks & Ready-to-Eat,SF MILLET NOODLES MILD MASALA 192GM,14,129,129,0,1
19-01-2025,"Grains, Flours & Dals",KORRALU (FOXTAIL M) 500GM,4,65,55,10,1
19-01-2025,"Grains, Flours & Dals",MAAGAANI MM KHAPLI ATTA 1KG,4,199,199,0,1
19-01-2025,Snacks & Ready-to-Eat,VD DAHI MIRCHI(SALTED) 100GM,14,45,45,0,1
19-01-2025,Spices & Seasonings,SREE MARUTHI IDLY KARAM 200GM,15,60,60,0,1
19-01-2025,"Grains, Flours & Dals",RICE FLOUR 1KG,4,70,55,15,1
19-01-2025,Oils & Ghee,Groundnut oil 1 L,9,720,660,60,2
19-01-2025,"Grains, Flours & Dals",RAGI FLOUR 1KG,4,80,70,10,1
19-01-2025,"Grains, Flours & Dals",Yellow jowar .F1 kg,4,110,100,10,1
19-01-2025,"Grains, Flours & Dals",Wheat Flour 1 kg,4,70,60,10,1
19-01-2025,"Grains, Flours & Dals",WHEAT 1 KG,4,180,150,30,3
19-01-2025,"Grains, Flours & Dals",FLOUR CHARGE,4,36,36,0,3
19-01-2025,"Health, Wellness & Ayurvedic Products",DWI MADIPHALA 100ML,5,150,150,0,2
19-01-2025,Oils & Ghee,Coconut oil 500 ml,9,220,200,20,1
19-01-2025,"Health, Wellness & Ayurvedic Products",DWI OMU WATER 100ML,5,40,40,0,1
19-01-2025,Oils & Ghee,Castor oil 200 ml,9,100,80,20,1
19-01-2025,Oils & Ghee,Groundnut oil 1 L,9,360,330,30,1
19-01-2025,Oils & Ghee,Olive Oil 1 L,9,1020,"1,020.00",0,1
19-01-2025,Oils & Ghee,Sesame oil 500ml,9,295,280,15,1
19-01-2025,Spices & Seasonings,Menthulu 250 gms,15,50,45,5,1
19-01-2025,Household & Cleaning,SURF EXCEL MATIC TL 500ML,6,130,130,0,1
19-01-2025,Personal Care & Cosmetics,MESWAK 100GM,10,140,140,0,2
19-01-2025,"Grains, Flours & Dals",VYS.SP RICE 1 KG,4,140,130,10,2
19-01-2025,Spices & Seasonings,NUVVULU 250GM,15,80,65,15,1
19-01-2025,Snacks & Ready-to-Eat,SATHVI REGIVADA 200GM,14,80,60,20,1
19-01-2025,Snacks & Ready-to-Eat,SESAME LADDU 200GM,14,100,80,20,1
19-01-2025,Household & Cleaning,EXO STEEL SCRUB,6,15,15,0,1
19-01-2025,Snacks & Ready-to-Eat,COPRA LADDU 200GM,14,100,80,20,1
19-01-2025,"Grains, Flours & Dals",VGR rice 1 kg,4,350,325,25,5
19-01-2025,"Grains, Flours & Dals",White jowar.F 1 kg,4,100,80,20,1
19-01-2025,"Grains, Flours & Dals",VGR rice 1 kg,4,280,260,20,4
19-01-2025,Oils & Ghee,Sesame oil 1 L,9,590,560,30,1
19-01-2025,Snacks & Ready-to-Eat,SATHVI REGIVADA 200GM,14,80,60,20,1
19-01-2025,"Grains, Flours & Dals",RAGI FLOUR 500GRMS,4,40,35,5,1
19-01-2025,Snacks & Ready-to-Eat,VD PAPPU CHEGODI 200GM,14,60,60,0,1
19-01-2025,Snacks & Ready-to-Eat,SD FINGER Millet with palm Jaggery 250gm,14,135,135,0,1
19-01-2025,Snacks & Ready-to-Eat,VD MIXTURE 175 GM,14,60,60,0,1
19-01-2025,Milk & Dairy,BROWN EGGS TRAY 30P,7,360,330,30,1
19-01-2025,"Grains, Flours & Dals",FLOUR CHARGE,4,12,12,0,1
19-01-2025,Snacks & Ready-to-Eat,RSC ORANGE 100GMS,14,20,20,0,1
19-01-2025,Spices & Seasonings,SATHVI ANASAPUVUU 25GM,15,90,65,25,1
19-01-2025,"Grains, Flours & Dals",BASMATHI RICE 1KG,4,150,135,15,1
19-01-2025,Spices & Seasonings,Miriyalu 50GM,15,100,80,20,1
19-01-2025,Milk & Dairy,BROWN EGGS 1P,7,140,120,20,10
19-01-2025,Spices & Seasonings,Marati Magga 50GM,15,130,110,20,1
19-01-2025,Spices & Seasonings,SREE MARUTHI IDLY KARAM 200GM,15,60,60,0,1
19-01-2025,Oils & Ghee,Coconut oil 1 L,9,440,400,40,1
19-01-2025,"Grains, Flours & Dals",RAGULU 1 KG,4,70,60,10,1
19-01-2025,Oils & Ghee,Safflower oil 1 L,9,440,400,40,1
19-01-2025,Spices & Seasonings,Tamarind 250GMS,15,80,65,15,1
19-01-2025,Spices & Seasonings,Vamu 100GM,15,60,50,10,1
19-01-2025,"Grains, Flours & Dals",SAMALU (Little millet) 1 kg,4,170,130,40,1
19-01-2025,Oils & Ghee,Groundnut oil 1 L,9,360,330,30,1
19-01-2025,"Grains, Flours & Dals",turdal 1kg,4,220,195,25,1
19-01-2025,Spices & Seasonings,Menthulu 500 gms,15,100,90,10,1
19-01-2025,"Dry Fruits, Nuts & Seeds",Groundnuts 1 kg,2,190,170,20,1
19-01-2025,"Grains, Flours & Dals",Urad dall 1 Kg,4,185,170,15,1
19-01-2025,"Grains, Flours & Dals",BAJRA 1 KG,4,60,50,10,1
19-01-2025,"Grains, Flours & Dals",BARLEY FLOUR 500GM,4,90,80,10,1
19-01-2025,"Grains, Flours & Dals",Chana Flour 500 gms,4,70,65,5,1
19-01-2025,Spices & Seasonings,Turmeric powder 250 gms,15,100,75,25,1
19-01-2025,"Grains, Flours & Dals",Urad dall 1 Kg,4,185,170,15,1
19-01-2025,"Health, Wellness & Ayurvedic Products",RAMA BALM 10ML,5,40,40,0,1
19-01-2025,"Dry Fruits, Nuts & Seeds",Groundnuts 500 gms,2,95,85,10,1
19-01-2025,"Grains, Flours & Dals",split urad dall 500 gms,4,90,80,10,1
19-01-2025,Sweeteners,SUGAR 500 GM,16,90,75,15,3
19-01-2025,"Grains, Flours & Dals",CHANA DAL 500GM,4,70,60,10,1
19-01-2025,"Grains, Flours & Dals",Idly Rava L 1KG,4,60,50,10,1
19-01-2025,"Grains, Flours & Dals",MAAGAANI SP RICE 20 KGS,4,4600,"3,920.00",680,2
19-01-2025,"Dry Fruits, Nuts & Seeds",KAJU HALF 250GM,2,310,290,20,1
19-01-2025,Spices & Seasonings,TATA SALT 1KG,15,30,30,0,1
19-01-2025,Pickles & Cooking Pastes,CHICKEN PICKLE 200GM,11,300,280,20,1
19-01-2025,"Grains, Flours & Dals",BOMBAY RAVA,4,70,55,15,1
19-01-2025,Spices & Seasonings,Marati Magga 50GM,15,130,110,20,1
19-01-2025,Spices & Seasonings,Tamarind 250GMS,15,80,65,15,1
19-01-2025,"Grains, Flours & Dals",SRILATHA RICE RAVVA 500GM,4,35,35,0,1
19-01-2025,"Health, Wellness & Ayurvedic Products",RB Max Protein DESI MASALA 60gm,5,45,45,0,1
19-01-2025,Sweeteners,ACHUBELLAM 500GM,16,50,40,10,1
19-01-2025,Personal Care & Cosmetics,VASELINE INTENSIVE CARE COCOA GLOW,10,115,115,0,1
19-01-2025,Pooja & Spiritual Items,JAGI KAYA 25GM,12,80,60,20,1
19-01-2025,Pickles & Cooking Pastes,SD MANGO PICKLE,11,110,110,0,1
19-01-2025,Sweeteners,MISHRI D,16,40,30,10,1
19-01-2025,"Health, Wellness & Ayurvedic Products",RB Max Protein Spanish Tomato,5,45,45,0,1
19-01-2025,Oils & Ghee,Groundnut oil 1 L,9,360,330,30,1
19-01-2025,Sweeteners,NATURAL HONEY 250GM,16,150,130,20,1
19-01-2025,Oils & Ghee,Sesame oil 1 L,9,590,560,30,1
19-01-2025,Oils & Ghee,Groundnut oil 1 L,9,360,330,30,1
19-01-2025,Oils & Ghee,Sesame oil 1 L,9,1770,"1,680.00",90,3
19-01-2025,"Health, Wellness & Ayurvedic Products",MH Millets Malt 500GM,5,200,190,10,1
19-01-2025,Milk & Dairy,HERITAGE CURD,7,48,48,0,1
19-01-2025,Milk & Dairy,HRITAGE TONED MILK 500ML,7,30,30,0,1
19-01-2025,"Grains, Flours & Dals",Wheat Rava M 500GM,4,33,30,3,1
19-01-2025,Oils & Ghee,Groundnut oil 1 L,9,360,330,30,1
19-01-2025,"Grains, Flours & Dals",turdal 1kg,4,220,195,25,1
19-01-2025,"Grains, Flours & Dals",Bajra Flour 1 kg,4,70,60,10,1
19-01-2025,"Grains, Flours & Dals",RICE FLOUR 500 GM,4,35,28,7,1
19-01-2025,"Dry Fruits, Nuts & Seeds",Groundnuts 1 kg,2,190,170,20,1
19-01-2025,"Grains, Flours & Dals",SL Suji Rava 500GM,4,64,64,0,2
19-01-2025,"Grains, Flours & Dals",Yellow jowar.F 500 gms,4,55,50,5,1
19-01-2025,Sweeteners,YB JAGGERY POWDER 500GMS,16,75,75,0,1
19-01-2025,"Grains, Flours & Dals",DH URAD GOTA 1KG,4,215,190,25,1
19-01-2025,"Grains, Flours & Dals",Wheat Flour 1 kg,4,210,180,30,3
19-01-2025,"Grains, Flours & Dals",RAGI FLOUR 500GRMS,4,40,35,5,1
19-01-2025,Milk & Dairy,BROWN EGGS 1P,7,280,240,40,20
19-01-2025,"Grains, Flours & Dals",VYS.SP.RICE 5 KGS,4,350,325,25,1
19-01-2025,Spices & Seasonings,Jeera 100GM,15,50,45,5,1
19-01-2025,Spices & Seasonings,Vamu 100GM,15,60,50,10,1
19-01-2025,Oils & Ghee,Groundnut oil 1 L,9,720,660,60,2
19-01-2025,Pooja & Spiritual Items,GD Aiswarya Deepam 700ML,12,195,195,0,1
19-01-2025,Spices & Seasonings,SONTI 50GM,15,30,20,10,1
19-01-2025,Sweeteners,Mishri 500GM,16,70,60,10,1
19-01-2025,Spices & Seasonings,Menthulu 250 gms,15,50,45,5,1
19-01-2025,"Dry Fruits, Nuts & Seeds",CASHEW 250GM,2,340,310,30,1
19-01-2025,Spices & Seasonings,Menthulu 250 gms,15,50,45,5,1
19-01-2025,"Grains, Flours & Dals",SPLIT BLACK GRAM 500 GM,4,90,85,5,1
19-01-2025,Spices & Seasonings,JEERA 250 gms,15,125,105,20,1
19-01-2025,"Dry Fruits, Nuts & Seeds",Groundnuts 500 gms,2,95,85,10,1
19-01-2025,"Grains, Flours & Dals",BAJRA 1 KG,4,60,50,10,1
19-01-2025,"Grains, Flours & Dals",MAAGAANI LOW GI SP 1KG,4,315,315,0,3
19-01-2025,"Dry Fruits, Nuts & Seeds",Putnalu 250GM,2,45,38,7,1
19-01-2025,Spices & Seasonings,Vamu 100GM,15,60,50,10,1
19-01-2025,"Grains, Flours & Dals",URAD DALL,4,95,85,10,1
19-01-2025,"Grains, Flours & Dals",CHANA DAL 1KG,4,140,120,20,1
19-01-2025,"Grains, Flours & Dals",turdal 1kg,4,440,390,50,2
19-01-2025,"Grains, Flours & Dals",Bajra Flour 1 kg,4,70,60,10,1
19-01-2025,"Grains, Flours & Dals",SINGLE POLISH 1KG,4,65,65,0,1
19-01-2025,Oils & Ghee,Groundnut oil 1 L,9,360,330,30,1
19-01-2025,Personal Care & Cosmetics,COLGATE KIDS 2 PLUS,10,30,30,0,1
19-01-2025,Oils & Ghee,Mustard oil 1 L,9,440,400,40,1
19-01-2025,Snacks & Ready-to-Eat,VD SAGOPAPAD 150GM,14,55,55,0,1
19-01-2025,Spices & Seasonings,Turmeric powder 250 gms,15,100,75,25,1
19-01-2025,Snacks & Ready-to-Eat,VD MINAPA SUNNUNDALU 12P,14,180,180,0,1
19-01-2025,"Grains, Flours & Dals",Multigrain 1 kg,4,100,85,15,1
19-01-2025,Oils & Ghee,Mustard oil 500 ml,9,220,195,25,1
19-01-2025,Oils & Ghee,Sesame oil 1 L,9,590,560,30,1
19-01-2025,"Grains, Flours & Dals",SINGHAM 26KG BAG,4,1650,"1,650.00",0,1
19-01-2025,Spices & Seasonings,DRY MIECHI 200GM,15,160,120,40,2
19-01-2025,Oils & Ghee,Sesame oil 500ml,9,590,560,30,2
19-01-2025,Oils & Ghee,Groundnut oil 500ml,9,360,330,30,2
19-01-2025,"Grains, Flours & Dals",Wheat Flour 2 kgs,4,140,120,20,1
19-01-2025,Spices & Seasonings,Jeera 100GM,15,50,45,5,1
19-01-2025,"Grains, Flours & Dals",PESARA PAPPU 500GMS,4,85,75,10,1
19-01-2025,"Grains, Flours & Dals",Wheat Flour 1 kg,4,140,120,20,2
19-01-2025,Oils & Ghee,Groundnut oil 500ml,9,180,165,15,1
19-01-2025,Milk & Dairy,HERITAGE CURD,7,48,48,0,1
19-01-2025,Milk & Dairy,HRITAGE TONED MILK 500ML,7,30,30,0,1
19-01-2025,Snacks & Ready-to-Eat,WHOLE WHEAT BREAD,14,55,55,0,1
19-01-2025,"Grains, Flours & Dals",MAAGAANI LOW GI SP 1KG,4,525,525,0,5
19-01-2025,Snacks & Ready-to-Eat,NGT CHATPATTA CHANA 90GM,14,25,25,0,1
19-01-2025,Snacks & Ready-to-Eat,RAJGIRA PEANUT CHIKKI,14,30,30,0,6
19-01-2025,Sweeteners,Natural Honey 500 gms,16,280,240,40,1
19-01-2025,"Grains, Flours & Dals",Wheat Rava M 1KG,4,65,55,10,1
19-01-2025,"Grains, Flours & Dals",KORRALU (FOXTAIL M) 500GM,4,65,55,10,1
19-01-2025,Oils & Ghee,BUFFALLO GHEE 500ML,9,410,370,40,1
19-01-2025,Snacks & Ready-to-Eat,TILLI CHIKKI,14,30,30,0,6
19-01-2025,Spices & Seasonings,AVALU 100GM,15,25,20,5,1
19-01-2025,Milk & Dairy,SANGAM FULL CREAM MILK 500ML,7,38,38,0,1
19-01-2025,"Grains, Flours & Dals",Bombay Rava 500GM,4,35,30,5,1
19-01-2025,Milk & Dairy,BROWN EGGS TRAY 30P,7,360,330,30,1
19-01-2025,Oils & Ghee,Sesame oil 5 L,9,2950,"2,750.00",200,1
19-01-2025,Milk & Dairy,TOTAL CURD 50GMS,7,10,10,0,1
19-01-2025,"Health, Wellness & Ayurvedic Products",RB Max Protein Jaggery Crunchy,5,175,175,0,1
19-01-2025,"Grains, Flours & Dals",HS RAGI FLAKES 250GM 1+1,4,119,119,0,1
19-01-2025,Oils & Ghee,Groundnut oil 1 L,9,720,660,60,2
19-01-2025,Spices & Seasonings,CHILLI POWDER,15,290,210,80,1
19-01-2025,Oils & Ghee,Safflower oil 5 L,9,4400,"3,900.00",500,2
19-01-2025,"Grains, Flours & Dals",KORRALU (FOXTAIL M) 500GM,4,130,110,20,2
19-01-2025,Sweeteners,YB JAGGERY POWDER 500GMS,16,75,75,0,1
19-01-2025,Spices & Seasonings,DURGA SALT CRYSTAL 1KG,15,25,25,0,1
19-01-2025,"Grains, Flours & Dals",BASMATHI RICE 1KG,4,150,135,15,1
19-01-2025,Snacks & Ready-to-Eat,OK Pasta Penne 400GM,14,240,240,0,2
19-01-2025,"Grains, Flours & Dals",turdal 500 gms,4,220,200,20,2
19-01-2025,"Grains, Flours & Dals",Bombay Rava 500GM,4,35,30,5,1
19-01-2025,"Grains, Flours & Dals",SB Javva Wheat Ravva 500GM,4,190,190,0,2
19-01-2025,Oils & Ghee,Safflower oil 1 L,9,440,400,40,1
19-01-2025,"Grains, Flours & Dals",Wheat Flour 1 kg,4,140,120,20,2
19-01-2025,"Dry Fruits, Nuts & Seeds",SATHVI CHIA SEEDS 100GM,2,100,80,20,1
19-01-2025,Oils & Ghee,Safflower oil 1 L,9,440,400,40,1
19-01-2025,"Dry Fruits, Nuts & Seeds",SABJA SEEDS 100GM,2,80,70,10,1
19-01-2025,Oils & Ghee,Sesame oil 1 L,9,590,560,30,1
19-01-2025,Spices & Seasonings,JEERA 250 gms,15,125,105,20,1
19-01-2025,"Dry Fruits, Nuts & Seeds",Groundnuts 1 kg,2,190,170,20,1
19-01-2025,"Grains, Flours & Dals",Idly Rava L 1KG,4,60,50,10,1
19-01-2025,Sweeteners,SUGAR 500 GM,16,30,25,5,1
19-01-2025,"Grains, Flours & Dals",Yellow jowar .F1 kg,4,110,100,10,1
19-01-2025,Sweeteners,MISHRI 250 GM,16,35,30,5,1
19-01-2025,Oils & Ghee,Groundnut oil 1 L,9,360,330,30,1
19-01-2025,"Health, Wellness & Ayurvedic Products",MD Triphala Chorrnam 100GM,5,80,80,0,1
19-01-2025,Sweeteners,Mishri 500GM,16,70,60,10,1
19-01-2025,"Grains, Flours & Dals",SRILALITHA MAIDA FLOUR 500G,4,64,64,0,2
19-01-2025,"Grains, Flours & Dals",split black gram 1 kg,4,360,340,20,2
19-01-2025,Snacks & Ready-to-Eat,urban murmura,14,60,55,5,1
19-01-2025,Snacks & Ready-to-Eat,BB ROASTED VERMICELLY 500GM,14,70,70,0,1
19-01-2025,Sweeteners,MISHRI D,16,40,30,10,1
19-01-2025,Spices & Seasonings,Lavangam 50GM,15,60,50,10,1
19-01-2025,Household & Cleaning,VIM EXTRA 110GM,6,10,10,0,1
19-01-2025,Spices & Seasonings,Elaichi 25GM,15,145,120,25,1
19-01-2025,Personal Care & Cosmetics,ORGANIC SPONGE LOOFAH,10,70,70,0,1
19-01-2025,Sweeteners,MISHRI 250 GM,16,35,30,5,1
19-01-2025,"Grains, Flours & Dals",BASMATHI RICE 1KG,4,150,135,15,1
19-01-2025,"Dry Fruits, Nuts & Seeds",CASHEW 250GM,2,340,310,30,1
19-01-2025,"Grains, Flours & Dals",MELMEKER 250GMS,4,60,45,15,1
19-01-2025,"Grains, Flours & Dals",MAAGAANI SP RICE 20 KGS,4,2300,"1,960.00",340,1
19-01-2025,"Dry Fruits, Nuts & Seeds",SALTED PISTA 250GM,2,400,350,50,1
19-01-2025,Snacks & Ready-to-Eat,NGT CHATPATTA CHANA 90GM,14,25,25,0,1
19-01-2025,Milk & Dairy,BROWN EGGS 1P,7,14,12,2,1
19-01-2025,"Grains, Flours & Dals",Red Bobarlu 1 kg,4,190,170,20,1
19-01-2025,Spices & Seasonings,SREE MARUTHI IDLY KARAM 200GM,15,60,60,0,1
19-01-2025,"Grains, Flours & Dals",PRO ORG TUR DAL UNPOLISHED 500GM,4,176,176,0,1
19-01-2025,Snacks & Ready-to-Eat,PALLI LADDU 200GMS,14,90,70,20,1
19-01-2025,Spices & Seasonings,AVALU 100GM,15,25,20,5,1
19-01-2025,Milk & Dairy,BROWN EGGS 1P,7,210,180,30,15
18-01-2025,Baking & Cooking Aids,GONDH 50GRMS,0,50,40,10,1
18-01-2025,Oils & Ghee,Sesame oil 1 L,9,590,560,30,1
18-01-2025,Snacks & Ready-to-Eat,SD Thati thandra 200gm,14,150,150,0,1
18-01-2025,Spices & Seasonings,Menthulu 250 gms,15,50,45,5,1
18-01-2025,"Dry Fruits, Nuts & Seeds",PULMAKHANA 100 GM,2,180,170,10,1
18-01-2025,"Grains, Flours & Dals",THICK POHA 500GM,4,40,35,5,1
18-01-2025,"Grains, Flours & Dals",HS Multimillet upma r 500g,4,65,65,0,1
18-01-2025,Snacks & Ready-to-Eat,URBAN MARMURA 450GM,14,60,55,5,1
18-01-2025,"Grains, Flours & Dals",Em Multimillet idli r 500g,4,129,129,0,1
18-01-2025,"Health, Wellness & Ayurvedic Products",RB Max Protein Choco Almond bar 50g,5,75,75,0,1
18-01-2025,"Grains, Flours & Dals",JOWAR YELLOW 1 K,4,100,90,10,1
18-01-2025,Sweeteners,YB JAGGERY POWDER 1KG,16,140,140,0,1
18-01-2025,"Grains, Flours & Dals",Em Foxtail upma r 500 g,4,109,109,0,1
18-01-2025,Snacks & Ready-to-Eat,PEANUT CHILLI,14,5,5,0,1
18-01-2025,"Grains, Flours & Dals",MELMEKER 250GMS,4,60,45,15,1
18-01-2025,"Grains, Flours & Dals",SAMALU (Little millet) 1 kg,4,170,130,40,1
18-01-2025,Sweeteners,YB JAGGERY POWDER 500GMS,16,75,75,0,1
18-01-2025,"Grains, Flours & Dals",RAGULU 1 KG,4,70,60,10,1
18-01-2025,"Grains, Flours & Dals",JOWAR UPMA RAVA,4,0,0,0,1
18-01-2025,Spices & Seasonings,Tamarind 250GMS,15,80,65,15,1
18-01-2025,"Dry Fruits, Nuts & Seeds",PUTNALU 500GMS,2,180,152,28,2
18-01-2025,Sweeteners,SUGAR 1KG,16,120,100,20,2
18-01-2025,Oils & Ghee,Sesame oil 5 L,9,2950,"2,750.00",200,1
18-01-2025,Spices & Seasonings,RED COPRA 250GMS,15,85,74,11,1
18-01-2025,"Dry Fruits, Nuts & Seeds",Groundnuts 1 kg,2,570,510,60,3
18-01-2025,"Grains, Flours & Dals",Urad dall 1 Kg,4,370,340,30,2
18-01-2025,Spices & Seasonings,DRY MIECHI 200GM,15,160,120,40,2
18-01-2025,"Grains, Flours & Dals",VGR RICE 5 KGS,4,350,325,25,1
18-01-2025,"Grains, Flours & Dals",Brown rice 5 kgs,4,350,325,25,1
18-01-2025,"Dry Fruits, Nuts & Seeds",FLAX SEEDS 250GM,2,60,50,10,1
18-01-2025,Oils & Ghee,Castor oil 200 ml,9,100,80,20,1
18-01-2025,"Grains, Flours & Dals",turdal 1kg,4,660,585,75,3
18-01-2025,"Grains, Flours & Dals",MAATEJA rice 1 kg,4,144,138,6,2
18-01-2025,Milk & Dairy,BROWN EGGS 1P,7,140,120,20,10
18-01-2025,"Grains, Flours & Dals",THICK POHA 500GM,4,40,35,5,1
18-01-2025,Milk & Dairy,SANGAM TONED MILK 500ML,7,30,30,0,1
18-01-2025,"Grains, Flours & Dals",SABDANA,4,40,35,5,1
18-01-2025,Sweeteners,MISHRI 250 GM,16,35,30,5,1
18-01-2025,"Dry Fruits, Nuts & Seeds",PULMAKHANA 100 GM,2,180,170,10,1
18-01-2025,"Grains, Flours & Dals",MELMEKER 250GMS,4,60,45,15,1
18-01-2025,"Grains, Flours & Dals",CHANA DAL 500GM,4,70,60,10,1
18-01-2025,Sweeteners,YB JAGGERY POWDER 500GMS,16,75,75,0,1
18-01-2025,"Grains, Flours & Dals",Red Bobarlu 500 gms,4,95,85,10,1
18-01-2025,"Grains, Flours & Dals",White Chana 250 GM,4,60,50,10,1
18-01-2025,"Grains, Flours & Dals",white Bobarlu 1 KG,4,170,150,20,1
18-01-2025,"Dry Fruits, Nuts & Seeds",SATHVI CHIA SEEDS 100GM,2,100,80,20,1
18-01-2025,Milk & Dairy,BROWN EGGS TRAY 30P,7,360,330,30,1
18-01-2025,Snacks & Ready-to-Eat,Popcorn Seeds 250GM,14,45,40,5,1
18-01-2025,"Grains, Flours & Dals",Idly Rava L 1KG,4,60,50,10,1
18-01-2025,Sweeteners,SUGAR 1KG,16,60,50,10,1
18-01-2025,Spices & Seasonings,AVALU 100GM,15,25,20,5,1
18-01-2025,Spices & Seasonings,DURGA SALT CRYSTAL 1KG,15,25,25,0,1
18-01-2025,"Dry Fruits, Nuts & Seeds",Groundnuts 1 kg,2,380,340,40,2
18-01-2025,Spices & Seasonings,RED COPRA 250GMS,15,170,148,22,2
18-01-2025,Spices & Seasonings,Menthulu 250 gms,15,50,45,5,1
18-01-2025,"Grains, Flours & Dals",Idly Rava L 1KG,4,120,100,20,2
18-01-2025,"Dry Fruits, Nuts & Seeds",PUTNALU 500GMS,2,180,152,28,2
18-01-2025,Spices & Seasonings,JEERA 250 gms,15,125,105,20,1
18-01-2025,Sweeteners,SUGAR 1KG,16,60,50,10,1
18-01-2025,Pickles & Cooking Pastes,CHUTNEFY,11,55,55,0,1
18-01-2025,"Grains, Flours & Dals",Wheat Flour 2 kgs,4,140,120,20,1
18-01-2025,Oils & Ghee,Sesame oil 1 L,9,590,560,30,1
18-01-2025,Milk & Dairy,BROWN EGGS 1P,7,168,144,24,12
18-01-2025,Spices & Seasonings,RED PASTE 500GRMS,15,320,295,25,1
18-01-2025,Household & Cleaning,LIZOL JAQSMINE 500ML,6,116,116,0,1
18-01-2025,Oils & Ghee,Groundnut oil 1 L,9,360,330,30,1
18-01-2025,Household & Cleaning,COMFORT EAU DE PARFUM 210ML,6,58,58,0,1
18-01-2025,Spices & Seasonings,AV Iodized Salt 1KG,15,28,25,3,1
18-01-2025,Household & Cleaning,HERBAL TOLET CLEANER 500ML,6,165,165,0,1
18-01-2025,Household & Cleaning,VIM COOLING FRESHNESS MINT,6,40,40,0,2
18-01-2025,Spices & Seasonings,CHILLI POWDER,15,290,210,80,1
18-01-2025,Oils & Ghee,BUFFALLO GHEE 500ML,9,410,370,40,1
18-01-2025,Oils & Ghee,Coconut oil 1 L,9,440,400,40,1
18-01-2025,"Grains, Flours & Dals",Multigrain 1 kg,4,100,85,15,1
18-01-2025,"Grains, Flours & Dals",Bajra Flour 1 kg,4,70,60,10,1
18-01-2025,"Grains, Flours & Dals",Wheat Rava M 500GM,4,33,30,3,1
18-01-2025,"Grains, Flours & Dals",White jowar.F 1 kg,4,200,160,40,2
18-01-2025,Snacks & Ready-to-Eat,SD Pumpkin Seeds With Dates 175gm,14,170,170,0,1
18-01-2025,Spices & Seasonings,Turmeric powder 250 gms,15,200,150,50,2
18-01-2025,Oils & Ghee,BUFFALLO GHEE 500ML,9,410,370,40,1
18-01-2025,"Grains, Flours & Dals",VYS.SP RICE 1 KG,4,70,65,5,1
18-01-2025,Pooja & Spiritual Items,GOMATHA AGARBATHI,12,75,75,0,1
18-01-2025,Snacks & Ready-to-Eat,SD GINGER CANDY 200GM,14,120,120,0,1
18-01-2025,"Grains, Flours & Dals",Wheat Flour 5 kgs,4,350,300,50,1
18-01-2025,Sweeteners,GS A2 Buffalo Ghee 500ML,16,550,550,0,1
18-01-2025,Snacks & Ready-to-Eat,SALTED PHALLI,14,65,65,0,1
18-01-2025,Oils & Ghee,Sesame oil 1 L,9,590,560,30,1
18-01-2025,"Grains, Flours & Dals",SB Javva Wheat Ravva 500GM,4,95,95,0,1
18-01-2025,Snacks & Ready-to-Eat,MARMURA LADDU,14,80,60,20,1
18-01-2025,Snacks & Ready-to-Eat,SD RAGI GAVVALU,14,95,95,0,1
18-01-2025,Snacks & Ready-to-Eat,RB Choco Delite Almonds Raisins 40g,14,45,45,0,1
18-01-2025,Snacks & Ready-to-Eat,PALLI LADDU 200GMS,14,90,70,20,1
18-01-2025,Snacks & Ready-to-Eat,BLACK SESAME CHIKKI,14,45,45,0,1
18-01-2025,Snacks & Ready-to-Eat,SESAME LADDU 200GM,14,100,80,20,1
18-01-2025,"Grains, Flours & Dals",Multigrain 1 kg,4,100,85,15,1
18-01-2025,"Grains, Flours & Dals",RAGI FLOUR 1KG,4,80,70,10,1
18-01-2025,Sweeteners,Natural Honey 500 gms,16,280,240,40,1
18-01-2025,"Dry Fruits, Nuts & Seeds",PUMPKIN SEEDS 250GM,2,200,160,40,1
18-01-2025,Sweeteners,MISHRI 250 GM,16,35,30,5,1
18-01-2025,"Dry Fruits, Nuts & Seeds",YELLOW KISHMISH 250GM,2,130,110,20,1
18-01-2025,Spices & Seasonings,ELACHI 25 GM,15,145,120,25,1
18-01-2025,"Grains, Flours & Dals",DISANO OATS 1KG,4,142,142,0,1
18-01-2025,Milk & Dairy,SANGAM CURD 450GM,7,38,38,0,1
18-01-2025,"Grains, Flours & Dals",MAATEJA rice 1 kg,4,432,414,18,6
18-01-2025,Snacks & Ready-to-Eat,VD NUVULU CHEGODI 175GM,14,120,120,0,2
18-01-2025,"Grains, Flours & Dals",RICE FLOUR 500 GM,4,35,28,7,1
18-01-2025,"Grains, Flours & Dals",VL Sabdana 500GM,4,77,77,0,1
18-01-2025,"Grains, Flours & Dals",Wheat Flour 2 kgs,4,140,120,20,1
18-01-2025,"Grains, Flours & Dals",Wheat Flour 1 kg,4,70,60,10,1
18-01-2025,Oils & Ghee,cow ghee 500 ml,9,430,390,40,1
18-01-2025,Spices & Seasonings,Tamarind 250GMS,15,80,65,15,1
18-01-2025,Oils & Ghee,Coconut oil 1 L,9,440,400,40,1
18-01-2025,"Grains, Flours & Dals",White jowar.F 1 kg,4,100,80,20,1
18-01-2025,Snacks & Ready-to-Eat,VD Pappu Chekkalu 190gm,14,120,120,0,2
18-01-2025,"Grains, Flours & Dals",DESI CHANA,4,25,25,0,1
18-01-2025,"Grains, Flours & Dals",ANDU KORRALU (Browntop.m) 1 kg,4,320,290,30,1
18-01-2025,Sweeteners,KAMAL JAGGERY 500GM,16,80,80,0,2
18-01-2025,"Grains, Flours & Dals",KORRALU (FOXTAIL M) 1KG,4,150,110,40,1
18-01-2025,"Grains, Flours & Dals",DESI CHANA,4,25,25,0,1
18-01-2025,Spices & Seasonings,AVALU 100GM,15,25,20,5,1
18-01-2025,"Grains, Flours & Dals",MIXED FLOUR,4,318,318,0,1
18-01-2025,"Health, Wellness & Ayurvedic Products",MORINGA LEAF POWDER M,5,80,75,5,1
18-01-2025,"Dry Fruits, Nuts & Seeds",SATHVI CHIA SEEDS 100GM,2,100,80,20,1
18-01-2025,Snacks & Ready-to-Eat,NGT CHATPATTA CHANA 90GM,14,25,25,0,1
18-01-2025,Spices & Seasonings,NUVVULU 500GM,15,160,130,30,1
18-01-2025,"Dry Fruits, Nuts & Seeds",ANJEER 250GM,2,400,360,40,1
18-01-2025,"Dry Fruits, Nuts & Seeds",SATHVI CHIA SEEDS 100GM,2,100,80,20,1
18-01-2025,"Grains, Flours & Dals",HS Multimillet idly R 500 gms,4,65,65,0,1
18-01-2025,"Dry Fruits, Nuts & Seeds",FLAX SEEDS 250GM,2,60,50,10,1
18-01-2025,"Grains, Flours & Dals",HS RAGI Idly rava 500 gms,4,70,70,0,1
18-01-2025,"Grains, Flours & Dals",DISANO OATS 1KG,4,285,285,0,1
18-01-2025,"Dry Fruits, Nuts & Seeds",WALLNUTS 250GM,2,320,290,30,1
18-01-2025,"Dry Fruits, Nuts & Seeds",BLACK KISMIS 250GM,2,175,140,35,1
18-01-2025,Spices & Seasonings,CHILLI POWDER,15,290,210,80,1
18-01-2025,Snacks & Ready-to-Eat,VD RICE SAGO PAPAD 150GM,14,55,55,0,1
18-01-2025,Oils & Ghee,cow ghee 500 ml,9,430,390,40,1
18-01-2025,"Grains, Flours & Dals",Wheat Flour 1 kg,4,210,180,30,3
18-01-2025,Spices & Seasonings,Turmeric powder 250 gms,15,100,75,25,1
18-01-2025,Spices & Seasonings,ROYAL SAFFRON 400GRMS,15,65,65,0,1
18-01-2025,Oils & Ghee,Mustard oil 500 ml,9,220,195,25,1
18-01-2025,"Grains, Flours & Dals",MAAGAANI LOW GI SP 1KG,4,210,210,0,2
18-01-2025,Milk & Dairy,BROWN EGGS 1P,7,140,120,20,10
18-01-2025,"Grains, Flours & Dals",Wheat Flour 1 kg,4,70,60,10,1
18-01-2025,Spices & Seasonings,NUVVULU 500GM,15,160,130,30,1
18-01-2025,Milk & Dairy,BROWN EGGS 1P,7,210,180,30,15
18-01-2025,Pooja & Spiritual Items,BALAJI KASTURI DHOOP STICKS,12,70,70,0,1
18-01-2025,Snacks & Ready-to-Eat,BATANA NGT 70GMS,14,80,80,0,4
18-01-2025,"Grains, Flours & Dals",split black gram 1 kg,4,180,170,10,1
18-01-2025,"Grains, Flours & Dals",SL Suji Rava 500GM,4,32,32,0,1
18-01-2025,"Grains, Flours & Dals",JOWAR UPMA RAVA,4,0,0,0,1
18-01-2025,"Grains, Flours & Dals",RAGI FLOUR 500GRMS,4,40,35,5,1
18-01-2025,Milk & Dairy,BROWN EGGS 1P,7,84,72,12,6
18-01-2025,Sweeteners,SH JAGGERY POWDER 500GM,16,80,68,12,1
18-01-2025,"Grains, Flours & Dals",Red Wheat Flour 1 kg,4,140,130,10,1
18-01-2025,Snacks & Ready-to-Eat,PEANUT CHILLI,14,20,20,0,4
18-01-2025,"Grains, Flours & Dals",Multigrain 1 kg,4,100,85,15,1
18-01-2025,"Grains, Flours & Dals",VYS.SP RICE 1 KG,4,420,390,30,6
18-01-2025,Snacks & Ready-to-Eat,MARMURA LADDU,14,80,60,20,1
18-01-2025,Snacks & Ready-to-Eat,ZEEDI,14,70,70,0,1
18-01-2025,"Grains, Flours & Dals",RAGI FLOUR 500GRMS,4,40,35,5,1
18-01-2025,"Grains, Flours & Dals",Wheat Flour 1 kg,4,140,120,20,2
18-01-2025,Oils & Ghee,Sesame oil 500ml,9,295,280,15,1
18-01-2025,"Grains, Flours & Dals",split green gram 500 gms,4,75,70,5,1
18-01-2025,Oils & Ghee,Groundnut oil 1 L,9,720,660,60,2
18-01-2025,Oils & Ghee,Groundnut oil 1 L,9,360,330,30,1
18-01-2025,Oils & Ghee,Mustard oil 500 ml,9,220,195,25,1
18-01-2025,Spices & Seasonings,ROYAL SAFFRON 400GRMS,15,130,130,0,2
18-01-2025,"Grains, Flours & Dals",Red Wheat Flour 1 kg,4,560,520,40,4
18-01-2025,"Grains, Flours & Dals",White jowar.F 1 kg,4,100,80,20,1
18-01-2025,"Grains, Flours & Dals",RAGI FLOUR 500GRMS,4,40,35,5,1
18-01-2025,"Dry Fruits, Nuts & Seeds",CASHEW 250GM,2,340,310,30,1
18-01-2025,"Dry Fruits, Nuts & Seeds",YELLOW KISHMISH 250GM,2,130,110,20,1
18-01-2025,"Grains, Flours & Dals",White jowar.F 1 kg,4,100,80,20,1
18-01-2025,"Grains, Flours & Dals",Wheat Flour 2 kgs,4,140,120,20,1
18-01-2025,"Grains, Flours & Dals",Red Bobarlu 500 gms,4,95,85,10,1
18-01-2025,"Grains, Flours & Dals",UDALU (Barnyard millet) 500 gms,4,70,60,10,1
18-01-2025,"Grains, Flours & Dals",KORRALU (FOXTAIL M) 1KG,4,150,110,40,1
18-01-2025,"Grains, Flours & Dals",SAMALU (Little millet) 1 kg,4,170,130,40,1
18-01-2025,"Grains, Flours & Dals",Wheat Rava M 1KG,4,65,55,10,1
18-01-2025,Snacks & Ready-to-Eat,MARMURA LADDU,14,80,60,20,1
18-01-2025,"Grains, Flours & Dals",white Bobarlu 500 gms,4,80,75,5,1
18-01-2025,Snacks & Ready-to-Eat,SD VAMU APPADALU 200GM,14,80,80,0,1
18-01-2025,"Grains, Flours & Dals",MELMEKER 250GMS,4,60,45,15,1
18-01-2025,"Grains, Flours & Dals",BASMATHI RICE 1KG,4,150,135,15,1
18-01-2025,"Grains, Flours & Dals",MAAGAANI LOW GI SP 1KG,4,230,230,0,2
18-01-2025,"Grains, Flours & Dals",SL Idly Rava 1KG,4,65,55,10,1
18-01-2025,"Grains, Flours & Dals",KORRALU (FOXTAIL M) 1KG,4,150,110,40,1
18-01-2025,"Grains, Flours & Dals",HS Multimillet idly R 500 gms,4,65,65,0,1
18-01-2025,Snacks & Ready-to-Eat,VD RED CHILLI RICEPAPAD 150GM,14,50,50,0,1
18-01-2025,Pooja & Spiritual Items,BALAJI KASTURI DHOOP STICKS,12,70,70,0,1
18-01-2025,Oils & Ghee,Groundnut oil 1 L,9,360,330,30,1
18-01-2025,Snacks & Ready-to-Eat,RINGS 200GM,14,30,30,0,1
18-01-2025,Personal Care & Cosmetics,OVAL BODY LOOFAH,10,55,55,0,1
18-01-2025,Sweeteners,YB JAGGERY POWDER 500GMS,16,150,150,0,2
18-01-2025,"Grains, Flours & Dals",HS jowar idly rava 500 gms,4,65,65,0,1
18-01-2025,"Grains, Flours & Dals",VYS.SP.RICE 10 KGS,4,700,650,50,1
18-01-2025,"Grains, Flours & Dals",Wheat Flour 1 kg,4,140,120,20,2
18-01-2025,Spices & Seasonings,SREE MARUTHI IDLY KARAM 200GM,15,60,60,0,1
18-01-2025,Oils & Ghee,Safflower oil 1 L,9,440,400,40,1
18-01-2025,Spices & Seasonings,SD Redgram Karam Powder 100GM,15,65,65,0,1
18-01-2025,"Grains, Flours & Dals",Wheat Flour 1 kg,4,70,60,10,1
18-01-2025,Spices & Seasonings,SREE MARUTHI IDLY KARAM 200GM,15,60,60,0,1
18-01-2025,Oils & Ghee,Castor oil 200 ml,9,100,80,20,1
18-01-2025,"Grains, Flours & Dals",WHEAT 1 KG,4,240,200,40,4
18-01-2025,"Grains, Flours & Dals",Wheat Rava M 500GM,4,33,30,3,1
18-01-2025,"Grains, Flours & Dals",Bombay Rava 500GM,4,35,30,5,1
18-01-2025,"Grains, Flours & Dals",FLOUR CHARGE,4,48,48,0,4
18-01-2025,"Grains, Flours & Dals",Red Chana 250GM,4,35,30,5,1
18-01-2025,"Grains, Flours & Dals",split black gram 1 kg,4,180,170,10,1
18-01-2025,Snacks & Ready-to-Eat,SD JOWAR WITH PALM JAGGERY 250GM,14,135,135,0,1
18-01-2025,"Grains, Flours & Dals",White Chana 250 GM,4,60,50,10,1
18-01-2025,Spices & Seasonings,Jeera 100GM,15,50,45,5,1
18-01-2025,Baking & Cooking Aids,GONDH 50GRMS,0,40,40,0,1
18-01-2025,Oils & Ghee,Groundnut oil 1 L,9,360,330,30,1
18-01-2025,Oils & Ghee,Groundnut oil 500ml,9,180,165,15,1
18-01-2025,Oils & Ghee,Sesame oil 1 L,9,590,560,30,1
18-01-2025,Spices & Seasonings,Jeera 100GM,15,50,45,5,1
18-01-2025,Spices & Seasonings,DRY MIECHI 200GM,15,80,60,20,1
18-01-2025,Spices & Seasonings,AVALU 100GM,15,25,20,5,1
18-01-2025,Spices & Seasonings,Tamarind 500GM,15,160,130,30,1
18-01-2025,Beverages,TATA CHAKRA GOLD PT 120GM,1,90,90,0,1
18-01-2025,"Grains, Flours & Dals",VGR rice 1 kg,4,350,325,25,5
18-01-2025,"Grains, Flours & Dals",Urad dall 1 Kg,4,185,170,15,1
18-01-2025,"Grains, Flours & Dals",turdal 1kg,4,220,195,25,1
18-01-2025,"Grains, Flours & Dals",Bombay Rava 500GM,4,35,30,5,1
18-01-2025,Spices & Seasonings,AV Iodized Salt 1KG,15,28,25,3,1
18-01-2025,"Dry Fruits, Nuts & Seeds",ALMONDS 250GM,2,280,260,20,1
18-01-2025,Personal Care & Cosmetics,DABUR RED PASTE 50GM,10,25,25,0,1
18-01-2025,Pickles & Cooking Pastes,SD MANGO TOKKU,11,110,110,0,1
18-01-2025,"Dry Fruits, Nuts & Seeds",WALLNUTS 250GM,2,320,290,30,1
18-01-2025,Spices & Seasonings,PRO ORG RED CHILLI WHOLE (HOT) 100GM,15,146,146,0,1
18-01-2025,"Grains, Flours & Dals",SAMALU (Little millet) 500 gms,4,85,65,20,1
18-01-2025,Spices & Seasonings,SH TAMARIND SEEDLESS 500GM,15,260,260,0,1
18-01-2025,"Grains, Flours & Dals",UDALU (Barnyard millet) 500 gms,4,70,60,10,1
18-01-2025,Spices & Seasonings,Telaga Pindi 250 GM,15,40,35,5,1
18-01-2025,Oils & Ghee,Mustard oil 500 ml,9,220,195,25,1
18-01-2025,"Health, Wellness & Ayurvedic Products",DWI OMU WATER 100ML,5,40,40,0,1
18-01-2025,"Dry Fruits, Nuts & Seeds",Groundnuts 1 kg,2,190,170,20,1
18-01-2025,"Grains, Flours & Dals",Urad dall 1 Kg,4,185,170,15,1
18-01-2025,"Grains, Flours & Dals",Chana Flour 500 gms,4,70,65,5,1
18-01-2025,"Grains, Flours & Dals",Green gram 1 kg,4,150,130,20,1
18-01-2025,"Grains, Flours & Dals",split black gram 1 kg,4,180,170,10,1
18-01-2025,Sweeteners,YB JAGGERY POWDER 1KG,16,140,140,0,1
18-01-2025,Milk & Dairy,HERITAGE CURD,7,48,48,0,1
18-01-2025,"Dry Fruits, Nuts & Seeds",Groundnuts 1 kg,2,190,170,20,1
18-01-2025,Snacks & Ready-to-Eat,VD SAGOPAPAD 150GM,14,55,55,0,1
18-01-2025,Sweeteners,ACHU BELLAM 1KG,16,100,80,20,1
18-01-2025,"Grains, Flours & Dals",HS Multimillet idly R 500 gms,4,65,65,0,1
18-01-2025,"Grains, Flours & Dals",SL Idly Rava 1KG,4,65,55,10,1
18-01-2025,Snacks & Ready-to-Eat,SD Thati thandra 200gm,14,150,150,0,1
18-01-2025,"Dry Fruits, Nuts & Seeds",FLAX SEEDS 250GM,2,60,50,10,1
18-01-2025,"Health, Wellness & Ayurvedic Products",RB Max Protein Choco Almond bar 50g,5,150,150,0,2
18-01-2025,"Grains, Flours & Dals",RAGI FLOUR 500GRMS,4,40,35,5,1
18-01-2025,Milk & Dairy,HRITAGE TONED MILK 500ML,7,30,30,0,1
18-01-2025,"Grains, Flours & Dals",URAD DALL,4,95,85,10,1
18-01-2025,Snacks & Ready-to-Eat,SATHVI REGIVADA 200GM,14,80,60,20,1
18-01-2025,"Grains, Flours & Dals",Em jowar idly R 500G,4,75,75,0,1
18-01-2025,Sweeteners,YB JAGGERY POWDER 500GMS,16,75,75,0,1
18-01-2025,"Grains, Flours & Dals",SAMALU (Little millet) 500 gms,4,85,65,20,1
18-01-2025,"Grains, Flours & Dals",UDALU (Barnyard millet) 500 gms,4,70,60,10,1
18-01-2025,"Grains, Flours & Dals",Arikalu (kodo),4,70,65,5,1
18-01-2025,"Dry Fruits, Nuts & Seeds",Groundnuts 500 gms,2,190,170,20,2
18-01-2025,"Grains, Flours & Dals",Green gram 500 gms,4,75,70,5,1
18-01-2025,"Dry Fruits, Nuts & Seeds",SUNFLOWER SEEDS 250GRM,2,150,130,20,1
18-01-2025,Milk & Dairy,BROWN EGGS 1P,7,140,120,20,10
18-01-2025,Spices & Seasonings,SREE MARUTHI IDLY KARAM 200GM,15,60,60,0,1
18-01-2025,Baking & Cooking Aids,WEIKFIELD BAKING SODA 100G,0,36,36,0,1
18-01-2025,"Dry Fruits, Nuts & Seeds",SALTED PISTA 250GM,2,400,350,50,1
18-01-2025,Personal Care & Cosmetics,NEEM SOAP 100GM,10,200,200,0,2
18-01-2025,Pooja & Spiritual Items,SWASTIK CAMPHORE,12,180,180,0,2
18-01-2025,"Grains, Flours & Dals",Green gram 1 kg,4,150,130,20,1
18-01-2025,"Dry Fruits, Nuts & Seeds",YELLOW KISHMISH 250GM,2,130,110,20,1
18-01-2025,"Dry Fruits, Nuts & Seeds",WALLNUTS 250GM,2,320,290,30,1
18-01-2025,"Dry Fruits, Nuts & Seeds",WATERMELON SEEDS 250GRM,2,320,280,40,1
18-01-2025,"Dry Fruits, Nuts & Seeds",PUMPKIN SEEDS 250GM,2,200,160,40,1
18-01-2025,"Grains, Flours & Dals",Wheat Rava M 1KG,4,65,55,10,1
18-01-2025,"Grains, Flours & Dals",UDALU (Barnyard millet) 1 kg,4,140,115,25,1
18-01-2025,Snacks & Ready-to-Eat,BATANA NGT 70GMS,14,40,40,0,2
18-01-2025,"Grains, Flours & Dals",MAAGAANI LOW GI SP 1KG,4,315,315,0,3
18-01-2025,Snacks & Ready-to-Eat,ONION RINGS,14,50,50,0,1
18-01-2025,Misc,JOKER,8,10,10,0,1
18-01-2025,Snacks & Ready-to-Eat,BD PEARL MILLET NOODLES 200G,14,70,70,0,1
18-01-2025,Snacks & Ready-to-Eat,SATHVI PALLI CHIKKI 200GM,14,100,80,20,1
18-01-2025,"Grains, Flours & Dals",Chana Flour 500 gms,4,70,65,5,1
18-01-2025,Snacks & Ready-to-Eat,VD GUMMADI VADIYAM,14,75,75,0,1
18-01-2025,Snacks & Ready-to-Eat,PALLI LADDU 200GMS,14,90,70,20,1
18-01-2025,Spices & Seasonings,Marati Magga 50GM,15,130,110,20,1
18-01-2025,Oils & Ghee,Coconut oil 500 ml,9,220,200,20,1
18-01-2025,Sweeteners,Mishri 500GM,16,140,120,20,2
18-01-2025,Sweeteners,SUGAR 1KG,16,60,50,10,1
18-01-2025,"Grains, Flours & Dals",Chana Flour 500 gms,4,70,65,5,1
18-01-2025,Spices & Seasonings,SAJEERA,15,60,40,20,1
18-01-2025,Oils & Ghee,BUFFALLO GHEE 500ML,9,410,370,40,1
18-01-2025,Sweeteners,PN ORGANIC BROWN SUGAR 500GM,16,78,78,0,1
18-01-2025,"Grains, Flours & Dals",Idly Rava L 1KG,4,60,50,10,1
18-01-2025,Pooja & Spiritual Items,SOSR SWATHHI 365,12,30,30,0,1
18-01-2025,"Grains, Flours & Dals",SAMALU (Little millet) 1 kg,4,170,130,40,1
18-01-2025,"Grains, Flours & Dals",KORRALU (FOXTAIL M) 1KG,4,150,110,40,1
18-01-2025,Oils & Ghee,Groundnut oil 5 L,9,1800,"1,600.00",200,1
18-01-2025,Sweeteners,GS Palm Jaggery Powder 400GM,16,180,180,0,1
18-01-2025,"Dry Fruits, Nuts & Seeds",ANJEER 250GM,2,400,360,40,1
18-01-2025,"Grains, Flours & Dals",Red Bobarlu 500 gms,4,95,85,10,1
18-01-2025,"Dry Fruits, Nuts & Seeds",CASHEW 250GM,2,340,310,30,1
18-01-2025,"Grains, Flours & Dals",PESARA PAPPU 1 KG,4,170,145,25,1
18-01-2025,"Dry Fruits, Nuts & Seeds",WALLNUTS 250GM,2,320,290,30,1
18-01-2025,Snacks & Ready-to-Eat,Sprouted Ragi Biscuits 450GM,14,150,150,0,1
18-01-2025,"Grains, Flours & Dals",Wheat Flour 1 kg,4,210,180,30,3
18-01-2025,"Grains, Flours & Dals",Arikadu ( kodo),4,280,260,20,2
18-01-2025,"Grains, Flours & Dals",HS jowar idly rava 500 gms,4,65,65,0,1
18-01-2025,"Grains, Flours & Dals",HS Jowar upma rava 500 gms,4,65,65,0,1
18-01-2025,Pooja & Spiritual Items,GD Dhoop Sticks 26GM,12,560,560,0,28
18-01-2025,"Grains, Flours & Dals",FLOUR CHARGE,4,24,24,0,2
18-01-2025,"Grains, Flours & Dals",HS Multimillet upma r 500g,4,65,65,0,1
18-01-2025,"Health, Wellness & Ayurvedic Products",SONAMUKHI,5,80,80,0,1
18-01-2025,Snacks & Ready-to-Eat,SALTED PHALLI,14,50,50,0,2
18-01-2025,Sweeteners,YB Palm Jaggery 250GM,16,400,400,0,2
18-01-2025,Snacks & Ready-to-Eat,VD GUMMADI VADIYAM,14,75,75,0,1
18-01-2025,"Grains, Flours & Dals",Multigrain 2 kgs,4,200,170,30,1
18-01-2025,"Grains, Flours & Dals",SPLIT BLACK GRAM 500 GM,4,90,85,5,1
18-01-2025,Snacks & Ready-to-Eat,VD SAGOPAPAD 150GM,14,55,55,0,1
18-01-2025,"Grains, Flours & Dals",Idly Rava L 1KG,4,60,50,10,1
18-01-2025,"Grains, Flours & Dals",White jowar.F 1 kg,4,100,80,20,1
18-01-2025,"Dry Fruits, Nuts & Seeds",SD Mango cubes 100gm,2,45,45,0,1
18-01-2025,Snacks & Ready-to-Eat,PEANUT CHIKKI 450GM,14,125,125,0,1
18-01-2025,Beverages,BRU GREEN LABEL 1.2G,1,48,48,0,24
18-01-2025,Pooja & Spiritual Items,GD Aiswarya Deepam 700ML,12,195,195,0,1
18-01-2025,Spices & Seasonings,GS GARLIC KARAM 100GM,15,75,75,0,1
18-01-2025,Sweeteners,YB JAGGERY POWDER 500GMS,16,75,75,0,1
18-01-2025,"Grains, Flours & Dals",RAGULU 1 KG,4,70,60,10,1
18-01-2025,Pooja & Spiritual Items,BANDA PUVVU 25GM 25GM,12,160,120,40,2
18-01-2025,Snacks & Ready-to-Eat,RSC ORANGE 100GMS,14,20,20,0,1
18-01-2025,Personal Care & Cosmetics,BAMBOO TOOTH BRUSH,10,120,120,0,1
18-01-2025,Oils & Ghee,BUFFALLO GHEE 500ML,9,410,370,40,1
18-01-2025,"Grains, Flours & Dals",MELMEKER 250GMS,4,60,45,15,1
18-01-2025,Oils & Ghee,Groundnut oil 5 L,9,1800,"1,600.00",200,1
18-01-2025,"Grains, Flours & Dals",SL Idly Rava 1KG,4,65,55,10,1
18-01-2025,"Grains, Flours & Dals",Sathya Javva Wheat Rava 500GM,4,95,95,0,1
18-01-2025,"Health, Wellness & Ayurvedic Products",RB Peanut butter Peanuts Dark 40g,5,45,45,0,1
18-01-2025,Snacks & Ready-to-Eat,GS INSTANT KORRA DOSA MIX 400GM,14,120,120,0,1
18-01-2025,Oils & Ghee,Groundnut oil 1 L,9,360,330,30,1
18-01-2025,"Grains, Flours & Dals",VYS.SP RICE 1 KG,4,70,65,5,1
18-01-2025,"Grains, Flours & Dals",DOCTOR RICE DIABETIC SFR 1KG,4,600,600,0,5
18-01-2025,Spices & Seasonings,ROYAL SAFFRON,15,125,125,0,1
18-01-2025,"Grains, Flours & Dals",Wheat Rava M 500GM,4,33,30,3,1
18-01-2025,"Grains, Flours & Dals",split green gram 1 kg,4,150,140,10,1
18-01-2025,"Grains, Flours & Dals",RAGI FLOUR 1KG,4,80,70,10,1
18-01-2025,Snacks & Ready-to-Eat,ZEEDI,14,70,70,0,1
18-01-2025,Snacks & Ready-to-Eat,RSC ORANGE 100GMS,14,80,80,0,4
18-01-2025,"Grains, Flours & Dals",White jowar.F 1 kg,4,300,240,60,3
18-01-2025,Pooja & Spiritual Items,OM SAINATH ISOBORNEOL 10GM,12,60,60,0,1
18-01-2025,"Grains, Flours & Dals",Red Wheat Flour 1 kg,4,140,130,10,1
18-01-2025,Snacks & Ready-to-Eat,VD DAHI MIRCHI(SALTED) 100GM,14,45,45,0,1
18-01-2025,Snacks & Ready-to-Eat,RINGS 200GM,14,60,60,0,2
18-01-2025,Snacks & Ready-to-Eat,SESAME LADDU 200GM,14,100,80,20,1
18-01-2025,"Grains, Flours & Dals",Wheat Flour 1 kg,4,70,60,10,1
18-01-2025,Snacks & Ready-to-Eat,PALLI LADDU 200GMS,14,180,140,40,2
18-01-2025,"Grains, Flours & Dals",VYS.SP RICE 1 KG,4,700,650,50,10
18-01-2025,Sweeteners,GS Organic Jaggery Powder 600GM,16,198,198,0,2
18-01-2025,"Grains, Flours & Dals",Wheat Flour 1 kg,4,140,120,20,2
18-01-2025,"Dry Fruits, Nuts & Seeds",ALMONDS 250GM,2,280,260,20,1
18-01-2025,Snacks & Ready-to-Eat,VD RICE SAGO PAPAD 150GM,14,55,55,0,1
18-01-2025,"Grains, Flours & Dals",BASMATHI RICE 1KG,4,150,135,15,1
18-01-2025,Spices & Seasonings,Menthulu 250 gms,15,50,45,5,1
18-01-2025,"Dry Fruits, Nuts & Seeds",CASHEW 250GM,2,340,310,30,1
18-01-2025,Snacks & Ready-to-Eat,SD FLAX SEED APPADALU,14,90,90,0,1
18-01-2025,"Grains, Flours & Dals",Idly Rava L 1KG,4,60,50,10,1
18-01-2025,Pickles & Cooking Pastes,SD TOMATO PICKLE,11,110,110,0,1
18-01-2025,"Dry Fruits, Nuts & Seeds",Groundnuts 1 kg,2,380,340,40,2
18-01-2025,"Grains, Flours & Dals",RAGI FLOUR 500GRMS,4,40,35,5,1
18-01-2025,"Grains, Flours & Dals",COW B rice 1 kg,4,360,345,15,5
18-01-2025,"Grains, Flours & Dals",turdal 1kg,4,220,195,25,1
18-01-2025,"Grains, Flours & Dals",MAATEJA rice 1 kg,4,360,345,15,5
18-01-2025,Spices & Seasonings,ROYAL SAFFRON 400GRMS,15,65,65,0,1
18-01-2025,Pickles & Cooking Pastes,SD MESTA PICKLE,11,110,110,0,1
18-01-2025,Snacks & Ready-to-Eat,PALLI LADDU 200GMS,14,90,70,20,1
18-01-2025,"Grains, Flours & Dals",Wheat Flour 1 kg,4,70,60,10,1
18-01-2025,Snacks & Ready-to-Eat,VD RICE SAGO PAPAD 150GM,14,55,55,0,1
18-01-2025,Snacks & Ready-to-Eat,VD RED CHILLI RICEPAPAD 150GM,14,50,50,0,1
18-01-2025,Snacks & Ready-to-Eat,VD SAGOPAPAD 150GM,14,55,55,0,1
18-01-2025,Snacks & Ready-to-Eat,SATHVI PALLI CHIKKI 200GM,14,200,160,40,2
18-01-2025,"Grains, Flours & Dals",MIXED FLOUR,4,220,220,0,1
18-01-2025,"Grains, Flours & Dals",Yellow jowar .F1 kg,4,110,100,10,1
18-01-2025,Oils & Ghee,Sesame oil 1 L,9,1180,"1,120.00",60,2
18-01-2025,"Grains, Flours & Dals",Bajra Flour 1 kg,4,70,60,10,1
18-01-2025,Milk & Dairy,SANGAM CURD 450GM,7,38,38,0,1
18-01-2025,Milk & Dairy,SANGAM TONED MILK 500ML,7,60,60,0,2
18-01-2025,"Grains, Flours & Dals",VGR rice 1 kg,4,70,65,5,1
18-01-2025,"Grains, Flours & Dals",VYS.SP RICE 1 KG,4,70,65,5,1
18-01-2025,Oils & Ghee,Groundnut oil 1 L,9,360,330,30,1
18-01-2025,Oils & Ghee,Groundnut oil 1 L,9,360,330,30,1
18-01-2025,Oils & Ghee,Coconut oil 500 ml,9,220,200,20,1
17-01-2025,Oils & Ghee,Groundnut oil 1 L,9,1080,990,90,3
17-01-2025,"Grains, Flours & Dals",HS Multimillet idly R 500 gms,4,65,65,0,1
17-01-2025,"Grains, Flours & Dals",HS Jowar upma rava 500 gms,4,65,65,0,1
17-01-2025,"Grains, Flours & Dals",HS jowar idly rava 500 gms,4,130,130,0,2
17-01-2025,"Grains, Flours & Dals",Yellow jowar .F1 kg,4,110,100,10,1
17-01-2025,"Dry Fruits, Nuts & Seeds",PUTNALU 500GMS,2,90,76,14,1
17-01-2025,Beverages,TATA CHAKRA GOLD PT 120GM,1,90,90,0,1
17-01-2025,Sweeteners,YB Brown Sugar 500GM,16,75,75,0,1
17-01-2025,Spices & Seasonings,AVALU 100GM,15,25,20,5,1
17-01-2025,"Grains, Flours & Dals",Idly Rava L 1KG,4,60,50,10,1
17-01-2025,"Dry Fruits, Nuts & Seeds",PUMPKIN SEEDS 250GM,2,200,160,40,1
17-01-2025,Spices & Seasonings,SONTI 50GM,15,30,20,10,1
17-01-2025,Oils & Ghee,Safflower oil 1 L,9,440,400,40,1
17-01-2025,"Grains, Flours & Dals",Multigrain 1 kg,4,100,85,15,1
17-01-2025,Spices & Seasonings,Avalu small 250 gms,15,60,40,20,1
17-01-2025,Spices & Seasonings,JEERA 250 gms,15,125,105,20,1
17-01-2025,"Grains, Flours & Dals",DESI CHANA,4,50,50,0,2
17-01-2025,Spices & Seasonings,ROYAL SAFFRON 400GRMS,15,65,65,0,1
17-01-2025,Spices & Seasonings,Coriander seeds 200 gms,15,48,40,8,1
17-01-2025,"Dry Fruits, Nuts & Seeds",Groundnuts 1 kg,2,190,170,20,1
17-01-2025,Snacks & Ready-to-Eat,SH PUFFED RICE 500GM,14,112,112,0,1
17-01-2025,"Grains, Flours & Dals",PESARA PAPPU 1 KG,4,170,145,25,1
17-01-2025,"Grains, Flours & Dals",Green gram 1 kg,4,150,130,20,1
17-01-2025,"Grains, Flours & Dals",turdal 1kg,4,220,195,25,1
17-01-2025,"Grains, Flours & Dals",SB Javva Wheat Ravva 500GM,4,190,190,0,2
17-01-2025,Sweeteners,Natural Honey 500 gms,16,280,240,40,1
17-01-2025,"Grains, Flours & Dals",Multigrain 1 kg,4,200,170,30,2
17-01-2025,Oils & Ghee,BUFFALLO GHEE 500ML,9,410,370,40,1
17-01-2025,"Grains, Flours & Dals",JOWAR YELLOW 1 K,4,200,180,20,2
17-01-2025,Spices & Seasonings,JEERA 250 gms,15,125,105,20,1
17-01-2025,"Dry Fruits, Nuts & Seeds",PULMAKHANA 100 GM,2,180,170,10,1
17-01-2025,"Dry Fruits, Nuts & Seeds",Groundnuts 1 kg,2,190,170,20,1
17-01-2025,Snacks & Ready-to-Eat,BB VERMICELLY 500GM,14,53,53,0,1
17-01-2025,Spices & Seasonings,Dalchin Chekka 50GM,15,50,40,10,1
17-01-2025,Oils & Ghee,Groundnut oil 1 L,9,360,330,30,1
17-01-2025,"Grains, Flours & Dals",WHEAT 1 KG,4,120,100,20,2
17-01-2025,"Grains, Flours & Dals",KORRALU (FOXTAIL M) 1KG,4,150,110,40,1
17-01-2025,Spices & Seasonings,SD IDLY KARAM,15,60,60,0,1
17-01-2025,"Grains, Flours & Dals",CHANA DAL 1KG,4,140,120,20,1
17-01-2025,Spices & Seasonings,Coconut Powder 250GM,15,90,90,0,1
17-01-2025,Sweeteners,YB JAGGERY POWDER 500GMS,16,75,75,0,1
17-01-2025,"Grains, Flours & Dals",RAJMA 500GM,4,90,90,0,1
17-01-2025,Household & Cleaning,SURF EXCEL 150GM,6,20,20,0,1
17-01-2025,"Grains, Flours & Dals",Multigrain 1 kg,4,100,85,15,1
17-01-2025,"Grains, Flours & Dals",HS jowar idly rava 500 gms,4,195,195,0,3
17-01-2025,"Grains, Flours & Dals",DESI CHANA,4,25,25,0,1
17-01-2025,Snacks & Ready-to-Eat,BATANA NGT 70GMS,14,40,40,0,2
17-01-2025,Snacks & Ready-to-Eat,SALTED PHALLI,14,25,25,0,1
17-01-2025,"Grains, Flours & Dals",ANDU KORRALU (Brown top .mlt) 500,4,160,145,15,1
17-01-2025,"Grains, Flours & Dals",Arikalu (kodo),4,70,65,5,1
17-01-2025,Oils & Ghee,Groundnut oil 1 L,9,360,330,30,1
17-01-2025,Snacks & Ready-to-Eat,SALTED PHALLI,14,65,65,0,1
17-01-2025,"Grains, Flours & Dals",RAGI FLOUR 500GRMS,4,40,35,5,1
17-01-2025,Oils & Ghee,Coconut oil 1 L,9,440,400,40,1
17-01-2025,Oils & Ghee,Castor oil 200 ml,9,100,80,20,1
17-01-2025,"Grains, Flours & Dals",MELMEKER 250GMS,4,60,45,15,1
17-01-2025,Sweeteners,MISHRI 250 GM,16,35,30,5,1
17-01-2025,Snacks & Ready-to-Eat,SD VAMU APPADALU 200GM,14,80,80,0,1
17-01-2025,"Grains, Flours & Dals",RICE FLOUR 1KG,4,70,55,15,1
17-01-2025,Snacks & Ready-to-Eat,VD SAGOPAPAD 150GM,14,55,55,0,1
17-01-2025,Snacks & Ready-to-Eat,BD RED RICE NOODLES 200G,14,70,70,0,1
17-01-2025,General Household & Kitchenware,CANDLE,3,30,30,0,1
17-01-2025,"Health, Wellness & Ayurvedic Products",DETTOL PLASTER,5,7.5,7.5,0,3
17-01-2025,Snacks & Ready-to-Eat,VD DAHI MIRCHI(SALTED) 100GM,14,45,45,0,1
17-01-2025,Snacks & Ready-to-Eat,BD RED RICE NOODLES 200G,14,70,70,0,1
17-01-2025,Snacks & Ready-to-Eat,VD Minapa papad 200gm,14,60,60,0,1
17-01-2025,Snacks & Ready-to-Eat,VD SANNAPUSA 175GM,14,60,60,0,1
17-01-2025,Spices & Seasonings,Turmeric powder 250 gms,15,100,75,25,1
17-01-2025,Spices & Seasonings,Poonam Mixed Masala 50GM,15,90,60,30,1
17-01-2025,"Grains, Flours & Dals",RAGI FLOUR 500GRMS,4,40,35,5,1
17-01-2025,Oils & Ghee,Mustard oil 500 ml,9,220,195,25,1
17-01-2025,Snacks & Ready-to-Eat,VD PAPPU CHEGODI 200GM,14,60,60,0,1
17-01-2025,Pickles & Cooking Pastes,SD AMALA PICKLE,11,110,110,0,1
17-01-2025,Milk & Dairy,SANGAM TONED MILK 500ML,7,30,30,0,1
17-01-2025,Snacks & Ready-to-Eat,SD Bajra with palm Jaggery 250gm,14,135,135,0,1
17-01-2025,Snacks & Ready-to-Eat,SD JOWAR WITH PALM JAGGERY 250GM,14,135,135,0,1
17-01-2025,Snacks & Ready-to-Eat,VD DRY FRUIT PUTHAREKULU,14,120,120,0,1
17-01-2025,Sweeteners,ACHU BELLAM 1KG,16,100,80,20,1
17-01-2025,Oils & Ghee,Sesame oil 1 L,9,590,560,30,1
17-01-2025,Oils & Ghee,Coconut oil 500 ml,9,220,200,20,1
17-01-2025,Oils & Ghee,Castor oil 200 ml,9,100,80,20,1
17-01-2025,"Grains, Flours & Dals",Wheat Flour 1 kg,4,70,60,10,1
17-01-2025,"Grains, Flours & Dals",RAGI FLOUR 500GRMS,4,40,35,5,1
17-01-2025,"Health, Wellness & Ayurvedic Products",RB Max Protein Choco Almond bar 50g,5,150,150,0,2
17-01-2025,Personal Care & Cosmetics,MD HERBAL HAIR SHAMPOO,10,300,300,0,1
17-01-2025,Snacks & Ready-to-Eat,NGT CHATPATTA CHANA 90GM,14,25,25,0,1
17-01-2025,Spices & Seasonings,Chilli powder 500 gms,15,870,630,240,3
17-01-2025,"Grains, Flours & Dals",RAGI FLOUR 1KG,4,80,70,10,1
17-01-2025,Milk & Dairy,SANGAM CURD 450GM,7,38,38,0,1
17-01-2025,General Household & Kitchenware,WOODEN SPOON BIG,3,40,40,0,1
17-01-2025,"Grains, Flours & Dals",SL Idly Rava 1KG,4,65,55,10,1
17-01-2025,"Health, Wellness & Ayurvedic Products",MD Kasturi Pasupu Choornam 50GM,5,80,80,0,1
17-01-2025,Pickles & Cooking Pastes,SD MANGO PICKLE,11,110,110,0,1
17-01-2025,Personal Care & Cosmetics,WHISPER,10,240,190,50,1
17-01-2025,Personal Care & Cosmetics,PARACHUTE 45ML,10,20,20,0,1
17-01-2025,Household & Cleaning,ODOMOS,6,32,32,0,1
17-01-2025,Household & Cleaning,HERBAL MOSQUITO REP RS 100ML,6,240,240,0,1
17-01-2025,Snacks & Ready-to-Eat,JUNNU POWDER 100GM,14,350,350,0,5
17-01-2025,Snacks & Ready-to-Eat,RSC ORANGE 100GMS,14,40,40,0,2
17-01-2025,"Grains, Flours & Dals",SL Idly Rava 1KG,4,130,110,20,2
17-01-2025,"Grains, Flours & Dals",RAGI FLOUR 1KG,4,80,70,10,1
17-01-2025,"Grains, Flours & Dals",RICE FLOUR 500 GM,4,35,28,7,1
17-01-2025,Spices & Seasonings,NUVVULU 250GM,15,80,65,15,1
17-01-2025,"Health, Wellness & Ayurvedic Products",MH Millets Malt 500GM,5,200,190,10,1
17-01-2025,"Grains, Flours & Dals",Urad dall 1 Kg,4,370,340,30,2
17-01-2025,Spices & Seasonings,DURGA SALT CRYSTAL 1KG,15,25,25,0,1
17-01-2025,"Dry Fruits, Nuts & Seeds",Groundnuts 1 kg,2,190,170,20,1
17-01-2025,Spices & Seasonings,TATA SALT 1KG,15,60,60,0,2
17-01-2025,Spices & Seasonings,JEERA 250 gms,15,125,105,20,1
17-01-2025,Spices & Seasonings,Turmeric powder 250 gms,15,100,75,25,1
17-01-2025,"Grains, Flours & Dals",Wheat Rava M 1KG,4,130,110,20,2
17-01-2025,Oils & Ghee,Groundnut oil 1 L,9,720,660,60,2
17-01-2025,Pooja & Spiritual Items,VRP APOORVA JAVADHU POW,12,35,35,0,1
17-01-2025,Pooja & Spiritual Items,GD Dhoop Cones 40GM,12,30,30,0,1
17-01-2025,Spices & Seasonings,PURO Healthy Salt 1KG,15,110,110,0,1
17-01-2025,"Grains, Flours & Dals",MELMEKER 250GMS,4,60,45,15,1
17-01-2025,Spices & Seasonings,DB SAFRON,15,180,180,0,1
17-01-2025,Spices & Seasonings,Menthulu 250 gms,15,50,45,5,1
17-01-2025,Sweeteners,YB JAGGERY POWDER 1KG,16,140,140,0,1
17-01-2025,Pooja & Spiritual Items,OM SAINATH ISOBORNEOL 10GM,12,60,60,0,1
17-01-2025,Spices & Seasonings,SATHVI ANASAPUVUU 25GM,15,90,65,25,1
17-01-2025,Pooja & Spiritual Items,BANDA PUVVU 25GM 25GM,12,80,60,20,1
17-01-2025,Spices & Seasonings,PURO Healthy Salt Crystal 1KG,15,135,135,0,1
17-01-2025,Household & Cleaning,VIM TROPICAL LEMON FRESHNESS 250ML,6,55,55,0,1
17-01-2025,"Grains, Flours & Dals",Multigrain 1 kg,4,300,255,45,3
17-01-2025,"Grains, Flours & Dals",Wheat Flour 1 kg,4,70,60,10,1
17-01-2025,"Grains, Flours & Dals",UDALU (Barnyard millet) 1 kg,4,140,115,25,1
17-01-2025,"Grains, Flours & Dals",SL Idly Rava 1KG,4,130,110,20,2
17-01-2025,"Grains, Flours & Dals",RICE FLOUR 1KG,4,70,55,15,1
17-01-2025,Milk & Dairy,SANGAM FULL CREAM MILK 500ML,7,38,38,0,1
17-01-2025,"Grains, Flours & Dals",Wheat Flour 1 kg,4,70,60,10,1
17-01-2025,Snacks & Ready-to-Eat,DOSA BATTER 1KG,14,60,60,0,1
17-01-2025,Milk & Dairy,SANGAM TONED MILK 500ML,7,30,30,0,1
17-01-2025,Pooja & Spiritual Items,SWASTIK CAMPHOR 15GM,12,40,40,0,1
17-01-2025,Personal Care & Cosmetics,DWI ALOEVERA 100GM,10,90,90,0,1
17-01-2025,Misc,NOVA,8,68,68,0,1
17-01-2025,Oils & Ghee,Black Sesame oil 500 ml,9,220,190,30,1
17-01-2025,Oils & Ghee,Coconut oil 500 ml,9,440,400,40,2
17-01-2025,Oils & Ghee,Black Sesame oil 500 ml,9,660,570,90,3
17-01-2025,Snacks & Ready-to-Eat,VD MIXTURE 175 GM,14,120,120,0,2
17-01-2025,Snacks & Ready-to-Eat,BATANA NGT 70GMS,14,20,20,0,1
17-01-2025,Snacks & Ready-to-Eat,ZEEDI,14,70,70,0,1
17-01-2025,Snacks & Ready-to-Eat,VD SANNAPUSA 175GM,14,60,60,0,1
17-01-2025,Snacks & Ready-to-Eat,RSC ORANGE 100GMS,14,20,20,0,1
17-01-2025,Beverages,BRU GREEN LABEL 1.2G,1,20,20,0,10
17-01-2025,Snacks & Ready-to-Eat,Corn Chips 250GM,14,80,70,10,2
17-01-2025,Snacks & Ready-to-Eat,VD VAMUPUSA 175GM,14,60,60,0,1
17-01-2025,Snacks & Ready-to-Eat,VD ATUKULU MIXTURE 175GM,14,60,60,0,1
17-01-2025,Snacks & Ready-to-Eat,PALLI LADDU 200GMS,14,90,70,20,1
17-01-2025,Snacks & Ready-to-Eat,VD CORNFLAKES MIXTURE 175GM,14,60,60,0,1
17-01-2025,"Grains, Flours & Dals",RAGI FLOUR 500GRMS,4,40,35,5,1
17-01-2025,"Grains, Flours & Dals",SAMALU (Little millet) 500 gms,4,85,65,20,1
17-01-2025,"Grains, Flours & Dals",THICK POHA 500GM,4,40,35,5,1
17-01-2025,"Grains, Flours & Dals",UDALU (Barnyard millet) 500 gms,4,70,60,10,1
17-01-2025,Oils & Ghee,Groundnut oil 1 L,9,360,330,30,1
17-01-2025,"Grains, Flours & Dals",Wheat Rava M 500GM,4,33,30,3,1
17-01-2025,"Grains, Flours & Dals",MELMEKER 250GMS,4,60,45,15,1
17-01-2025,"Grains, Flours & Dals",KORRALU (FOXTAIL M) 500GM,4,65,55,10,1
17-01-2025,"Grains, Flours & Dals",JOWAR WHITE 1 KG,4,40,35,5,0.5
17-01-2025,Spices & Seasonings,SATHVI ANASAPUVUU 25GM,15,90,65,25,1
17-01-2025,Sweeteners,Mishri 500GM,16,70,60,10,1
17-01-2025,Spices & Seasonings,Japatri 25GM,15,100,80,20,1
17-01-2025,Pooja & Spiritual Items,SWASTIK CAMPHORE,12,90,90,0,1
17-01-2025,Spices & Seasonings,SAJEERA,15,60,40,20,1
17-01-2025,"Grains, Flours & Dals",Wheat Flour 1 kg,4,70,60,10,1
17-01-2025,"Grains, Flours & Dals",RICE FLOUR 1KG,4,70,55,15,1
17-01-2025,Spices & Seasonings,ROYAL SAFFRON,15,250,250,0,2
17-01-2025,"Grains, Flours & Dals",Chana Flour 1 kg,4,140,130,10,1
17-01-2025,Pooja & Spiritual Items,SWASTIK CAMPHOR 25GM,12,60,60,0,1
17-01-2025,"Grains, Flours & Dals",RAGI FLOUR 1KG,4,80,70,10,1
17-01-2025,Spices & Seasonings,ROYAL SAFFRON,15,125,125,0,1
17-01-2025,"Grains, Flours & Dals",FLOUR CHARGE,4,57.6,57.6,0,4.8
17-01-2025,"Grains, Flours & Dals",Chana Flour 500 gms,4,140,130,10,2
17-01-2025,Pooja & Spiritual Items,SWASTIK CAMPHORE,12,180,180,0,2
17-01-2025,Misc,HOME LIKES,8,20,20,0,2
17-01-2025,"Grains, Flours & Dals",SA WHITE JOWAR RAVA 500GM,4,69,69,0,1
17-01-2025,"Grains, Flours & Dals",Chana Flour 500 gms,4,70,65,5,1
17-01-2025,Pooja & Spiritual Items,DASANGAM DHOOP POWDER 50GM,12,43,43,0,1
17-01-2025,"Grains, Flours & Dals",Em Little idli R 500g,4,129,129,0,1
17-01-2025,Beverages,GANTASALA TEJ DRY GINGER COFFEE,1,149,149,0,1
17-01-2025,"Grains, Flours & Dals",Em kodo idli R 500G,4,129,129,0,1
17-01-2025,"Grains, Flours & Dals",Green gram 500 gms,4,75,70,5,1
17-01-2025,Spices & Seasonings,Jeera 100GM,15,50,45,5,1
17-01-2025,Oils & Ghee,Sesame oil 500ml,9,295,280,15,1
17-01-2025,Milk & Dairy,SANGAM TONED MILK 500ML,7,30,30,0,1
17-01-2025,"Grains, Flours & Dals",Red Chana 250GM,4,35,30,5,1
17-01-2025,"Grains, Flours & Dals",DESI CHANA,4,25,25,0,1
17-01-2025,"Dry Fruits, Nuts & Seeds",DRYDATES YELLOW 250GM,2,135,120,15,1
17-01-2025,Snacks & Ready-to-Eat,BATANA NGT 70GMS,14,20,20,0,1
17-01-2025,Snacks & Ready-to-Eat,VD PANIPURI 100GM,14,30,30,0,1
17-01-2025,"Grains, Flours & Dals",HS RAGI Idly rava 500 gms,4,140,140,0,2
17-01-2025,Spices & Seasonings,TM MIRCH POWDER 200GM,15,326,326,0,2
17-01-2025,"Grains, Flours & Dals",SL Idly Rava 1KG,4,260,220,40,4
17-01-2025,Spices & Seasonings,RED COPRA 500GM,15,170,148,22,1
17-01-2025,Personal Care & Cosmetics,Soapnut 250GM,10,90,90,0,2
17-01-2025,Snacks & Ready-to-Eat,VD RICE MURUKU 150GM,14,100,100,0,2
17-01-2025,Spices & Seasonings,GD Turmeric 50GM,15,75,75,0,3
17-01-2025,"Grains, Flours & Dals",Chana Flour 500 gms,4,140,130,10,2
17-01-2025,"Grains, Flours & Dals",SL Suji Rava 500GM,4,64,64,0,2
17-01-2025,Spices & Seasonings,AVALU 100GM,15,125,100,25,5
17-01-2025,Snacks & Ready-to-Eat,VD SAGOPAPAD 150GM,14,110,110,0,2
17-01-2025,Snacks & Ready-to-Eat,VD Pappu Chekkalu 190gm,14,60,60,0,1
17-01-2025,Spices & Seasonings,SAJEERA,15,60,40,20,1
17-01-2025,Sweeteners,MISHRI 250 GM,16,35,30,5,1
17-01-2025,Snacks & Ready-to-Eat,Corn Chips 250GM,14,80,70,10,2
17-01-2025,Snacks & Ready-to-Eat,NGT CHATPATTA CHANA 90GM,14,25,25,0,1
17-01-2025,Spices & Seasonings,GREEN SOUNF,15,240,160,80,4
17-01-2025,Oils & Ghee,Safflower oil 1 L,9,440,400,40,1
17-01-2025,Spices & Seasonings,JEERA 250 gms,15,125,105,20,1
17-01-2025,Snacks & Ready-to-Eat,MARMURA LADDU,14,80,60,20,1
17-01-2025,Sweeteners,Natural Honey 500 gms,16,560,480,80,2
17-01-2025,"Grains, Flours & Dals",Urad dall 1 Kg,4,185,170,15,1
17-01-2025,"Grains, Flours & Dals",RAGI FLOUR 500GRMS,4,40,35,5,1
17-01-2025,Oils & Ghee,Safflower oil 1 L,9,440,400,40,1
17-01-2025,"Grains, Flours & Dals",Wheat Flour 1 kg,4,70,60,10,1
17-01-2025,Oils & Ghee,Coconut oil 500 ml,9,220,200,20,1
17-01-2025,"Grains, Flours & Dals",RICE FLOUR 500 GM,4,35,28,7,1
17-01-2025,Oils & Ghee,Castor oil 200 ml,9,100,80,20,1
17-01-2025,Pooja & Spiritual Items,GD Aiswarya Deepam 700ML,12,195,195,0,1
17-01-2025,Oils & Ghee,Groundnut oil 1 L,9,360,330,30,1
17-01-2025,"Grains, Flours & Dals",VYS.SP RICE 1 KG,4,140,130,10,2
17-01-2025,Pooja & Spiritual Items,SWASTIK CAMPHORE,12,90,90,0,1
17-01-2025,Oils & Ghee,Groundnut oil 1 L,9,720,660,60,2
17-01-2025,"Dry Fruits, Nuts & Seeds",GF KIMIA DATES 500GM,2,310,190,120,1
17-01-2025,Milk & Dairy,SANGAM TONED MILK 500ML,7,30,30,0,1
17-01-2025,Pooja & Spiritual Items,SWASTIK CAMPHOR 10GM,12,60,60,0,3
17-01-2025,Pooja & Spiritual Items,VRP APOORVA JAVADHU POW,12,35,35,0,1
17-01-2025,"Grains, Flours & Dals",EM Ragi idli R 500G,4,75,75,0,1
17-01-2025,Pooja & Spiritual Items,ZED BLACK PREMIUM STICKS 3 IN 1 100G,12,60,60,0,1
17-01-2025,"Grains, Flours & Dals",SA YELLOW JOWAR RAVA 500GM,4,95,95,0,1
17-01-2025,"Grains, Flours & Dals",EM Foxtail idli r 500 g,4,109,109,0,1
17-01-2025,Snacks & Ready-to-Eat,SF COOKIES CHOCO RAGI,14,99,99,0,1
17-01-2025,Oils & Ghee,Groundnut oil 1 L,9,360,330,30,1
17-01-2025,"Grains, Flours & Dals",Multigrain 1 kg,4,100,85,15,1
17-01-2025,"Grains, Flours & Dals",Green gram 1 kg,4,150,130,20,1
17-01-2025,"Dry Fruits, Nuts & Seeds",Groundnuts 1 kg,2,190,170,20,1
17-01-2025,Snacks & Ready-to-Eat,SH PUFFED RICE 500GM,14,112,112,0,1
17-01-2025,Snacks & Ready-to-Eat,SD Thati thandra 200gm,14,300,300,0,2
17-01-2025,Oils & Ghee,Groundnut oil 5 L,9,1800,"1,600.00",200,1
17-01-2025,"Grains, Flours & Dals",RAGULU 1 KG,4,140,120,20,2
17-01-2025,"Grains, Flours & Dals",Idly Rava L 1KG,4,120,100,20,2
17-01-2025,Snacks & Ready-to-Eat,SATHVI PALLI CHIKKI 200GM,14,100,80,20,1
17-01-2025,"Dry Fruits, Nuts & Seeds",PULMAKHANA 100 GM,2,180,170,10,1
17-01-2025,"Grains, Flours & Dals",Wheat Rava M 1KG,4,65,55,10,1
17-01-2025,Oils & Ghee,Groundnut oil 1 L,9,360,330,30,1
17-01-2025,"Grains, Flours & Dals",Multigrain 1 kg,4,100,85,15,1
17-01-2025,Snacks & Ready-to-Eat,SESAME LADDU 200GM,14,100,80,20,1
17-01-2025,"Grains, Flours & Dals",Chana Flour 500 gms,4,140,130,10,2
17-01-2025,"Grains, Flours & Dals",RICE FLOUR 1KG,4,70,55,15,1
17-01-2025,"Dry Fruits, Nuts & Seeds",PUMPKIN SEEDS 250GM,2,200,160,40,1
17-01-2025,"Grains, Flours & Dals",UDALU (Barnyard millet) 500 gms,4,70,60,10,1
17-01-2025,Snacks & Ready-to-Eat,SATHVI REGIVADA 200GM,14,160,120,40,2
17-01-2025,Snacks & Ready-to-Eat,RINGS 200GM,14,30,30,0,1
17-01-2025,Snacks & Ready-to-Eat,RSC ORANGE 100GMS,14,40,40,0,2
17-01-2025,"Grains, Flours & Dals",KORRALU (FOXTAIL M) 500GM,4,65,55,10,1
17-01-2025,Sweeteners,SUGAR 1KG,16,60,50,10,1
17-01-2025,"Dry Fruits, Nuts & Seeds",Groundnuts 500 gms,2,95,85,10,1
17-01-2025,"Grains, Flours & Dals",THIN POHA 500GM,4,40,35,5,1
17-01-2025,"Dry Fruits, Nuts & Seeds",Putnalu 250GM,2,45,38,7,1
17-01-2025,Oils & Ghee,Mustard oil 500 ml,9,220,195,25,1
17-01-2025,Snacks & Ready-to-Eat,SD Bajra with palm Jaggery 250gm,14,135,135,0,1
17-01-2025,Snacks & Ready-to-Eat,SD JOWAR WITH PALM JAGGERY 250GM,14,135,135,0,1
17-01-2025,Snacks & Ready-to-Eat,SATHVI PALLI CHIKKI 200GM,14,200,160,40,2
17-01-2025,Snacks & Ready-to-Eat,SALTED PHALLI,14,130,130,0,2
17-01-2025,Snacks & Ready-to-Eat,BELLAM MINAPA SUNADULLU,14,180,180,0,1
17-01-2025,Snacks & Ready-to-Eat,COPRA LADDU 200GM,14,200,160,40,2
17-01-2025,Snacks & Ready-to-Eat,VD PAPPU CHEGODI 200GM,14,60,60,0,1
17-01-2025,Snacks & Ready-to-Eat,PALLI LADDU 200GMS,14,180,140,40,2
17-01-2025,Oils & Ghee,Coconut oil 500 ml,9,220,200,20,1
17-01-2025,"Grains, Flours & Dals",Multigrain 1 kg,4,100,85,15,1
17-01-2025,Oils & Ghee,Groundnut oil 1 L,9,360,330,30,1
17-01-2025,"Dry Fruits, Nuts & Seeds",Groundnuts 1 kg,2,190,170,20,1
17-01-2025,Snacks & Ready-to-Eat,SUNNUNDALU,14,100,100,0,1
17-01-2025,Beverages,BRU GREEN LABEL 1.2G,1,20,20,0,10
17-01-2025,Spices & Seasonings,DRY MIECHI 200GM,15,80,60,20,1
17-01-2025,Spices & Seasonings,ROYAL SAFFRON 400GRMS,15,130,130,0,2
17-01-2025,"Grains, Flours & Dals",Wheat Rava M 1KG,4,65,55,10,1
17-01-2025,Spices & Seasonings,ROYAL SAFFRON,15,125,125,0,1
17-01-2025,Oils & Ghee,Safflower oil 1 L,9,440,400,40,1
17-01-2025,Oils & Ghee,Sesame oil 1 L,9,590,560,30,1
17-01-2025,Pooja & Spiritual Items,SWASTIK PURE CAMPHOR 7GM,12,40,40,0,2
17-01-2025,Personal Care & Cosmetics,INDICA EASY,10,30,30,0,1
17-01-2025,Oils & Ghee,Sesame oil 500ml,9,295,280,15,1
17-01-2025,Personal Care & Cosmetics,MD Henna Choornam 100GM,10,160,160,0,2
17-01-2025,"Health, Wellness & Ayurvedic Products",MD Neem Leaf Choornam 100GM,5,80,80,0,1
17-01-2025,Oils & Ghee,Groundnut oil 1 L,9,360,330,30,1
17-01-2025,Pooja & Spiritual Items,GD Aiswarya Deepam 700ML,12,195,195,0,1
17-01-2025,Spices & Seasonings,TM MIRCH POWDER 200GM,15,163,163,0,1
17-01-2025,"Grains, Flours & Dals",YB CHITTIMUTYALU RICE 1KG,4,200,200,0,1
17-01-2025,"Grains, Flours & Dals",White jowar.F 1 kg,4,100,80,20,1
17-01-2025,Milk & Dairy,HERITAGE CURD,7,48,48,0,1
17-01-2025,"Grains, Flours & Dals",AISHWARYA SP 1KG,4,80,75,5,1
17-01-2025,"Grains, Flours & Dals",FLOUR CHARGE,4,24,24,0,2
17-01-2025,"Grains, Flours & Dals",WHEAT 1 KG,4,120,100,20,2
17-01-2025,"Health, Wellness & Ayurvedic Products",RB Max Protein Salt & Caramel Bar 50g,5,75,75,0,1
17-01-2025,Snacks & Ready-to-Eat,VD GUMMADI VADIYAM,14,75,75,0,1
17-01-2025,Snacks & Ready-to-Eat,SF MIGHTY PUFFS,14,25,25,0,1
17-01-2025,"Grains, Flours & Dals",JOWAR WHITE 1 KG,4,160,140,20,2
17-01-2025,Personal Care & Cosmetics,Khadi Shikakai With Amla Shampoo 200,10,199,199,0,1
17-01-2025,"Grains, Flours & Dals",URAD DALL,4,95,85,10,1
17-01-2025,Oils & Ghee,Sesame oil 1 L,9,590,560,30,1
17-01-2025,Snacks & Ready-to-Eat,JUNNU POWDER 100GM,14,70,70,0,1
17-01-2025,"Grains, Flours & Dals",JOWAR UPMA RAVA,4,75,75,0,1
17-01-2025,Snacks & Ready-to-Eat,SATHVI REGIVADA 200GM,14,80,80,0,1
17-01-2025,"Grains, Flours & Dals",Em jowar idly R 500G,4,75,75,0,1
17-01-2025,Oils & Ghee,Groundnut oil 1 L,9,720,660,60,2
17-01-2025,"Grains, Flours & Dals",split black gram 1 kg,4,180,170,10,1
17-01-2025,"Dry Fruits, Nuts & Seeds",PULMAKHANA 100 GM,2,180,170,10,1
17-01-2025,Oils & Ghee,Sesame oil 500ml,9,295,280,15,1
17-01-2025,"Grains, Flours & Dals",VYS.SP RICE 1 KG,4,210,195,15,3
17-01-2025,"Grains, Flours & Dals",Multigrain 1 kg,4,100,85,15,1
17-01-2025,Oils & Ghee,Coconut oil 500 ml,9,220,200,20,1
17-01-2025,"Grains, Flours & Dals",BAJRA 1 KG,4,60,50,10,1
17-01-2025,Beverages,BISLERI 100ml,1,10,10,0,1
17-01-2025,Oils & Ghee,Groundnut oil 1 L,9,360,330,30,1
17-01-2025,"Grains, Flours & Dals",SB Javva Wheat Ravva 500GM,4,95,95,0,1
17-01-2025,"Grains, Flours & Dals",Wheat Flour 1 kg,4,70,60,10,1
17-01-2025,"Grains, Flours & Dals",SA YELLOW JOWAR RAVA 500GM,4,95,95,0,1
17-01-2025,"Grains, Flours & Dals",JOWAR YELLOW 1 K,4,300,270,30,3
17-01-2025,Milk & Dairy,BROWN EGGS TRAY 30P,7,360,330,30,1
17-01-2025,Spices & Seasonings,Coriander seeds 200 gms,15,48,40,8,1
17-01-2025,Oils & Ghee,Groundnut oil 1 L,9,1080,990,90,3
17-01-2025,Pooja & Spiritual Items,BALAJI DESH MERE 220GM,12,150,150,0,1
17-01-2025,Misc,JOKER,8,10,10,0,1
17-01-2025,Pooja & Spiritual Items,PACHI KARPURAM 25GM,12,180,180,0,2
17-01-2025,"Grains, Flours & Dals",WHEAT 1 KG,4,180,150,30,3
17-01-2025,"Grains, Flours & Dals",RAGI FLOUR 1KG,4,80,70,10,1
17-01-2025,"Grains, Flours & Dals",FLOUR CHARGE,4,36,36,0,3
17-01-2025,"Grains, Flours & Dals",White jowar.F 1 kg,4,100,80,20,1
17-01-2025,Oils & Ghee,Groundnut oil 5 L,9,1800,"1,600.00",200,1
17-01-2025,Spices & Seasonings,NUVVULU 500GM,15,200,170,30,1
17-01-2025,Oils & Ghee,Coconut oil 1 L,9,440,400,40,1
17-01-2025,"Grains, Flours & Dals",EM Ragi idli R 500G,4,75,75,0,1
17-01-2025,"Grains, Flours & Dals",Em kodo idli R 500G,4,129,129,0,1
17-01-2025,"Grains, Flours & Dals",Em jowar idly R 500G,4,75,75,0,1
17-01-2025,"Grains, Flours & Dals",Em Little idli R 500g,4,129,129,0,1
17-01-2025,"Grains, Flours & Dals",EM Foxtail idli r 500 g,4,109,109,0,1
17-01-2025,"Grains, Flours & Dals",GS BROWN RICE POHA 200GM,4,60,60,0,1
17-01-2025,Spices & Seasonings,SAJEERA,15,60,40,20,1
17-01-2025,"Grains, Flours & Dals",Wheat Flour 1 kg,4,140,120,20,2
17-01-2025,Oils & Ghee,Safflower oil 1 L,9,440,400,40,1
17-01-2025,Milk & Dairy,BROWN EGGS 1P,7,168,144,24,12
17-01-2025,"Dry Fruits, Nuts & Seeds",PUMPKIN SEEDS 250GM,2,200,160,40,1
17-01-2025,"Grains, Flours & Dals",turdal 1kg,4,220,195,25,1
17-01-2025,Spices & Seasonings,Dalchin Chekka 50GM,15,50,40,10,1
17-01-2025,Oils & Ghee,Groundnut oil 1 L,9,720,660,60,2
17-01-2025,Spices & Seasonings,SATHVI ANASAPUVUU 25GM,15,90,65,25,1
17-01-2025,Spices & Seasonings,Japatri 25GM,15,100,80,20,1
17-01-2025,Spices & Seasonings,SAJEERA,15,60,40,20,1
17-01-2025,Spices & Seasonings,Elaichi 25GM,15,145,120,25,1
17-01-2025,Spices & Seasonings,Marati Magga 50GM,15,130,110,20,1
17-01-2025,Oils & Ghee,Coconut oil 1 L,9,440,400,40,1
17-01-2025,Oils & Ghee,Coconut oil 1 L,9,440,400,40,1
17-01-2025,Oils & Ghee,GANTASALA A2 COW GHEE 500ML,9,550,550,0,1
17-01-2025,Snacks & Ready-to-Eat,VD RICE MURUKU 150GM,14,100,100,0,2
17-01-2025,"Grains, Flours & Dals",VGR RICE 5 KGS,4,350,325,25,1
17-01-2025,Oils & Ghee,BUFFALLO GHEE 500ML,9,410,370,40,1
17-01-2025,Snacks & Ready-to-Eat,VD Minapa papad 200gm,14,120,120,0,2
17-01-2025,"Grains, Flours & Dals",Green gram 1 kg,4,300,260,40,2
17-01-2025,"Dry Fruits, Nuts & Seeds",Groundnuts 1 kg,2,190,170,20,1
17-01-2025,Personal Care & Cosmetics,BANJARAS HAIR CARE POWDER HIBISCUS,10,100,100,0,1
17-01-2025,Personal Care & Cosmetics,UVIS ALOEVERA GEL,10,149,149,0,1
17-01-2025,"Grains, Flours & Dals",RAGULU 1 KG,4,35,30,5,0.5
17-01-2025,"Grains, Flours & Dals",BAJRA 1 KG,4,30,25,5,0.5
17-01-2025,"Grains, Flours & Dals",KORRALU (FOXTAIL M) 500GM,4,65,55,10,1
17-01-2025,Pooja & Spiritual Items,GD Kailash 60 GM,12,60,60,0,1
17-01-2025,Oils & Ghee,Black Sesame oil 500 ml,9,440,380,60,2
17-01-2025,"Grains, Flours & Dals",turdal 500 gms,4,110,100,10,1
17-01-2025,"Grains, Flours & Dals",RAGI FLOUR 500GRMS,4,40,35,5,1
17-01-2025,Personal Care & Cosmetics,DABUR RED PASTE 50GM,10,25,25,0,1
17-01-2025,Spices & Seasonings,Tamarind 250GMS,15,80,65,15,1
17-01-2025,"Dry Fruits, Nuts & Seeds",SABJA SEEDS 100GM,2,80,70,10,1
17-01-2025,Personal Care & Cosmetics,HIMALAYA LIP BALM 10GM,10,40,40,0,1
17-01-2025,Oils & Ghee,Coconut oil 500 ml,9,220,200,20,1
17-01-2025,General Household & Kitchenware,PREMIER KITTCHEN TOWEL,3,160,160,0,1
17-01-2025,Sweeteners,NATURAL HONEY 250GM,16,150,130,20,1
17-01-2025,"Grains, Flours & Dals",MAAGAANI LOW GI SP 1KG,4,315,315,0,3
17-01-2025,Pickles & Cooking Pastes,SD GINGER PICKLE 250GM,11,110,110,0,1
17-01-2025,Snacks & Ready-to-Eat,SD Atreyapuram DRY Fruit ghee,14,150,150,0,1
17-01-2025,Snacks & Ready-to-Eat,ZEEDI,14,70,70,0,1
17-01-2025,Snacks & Ready-to-Eat,PEANUT CANDY,14,45,45,0,1
17-01-2025,Snacks & Ready-to-Eat,BLACK SESAME CHIKKI,14,25,25,0,5
17-01-2025,"Dry Fruits, Nuts & Seeds",PRO ORG RAW PEANUTS 500GM,2,174,174,0,1
17-01-2025,"Grains, Flours & Dals",VGR rice 1 kg,4,210,195,15,3
17-01-2025,Snacks & Ready-to-Eat,FUN TIME CRUNCH,14,90,90,0,2
17-01-2025,"Health, Wellness & Ayurvedic Products",ZINDA TILISMATH 5ML,5,140,140,0,2
17-01-2025,"Grains, Flours & Dals",Wheat Flour 5 kgs,4,350,300,50,1
17-01-2025,Pooja & Spiritual Items,BALAJI GUGGAL DHOOP 10STK,12,70,70,0,1
17-01-2025,"Grains, Flours & Dals",Urad dall 1 Kg,4,185,170,15,1
17-01-2025,Household & Cleaning,RIN ANTIBAC NEEM EXTRACT 1KG,6,126,126,0,1
17-01-2025,"Dry Fruits, Nuts & Seeds",WALLNUTS 250GM,2,320,290,30,1
17-01-2025,"Health, Wellness & Ayurvedic Products",MORINGA LEAF POWDER M,5,80,75,5,1
17-01-2025,"Grains, Flours & Dals",CHANA DAL 500GM,4,70,60,10,1
17-01-2025,"Dry Fruits, Nuts & Seeds",PULMAKHANA 100 GM,2,180,170,10,1
17-01-2025,Spices & Seasonings,Jeera 100GM,15,50,45,5,1
17-01-2025,"Dry Fruits, Nuts & Seeds",PUMPKIN SEEDS 250GM,2,200,160,40,1
17-01-2025,Spices & Seasonings,SATHVI BIRYANI LEAF 25GM,15,30,20,10,1
17-01-2025,"Grains, Flours & Dals",Wheat Rava M 1KG,4,65,55,10,1
17-01-2025,Oils & Ghee,Black Sesame oil 500 ml,9,220,190,30,1
17-01-2025,"Grains, Flours & Dals",COW B rice 1 kg,4,144,138,6,2
17-01-2025,Snacks & Ready-to-Eat,VD SANNAPUSA 175GM,14,60,60,0,1
17-01-2025,Snacks & Ready-to-Eat,VD MYSOREPAK 6PIC,14,100,100,0,1
17-01-2025,Oils & Ghee,Safflower oil 1 L,9,440,400,40,1
17-01-2025,Household & Cleaning,TIDE DOUBLE POWER LEMON &amp;MINT,6,132,132,0,1
17-01-2025,Spices & Seasonings,PURO Healthy Salt 1KG,15,110,110,0,1
17-01-2025,"Dry Fruits, Nuts & Seeds",Groundnuts 1 kg,2,190,170,20,1
17-01-2025,Pooja & Spiritual Items,ZED BLACK PREMIUM STICKS 3 IN 1 100G,12,60,60,0,1
17-01-2025,Milk & Dairy,HERITAGE CURD,7,48,48,0,1
17-01-2025,Milk & Dairy,SANGAM TONED MILK 500ML,7,30,30,0,1
17-01-2025,"Grains, Flours & Dals",JOWAR YELLOW 1 K,4,800,720,80,8
17-01-2025,Oils & Ghee,Safflower oil 1 L,9,440,400,40,1
17-01-2025,Oils & Ghee,Sesame oil 1 L,9,590,560,30,1
17-01-2025,"Grains, Flours & Dals",RAGULU 1 KG,4,140,120,20,2
17-01-2025,Pooja & Spiritual Items,GD Sree Chandan 50GM,12,50,50,0,1
17-01-2025,Pooja & Spiritual Items,SWATHI POOJA VATHULU,12,50,50,0,1
17-01-2025,Oils & Ghee,Groundnut oil 1 L,9,360,330,30,1
17-01-2025,"Grains, Flours & Dals",YB Red RICE 1 KG,4,150,120,30,1
17-01-2025,Oils & Ghee,Sesame oil 1 L,9,590,560,30,1
17-01-2025,Oils & Ghee,Mustard oil 500 ml,9,220,195,25,1
17-01-2025,Milk & Dairy,BROWN EGGS 1P,7,168,144,24,12
17-01-2025,Oils & Ghee,Mustard oil 500 ml,9,220,195,25,1
16-01-2025,"Grains, Flours & Dals",VYS.SP.RICE 10 KGS,4,700,650,50,1
16-01-2025,Snacks & Ready-to-Eat,SALTED PHALLI,14,25,25,0,1
16-01-2025,Sweeteners,ACHU BELLAM 1KG,16,100,80,20,1
16-01-2025,Sweeteners,ACHUBELLAM 500GM,16,50,40,10,1
16-01-2025,"Health, Wellness & Ayurvedic Products",AMLA PACHAK,5,100,100,0,1
16-01-2025,"Grains, Flours & Dals",VYS.SP.RICE BAG 1,4,1800,"1,650.00",150,1
16-01-2025,Oils & Ghee,Black Sesame oil 500 ml,9,220,190,30,1
16-01-2025,"Grains, Flours & Dals",Wheat Rava M 1KG,4,65,55,10,1
16-01-2025,Snacks & Ready-to-Eat,JUNNU POWDER 100GM,14,140,140,0,2
16-01-2025,"Health, Wellness & Ayurvedic Products",MAHAVEDA NANNARI SHARBATH 750ML,5,220,220,0,1
16-01-2025,"Grains, Flours & Dals",SRILATHA RICE RAVVA 500GM,4,35,35,0,1
16-01-2025,"Grains, Flours & Dals",Wheat Flour 2 kgs,4,140,120,20,1
16-01-2025,"Grains, Flours & Dals",RAGI FLOUR 500GRMS,4,40,35,5,1
16-01-2025,Oils & Ghee,Groundnut oil 5 L,9,1800,"1,600.00",200,1
16-01-2025,"Grains, Flours & Dals",Chana Flour 500 gms,4,70,65,5,1
16-01-2025,"Grains, Flours & Dals",White jowar.F 1 kg,4,200,160,40,2
16-01-2025,"Grains, Flours & Dals",Chana Flour 500 gms,4,70,65,5,1
16-01-2025,"Grains, Flours & Dals",Wheat Flour 1 kg,4,70,60,10,1
16-01-2025,"Grains, Flours & Dals",Wheat Flour 1 kg,4,210,180,30,3
16-01-2025,"Grains, Flours & Dals",Yellow jowar .F1 kg,4,110,100,10,1
16-01-2025,Oils & Ghee,Groundnut oil 5 L,9,1800,"1,600.00",200,1
16-01-2025,Snacks & Ready-to-Eat,MB LITTLE MILLET COOKIES,14,75,75,0,1
16-01-2025,Snacks & Ready-to-Eat,VD ATUKULU MIXTURE 175GM,14,60,60,0,1
16-01-2025,"Grains, Flours & Dals",SA YELLOW JOWAR RAVA 500GM,4,190,190,0,2
16-01-2025,"Grains, Flours & Dals",Yellow jowar .F1 kg,4,110,100,10,1
16-01-2025,"Grains, Flours & Dals",FLOUR CHARGE,4,60,60,0,5
16-01-2025,Snacks & Ready-to-Eat,MARMURA LADDU,14,80,60,20,1
16-01-2025,Snacks & Ready-to-Eat,PALLI LADDU 200GMS,14,90,70,20,1
16-01-2025,"Dry Fruits, Nuts & Seeds",SUNFLOWER SEEDS 250GRM,2,150,130,20,1
16-01-2025,Snacks & Ready-to-Eat,SF MIGHTY PUFFS,14,25,25,0,1
16-01-2025,Spices & Seasonings,SWASTIKS GINGER &amp;GARLIC PASTE,15,69,69,0,1
16-01-2025,Snacks & Ready-to-Eat,MP CHOCO ALMOND COOKIE,14,60,60,0,1
16-01-2025,"Grains, Flours & Dals",ANDU KORRALU (Browntop.m) 1 kg,4,640,580,60,2
16-01-2025,"Grains, Flours & Dals",SAMALU (Little millet) 1 kg,4,340,260,80,2
16-01-2025,"Grains, Flours & Dals",KORRALU (FOXTAIL M) 1KG,4,300,220,80,2
16-01-2025,"Grains, Flours & Dals",RAGI FLOUR 1KG,4,160,140,20,2
16-01-2025,"Grains, Flours & Dals",UDALU (Barnyard millet) 1 kg,4,280,230,50,2
16-01-2025,"Grains, Flours & Dals",Arikadu ( kodo),4,280,260,20,2
16-01-2025,Milk & Dairy,BROWN EGGS 1P,7,168,144,24,12
16-01-2025,"Grains, Flours & Dals",SRI LALITHA BROWN RICE,4,370,370,0,1
16-01-2025,Oils & Ghee,Coconut oil 500 ml,9,220,200,20,1
16-01-2025,Oils & Ghee,Castor oil 500 ml,9,250,200,50,1
16-01-2025,"Health, Wellness & Ayurvedic Products",MD Yashtimadhu Choornam 50GM,5,80,80,0,1
16-01-2025,"Health, Wellness & Ayurvedic Products",AMLAKI CHOORNAM,5,100,100,0,1
16-01-2025,General Household & Kitchenware,k2,3,210,199.5,10.5,1
16-01-2025,Snacks & Ready-to-Eat,SD VAMU APPADALU 200GM,14,80,80,0,1
16-01-2025,Snacks & Ready-to-Eat,VD ARISELU 5 PIC,14,200,200,0,2
16-01-2025,Sweeteners,MISHRI 250 GM,16,35,30,5,1
16-01-2025,Oils & Ghee,Coconut oil 1 L,9,440,400,40,1
16-01-2025,Oils & Ghee,Coconut oil 500 ml,9,220,200,20,1
16-01-2025,"Grains, Flours & Dals",Multigrain 1 kg,4,100,85,15,1
16-01-2025,"Grains, Flours & Dals",AS Maize Rava 500GM,4,42,38,4,1
16-01-2025,Snacks & Ready-to-Eat,PALLI LADDU 200GMS,14,90,70,20,1
16-01-2025,"Grains, Flours & Dals",Green gram 500 gms,4,75,70,5,1
16-01-2025,Oils & Ghee,Coconut oil 1 L,9,440,400,40,1
16-01-2025,Personal Care & Cosmetics,NIVEA FACE WASH,10,130,130,0,1
16-01-2025,Snacks & Ready-to-Eat,PALLI LADDU 200GMS,14,90,70,20,1
16-01-2025,Snacks & Ready-to-Eat,ELITE MILK RUSK 200GM,14,35,35,0,1
16-01-2025,"Dry Fruits, Nuts & Seeds",Groundnuts 500 gms,2,95,85,10,1
16-01-2025,"Dry Fruits, Nuts & Seeds",ALMONDS 250GM,2,280,260,20,1
16-01-2025,Snacks & Ready-to-Eat,PALLI LADDU 200GMS,14,90,70,20,1
16-01-2025,Snacks & Ready-to-Eat,SD Vamu with palm jaggery 250gm,14,135,135,0,1
16-01-2025,Snacks & Ready-to-Eat,RAGI LADDU,14,120,120,0,1
16-01-2025,Oils & Ghee,Sesame oil 500ml,9,295,280,15,1
16-01-2025,"Grains, Flours & Dals",Wheat Rava M 500GM,4,33,30,3,1
16-01-2025,Personal Care & Cosmetics,DABUR RED PASTE 50GM,10,25,25,0,1
16-01-2025,Spices & Seasonings,NUVVULU 250GM,15,80,65,15,1
16-01-2025,"Grains, Flours & Dals",Wheat Flour 1 kg,4,70,60,10,1
16-01-2025,Oils & Ghee,Sesame oil 500ml,9,295,280,15,1
16-01-2025,Snacks & Ready-to-Eat,GB SALT COOKIES,14,60,55,5,1
16-01-2025,Snacks & Ready-to-Eat,ANNAPURNA APPALAM,14,70,70,0,2
16-01-2025,"Dry Fruits, Nuts & Seeds",Putnalu 250GM,2,45,38,7,1
16-01-2025,Spices & Seasonings,MM Kasuri Methi 25GM,15,30,30,0,1
16-01-2025,"Grains, Flours & Dals",turdal 1kg,4,220,195,25,1
16-01-2025,Oils & Ghee,Sesame oil 1 L,9,590,560,30,1
16-01-2025,"Grains, Flours & Dals",Multigrain 1 kg,4,200,170,30,2
16-01-2025,Snacks & Ready-to-Eat,SALTED PHALLI,14,65,65,0,1
16-01-2025,Snacks & Ready-to-Eat,MARMURA LADDU,14,80,60,20,1
16-01-2025,Snacks & Ready-to-Eat,GB SALT COOKIES,14,60,55,5,1
16-01-2025,Snacks & Ready-to-Eat,RSC ORANGE 100GMS,14,20,20,0,1
16-01-2025,"Grains, Flours & Dals",Idly Rava L 1KG,4,60,50,10,1
16-01-2025,Spices & Seasonings,Turmeric powder 250 gms,15,100,75,25,1
16-01-2025,"Dry Fruits, Nuts & Seeds",Groundnuts 1 kg,2,190,170,20,1
16-01-2025,Spices & Seasonings,SREE MARUTHI IDLY KARAM 200GM,15,60,60,0,1
16-01-2025,"Grains, Flours & Dals",Wheat Flour 1 kg,4,140,120,20,2
16-01-2025,Oils & Ghee,Groundnut oil 5 L,9,1800,"1,600.00",200,1
16-01-2025,Snacks & Ready-to-Eat,BATANA NGT 70GMS,14,20,20,0,1
16-01-2025,Beverages,GANTASALA GREEN TEA 100GM,1,149,149,0,1
16-01-2025,Spices & Seasonings,SV Oregano 15GM,15,110,110,0,1
16-01-2025,"Grains, Flours & Dals",RAGI FLOUR 500GRMS,4,40,35,5,1
16-01-2025,Spices & Seasonings,SV Smoked Chilli Flakes 30GM,15,46,46,0,1
16-01-2025,"Grains, Flours & Dals",VYS.SP.RICE 5 KGS,4,350,325,25,1
16-01-2025,"Grains, Flours & Dals",Wheat Flour 2 kgs,4,140,120,20,1
16-01-2025,Milk & Dairy,BROWN EGGS 1P,7,210,180,30,15
16-01-2025,Snacks & Ready-to-Eat,KURNOOL MARMURA,14,70,55,15,1
16-01-2025,"Grains, Flours & Dals",Chana Flour 500 gms,4,70,65,5,1
16-01-2025,Sweeteners,Mishri 500GM,16,70,60,10,1
16-01-2025,"Grains, Flours & Dals",Wheat Rava M 500GM,4,33,30,3,1
16-01-2025,Spices & Seasonings,LG 50GM,15,92,92,0,1
16-01-2025,Spices & Seasonings,Chilli powder 500 gms,15,290,210,80,1
16-01-2025,Oils & Ghee,Sesame oil 1 L,9,590,560,30,1
16-01-2025,Household & Cleaning,ROOPERI PITAMBARI SILVER 50ML,6,110,110,0,1
16-01-2025,Spices & Seasonings,DRY MIRCHI 1KG,15,225,180,45,0.75
16-01-2025,Spices & Seasonings,NUVVULU 500GM,15,400,340,60,2
16-01-2025,Snacks & Ready-to-Eat,MARMURA LADDU,14,80,60,20,1
16-01-2025,"Grains, Flours & Dals",FLOUR CHARGE,4,42,42,0,3.5
16-01-2025,"Grains, Flours & Dals",Chana Flour 500 gms,4,70,65,5,1
16-01-2025,Spices & Seasonings,GREEN SOUNF,15,60,40,20,1
16-01-2025,Spices & Seasonings,Vamu 100GM,15,60,50,10,1
16-01-2025,Spices & Seasonings,ROYAL SAFFRON 400GRMS,15,65,65,0,1
16-01-2025,Oils & Ghee,Sesame oil 500ml,9,295,280,15,1
16-01-2025,"Dry Fruits, Nuts & Seeds",PULMAKHANA 100 GM,2,180,170,10,1
16-01-2025,"Health, Wellness & Ayurvedic Products",AMLA PACHAK,5,100,100,0,1
16-01-2025,Beverages,MUA COFFEE EXT STRONG 250GM,1,140,140,0,1
16-01-2025,"Grains, Flours & Dals",Chana Flour 500 gms,4,70,65,5,1
16-01-2025,"Grains, Flours & Dals",ANDU KORRALU (Brown top .mlt) 500,4,160,145,15,1
16-01-2025,"Grains, Flours & Dals",Wheat Flour 1 kg,4,70,60,10,1
16-01-2025,"Grains, Flours & Dals",SF OATS JUMBO ROLLED 500GM,4,249,249,0,1
16-01-2025,"Grains, Flours & Dals",VYS.SP.RICE 5 KGS,4,350,325,25,1
16-01-2025,Spices & Seasonings,Chilli powder 500 gms,15,580,420,160,2
16-01-2025,Snacks & Ready-to-Eat,VD MAIDA CHEGODI 175GM,14,120,120,0,2
16-01-2025,Snacks & Ready-to-Eat,SATHVI PALLI CHIKKI 200GM,14,100,80,20,1
16-01-2025,Snacks & Ready-to-Eat,RINGS 200GM,14,30,30,0,1
16-01-2025,Snacks & Ready-to-Eat,ONION RINGS,14,50,50,0,1
16-01-2025,"Grains, Flours & Dals",JOWAR WHITE 1 KG,4,160,140,20,2
16-01-2025,"Dry Fruits, Nuts & Seeds",PULMAKHANA 100 GM,2,180,170,10,1
16-01-2025,"Grains, Flours & Dals",KORRALU (FOXTAIL M) 500GM,4,65,55,10,1
16-01-2025,Snacks & Ready-to-Eat,GS INSTANT KORRA DOSA MIX 400GM,14,120,120,0,1
16-01-2025,"Grains, Flours & Dals",YB Red RICE 1 KG,4,150,120,30,1
16-01-2025,"Grains, Flours & Dals",DISANO ROLED OATS,4,395,395,0,1
16-01-2025,"Grains, Flours & Dals",YB BLACK RICE 500GM,4,150,150,0,1
16-01-2025,Snacks & Ready-to-Eat,VD RED CHILLI RICEPAPAD 150GM,14,50,50,0,1
16-01-2025,Snacks & Ready-to-Eat,VD SAGOPAPAD 150GM,14,55,55,0,1
16-01-2025,Snacks & Ready-to-Eat,VD PANIPURI 100GM,14,60,60,0,2
16-01-2025,Snacks & Ready-to-Eat,MB Multi Millet Pongal Mix 250GM,14,125,125,0,1
16-01-2025,"Grains, Flours & Dals",VYS.SP RICE 1 KG,4,210,195,15,3
16-01-2025,Pickles & Cooking Pastes,SD RED CHILLI MESTA,11,110,110,0,1
16-01-2025,Oils & Ghee,Groundnut oil 1 L,9,720,660,60,2
16-01-2025,Oils & Ghee,Sesame oil 500ml,9,295,280,15,1
16-01-2025,"Grains, Flours & Dals",MAAGAANI LOW GI SP 1KG,4,115,115,0,1
16-01-2025,Oils & Ghee,Coconut oil 500 ml,9,220,200,20,1
16-01-2025,"Grains, Flours & Dals",SA YELLOW JOWAR RAVA 500GM,4,95,95,0,1
16-01-2025,"Dry Fruits, Nuts & Seeds",MAHA BEERA SEEDS 100GM,2,60,60,0,1
16-01-2025,Milk & Dairy,BROWN EGGS 1P,7,364,312,52,26
16-01-2025,Personal Care & Cosmetics,UVIS ALOEVERA &amp;NEEM,10,175,175,0,1
16-01-2025,Personal Care & Cosmetics,DABUR RED PASTE 50GM,10,25,25,0,1
16-01-2025,Personal Care & Cosmetics,UVIS ONION SHAMPOO,10,210,210,0,1
16-01-2025,"Grains, Flours & Dals",Green gram 500 gms,4,75,70,5,1
16-01-2025,Snacks & Ready-to-Eat,PALLI LADDU 200GMS,14,90,70,20,1
16-01-2025,"Grains, Flours & Dals",Sathya Javva Wheat Rava 500GM,4,95,95,0,1
16-01-2025,Snacks & Ready-to-Eat,MARMURA LADDU,14,80,60,20,1
16-01-2025,Snacks & Ready-to-Eat,GB SALT COOKIES,14,120,110,10,2
16-01-2025,Sweeteners,MISHRI 250 GM,16,35,30,5,1
16-01-2025,Beverages,ASSAM MASALA TEA,1,199,199,0,1
16-01-2025,Sweeteners,MADHUR SUGAR 1KG,16,65,55,10,1
16-01-2025,Spices & Seasonings,YB PINK ROCK SALT 1KG,15,360,360,0,3
16-01-2025,Sweeteners,GS Palm Jaggery Powder 400GM,16,360,360,0,2
16-01-2025,"Dry Fruits, Nuts & Seeds",DRIED KIWI 200GM,2,145,130,15,1
16-01-2025,"Dry Fruits, Nuts & Seeds",ANJEER 250GM,2,400,360,40,1
16-01-2025,"Dry Fruits, Nuts & Seeds",ALMONDS 250GM,2,280,260,20,1
16-01-2025,"Dry Fruits, Nuts & Seeds",PUMPKIN SEEDS 250GM,2,200,160,40,1
16-01-2025,"Grains, Flours & Dals",turdal 1kg,4,220,195,25,1
16-01-2025,Snacks & Ready-to-Eat,BD RAGI NOODLES,14,75,75,0,1
16-01-2025,Snacks & Ready-to-Eat,VD DRY FRUIT PUTHAREKULU,14,120,120,0,1
16-01-2025,"Dry Fruits, Nuts & Seeds",PUTNALU 500GMS,2,90,76,14,1
16-01-2025,Sweeteners,YB Brown Sugar 500GM,16,75,75,0,1
16-01-2025,"Grains, Flours & Dals",Arikalu (kodo),4,70,65,5,1
16-01-2025,Snacks & Ready-to-Eat,SD RAGI GAVVALU,14,95,95,0,1
16-01-2025,"Grains, Flours & Dals",split black gram 1 kg,4,360,340,20,2
16-01-2025,Snacks & Ready-to-Eat,MB SORGHUM NOODLES 180GM,14,95,95,0,1
16-01-2025,Snacks & Ready-to-Eat,VD SAGOPAPAD 150GM,14,55,55,0,1
16-01-2025,"Dry Fruits, Nuts & Seeds",DRIED KIWI 200GM,2,145,130,15,1
16-01-2025,"Grains, Flours & Dals",VYS.SP.RICE BAG 1,4,1800,"1,650.00",150,1
16-01-2025,"Dry Fruits, Nuts & Seeds",SALTED PISTA 250GM,2,400,350,50,1
16-01-2025,"Grains, Flours & Dals",Sathya Javva Wheat Rava 500GM,4,95,95,0,1
16-01-2025,"Grains, Flours & Dals",VYS.SP RICE 1 KG,4,70,65,5,1
16-01-2025,Snacks & Ready-to-Eat,ELITE MILK RUSK 200GM,14,35,35,0,1
16-01-2025,"Dry Fruits, Nuts & Seeds",DRIED KIWI 200GM,2,145,130,15,1
16-01-2025,"Dry Fruits, Nuts & Seeds",DRYDATES YELLOW 250GM,2,135,120,15,1
16-01-2025,Personal Care & Cosmetics,BAMBOO TOOTH BRUSH,10,50,50,0,1
16-01-2025,"Dry Fruits, Nuts & Seeds",YELLOW KISHMISH 250GM,2,130,110,20,1
16-01-2025,"Dry Fruits, Nuts & Seeds",SD Mango cubes 100gm,2,45,45,0,1
16-01-2025,"Dry Fruits, Nuts & Seeds",SUNFLOWER SEEDS 250GRM,2,150,130,20,1
16-01-2025,"Dry Fruits, Nuts & Seeds",PUMPKIN SEEDS 250GM,2,200,160,40,1
16-01-2025,"Dry Fruits, Nuts & Seeds",FLAX SEEDS 250GM,2,60,50,10,1
16-01-2025,Oils & Ghee,Groundnut oil 500ml,9,180,165,15,1
16-01-2025,"Grains, Flours & Dals",RAGI FLOUR 500GRMS,4,40,35,5,1
16-01-2025,Oils & Ghee,Coconut oil 500 ml,9,220,200,20,1
16-01-2025,Oils & Ghee,Mustard oil 500 ml,9,220,195,25,1
16-01-2025,Oils & Ghee,Groundnut oil 1 L,9,720,640,80,2
13-01-2025,Sweeteners,NATURAL HONEY 1KG,16,560,480,80,1
13-01-2025,Snacks & Ready-to-Eat,SD Aswagandha with palm Jaggery250Gm,14,135,135,0,1
13-01-2025,"Grains, Flours & Dals",RAGULU 1 KG,4,70,60,10,1
13-01-2025,Spices & Seasonings,PURO Healthy Salt Crystal 1KG,15,135,135,0,1
13-01-2025,Spices & Seasonings,Masala Karam 500 gms,15,780,720,60,3
13-01-2025,Spices & Seasonings,PURO Healthy Salt 1KG,15,110,110,0,1
13-01-2025,"Grains, Flours & Dals",Yellow jowar .F1 kg,4,110,100,10,1
13-01-2025,Personal Care & Cosmetics,KHADI LEMONGRASS SOAP 125GM,10,80,80,0,1
13-01-2025,Pooja & Spiritual Items,GD Sambrani Cup Dhoop 10 PC,12,96,96,0,1
13-01-2025,Pooja & Spiritual Items,GD Yagnadhara 31PC,12,70,70,0,1
13-01-2025,Personal Care & Cosmetics,GAYATHRI KUMKUDUKAYA,10,150,150,0,1
13-01-2025,Personal Care & Cosmetics,KHADI MIX FRUIT SOAP 125GM,10,80,80,0,1
13-01-2025,Pooja & Spiritual Items,BALAJI KEWDA DHOOP STICKS 10STK,12,70,70,0,1
13-01-2025,Snacks & Ready-to-Eat,sf berry crunch,14,299,299,0,1
13-01-2025,Pooja & Spiritual Items,BALAJI BEL PHOOL DHOOP STICKS 10STK,12,70,70,0,1
13-01-2025,Pooja & Spiritual Items,BALAJI KASTURI DHOOP STICKS,12,70,70,0,1
13-01-2025,"Grains, Flours & Dals",HS Multimillet idly R 500 gms,4,65,65,0,1
13-01-2025,"Grains, Flours & Dals",MAGGANI RICE 5KG,4,525,525,0,1
13-01-2025,Snacks & Ready-to-Eat,RSC ORANGE 100GMS,14,20,20,0,1
13-01-2025,Sweeteners,SUGAR 1KG,16,120,100,20,2
13-01-2025,"Grains, Flours & Dals",White jowar.F 1 kg,4,100,80,20,1
13-01-2025,Pooja & Spiritual Items,GD Aiswarya Deepam 700ML,12,195,195,0,1
13-01-2025,Sweeteners,GS JAGGERY NUGGETS 500GM,16,120,120,0,1
13-01-2025,Snacks & Ready-to-Eat,SESAME LADDU 200GM,14,100,80,20,1
13-01-2025,"Grains, Flours & Dals",Wheat Flour 1 kg,4,70,60,10,1
13-01-2025,Oils & Ghee,cow ghee 500 ml,9,430,390,40,1
13-01-2025,Personal Care & Cosmetics,DABUR RED PASTE 50GM,10,25,25,0,1
13-01-2025,"Grains, Flours & Dals",Arikadu ( kodo),4,140,130,10,1
13-01-2025,Snacks & Ready-to-Eat,SD Bajra with palm Jaggery 250gm,14,135,135,0,1
13-01-2025,"Grains, Flours & Dals",FLOUR CHARGE,4,12,12,0,1
13-01-2025,Sweeteners,YB JAGGERY POWDER 1KG,16,140,140,0,1
13-01-2025,Snacks & Ready-to-Eat,SD JOWAR WITH PALM JAGGERY 250GM,14,135,135,0,1
13-01-2025,Snacks & Ready-to-Eat,SD Little Millet WITH PLAM JAGGERY,14,135,135,0,1
13-01-2025,Snacks & Ready-to-Eat,SD FINGER Millet with palm Jaggery 250gm,14,270,270,0,2
13-01-2025,Snacks & Ready-to-Eat,SD KODO MILLET WITH PALM JAGGERY,14,135,135,0,1
13-01-2025,Snacks & Ready-to-Eat,PEANUT CANDY,14,90,90,0,2
13-01-2025,Snacks & Ready-to-Eat,VD RICE SAGO PAPAD 150GM,14,55,55,0,1
13-01-2025,"Grains, Flours & Dals",Wheat Flour 1 kg,4,70,60,10,1
13-01-2025,"Grains, Flours & Dals",VYS.SP.RICE 5 KGS,4,350,325,25,1
13-01-2025,Sweeteners,GS Organic Jaggery Powder 600GM,16,99,99,0,1
13-01-2025,"Grains, Flours & Dals",Multigrain 1 kg,4,100,85,15,1
13-01-2025,Spices & Seasonings,WHITE SESAME,15,75,75,0,1
13-01-2025,Snacks & Ready-to-Eat,VD Minapa papad 200gm,14,60,60,0,1
13-01-2025,"Dry Fruits, Nuts & Seeds",Groundnuts 1 kg,2,190,170,20,1
13-01-2025,"Grains, Flours & Dals",CHANA DAL 500GM,4,70,60,10,1
13-01-2025,Sweeteners,SUGAR 1KG,16,60,50,10,1
13-01-2025,Beverages,3ROSES,1,90,90,0,1
13-01-2025,Oils & Ghee,Groundnut oil 1 L,9,360,330,30,1
13-01-2025,"Grains, Flours & Dals",turdal 1kg,4,220,195,25,1
13-01-2025,"Health, Wellness & Ayurvedic Products",MD Mandara Leaf Powder 50GM,5,100,100,0,1
13-01-2025,Spices & Seasonings,Elaichi 25GM,15,145,120,25,1
13-01-2025,"Grains, Flours & Dals",DH URAD GOTA 1KG,4,215,190,25,1
13-01-2025,"Grains, Flours & Dals",SRILATHA RICE RAVVA 500GM,4,70,70,0,2
13-01-2025,"Health, Wellness & Ayurvedic Products",MD Rose Patals Choornam 30GM,5,90,90,0,1
13-01-2025,Oils & Ghee,Safflower oil 1 L,9,440,400,40,1
13-01-2025,Oils & Ghee,Sesame oil 500ml,9,295,280,15,1
13-01-2025,"Grains, Flours & Dals",AISHWARYA SP 1KG,4,80,75,5,1
13-01-2025,"Dry Fruits, Nuts & Seeds",Groundnuts 1 kg,2,190,170,20,1
13-01-2025,Oils & Ghee,Sesame oil 1 L,9,590,560,30,1
13-01-2025,Spices & Seasonings,YB PINK ROCK SALT 1KG,15,120,120,0,1
13-01-2025,Snacks & Ready-to-Eat,PALLI LADDU 200GMS,14,270,210,60,3
13-01-2025,Snacks & Ready-to-Eat,VD CORNFLAKES MIXTURE 175GM,14,60,60,0,1
13-01-2025,Pooja & Spiritual Items,SWASTIK CAMPHOR 25GM,12,90,90,0,2
13-01-2025,Oils & Ghee,Groundnut oil 1 L,9,360,330,30,1
13-01-2025,Spices & Seasonings,PURO Healthy Salt 1KG,15,110,110,0,1
13-01-2025,Oils & Ghee,Groundnut oil 1 L,9,360,330,30,1
13-01-2025,Spices & Seasonings,CHILLI POWDER,15,290,210,80,1
13-01-2025,Snacks & Ready-to-Eat,ZEEDI,14,70,70,0,1
13-01-2025,Sweeteners,ACHUBELLAM 500GM,16,50,40,10,1
13-01-2025,"Dry Fruits, Nuts & Seeds",Groundnuts 1 kg,2,190,170,20,1
13-01-2025,Spices & Seasonings,Masala Karam 500 gms,15,260,240,20,1
13-01-2025,Snacks & Ready-to-Eat,PALLI LADDU 200GMS,14,90,70,20,1
13-01-2025,Snacks & Ready-to-Eat,VD MYSOREPAK 6PIC,14,200,200,0,2
13-01-2025,Oils & Ghee,Safflower oil 5 L,9,4400,"3,900.00",500,2
13-01-2025,Oils & Ghee,Groundnut oil 1 L,9,360,330,30,1
13-01-2025,Snacks & Ready-to-Eat,VD JAGGERY GHEE 12PIC,14,180,180,0,1
13-01-2025,"Dry Fruits, Nuts & Seeds",SH GROUNDNUT 500GM,2,326,260,66,2
13-01-2025,"Grains, Flours & Dals",DOCTOR RICE DIABETIC SFR 1KG,4,360,360,0,3
13-01-2025,Pooja & Spiritual Items,GD Aiswarya Deepam 700ML,12,195,195,0,1
13-01-2025,Oils & Ghee,Groundnut oil 1 L,9,720,660,60,2
13-01-2025,Oils & Ghee,Sesame oil 500ml,9,295,280,15,1
13-01-2025,"Grains, Flours & Dals",Green gram 1 kg,4,150,130,20,1
13-01-2025,Snacks & Ready-to-Eat,NGT CHATPATTA CHANA 90GM,14,25,25,0,1
13-01-2025,"Grains, Flours & Dals",Wheat Flour 1 kg,4,70,60,10,1
13-01-2025,"Grains, Flours & Dals",RAGI FLOUR 1KG,4,80,70,10,1
13-01-2025,Snacks & Ready-to-Eat,ZEEDI,14,140,140,0,2
13-01-2025,Snacks & Ready-to-Eat,SESAME CHIKKI,14,240,200,40,2
13-01-2025,Snacks & Ready-to-Eat,SESAME LADDU 200GM,14,200,160,40,2
13-01-2025,Pooja & Spiritual Items,GD KUMKUM 50GM,12,150,150,0,5
13-01-2025,"Dry Fruits, Nuts & Seeds",YELLOW KISHMISH 250GM,2,130,110,20,1
13-01-2025,Snacks & Ready-to-Eat,MIX MILLET NOODLES,14,75,75,0,1
13-01-2025,"Dry Fruits, Nuts & Seeds",DRYDATES YELLOW 250GM,2,135,120,15,1
13-01-2025,"Dry Fruits, Nuts & Seeds",WATERMELON SEEDS 250GRM,2,320,280,40,1
13-01-2025,"Grains, Flours & Dals",VYS.SP RICE 1 KG,4,1050,975,75,15
13-01-2025,"Grains, Flours & Dals",White jowar.F 1 kg,4,100,80,20,1
13-01-2025,"Grains, Flours & Dals",VGR RICE bag 1,4,1899,"1,650.00",249,1
13-01-2025,"Grains, Flours & Dals",VYS.SP.RICE BAG 1,4,1800,"1,650.00",150,1
13-01-2025,"Dry Fruits, Nuts & Seeds",ALBUKARA 250GM,2,145,120,25,1
13-01-2025,Oils & Ghee,Safflower oil 500 ml,9,220,200,20,1
13-01-2025,"Grains, Flours & Dals",Urad dall 1 Kg,4,185,170,15,1
13-01-2025,"Grains, Flours & Dals",SA YELLOW JOWAR RAVA 500GM,4,380,380,0,4
13-01-2025,"Grains, Flours & Dals",Wheat Flour 1 kg,4,70,60,10,1
13-01-2025,"Grains, Flours & Dals",Wheat Flour 2 kgs,4,140,120,20,1
13-01-2025,Oils & Ghee,Groundnut oil 500ml,9,180,165,15,1
13-01-2025,Snacks & Ready-to-Eat,SUNNUNDALU,14,120,100,20,1
13-01-2025,"Grains, Flours & Dals",Bajra Flour 1 kg,4,70,60,10,1
13-01-2025,"Grains, Flours & Dals",UDALU (Barnyard millet) 500 gms,4,70,60,10,1
13-01-2025,"Grains, Flours & Dals",Wheat Rava S 1KG,4,130,110,20,2
13-01-2025,Snacks & Ready-to-Eat,ID IDLY DOSA BATTER,14,90,90,0,1
13-01-2025,Snacks & Ready-to-Eat,FUN TIME CRUNCH,14,90,90,0,2
13-01-2025,"Dry Fruits, Nuts & Seeds",ALMONDS 250GM,2,280,260,20,1
13-01-2025,Sweeteners,ACHU BELLAM 1KG,16,100,80,20,1
13-01-2025,Snacks & Ready-to-Eat,sf berry crunch,14,299,299,0,1
13-01-2025,Oils & Ghee,Black Sesame oil 500 ml,9,220,190,30,1
13-01-2025,Milk & Dairy,HRITAGE TONED MILK 500ML,7,60,60,0,2
13-01-2025,"Grains, Flours & Dals",white Bobarlu 500 gms,4,80,75,5,1
12-01-2025,"Grains, Flours & Dals",VYS.SP.RICE BAG 1,4,1800,"1,650.00",150,1
12-01-2025,"Grains, Flours & Dals",Wheat Flour 1 kg,4,140,120,20,2
12-01-2025,Sweeteners,GS Organic Jaggery Powder 600GM,16,99,99,0,1
12-01-2025,Spices & Seasonings,NUVVULU 250GM,15,80,65,15,1
12-01-2025,"Grains, Flours & Dals",Bajra Flour 500 gms,4,35,30,5,1
12-01-2025,Snacks & Ready-to-Eat,SATHVI REGIVADA 200GM,14,80,80,0,1
12-01-2025,Oils & Ghee,Groundnut oil 1 L,9,360,330,30,1
12-01-2025,"Grains, Flours & Dals",White jowar.F 1 kg,4,100,80,20,1
12-01-2025,Oils & Ghee,Sesame oil 500ml,9,295,280,15,1
12-01-2025,"Health, Wellness & Ayurvedic Products",RB Max Protein Choco Berry bar 50g,5,75,75,0,1
12-01-2025,Snacks & Ready-to-Eat,VD MINAPA VADIYAM,14,65,65,0,1
12-01-2025,Snacks & Ready-to-Eat,MARMURA LADDU,14,80,60,20,1
12-01-2025,Snacks & Ready-to-Eat,VD GUMMADI VADIYAM,14,75,75,0,1
12-01-2025,Snacks & Ready-to-Eat,FUN TIME CRUNCH,14,45,45,0,1
12-01-2025,"Grains, Flours & Dals",Wheat Rava S 1KG,4,65,55,10,1
12-01-2025,Snacks & Ready-to-Eat,SF CHOCO CRUNCH,14,299,299,0,1
12-01-2025,"Grains, Flours & Dals",SA Sprouted Ragi Flour 500GM,4,69,69,0,1
12-01-2025,"Health, Wellness & Ayurvedic Products",RB Max Protein Salt & Caramel Bar 50g,5,75,75,0,1
12-01-2025,Pooja & Spiritual Items,NAGA SINDHURAM,12,40,40,0,1
12-01-2025,"Dry Fruits, Nuts & Seeds",FLAX SEEDS 250GM,2,60,50,10,1
12-01-2025,Snacks & Ready-to-Eat,SD Thati thandra 200gm,14,150,150,0,1
12-01-2025,Sweeteners,MISHRI D,16,40,30,10,1
12-01-2025,"Dry Fruits, Nuts & Seeds",Groundnuts 1 kg,2,380,340,40,2
12-01-2025,"Grains, Flours & Dals",SH WHITE POHA 500GM,4,150,150,0,2
12-01-2025,"Grains, Flours & Dals",Chana Flour 500 gms,4,70,65,5,1
12-01-2025,Snacks & Ready-to-Eat,SUNNUNDALU,14,100,100,0,1
12-01-2025,"Grains, Flours & Dals",Red Chana 500 GM,4,75,60,15,1
12-01-2025,"Grains, Flours & Dals",Wheat Flour 1 kg,4,70,60,10,1
12-01-2025,"Grains, Flours & Dals",RAGULU 1 KG,4,70,60,10,1
12-01-2025,Oils & Ghee,cow ghee 500 ml,9,430,390,40,1
12-01-2025,"Grains, Flours & Dals",PESARA PAPPU 500GMS,4,85,75,10,1
12-01-2025,Spices & Seasonings,Tamarind 250GMS,15,80,65,15,1
12-01-2025,Oils & Ghee,Groundnut oil 1 L,9,360,330,30,1
12-01-2025,"Grains, Flours & Dals",turdal 1kg,4,220,195,25,1
12-01-2025,"Dry Fruits, Nuts & Seeds",DRYDATES YELLOW 250GM,2,270,240,30,2
12-01-2025,Pooja & Spiritual Items,GD Aiswarya Deepam 700ML,12,390,390,0,2
12-01-2025,"Dry Fruits, Nuts & Seeds",SATHVI CHIA SEEDS 100GM,2,200,160,40,2
12-01-2025,Personal Care & Cosmetics,GAYATHRI KUMKUDUKAYA,10,150,150,0,1
12-01-2025,"Dry Fruits, Nuts & Seeds",SABJA SEEDS 100GM,2,160,140,20,2
12-01-2025,"Health, Wellness & Ayurvedic Products",ORGANIC MORINGA POWER 100GM,5,249,249,0,1
12-01-2025,"Dry Fruits, Nuts & Seeds",MAHA BEERA SEEDS 100GM,2,180,180,0,3
12-01-2025,Sweeteners,NATURAL HONEY 250GM,16,150,130,20,1
12-01-2025,Sweeteners,GS Organic Jaggery Powder 600GM,16,99,99,0,1
12-01-2025,Snacks & Ready-to-Eat,ELITE ELAICHI RUSK 200GM,14,35,35,0,1
12-01-2025,"Grains, Flours & Dals",URAD DALL,4,95,85,10,1
12-01-2025,"Grains, Flours & Dals",Multigrain 1 kg,4,200,170,30,2
12-01-2025,General Household & Kitchenware,VERMI COMPOST MIX,3,90,90,0,3
12-01-2025,"Grains, Flours & Dals",BASMATHI RICE 1KG,4,150,135,15,1
12-01-2025,Snacks & Ready-to-Eat,TILLI CHIKKI,14,10,10,0,2
12-01-2025,"Grains, Flours & Dals",Wheat Flour 1 kg,4,70,60,10,1
12-01-2025,Snacks & Ready-to-Eat,BLACK SESAME CHIKKI,14,20,20,0,2
12-01-2025,Snacks & Ready-to-Eat,VD JAGGERY GHEE 12PIC,14,180,180,0,1
12-01-2025,Sweeteners,KAMAL JAGGERY 500GM,16,80,80,0,2
12-01-2025,"Dry Fruits, Nuts & Seeds",Groundnuts 1 kg,2,190,170,20,1
12-01-2025,"Grains, Flours & Dals",Wheat Flour 1 kg,4,140,120,20,2
12-01-2025,Oils & Ghee,Groundnut oil 1 L,9,360,330,30,1
12-01-2025,Sweeteners,Mishri 500GM,16,140,120,20,2
12-01-2025,"Grains, Flours & Dals",VGR rice 1 kg,4,140,130,10,2
12-01-2025,Snacks & Ready-to-Eat,MARMURA LADDU,14,80,60,20,1
12-01-2025,Oils & Ghee,Coconut oil 500 ml,9,220,200,20,1
12-01-2025,Oils & Ghee,Sesame oil 1 L,9,590,560,30,1
12-01-2025,"Grains, Flours & Dals",RAGI FLOUR 500GRMS,4,40,35,5,1
12-01-2025,"Grains, Flours & Dals",PRO ORG SONAMASOORI RICE,4,128,128,0,1
12-01-2025,Snacks & Ready-to-Eat,SD FINGER Millet with palm Jaggery 250gm,14,135,135,0,1
12-01-2025,"Grains, Flours & Dals",Green gram 500 gms,4,75,70,5,1
12-01-2025,"Grains, Flours & Dals",RAGI FLOUR 500GRMS,4,40,35,5,1
12-01-2025,"Dry Fruits, Nuts & Seeds",Groundnuts 1 kg,2,190,170,20,1
12-01-2025,Snacks & Ready-to-Eat,VD DAHI MIRCHI(SALTED) 100GM,14,45,45,0,1
12-01-2025,Personal Care & Cosmetics,MYSORE SANDAL SOAP 75G,10,42,42,0,1
12-01-2025,Snacks & Ready-to-Eat,RSC ORANGE 100GMS,14,20,20,0,1
12-01-2025,Spices & Seasonings,SATHVI BIRYANI LEAF 25GM,15,30,20,10,1
12-01-2025,"Health, Wellness & Ayurvedic Products",RB FRUITS &amp;seeds Cranberries,5,45,45,0,1
12-01-2025,"Grains, Flours & Dals",PESARA PAPPU 500GMS,4,85,75,10,1
12-01-2025,"Grains, Flours & Dals",DH URAD GOTA 1KG,4,215,190,25,1
12-01-2025,"Dry Fruits, Nuts & Seeds",Groundnuts 1 kg,2,190,170,20,1
12-01-2025,"Grains, Flours & Dals",Brown RICE 1KG,4,140,130,10,2
12-01-2025,"Grains, Flours & Dals",turdal 500 gms,4,110,100,10,1
12-01-2025,Oils & Ghee,Coconut oil 500 ml,9,220,200,20,1
12-01-2025,Oils & Ghee,Sesame oil 500ml,9,295,280,15,1
12-01-2025,Oils & Ghee,Castor oil 500 ml,9,250,200,50,1
12-01-2025,"Health, Wellness & Ayurvedic Products",VATTIVERU CHOORNAM,5,90,90,0,1
12-01-2025,Oils & Ghee,Coconut oil 500 ml,9,220,200,20,1
12-01-2025,Pooja & Spiritual Items,GD Bhagavatha Mallika 75GM,12,60,60,0,1
12-01-2025,Sweeteners,ACHUBELLAM 500GM,16,50,40,10,1
12-01-2025,Oils & Ghee,Groundnut oil 500ml,9,180,165,15,1
12-01-2025,"Grains, Flours & Dals",CHANA DAL 500GM,4,70,60,10,1
12-01-2025,"Grains, Flours & Dals",SPLIT BLACK GRAM 500 GM,4,90,85,5,1
12-01-2025,Snacks & Ready-to-Eat,PUMPKIN CHIKKI 200GM,14,140,120,20,1
12-01-2025,Personal Care & Cosmetics,NIVEA ALOE HYDRATION,10,299,299,0,1
12-01-2025,"Dry Fruits, Nuts & Seeds",PUMPKIN SEEDS 250GM,2,200,160,40,1
12-01-2025,"Health, Wellness & Ayurvedic Products",HARITHAKI CHOORNAM,5,60,60,0,1
12-01-2025,Personal Care & Cosmetics,UVIS ROSEWATER 100ML,10,75,75,0,1
12-01-2025,Oils & Ghee,Groundnut oil 1 L,9,360,330,30,1
12-01-2025,Oils & Ghee,Sesame oil 1 L,9,590,560,30,1
12-01-2025,"Grains, Flours & Dals",VYS.SP RICE 1 KG,4,1050,975,75,15
12-01-2025,Sweeteners,KAMAL JAGGERY 500GM,16,40,40,0,1
12-01-2025,"Grains, Flours & Dals",SL Idly Rava 1KG,4,65,55,10,1
12-01-2025,"Grains, Flours & Dals",SL Idly Rava 1KG,4,65,55,10,1
12-01-2025,Sweeteners,KAMAL JAGGERY 500GM,16,40,40,0,1
12-01-2025,Personal Care & Cosmetics,MYSORE SANDAL SOAP 75G,10,84,84,0,2
12-01-2025,Snacks & Ready-to-Eat,RINGS 200GM,14,30,30,0,1
12-01-2025,Snacks & Ready-to-Eat,VD DAHI MIRCHI(SALTED) 100GM,14,45,45,0,1
12-01-2025,Snacks & Ready-to-Eat,JUNNU POWDER 100GM,14,70,70,0,1
12-01-2025,Spices & Seasonings,Gasagasalu 50GM,15,130,110,20,1
12-01-2025,"Grains, Flours & Dals",Wheat Flour 1 kg,4,70,60,10,1
12-01-2025,Pooja & Spiritual Items,BALAJI KEWDA DHOOP STICKS 10STK,12,70,70,0,1
12-01-2025,Snacks & Ready-to-Eat,NGT CHATPATTA CHANA 90GM,14,75,75,0,3
12-01-2025,Pooja & Spiritual Items,BALAJI KEWDA STICKS 220GM,12,150,150,0,1
12-01-2025,Snacks & Ready-to-Eat,SESAME CHIKKI,14,120,100,20,1
12-01-2025,Snacks & Ready-to-Eat,VD DAHI MIRCHI(SALTED) 100GM,14,45,45,0,1
12-01-2025,Snacks & Ready-to-Eat,VD GUMMADI VADIYAM,14,75,75,0,1
12-01-2025,Snacks & Ready-to-Eat,MARMURA LADDU,14,80,60,20,1
12-01-2025,Snacks & Ready-to-Eat,ANNAPURNA APPALAM,14,35,35,0,1
12-01-2025,Snacks & Ready-to-Eat,SATHVI PALLI CHIKKI 200GM,14,100,80,20,1
12-01-2025,Snacks & Ready-to-Eat,VD SAGOPAPAD 150GM,14,55,55,0,1
12-01-2025,"Grains, Flours & Dals",Bajra Flour 1 kg,4,70,60,10,1
12-01-2025,"Grains, Flours & Dals",Chana Flour 1 kg,4,140,130,10,1
12-01-2025,Sweeteners,ACHUBELLAM 500GM,16,100,80,20,2
12-01-2025,Oils & Ghee,Coconut oil 500 ml,9,220,200,20,1
12-01-2025,Snacks & Ready-to-Eat,VD Minapa papad 200gm,14,60,60,0,1
12-01-2025,Snacks & Ready-to-Eat,SD VAMU APPADALU 200GM,14,80,80,0,1
12-01-2025,"Grains, Flours & Dals",Chana Flour 500 gms,4,70,65,5,1
12-01-2025,"Grains, Flours & Dals",FLOUR CHARGE,4,18,18,0,1.5
12-01-2025,Snacks & Ready-to-Eat,KURNOOL MARMURA,14,70,55,15,1
12-01-2025,Spices & Seasonings,Masala Karam 500 gms,15,260,240,20,1
12-01-2025,Spices & Seasonings,MM Kasuri Methi 25GM,15,30,30,0,1
12-01-2025,"Health, Wellness & Ayurvedic Products",RB Max Protein Choco chips 55gm,5,50,50,0,1
12-01-2025,"Grains, Flours & Dals",Wheat Flour 1 kg,4,210,180,30,3
12-01-2025,"Grains, Flours & Dals",Wheat Flour 2 kgs,4,140,120,20,1
12-01-2025,"Grains, Flours & Dals",Chana Flour 500 gms,4,70,65,5,1
12-01-2025,Beverages,BRU GREEN LABEL 1.2G,1,20,20,0,10
12-01-2025,Snacks & Ready-to-Eat,MARMURA LADDU,14,80,60,20,1
12-01-2025,Snacks & Ready-to-Eat,VD Pappu Chekkalu 190gm,14,60,60,0,1
12-01-2025,Snacks & Ready-to-Eat,BD KODO MILLET NOODLES 200GM,14,75,75,0,1
12-01-2025,"Grains, Flours & Dals",MELMEKER 250GMS,4,60,45,15,1
12-01-2025,Spices & Seasonings,SWEET SOUNF,15,20,20,0,1
12-01-2025,"Grains, Flours & Dals",Red Chana 250GM,4,70,60,10,2
12-01-2025,"Grains, Flours & Dals",White Chana 500GM,4,120,100,20,1
12-01-2025,"Grains, Flours & Dals",Wheat Rava M 1KG,4,65,55,10,1
12-01-2025,"Grains, Flours & Dals",RAJMA 250GM,4,55,45,10,1
12-01-2025,Personal Care & Cosmetics,HERBAL BATH POWDER 200GM,10,80,80,0,1
12-01-2025,"Health, Wellness & Ayurvedic Products",MD Ashwagandha Choornam 100GM,5,170,170,0,1
12-01-2025,Baking & Cooking Aids,RAJ BIRDS GELATINE 50GM,0,90,90,0,1
12-01-2025,"Grains, Flours & Dals",PESARA PAPPU 500GMS,4,85,75,10,1
12-01-2025,Spices & Seasonings,Avalu small 250 gms,15,60,40,20,1
12-01-2025,Snacks & Ready-to-Eat,NGT CHATPATTA CHANA 90GM,14,25,25,0,1
12-01-2025,Spices & Seasonings,Jeera 100GM,15,50,45,5,1
12-01-2025,Snacks & Ready-to-Eat,VD VAMUPUSA 175GM,14,60,60,0,1
12-01-2025,Snacks & Ready-to-Eat,JUNNU POWDER 100GM,14,70,70,0,1
12-01-2025,"Grains, Flours & Dals",Wheat Flour 2 kgs,4,140,120,20,1
12-01-2025,"Grains, Flours & Dals",RAGI FLOUR 500GRMS,4,40,35,5,1
12-01-2025,"Dry Fruits, Nuts & Seeds",SATHVI CHIA SEEDS 100GM,2,100,80,20,1
12-01-2025,Spices & Seasonings,Gasagasalu 50GM,15,130,110,20,1
12-01-2025,"Grains, Flours & Dals",Em jowar idly R 500G,4,75,75,0,1
12-01-2025,"Dry Fruits, Nuts & Seeds",Putnalu 250GM,2,45,38,7,1
12-01-2025,Spices & Seasonings,Jeera 100GM,15,50,45,5,1
12-01-2025,Spices & Seasonings,Vamu 100GM,15,60,50,10,1
12-01-2025,"Grains, Flours & Dals",RED TURDAL 500GM,4,75,70,5,1
12-01-2025,Spices & Seasonings,Coriander seeds 200 gms,15,48,40,8,1
12-01-2025,"Grains, Flours & Dals",BARLEY SEEDS 250GMS,4,40,35,5,1
12-01-2025,"Dry Fruits, Nuts & Seeds",PULMAKHANA 100 GM,2,360,340,20,2
12-01-2025,Oils & Ghee,GRB GHEE 100ML,9,103,103,0,1
12-01-2025,Oils & Ghee,Freedom Rice Bran Oil 1L,9,194,180,14,1
12-01-2025,"Grains, Flours & Dals",Chana Flour 1 kg,4,140,130,10,1
12-01-2025,Spices & Seasonings,Dalchin Chekka 50GM,15,50,40,10,1
12-01-2025,"Grains, Flours & Dals",Em Little idli R 500g,4,129,129,0,1
12-01-2025,"Dry Fruits, Nuts & Seeds",PUMPKIN SEEDS 250GM,2,200,160,40,1
12-01-2025,"Grains, Flours & Dals",RICE FLOUR 1KG,4,77,77,0,1
12-01-2025,"Grains, Flours & Dals",SAMALU (Little millet) 1 kg,4,170,130,40,1
12-01-2025,Spices & Seasonings,Telaga Pindi 500GM,15,80,70,10,1
12-01-2025,Oils & Ghee,Sesame oil 1 L,9,590,560,30,1
12-01-2025,Spices & Seasonings,NUVVULU 250GM,15,80,65,15,1
12-01-2025,"Grains, Flours & Dals",SABDANA 500GM,4,90,70,20,1
12-01-2025,Spices & Seasonings,ROYAL SAFFRON 400GRMS,15,65,65,0,1
12-01-2025,Spices & Seasonings,EV Chicken Masala 50GM,15,48,48,0,1
12-01-2025,Spices & Seasonings,EVEREST MEAT MASALA 50GM,15,48,48,0,1
12-01-2025,Spices & Seasonings,Coriander seeds 200 gms,15,48,40,8,1
12-01-2025,"Grains, Flours & Dals",SH WHITE POHA 500GM,4,75,75,0,1
12-01-2025,"Dry Fruits, Nuts & Seeds",Groundnuts 1 kg,2,190,170,20,1
12-01-2025,Spices & Seasonings,JEERA 250 gms,15,125,105,20,1
12-01-2025,Spices & Seasonings,DRY MANGO POWDER,15,45,45,0,1
12-01-2025,Oils & Ghee,BUFFALLO GHEE 500ML,9,410,370,40,1
12-01-2025,Spices & Seasonings,Miriyalu 50GM,15,100,80,20,1
12-01-2025,"Dry Fruits, Nuts & Seeds",PUTNALU 500GMS,2,90,76,14,1
12-01-2025,Snacks & Ready-to-Eat,VD Minapa papad 200gm,14,60,60,0,1
12-01-2025,"Grains, Flours & Dals",SL Suji Rava 500GM,4,32,32,0,1
12-01-2025,"Dry Fruits, Nuts & Seeds",PULMAKHANA 100 GM,2,180,170,10,1
12-01-2025,Spices & Seasonings,ROYAL SAFFRON 400GRMS,15,65,65,0,1
12-01-2025,"Grains, Flours & Dals",Chana Flour 500 gms,4,70,65,5,1
12-01-2025,"Grains, Flours & Dals",SL Idly Rava 1KG,4,65,55,10,1
12-01-2025,Personal Care & Cosmetics,HERBAL BATH POWDER 200GM,10,80,80,0,1
12-01-2025,Pooja & Spiritual Items,SST 365 PURE COTTON POOJA,12,60,60,0,2
12-01-2025,Pooja & Spiritual Items,GD Aiswarya Deepam 700ML,12,195,195,0,1
12-01-2025,"Grains, Flours & Dals",turdal 1kg,4,220,195,25,1
12-01-2025,Spices & Seasonings,NUVVULU 250GM,15,100,85,15,1
12-01-2025,"Grains, Flours & Dals",Wheat Rava M 1KG,4,65,55,10,1
12-01-2025,"Grains, Flours & Dals",CHANA DAL 1KG,4,140,120,20,1
12-01-2025,Household & Cleaning,VIM 300GM,6,60,60,0,2
12-01-2025,Pooja & Spiritual Items,SWAATHI GATTI DEEPAM VATTULU,12,30,30,0,1
12-01-2025,Spices & Seasonings,Gasagasalu 50GM,15,130,110,20,1
12-01-2025,"Grains, Flours & Dals",Green gram 500 gms,4,75,70,5,1
12-01-2025,Oils & Ghee,Safflower oil 1 L,9,440,400,40,1
12-01-2025,"Grains, Flours & Dals",PESARA PAPPU 500GMS,4,85,75,10,1
12-01-2025,Baking & Cooking Aids,GONDH 50GRMS,0,50,40,10,1
12-01-2025,"Health, Wellness & Ayurvedic Products",RB Max Protein Choco Almond bar 50g,5,75,75,0,1
12-01-2025,"Grains, Flours & Dals",RAGI FLOUR 500GRMS,4,40,35,5,1
12-01-2025,Snacks & Ready-to-Eat,DISANO VERMICELLI 425 GM,14,50,50,0,1
12-01-2025,Personal Care & Cosmetics,MESWAK 100GM,10,70,70,0,1
12-01-2025,"Grains, Flours & Dals",DH URAD GOTA 1KG,4,215,190,25,1
12-01-2025,Oils & Ghee,Sesame oil 1 L,9,1180,"1,120.00",60,2
12-01-2025,"Grains, Flours & Dals",RAGI FLOUR 500GRMS,4,40,35,5,1
12-01-2025,"Grains, Flours & Dals",Wheat Flour 2 kgs,4,140,120,20,1
12-01-2025,Spices & Seasonings,Masala Karam 500 gms,15,260,240,20,1
12-01-2025,"Dry Fruits, Nuts & Seeds",PULMAKHANA 100 GM,2,180,170,10,1
12-01-2025,"Grains, Flours & Dals",FLOUR CHARGE,4,36,36,0,3
12-01-2025,Spices & Seasonings,Masala Karam 500 gms,15,260,240,20,1
12-01-2025,Spices & Seasonings,Coconut Powder 250GM,15,90,70,20,1
12-01-2025,Oils & Ghee,Freedom Rice Bran Oil 1L,9,194,180,14,1
12-01-2025,Oils & Ghee,Groundnut oil 1 L,9,360,330,30,1
12-01-2025,Snacks & Ready-to-Eat,PEANUT CANDY,14,45,45,0,1
12-01-2025,"Grains, Flours & Dals",BAJRA 1 KG,4,60,50,10,1
12-01-2025,"Grains, Flours & Dals",JOWAR YELLOW 1 K,4,100,90,10,1
12-01-2025,"Grains, Flours & Dals",BASMATHI RICE 1KG,4,150,135,15,1
12-01-2025,"Grains, Flours & Dals",RAGULU 1 KG,4,70,60,10,1
12-01-2025,"Dry Fruits, Nuts & Seeds",SUNFLOWER SEEDS 250GRM,2,150,130,20,1
12-01-2025,Snacks & Ready-to-Eat,SD Moringa with plam jaggery 250gm,14,135,135,0,1
12-01-2025,"Grains, Flours & Dals",Sathya Javva Wheat Rava 500GM,4,95,95,0,1
12-01-2025,"Grains, Flours & Dals",THICK POHA 1KG,4,80,70,10,1
12-01-2025,"Health, Wellness & Ayurvedic Products",MH Baby Food 400GM,5,200,200,0,1
12-01-2025,"Dry Fruits, Nuts & Seeds",PUMPKIN SEEDS 250GM,2,200,160,40,1
12-01-2025,"Dry Fruits, Nuts & Seeds",WATERMELON SEEDS 250GRM,2,320,280,40,1
12-01-2025,Pooja & Spiritual Items,GD Sree Chandan 50GM,12,50,50,0,1
12-01-2025,Sweeteners,MISHRI D,16,40,30,10,1
12-01-2025,General Household & Kitchenware,MATCH BOX,3,20,20,0,1
12-01-2025,"Dry Fruits, Nuts & Seeds",ALMONDS 250GM,2,280,260,20,1
12-01-2025,Snacks & Ready-to-Eat,VAKKALU,14,80,60,20,1
12-01-2025,"Health, Wellness & Ayurvedic Products",AMLAMRUT AMLA MASALA CANDY,5,95,95,0,1
12-01-2025,Pooja & Spiritual Items,SST 365 PURE COTTON POOJA,12,120,120,0,4
12-01-2025,"Grains, Flours & Dals",RED TURDAL 500GM,4,75,70,5,1
12-01-2025,Spices & Seasonings,Menthulu 250 gms,15,50,45,5,1
12-01-2025,Snacks & Ready-to-Eat,MORINGA LEAVES PAPAD 200GM,14,90,90,0,1
12-01-2025,Pooja & Spiritual Items,GD KUMKUM 50GM,12,30,30,0,1
12-01-2025,"Dry Fruits, Nuts & Seeds",WALLNUTS 250GM,2,320,290,30,1
12-01-2025,General Household & Kitchenware,BB BOWL,3,420,399,21,1
12-01-2025,Pooja & Spiritual Items,SHIVA SHAKTHI CAMPHOR 10GM,12,40,40,0,2
12-01-2025,Pooja & Spiritual Items,SWASTIK CAMPHOR 25GM,12,45,45,0,1
12-01-2025,Pooja & Spiritual Items,SST 365 PURE COTTON POOJA,12,30,30,0,1
12-01-2025,"Grains, Flours & Dals",CHANA DAL 1KG,4,140,120,20,1
12-01-2025,Sweeteners,KAMAL JAGGERY 500GM,16,80,80,0,2
12-01-2025,Spices & Seasonings,Coriander seeds 200 gms,15,48,40,8,1
12-01-2025,"Grains, Flours & Dals",URAD DALL,4,190,170,20,2
12-01-2025,Oils & Ghee,Black Sesame oil 1 L,9,440,380,60,1
12-01-2025,Oils & Ghee,Groundnut oil 1 L,9,360,330,30,1
12-01-2025,Sweeteners,MISHRI 250 GM,16,35,30,5,1
12-01-2025,Sweeteners,YB JAGGERY POWDER 1KG,16,140,140,0,1
12-01-2025,"Grains, Flours & Dals",Multigrain 1 kg,4,100,85,15,1
12-01-2025,"Grains, Flours & Dals",VYS.SP.RICE BAG 1,4,1800,"1,650.00",150,1
12-01-2025,"Health, Wellness & Ayurvedic Products",RB Max Protein Classic Creamy,5,169,169,0,1
12-01-2025,"Health, Wellness & Ayurvedic Products",RB Max Protein Choco Almond bar 50g,5,75,75,0,1
12-01-2025,"Health, Wellness & Ayurvedic Products",MORINGA LEAF POWDER M,5,80,75,5,1
12-01-2025,Snacks & Ready-to-Eat,BD LITTLE MILLET NOODLES 200G,14,75,75,0,1
12-01-2025,Oils & Ghee,Sesame oil 500ml,9,295,280,15,1
12-01-2025,"Health, Wellness & Ayurvedic Products",MH Baby Food 400GM,5,200,200,0,1
12-01-2025,Snacks & Ready-to-Eat,FOXTAIL NOODLES,14,150,150,0,2
12-01-2025,General Household & Kitchenware,MATCH BOX,3,20,20,0,1
12-01-2025,"Grains, Flours & Dals",COW B rice 1 kg,4,1080,"1,035.00",45,15
12-01-2025,"Grains, Flours & Dals",turdal 500 gms,4,110,100,10,1
12-01-2025,"Grains, Flours & Dals",SL Idly Rava 1KG,4,195,165,30,3
12-01-2025,"Grains, Flours & Dals",turdal 1kg,4,220,195,25,1
12-01-2025,Oils & Ghee,Groundnut oil 1 L,9,720,660,60,2
12-01-2025,"Dry Fruits, Nuts & Seeds",Groundnuts 1 kg,2,190,170,20,1
12-01-2025,Spices & Seasonings,DRY MIECHI 200GM,15,80,60,20,1
12-01-2025,"Grains, Flours & Dals",Urad dall 1 Kg,4,555,510,45,3
12-01-2025,"Dry Fruits, Nuts & Seeds",Groundnuts 500 gms,2,95,85,10,1
12-01-2025,"Grains, Flours & Dals",CHANA DAL 500GM,4,70,60,10,1
12-01-2025,Spices & Seasonings,ROYAL SAFFRON 400GRMS,15,65,65,0,1
12-01-2025,Spices & Seasonings,YB PINK ROCK SALT 1KG,15,120,120,0,1
12-01-2025,Spices & Seasonings,Jeera 100GM,15,50,45,5,1
12-01-2025,Milk & Dairy,BROWN EGGS 1P,7,280,240,40,20
12-01-2025,"Grains, Flours & Dals",Wheat Flour 1 kg,4,140,120,20,2
12-01-2025,Oils & Ghee,Castor oil 500 ml,9,250,200,50,1
12-01-2025,Oils & Ghee,Coconut oil 500 ml,9,220,200,20,1
12-01-2025,Oils & Ghee,Sesame oil 1 L,9,1180,"1,120.00",60,2
12-01-2025,"Grains, Flours & Dals",THICK POHA 1KG,4,80,70,10,1
12-01-2025,Spices & Seasonings,SAMBAR POWDER,15,150,150,0,1
12-01-2025,Beverages,TAJ MAHAL 250GM,1,235,235,0,1
12-01-2025,Household & Cleaning,EXO STEEL SCRUB,6,90,90,0,6
12-01-2025,Spices & Seasonings,MIRYALU 250 GRMS,15,440,360,80,1
12-01-2025,Household & Cleaning,SCOTCH BRITE,6,108,108,0,6
12-01-2025,Spices & Seasonings,Avalu big 250 gms,15,120,80,40,1
12-01-2025,Personal Care & Cosmetics,REVIVE ANTI BACTERIA 50GM,10,20,20,0,1
12-01-2025,Household & Cleaning,VIM EXTRA 110GM,6,100,100,0,10
12-01-2025,Oils & Ghee,Groundnut oil 1 L,9,720,660,60,2
12-01-2025,"Grains, Flours & Dals",turdal 1kg,4,660,585,75,3
12-01-2025,"Grains, Flours & Dals",Bombay Rava 500GM,4,35,30,5,1
12-01-2025,"Grains, Flours & Dals",Wheat Rava M 500GM,4,33,30,3,1
12-01-2025,"Grains, Flours & Dals",MAA TEJA RICE BAG 26KG,4,2210,"1,750.00",460,1
12-01-2025,Spices & Seasonings,Coriander seeds 200 gms,15,96,80,16,2
12-01-2025,"Dry Fruits, Nuts & Seeds",CASHEW 250GM,2,340,310,30,1
12-01-2025,Spices & Seasonings,RASAM POWDER,15,95,95,0,1
12-01-2025,"Grains, Flours & Dals",Urad dall 1 Kg,4,370,340,30,2
12-01-2025,Spices & Seasonings,JEERA 250 gms,15,250,210,40,2
12-01-2025,Oils & Ghee,Sesame oil 1 L,9,1180,"1,120.00",60,2
12-01-2025,Oils & Ghee,Coconut oil 500 ml,9,220,200,20,1
12-01-2025,Snacks & Ready-to-Eat,VD GUMMADI VADIYAM,14,375,375,0,5
12-01-2025,Snacks & Ready-to-Eat,VD DAHI MIRCHI(SALTED) 100GM,14,45,45,0,1
12-01-2025,Snacks & Ready-to-Eat,MB PEARL MILLET NOODLES 180GM,14,95,95,0,1
12-01-2025,"Grains, Flours & Dals",BAJRA 1 KG,4,60,50,10,1
12-01-2025,Personal Care & Cosmetics,HERBAL BATH POWDER,10,160,160,0,1
12-01-2025,Pickles & Cooking Pastes,CHUTNEFY,11,55,55,0,1
12-01-2025,"Grains, Flours & Dals",Chana Flour 500 gms,4,70,65,5,1
12-01-2025,"Grains, Flours & Dals",White jowar.F 1 kg,4,200,160,40,2
12-01-2025,Spices & Seasonings,JEERA 250 gms,15,125,105,20,1
12-01-2025,Spices & Seasonings,SREE MARUTHI IDLY KARAM 200GM,15,60,60,0,1
12-01-2025,Spices & Seasonings,Avalu small 250 gms,15,60,40,20,1
12-01-2025,Snacks & Ready-to-Eat,ELITE MILK RUSK 200GM,14,35,35,0,1
12-01-2025,Snacks & Ready-to-Eat,ELITE ELAICHI RUSK 200GM,14,35,35,0,1
12-01-2025,Snacks & Ready-to-Eat,VD RICE MURUKU 150GM,14,100,100,0,2
12-01-2025,Snacks & Ready-to-Eat,VD DRY FRUIT PUTHAREKULU,14,120,120,0,1
12-01-2025,"Grains, Flours & Dals",RICE FLOUR 1KG,4,77,77,0,1
12-01-2025,Snacks & Ready-to-Eat,VD DRY FRUIT PUTHAREKULU,14,120,120,0,1
12-01-2025,"Grains, Flours & Dals",White jowar.F 1 kg,4,300,240,60,3
12-01-2025,"Grains, Flours & Dals",BAJRA 1 KG,4,120,100,20,2
12-01-2025,Spices & Seasonings,DURGA SALT CRYSTAL 1KG,15,75,75,0,3
12-01-2025,"Dry Fruits, Nuts & Seeds",Groundnuts 1 kg,2,190,170,20,1
12-01-2025,"Dry Fruits, Nuts & Seeds",Putnalu 250GM,2,45,38,7,1
12-01-2025,"Health, Wellness & Ayurvedic Products",RB Max Protein Choco chips 55gm,5,50,50,0,1
12-01-2025,Oils & Ghee,Safflower oil 1 L,9,440,400,40,1
12-01-2025,"Grains, Flours & Dals",Wheat Flour 1 kg,4,70,60,10,1
12-01-2025,"Grains, Flours & Dals",Wheat Rava M 1KG,4,65,55,10,1
12-01-2025,Oils & Ghee,Groundnut oil 1 L,9,360,330,30,1
12-01-2025,Snacks & Ready-to-Eat,VD NUVULU CHEGODI 175GM,14,60,60,0,1
12-01-2025,"Grains, Flours & Dals",turdal 1kg,4,220,195,25,1
12-01-2025,"Grains, Flours & Dals",Wheat Rava M 500GM,4,33,30,3,1
12-01-2025,"Grains, Flours & Dals",Bombay Rava 500GM,4,35,30,5,1
12-01-2025,Sweeteners,KAMAL JAGGERY 500GM,16,40,40,0,1
12-01-2025,Personal Care & Cosmetics,VASELINE 5GM,10,5,5,0,1
12-01-2025,"Grains, Flours & Dals",PESARA PAPPU 500GMS,4,85,75,10,1
12-01-2025,Spices & Seasonings,LG 50GM,15,92,92,0,1
12-01-2025,Pooja & Spiritual Items,BALAJI LAVENDER DOOP STICK 10STK,12,125,125,0,1
12-01-2025,Spices & Seasonings,PRO ORG TURMERIC POWDER 100G,15,70,70,0,1
12-01-2025,Oils & Ghee,Safflower oil 1 L,9,880,800,80,2
12-01-2025,"Grains, Flours & Dals",SABDANA 500GM,4,90,70,20,1
12-01-2025,"Grains, Flours & Dals",DH URAD GOTA 1KG,4,215,190,25,1
12-01-2025,"Grains, Flours & Dals",THICK POHA 500GM,4,40,35,5,1
12-01-2025,"Grains, Flours & Dals",Wheat Flour 1 kg,4,70,60,10,1
12-01-2025,Spices & Seasonings,Chilli powder 500 gms,15,290,210,80,1
12-01-2025,"Dry Fruits, Nuts & Seeds",PULMAKHANA 100 GM,2,180,170,10,1
12-01-2025,Sweeteners,SUGAR 1KG,16,120,100,20,2
12-01-2025,"Grains, Flours & Dals",Yellow jowar.F 500 gms,4,55,50,5,1
12-01-2025,Spices & Seasonings,Tamarind 500GM,15,160,130,30,1
12-01-2025,Spices & Seasonings,Coriander seeds 200 gms,15,48,40,8,1
12-01-2025,Spices & Seasonings,DB CRYSTAL SALT 1KG,15,25,25,0,1
12-01-2025,"Grains, Flours & Dals",Green gram 1 kg,4,300,260,40,2
12-01-2025,Spices & Seasonings,TATA SALT 1KG,15,30,30,0,1
12-01-2025,"Grains, Flours & Dals",KORRALU (FOXTAIL M) 500GM,4,130,110,20,2
12-01-2025,Spices & Seasonings,DRY MIECHI 200GM,15,80,60,20,1
12-01-2025,"Grains, Flours & Dals",Idly Rava L 1KG,4,120,100,20,2
12-01-2025,"Dry Fruits, Nuts & Seeds",Groundnuts 500 gms,2,95,85,10,1
12-01-2025,Spices & Seasonings,JEERA 250 gms,15,125,105,20,1
12-01-2025,"Dry Fruits, Nuts & Seeds",PN ORGANIC MAKHANA 50GM,2,125,125,0,1
12-01-2025,"Grains, Flours & Dals",MELMEKER 250GMS,4,60,45,15,1
12-01-2025,Snacks & Ready-to-Eat,VD GUMMADI VADIYAM,14,75,75,0,1
12-01-2025,Sweeteners,MISHRI 250 GM,16,35,30,5,1
12-01-2025,Snacks & Ready-to-Eat,RINGS 200GM,14,30,30,0,1
12-01-2025,Snacks & Ready-to-Eat,VD Pappu Chekkalu 190gm,14,60,60,0,1
12-01-2025,Oils & Ghee,Groundnut oil 1 L,9,360,330,30,1
12-01-2025,Milk & Dairy,SANGAM FULL CREAM MILK 500ML,7,38,38,0,1
12-01-2025,"Grains, Flours & Dals",JOWAR WHITE 1 KG,4,80,70,10,1
12-01-2025,Pooja & Spiritual Items,GD KUMKUM 50GM,12,120,120,0,4
12-01-2025,"Health, Wellness & Ayurvedic Products",MH Millets Malt 500GM,5,200,190,10,1
12-01-2025,"Grains, Flours & Dals",FLOUR CHARGE,4,30,30,0,2.5
12-01-2025,Snacks & Ready-to-Eat,VD PAPPU CHEGODI 200GM,14,120,120,0,2
12-01-2025,Snacks & Ready-to-Eat,PALLI LADDU 200GMS,14,180,140,40,2
12-01-2025,Oils & Ghee,Sesame oil 5 L,9,2950,"2,750.00",200,1
12-01-2025,Oils & Ghee,Groundnut oil 1 L,9,720,660,60,2
12-01-2025,"Grains, Flours & Dals",SL Idly Rava 1KG,4,65,55,10,1
12-01-2025,Milk & Dairy,BROWN EGGS 1P,7,140,120,20,10
12-01-2025,Spices & Seasonings,DRY MIECHI 200GM,15,80,60,20,1
12-01-2025,"Grains, Flours & Dals",White jowar.F 1 kg,4,100,80,20,1
12-01-2025,Spices & Seasonings,DRY MIECHI 200GM,15,80,60,20,1
12-01-2025,"Grains, Flours & Dals",Multigrain 5 kgs,4,500,425,75,1
12-01-2025,Spices & Seasonings,ROYAL SAFFRON 400GRMS,15,130,130,0,2
12-01-2025,Spices & Seasonings,Coriander seeds 200 gms,15,48,40,8,1
12-01-2025,Spices & Seasonings,RED COPRA 250GMS,15,85,74,11,1
12-01-2025,Spices & Seasonings,Dalchin Chekka 50GM,15,50,40,10,1
12-01-2025,"Grains, Flours & Dals",Bajra Flour 1 kg,4,70,60,10,1
12-01-2025,Spices & Seasonings,Avalu small 250 gms,15,60,40,20,1
12-01-2025,Spices & Seasonings,Elaichi 25GM,15,145,120,25,1
12-01-2025,Oils & Ghee,Sesame oil 1 L,9,590,560,30,1
12-01-2025,"Dry Fruits, Nuts & Seeds",PLAIN PISTA 250GM,2,660,550,110,1
12-01-2025,Snacks & Ready-to-Eat,SALTED PHALLI,14,65,65,0,1
12-01-2025,Oils & Ghee,Sesame oil 1 L,9,590,560,30,1
12-01-2025,Oils & Ghee,Safflower oil 1 L,9,440,400,40,1
12-01-2025,Oils & Ghee,Groundnut oil 1 L,9,360,330,30,1
12-01-2025,Sweeteners,ACHUBELLAM 500GM,16,100,80,20,2
12-01-2025,Oils & Ghee,Groundnut oil 1 L,9,1080,990,90,3
12-01-2025,Sweeteners,MISHRI D,16,40,30,10,1
12-01-2025,"Grains, Flours & Dals",Chana Flour 500 gms,4,140,130,10,2
12-01-2025,Spices & Seasonings,Miriyalu 50GM,15,100,80,20,1
12-01-2025,Spices & Seasonings,SV Oregano 15GM,15,110,110,0,1
12-01-2025,Sweeteners,Mishri 500GM,16,70,60,10,1
12-01-2025,"Grains, Flours & Dals",MELMEKER 250GMS,4,60,45,15,1
12-01-2025,"Dry Fruits, Nuts & Seeds",Groundnuts 500 gms,2,95,85,10,1
12-01-2025,"Grains, Flours & Dals",SRILALITHA MAIDA FLOUR 500G,4,32,32,0,1
12-01-2025,"Dry Fruits, Nuts & Seeds",PUTNALU 500GMS,2,90,76,14,1
12-01-2025,"Grains, Flours & Dals",White jowar.F 1 kg,4,100,80,20,1
12-01-2025,Spices & Seasonings,SV Smoked Chilli Flakes 30GM,15,46,46,0,1
12-01-2025,"Grains, Flours & Dals",Wheat Flour 2 kgs,4,280,240,40,2
12-01-2025,"Grains, Flours & Dals",SRILATHA RICE RAVVA 500GM,4,35,35,0,1
12-01-2025,Spices & Seasonings,NUVVULU 500GM,15,160,130,30,1
12-01-2025,"Grains, Flours & Dals",VL Sabdana 500GM,4,77,77,0,1
12-01-2025,Spices & Seasonings,SREE MARUTHI IDLY KARAM 200GM,15,60,60,0,1
12-01-2025,"Grains, Flours & Dals",COW B rice 1 kg,4,720,690,30,10
12-01-2025,Beverages,GANTASALA TEJ DRY GINGER COFFEE,1,149,149,0,1
12-01-2025,Personal Care & Cosmetics,KHADI Neem Anti Dandruff Shampoo,10,199,199,0,1
12-01-2025,Snacks & Ready-to-Eat,VD JAGGERY GHEE 250GM,14,180,180,0,1
12-01-2025,Snacks & Ready-to-Eat,SD RAGI GAVVALU,14,95,95,0,1
12-01-2025,Snacks & Ready-to-Eat,BD PEARL MILLET NOODLES 200G,14,70,70,0,1
12-01-2025,Snacks & Ready-to-Eat,SATHVI PALLI CHIKKI 200GM,14,100,80,20,1
12-01-2025,"Grains, Flours & Dals",KORRALU (FOXTAIL M) 500GM,4,65,55,10,1
12-01-2025,"Dry Fruits, Nuts & Seeds",SATHVI CHIA SEEDS 100GM,2,100,80,20,1
12-01-2025,"Grains, Flours & Dals",THICK POHA 500GM,4,40,35,5,1
12-01-2025,Oils & Ghee,Coconut oil 1 L,9,440,400,40,1
12-01-2025,Snacks & Ready-to-Eat,SESAME LADDU 200GM,14,100,80,20,1
12-01-2025,"Grains, Flours & Dals",Wheat Flour 1 kg,4,140,120,20,2
12-01-2025,"Grains, Flours & Dals",Chana Flour 500 gms,4,210,195,15,3
12-01-2025,Oils & Ghee,Groundnut oil 1 L,9,360,330,30,1
12-01-2025,Snacks & Ready-to-Eat,SS IDLY BATTER 1KG,14,120,120,0,2
12-01-2025,"Dry Fruits, Nuts & Seeds",DRYDATES YELLOW 250GM,2,135,120,15,1
12-01-2025,"Health, Wellness & Ayurvedic Products",HARITHAKI CHOORNAM,5,60,60,0,1
12-01-2025,Beverages,MARWADI CHAI 100GM,1,75,75,0,1
12-01-2025,Oils & Ghee,DB CASTOR OIL 100ML,9,130,130,0,1
12-01-2025,Personal Care & Cosmetics,REVLON,10,45,45,0,1
12-01-2025,Sweeteners,MISHRI D,16,40,30,10,1
12-01-2025,"Health, Wellness & Ayurvedic Products",BHRINGARAJA,5,280,280,0,1
12-01-2025,Beverages,GANTASALA TEJ DRY GINGER COFFEE,1,149,149,0,1
12-01-2025,Pickles & Cooking Pastes,SD SWEET AVAKAYA,11,110,110,0,1
12-01-2025,Spices & Seasonings,GD Turmeric 50GM,15,25,25,0,1
12-01-2025,Personal Care & Cosmetics,BIOTIQUE HERBCOLOR 1N,10,300,300,0,1
12-01-2025,Household & Cleaning,HERBAL MOSQUITO REP RS 100ML,6,240,240,0,1
12-01-2025,"Health, Wellness & Ayurvedic Products",DWI OMU WATER 100ML,5,40,40,0,1
12-01-2025,Snacks & Ready-to-Eat,ELITE ELAICHI RUSK 200GM,14,35,35,0,1
12-01-2025,Pickles & Cooking Pastes,SD CURRY LEAVES PICKLE,11,110,110,0,1
12-01-2025,Pickles & Cooking Pastes,SD BITTER GOURD PICKLE,11,110,110,0,1
12-01-2025,"Dry Fruits, Nuts & Seeds",BLACK KISMIS 250GM,2,175,140,35,1
12-01-2025,Personal Care & Cosmetics,OVAL BODY LOOFAH,10,55,55,0,1
12-01-2025,Snacks & Ready-to-Eat,VD GUMMADI VADIYAM,14,75,75,0,1
12-01-2025,Sweeteners,MISHRI 250 GM,16,35,30,5,1
12-01-2025,Pooja & Spiritual Items,GD KUMKUM 50GM,12,30,30,0,1
12-01-2025,Snacks & Ready-to-Eat,VD NUVULU LADDU 9PIC,14,100,100,0,1
12-01-2025,Snacks & Ready-to-Eat,SATHVI PALLI CHIKKI 200GM,14,100,80,20,1
12-01-2025,"Grains, Flours & Dals",JOWAR UPMA RAVA,4,65,65,0,1
12-01-2025,"Grains, Flours & Dals",KORRALU (FOXTAIL M) 1KG,4,150,110,40,1
12-01-2025,"Dry Fruits, Nuts & Seeds",SD Mango cubes 200gm,2,90,90,0,1
12-01-2025,Oils & Ghee,Groundnut oil 1 L,9,720,660,60,2
12-01-2025,Pooja & Spiritual Items,GD Aiswarya Deepam 700ML,12,390,390,0,2
12-01-2025,Personal Care & Cosmetics,HERBAL BATH POWDER 200GM,10,80,80,0,1
12-01-2025,"Grains, Flours & Dals",Chana Flour 500 gms,4,140,130,10,2
12-01-2025,"Grains, Flours & Dals",AISHWARYA SP 1KG,4,80,75,5,1
12-01-2025,Oils & Ghee,Safflower oil 1 L,9,1320,"1,200.00",120,3
12-01-2025,Personal Care & Cosmetics,MD Bath Powder 100GM,10,40,40,0,1
12-01-2025,"Grains, Flours & Dals",VYS.SP RICE 1 KG,4,70,65,5,1
12-01-2025,Personal Care & Cosmetics,UVIS ALOEVERA &amp;NEEM,10,175,175,0,1
12-01-2025,"Health, Wellness & Ayurvedic Products",DWI EUCALYPTUS 8ML,5,80,80,0,1
12-01-2025,"Health, Wellness & Ayurvedic Products",MD Neem Leaf Choornam 100GM,5,80,80,0,1
12-01-2025,"Grains, Flours & Dals",Chana Flour 1 kg,4,280,260,20,2
12-01-2025,"Grains, Flours & Dals",RAGI FLOUR 1KG,4,80,70,10,1
12-01-2025,"Grains, Flours & Dals",White Chana 500GM,4,120,100,20,1
12-01-2025,"Grains, Flours & Dals",Bajra Flour 1 kg,4,70,60,10,1
12-01-2025,"Grains, Flours & Dals",RAJMA 250GM,4,55,45,10,1
12-01-2025,"Grains, Flours & Dals",DH URAD GOTA 1KG,4,430,380,50,2
12-01-2025,"Grains, Flours & Dals",Wheat Flour 2 kgs,4,280,240,40,2
12-01-2025,"Grains, Flours & Dals",white Bobarlu 500 gms,4,80,75,5,1
12-01-2025,"Grains, Flours & Dals",Yellow jowar .F1 kg,4,110,100,10,1
12-01-2025,Sweeteners,YB JAGGERY POWDER 1KG,16,420,420,0,3
12-01-2025,"Grains, Flours & Dals",Brown RICE 1KG,4,70,65,5,1
12-01-2025,Spices & Seasonings,ROYAL SAFFRON 400GRMS,15,325,325,0,5
12-01-2025,"Grains, Flours & Dals",PESARA PAPPU 1 KG,4,170,145,25,1
12-01-2025,Spices & Seasonings,ROYAL SAFFRON 400GRMS,15,65,65,0,1
12-01-2025,"Dry Fruits, Nuts & Seeds",Groundnuts 500 gms,2,95,85,10,1
12-01-2025,"Grains, Flours & Dals",RED TURDAL 500GM,4,75,70,5,1
12-01-2025,"Grains, Flours & Dals",Red Chana 250GM,4,35,30,5,1
12-01-2025,"Grains, Flours & Dals",CHANA DAL 1KG,4,140,120,20,1
12-01-2025,"Grains, Flours & Dals",Wheat Rava M 1KG,4,65,55,10,1
12-01-2025,"Grains, Flours & Dals",turdal 1kg,4,220,195,25,1
12-01-2025,"Grains, Flours & Dals",SRILATHA RICE RAVVA 500GM,4,35,35,0,1
12-01-2025,Spices & Seasonings,AVALU 100GM,15,25,20,5,1
12-01-2025,"Health, Wellness & Ayurvedic Products",JAMBU SEED CHOORNAM 100GM,5,80,80,0,1
12-01-2025,"Health, Wellness & Ayurvedic Products",MD Neem Leaf Choornam 100GM,5,80,80,0,1
12-01-2025,Spices & Seasonings,NUVVULU 250GM,15,100,85,15,1
12-01-2025,Oils & Ghee,Sesame oil 1 L,9,1180,"1,120.00",60,2
12-01-2025,"Grains, Flours & Dals",VYS.SP RICE 1 KG,4,350,325,25,5
12-01-2025,"Grains, Flours & Dals",RAGI FLOUR 1KG,4,80,70,10,1
12-01-2025,Oils & Ghee,Freedom Rice Bran Oil 1L,9,388,360,28,2
12-01-2025,Spices & Seasonings,AVALU 100GM,15,25,20,5,1
12-01-2025,Spices & Seasonings,DRY MIECHI 200GM,15,80,60,20,1
12-01-2025,"Grains, Flours & Dals",SRILALITHA MAIDA FLOUR 500G,4,64,64,0,2
12-01-2025,"Dry Fruits, Nuts & Seeds",PUTNALU 500GMS,2,90,76,14,1
12-01-2025,Oils & Ghee,Safflower oil 1 L,9,880,800,80,2
12-01-2025,Milk & Dairy,BROWN EGGS 1P,7,84,72,12,6
12-01-2025,Oils & Ghee,Sesame oil 1 L,9,590,560,30,1
12-01-2025,Oils & Ghee,Groundnut oil 1 L,9,360,330,30,1
12-01-2025,Oils & Ghee,Groundnut oil 1 L,9,360,330,30,1
12-01-2025,Snacks & Ready-to-Eat,SATHVI PALLI CHIKKI 200GM,14,100,80,20,1
12-01-2025,Oils & Ghee,Safflower oil 1 L,9,440,400,40,1
12-01-2025,Snacks & Ready-to-Eat,PUMPKIN CHIKKI 200GM,14,140,120,20,1
12-01-2025,Milk & Dairy,BROWN EGGS 1P,7,168,144,24,12
12-01-2025,Sweeteners,ACHUBELLAM 500GM,16,50,40,10,1
12-01-2025,Snacks & Ready-to-Eat,RB Choco Delite Almonds Raisins 40g,14,90,90,0,2
12-01-2025,"Grains, Flours & Dals",split black gram 1 kg,4,360,340,20,2
12-01-2025,Oils & Ghee,Sesame oil 1 L,9,590,560,30,1
12-01-2025,Spices & Seasonings,Masala Karam 500 gms,15,520,480,40,2
12-01-2025,"Grains, Flours & Dals",Chana Flour 1 kg,4,280,260,20,2
12-01-2025,"Grains, Flours & Dals",MAATEJA rice 5 kg,4,360,345,15,1
12-01-2025,Sweeteners,KAMAL JAGGERY 500GM,16,40,40,0,1
12-01-2025,"Grains, Flours & Dals",KORRALU (FOXTAIL M) 500GM,4,65,55,10,1
12-01-2025,Sweeteners,Mishri 500GM,16,70,60,10,1
12-01-2025,"Grains, Flours & Dals",Arikalu (kodo),4,70,65,5,1
12-01-2025,Spices & Seasonings,Menthulu 250 gms,15,50,45,5,1
12-01-2025,Spices & Seasonings,AVALU 100GM,15,25,20,5,1
12-01-2025,Spices & Seasonings,ROYAL SAFFRON 400GRMS,15,65,65,0,1
12-01-2025,"Grains, Flours & Dals",UDALU (Barnyard millet) 500 gms,4,70,60,10,1
12-01-2025,Spices & Seasonings,NUVVULU 250GM,15,80,65,15,1
12-01-2025,Sweeteners,Natural Honey 500 gms,16,280,240,40,1
12-01-2025,Oils & Ghee,Sesame oil 500ml,9,295,280,15,1
12-01-2025,Sweeteners,Mishri 500GM,16,70,60,10,1
12-01-2025,Spices & Seasonings,DURGA SALT CRYSTAL 1KG,15,25,25,0,1
12-01-2025,"Grains, Flours & Dals",SABDANA 500GM,4,90,70,20,1
12-01-2025,Sweeteners,NATURAL HONEY 1KG,16,1120,960,160,2
12-01-2025,"Grains, Flours & Dals",SAMALU (Little millet) 1 kg,4,170,130,40,1
12-01-2025,"Grains, Flours & Dals",UDALU (Barnyard millet) 1 kg,4,140,115,25,1
12-01-2025,"Grains, Flours & Dals",KORRALU (FOXTAIL M) 1KG,4,150,110,40,1
12-01-2025,"Dry Fruits, Nuts & Seeds",PUMPKIN SEEDS 250GM,2,200,160,40,1
12-01-2025,Snacks & Ready-to-Eat,ZEEDI,14,70,70,0,1
12-01-2025,"Grains, Flours & Dals",Arikalu (kodo),4,70,65,5,1
12-01-2025,"Health, Wellness & Ayurvedic Products",BRAHMI CHOORNAM 100GM,5,100,100,0,1
12-01-2025,"Dry Fruits, Nuts & Seeds",SUNFLOWER SEEDS 250GRM,2,150,130,20,1
12-01-2025,"Dry Fruits, Nuts & Seeds",SABJA SEEDS 100GM,2,80,70,10,1
12-01-2025,"Dry Fruits, Nuts & Seeds",SATHVI CHIA SEEDS 100GM,2,100,80,20,1
12-01-2025,Snacks & Ready-to-Eat,SESAME LADDU 200GM,14,200,160,40,2
12-01-2025,"Grains, Flours & Dals",ANDU KORRALU (Brown top .mlt) 500,4,160,145,15,1
12-01-2025,"Grains, Flours & Dals",ANDU KORRALU (Brown top .mlt) 500,4,160,145,15,1
12-01-2025,"Grains, Flours & Dals",UDALU (Barnyard millet) 500 gms,4,70,60,10,1
12-01-2025,"Grains, Flours & Dals",Arikalu (kodo),4,70,65,5,1
12-01-2025,"Grains, Flours & Dals",KORRALU (FOXTAIL M) 500GM,4,65,55,10,1
12-01-2025,"Grains, Flours & Dals",CHANA DAL 500GM,4,70,60,10,1
12-01-2025,"Grains, Flours & Dals",Idly Rava L 1KG,4,60,50,10,1
12-01-2025,"Grains, Flours & Dals",Urad dall 1 Kg,4,185,170,15,1
12-01-2025,"Dry Fruits, Nuts & Seeds",Groundnuts 1 kg,2,380,340,40,2
12-01-2025,Spices & Seasonings,AV Iodized Salt 1KG,15,28,25,3,1
12-01-2025,"Grains, Flours & Dals",Wheat Rava M 1KG,4,65,55,10,1
12-01-2025,Sweeteners,ACHUBELLAM 500GM,16,50,40,10,1
12-01-2025,"Grains, Flours & Dals",SAMALU (Little millet) 1 kg,4,170,130,40,1
12-01-2025,Oils & Ghee,Groundnut oil 1 L,9,360,330,30,1
12-01-2025,Personal Care & Cosmetics,GOW DURBAR 75G,10,60,60,0,1
12-01-2025,Pooja & Spiritual Items,GD Aiswarya Deepam 700ML,12,195,195,0,1
12-01-2025,"Grains, Flours & Dals",turdal 1kg,4,220,195,25,1
12-01-2025,"Grains, Flours & Dals",Green gram 500 gms,4,75,70,5,1
12-01-2025,Oils & Ghee,Coconut oil 1 L,9,880,800,80,2
12-01-2025,"Grains, Flours & Dals",Arikadu ( kodo),4,420,390,30,3
12-01-2025,"Grains, Flours & Dals",Red Bobarlu 500 gms,4,95,85,10,1
12-01-2025,"Grains, Flours & Dals",VYS.SP.RICE 5 KGS,4,350,325,25,1
12-01-2025,"Grains, Flours & Dals",URAD DALL,4,95,85,10,1
12-01-2025,Snacks & Ready-to-Eat,DISANO VERMICELLI 425 GM,14,50,50,0,1
12-01-2025,"Grains, Flours & Dals",Wheat Flour 2 kgs,4,140,120,20,1
12-01-2025,"Grains, Flours & Dals",Bajra Flour 500 gms,4,140,120,20,4
12-01-2025,Snacks & Ready-to-Eat,VD SAGOPAPAD 150GM,14,55,55,0,1
12-01-2025,Snacks & Ready-to-Eat,VD RICE PAPAD 150GM,14,50,50,0,1
12-01-2025,"Grains, Flours & Dals",Chana Flour 500 gms,4,70,65,5,1
12-01-2025,Spices & Seasonings,ROYAL SAFFRON 400GRMS,15,65,65,0,1
12-01-2025,Snacks & Ready-to-Eat,MAAGAANI JOWAR M COOKIES 120GM,14,149,149,0,1
12-01-2025,Sweeteners,Natural Honey 500 gms,16,280,240,40,1
12-01-2025,Oils & Ghee,Groundnut oil 1 L,9,360,330,30,1
12-01-2025,Oils & Ghee,Freedom Rice Bran Oil 1L,9,388,360,28,2
12-01-2025,"Grains, Flours & Dals",BASMATHI RICE 1KG,4,150,135,15,1
11-01-2025,Snacks & Ready-to-Eat,KURNOOL MARMURA,14,140,110,30,2
11-01-2025,"Grains, Flours & Dals",White jowar.F 1 kg,4,200,160,40,2
11-01-2025,Snacks & Ready-to-Eat,VD MAIDA CHEGODI 175GM,14,60,60,0,1
11-01-2025,Snacks & Ready-to-Eat,PUMPKIN CHIKKI 200GM,14,140,120,20,1
11-01-2025,Snacks & Ready-to-Eat,VD BELLAM GAVVALU 200GM,14,60,60,0,1
11-01-2025,Snacks & Ready-to-Eat,SD FINGER Millet with palm Jaggery 250gm,14,135,135,0,1
11-01-2025,Snacks & Ready-to-Eat,SESAME CHIKKI,14,120,100,20,1
11-01-2025,Snacks & Ready-to-Eat,MARMURA LADDU,14,80,60,20,1
11-01-2025,Snacks & Ready-to-Eat,PALLI LADDU 200GMS,14,90,70,20,1
11-01-2025,"Grains, Flours & Dals",HS RAGI Idly rava 500 gms,4,140,140,0,2
11-01-2025,"Grains, Flours & Dals",HS Multimillet upma r 500g,4,65,65,0,1
11-01-2025,"Grains, Flours & Dals",Wheat Flour 1 kg,4,140,120,20,2
11-01-2025,"Grains, Flours & Dals",BOMBAY RAVA,4,70,55,15,1
11-01-2025,"Grains, Flours & Dals",Sathya Javva Wheat Rava 500GM,4,190,190,0,2
11-01-2025,"Grains, Flours & Dals",HS Jowar upma rava 500 gms,4,65,65,0,1
11-01-2025,"Grains, Flours & Dals",SA WHITE JOWAR RAVA 500GM,4,138,138,0,2
11-01-2025,"Grains, Flours & Dals",MELMEKER 250GMS,4,60,45,15,1
11-01-2025,Sweeteners,ACHU BELLAM 1KG,16,200,160,40,2
11-01-2025,Sweeteners,ACHUBELLAM 500GM,16,100,80,20,2
11-01-2025,Snacks & Ready-to-Eat,SD FINGER Millet with palm Jaggery 250gm,14,135,135,0,1
11-01-2025,Oils & Ghee,Groundnut oil 500ml,9,180,165,15,1
11-01-2025,Snacks & Ready-to-Eat,MARMURA LADDU,14,80,60,20,1
11-01-2025,Sweeteners,Mishri 500GM,16,70,60,10,1
11-01-2025,"Dry Fruits, Nuts & Seeds",Groundnuts 500 gms,2,95,85,10,1
11-01-2025,Sweeteners,YB JAGGERY POWDER 500GMS,16,75,75,0,1
11-01-2025,Sweeteners,KAMAL JAGGERY 500GM,16,40,40,0,1
11-01-2025,Spices & Seasonings,ROYAL SAFFRON 400GRMS,15,65,65,0,1
11-01-2025,"Grains, Flours & Dals",SRILALITHA MAIDA FLOUR 500G,4,64,64,0,2
11-01-2025,"Grains, Flours & Dals",Chana Flour 500 gms,4,70,65,5,1
11-01-2025,Snacks & Ready-to-Eat,VD ARISELU 5 PIC,14,100,100,0,1
11-01-2025,Snacks & Ready-to-Eat,GANTASALA GINGER SNACKS 150GM,14,60,60,0,1
11-01-2025,Snacks & Ready-to-Eat,VD Pappu Chekkalu 190gm,14,60,60,0,1
11-01-2025,Snacks & Ready-to-Eat,SD RAGI GAVVALU,14,95,95,0,1
11-01-2025,"Grains, Flours & Dals",THICK POHA 1KG,4,80,70,10,1
11-01-2025,Snacks & Ready-to-Eat,SATHVI REGIVADA 200GM,14,80,60,20,1
11-01-2025,Spices & Seasonings,SV Smoked Chilli Flakes 30GM,15,46,46,0,1
11-01-2025,Snacks & Ready-to-Eat,GANTASALA ONION SNACKS 150GM,14,60,60,0,1
11-01-2025,Snacks & Ready-to-Eat,GANTASALA TOMATO SNACKS 150GM,14,60,60,0,1
11-01-2025,Snacks & Ready-to-Eat,VD DRY FRUIT PUTHAREKULU,14,120,120,0,1
11-01-2025,"Grains, Flours & Dals",Wheat Rava M 1KG,4,65,55,10,1
11-01-2025,"Grains, Flours & Dals",DECCAN MUDRA,4,499,475,24,1
11-01-2025,Snacks & Ready-to-Eat,SATHVI PALLI CHIKKI 200GM,14,100,80,20,1
11-01-2025,Snacks & Ready-to-Eat,NGT CHATPATTA CHANA 90GM,14,75,75,0,3
11-01-2025,Personal Care & Cosmetics,HERBAL BATH POWDER 200GM,10,80,80,0,1
11-01-2025,Sweeteners,Natural Honey 500 gms,16,280,240,40,1
11-01-2025,"Grains, Flours & Dals",RAGI FLOUR 500GRMS,4,40,35,5,1
11-01-2025,"Grains, Flours & Dals",Wheat Flour 1 kg,4,70,60,10,1
11-01-2025,Oils & Ghee,Groundnut oil 1 L,9,360,330,30,1
11-01-2025,"Grains, Flours & Dals",Chana Flour 500 gms,4,70,65,5,1
11-01-2025,Snacks & Ready-to-Eat,SD Sesame laddu with dates250gm,14,270,270,0,2
11-01-2025,"Grains, Flours & Dals",FLOUR CHARGE,4,19.2,19.2,0,1.6
11-01-2025,"Grains, Flours & Dals",Bajra Flour 500 gms,4,35,30,5,1
11-01-2025,"Grains, Flours & Dals",Bajra Flour 1 kg,4,70,60,10,1
11-01-2025,Spices & Seasonings,FLAXSEED KARAM,15,450,450,0,6
11-01-2025,Spices & Seasonings,SD IDLY KARAM,15,130,130,0,2
11-01-2025,"Dry Fruits, Nuts & Seeds",SD Mango cubes 200gm,2,180,180,0,2
11-01-2025,Spices & Seasonings,SD Curry Leaves Karam Powder 100GM,15,455,455,0,7
11-01-2025,"Dry Fruits, Nuts & Seeds",SD Mango cubes 100gm,2,360,360,0,8
11-01-2025,Snacks & Ready-to-Eat,BD LITTLE MILLET NOODLES 200G,14,75,75,0,1
11-01-2025,Personal Care & Cosmetics,SVE SUNNI PINDI SCRUBSOAP 100GM,10,400,400,0,4
11-01-2025,Personal Care & Cosmetics,SVE MULTANI MITTI SOAP 100GM,10,90,90,0,1
11-01-2025,Spices & Seasonings,SD Redgram Karam Powder 100GM,15,130,130,0,2
11-01-2025,Snacks & Ready-to-Eat,PUMPKIN CHIKKI 200GM,14,140,120,20,1
11-01-2025,"Grains, Flours & Dals",Multigrain 1 kg,4,200,170,30,2
11-01-2025,"Grains, Flours & Dals",VGR RICE 10 KGS,4,700,650,50,1
11-01-2025,"Grains, Flours & Dals",THICK POHA 1KG,4,80,70,10,1
11-01-2025,"Grains, Flours & Dals",SL Idly Rava 1KG,4,65,55,10,1
11-01-2025,"Grains, Flours & Dals",RAGI FLOUR 500GRMS,4,40,35,5,1
11-01-2025,Beverages,BRU GREEN LABEL 1.2G,1,24,24,0,12
11-01-2025,"Grains, Flours & Dals",Yellow jowar.F 500 gms,4,55,50,5,1
11-01-2025,"Grains, Flours & Dals",turdal 1kg,4,220,195,25,1
11-01-2025,Milk & Dairy,BROWN EGGS TRAY 30P,7,360,330,30,1
11-01-2025,"Grains, Flours & Dals",RAGI FLOUR 1KG,4,80,70,10,1
11-01-2025,Snacks & Ready-to-Eat,BATANA NGT 70GMS,14,20,20,0,1
11-01-2025,"Grains, Flours & Dals",JOWAR YELLOW 1 K,4,50,45,5,0.5
11-01-2025,"Grains, Flours & Dals",JOWAR WHITE 1 KG,4,40,35,5,0.5
11-01-2025,Snacks & Ready-to-Eat,VD RICE PAPAD 150GM,14,50,50,0,1
11-01-2025,Snacks & Ready-to-Eat,RSC ORANGE 100GMS,14,20,20,0,1
11-01-2025,"Dry Fruits, Nuts & Seeds",YELLOW KISHMISH 250GM,2,130,110,20,1
11-01-2025,"Grains, Flours & Dals",Yellow jowar .F1 kg,4,110,100,10,1
11-01-2025,Sweeteners,YB JAGGERY POWDER 500GMS,16,75,75,0,1
11-01-2025,"Grains, Flours & Dals",RAGI FLOUR 1KG,4,80,70,10,1
11-01-2025,Oils & Ghee,Groundnut oil 1 L,9,720,660,60,2
11-01-2025,Personal Care & Cosmetics,DWI NEEM TULSI SOAP 100GM,10,150,150,0,2
11-01-2025,Pooja & Spiritual Items,GD TULASI 75GM,12,120,120,0,2
11-01-2025,Oils & Ghee,Groundnut oil 5 L,9,1800,"1,600.00",200,1
11-01-2025,"Grains, Flours & Dals",Bajra Flour 1 kg,4,140,120,20,2
11-01-2025,"Grains, Flours & Dals",Chana Flour 1 kg,4,140,130,10,1
11-01-2025,"Dry Fruits, Nuts & Seeds",Putnalu 250GM,2,45,38,7,1
11-01-2025,Snacks & Ready-to-Eat,Corn Chips 250GM,14,40,35,5,1
11-01-2025,"Grains, Flours & Dals",MELMEKER 250GMS,4,60,45,15,1
11-01-2025,Pooja & Spiritual Items,SWASTIK CAMPHORE,12,90,90,0,1
11-01-2025,Snacks & Ready-to-Eat,MARMURA LADDU,14,80,60,20,1
11-01-2025,Spices & Seasonings,Turmeric powder 250 gms,15,200,150,50,2
11-01-2025,"Grains, Flours & Dals",SL Suji Rava 500GM,4,32,32,0,1
11-01-2025,"Grains, Flours & Dals",SRILALITHA MAIDA FLOUR 500G,4,32,32,0,1
11-01-2025,"Dry Fruits, Nuts & Seeds",PUMPKIN SEEDS 250GM,2,200,160,40,1
11-01-2025,Snacks & Ready-to-Eat,ZEEDI,14,70,70,0,1
11-01-2025,Spices & Seasonings,SREE MARUTHI IDLY KARAM 200GM,15,60,60,0,1
11-01-2025,Snacks & Ready-to-Eat,Corn Chips 250GM,14,40,35,5,1
11-01-2025,Pooja & Spiritual Items,BANDA PUVVU 25GM 25GM,12,80,60,20,1
11-01-2025,Snacks & Ready-to-Eat,SATHVI REGIVADA 200GM,14,80,60,20,1
11-01-2025,Snacks & Ready-to-Eat,SALTED PHALLI,14,65,65,0,1
11-01-2025,Personal Care & Cosmetics,ORAL B KIDS,10,50,50,0,2
11-01-2025,Spices & Seasonings,MG Dasa dinasalu 250gm,15,220,220,0,1
11-01-2025,Snacks & Ready-to-Eat,PEANUT CANDY,14,45,45,0,1
11-01-2025,"Grains, Flours & Dals",RAGI FLOUR 1KG,4,80,70,10,1
11-01-2025,Milk & Dairy,BROWN EGGS TRAY 30P,7,360,330,30,1
11-01-2025,Oils & Ghee,Castor oil 200 ml,9,100,80,20,1
11-01-2025,"Grains, Flours & Dals",Bajra Flour 1 kg,4,70,60,10,1
11-01-2025,"Grains, Flours & Dals",PESARA PAPPU 500GMS,4,85,75,10,1
11-01-2025,Snacks & Ready-to-Eat,Sprouted Ragi Biscuits 450GM,14,150,150,0,1
11-01-2025,Spices & Seasonings,PRO ORG CORIANDER WHOLE 100G,15,70,70,0,1
11-01-2025,Snacks & Ready-to-Eat,SATHVI REGIVADA 200GM,14,80,60,20,1
11-01-2025,"Grains, Flours & Dals",MELMEKER 250GMS,4,60,45,15,1
11-01-2025,"Grains, Flours & Dals",Green gram 1 kg,4,150,130,20,1
11-01-2025,Snacks & Ready-to-Eat,VD Minapa papad 200gm,14,60,60,0,1
11-01-2025,"Dry Fruits, Nuts & Seeds",SD SUNFLOWER SEEDS WITH DATES,2,135,135,0,1
11-01-2025,Snacks & Ready-to-Eat,SD KODO MILLET WITH PALM JAGGERY,14,135,135,0,1
11-01-2025,Oils & Ghee,Groundnut oil 1 L,9,360,330,30,1
11-01-2025,"Grains, Flours & Dals",DR.RICE 5KG,4,600,600,0,1
11-01-2025,Oils & Ghee,Coconut oil 500 ml,9,220,200,20,1
11-01-2025,Spices & Seasonings,NUVVULU 500GM,15,160,130,30,1
11-01-2025,Snacks & Ready-to-Eat,RI SPORTS BAR 40G,14,45,45,0,1
11-01-2025,"Health, Wellness & Ayurvedic Products",NEELI LEAF CHOORNAM,5,110,110,0,1
11-01-2025,Personal Care & Cosmetics,MD Bath Powder 100GM,10,40,40,0,1
11-01-2025,Personal Care & Cosmetics,GAYATHRI KUMKUDUKAYA,10,150,150,0,1
11-01-2025,Personal Care & Cosmetics,UVIS MULTANI MITTI 200GM,10,90,90,0,1
11-01-2025,"Grains, Flours & Dals",Wheat Flour 1 kg,4,210,180,30,3
11-01-2025,Snacks & Ready-to-Eat,RSC ORANGE 100GMS,14,20,20,0,1
11-01-2025,"Grains, Flours & Dals",Yellow jowar .F1 kg,4,110,100,10,1
11-01-2025,Snacks & Ready-to-Eat,KURNOOL MARMURA,14,70,55,15,1
11-01-2025,Personal Care & Cosmetics,KHADI LEMONGRASS SOAP 125GM,10,80,80,0,1
11-01-2025,Personal Care & Cosmetics,KHADI ACTIVATED CHARCOAL SOAP,10,80,80,0,1
11-01-2025,Personal Care & Cosmetics,CLOSEUP,10,134,134,0,2
11-01-2025,"Grains, Flours & Dals",White jowar.F 1 kg,4,100,80,20,1
11-01-2025,Personal Care & Cosmetics,UVIS BLACK HENNA 100GM,10,175,175,0,1
11-01-2025,"Grains, Flours & Dals",Chana Flour 1 kg,4,140,130,10,1
11-01-2025,Personal Care & Cosmetics,SVE SHIKAKAI SOAP 100GM,10,100,100,0,1
11-01-2025,Spices & Seasonings,Chilli powder 500 gms,15,290,210,80,1
11-01-2025,"Grains, Flours & Dals",FLOUR CHARGE,4,18,18,0,1.5
11-01-2025,Snacks & Ready-to-Eat,VD MINAPA MIRCHI PAPAD 195GM,14,60,60,0,1
11-01-2025,Snacks & Ready-to-Eat,TILLI CHIKKI,14,5,5,0,1
11-01-2025,"Grains, Flours & Dals",VGR rice 1 kg,4,350,325,25,5
11-01-2025,Snacks & Ready-to-Eat,VD RED CHILLI RICEPAPAD 150GM,14,50,50,0,1
11-01-2025,"Grains, Flours & Dals",Wheat Flour 1 kg,4,140,120,20,2
11-01-2025,"Grains, Flours & Dals",Multigrain 1 kg,4,200,170,30,2
11-01-2025,"Dry Fruits, Nuts & Seeds",SH GROUNDNUT 500GM,2,163,130,33,1
11-01-2025,Snacks & Ready-to-Eat,ELITE ELAICHI RUSK 200GM,14,35,35,0,1
11-01-2025,"Dry Fruits, Nuts & Seeds",SABJA SEEDS 100GM,2,160,140,20,2
11-01-2025,Oils & Ghee,Coconut oil 500 ml,9,220,200,20,1
11-01-2025,"Grains, Flours & Dals",SPLIT BLACK GRAM 500 GM,4,90,85,5,1
11-01-2025,Snacks & Ready-to-Eat,TILLI CHIKKI,14,5,5,0,1
11-01-2025,"Dry Fruits, Nuts & Seeds",PUTNALU 500GMS,2,90,76,14,1
11-01-2025,"Grains, Flours & Dals",PRO NATURE CHANNA DAL500GM,4,124,124,0,1
11-01-2025,"Grains, Flours & Dals",SH ROASTED SOOJI 500GM,4,66,59,7,1
11-01-2025,Pooja & Spiritual Items,BALAJI BEL PHOOL DHOOP STICKS 10STK,12,70,70,0,1
11-01-2025,Spices & Seasonings,SH CLOVES 30GM,15,95,95,0,1
11-01-2025,Pooja & Spiritual Items,GOMATHA AGARBATHI,12,75,75,0,1
11-01-2025,Spices & Seasonings,SH CASSIA STICKS 50GM,15,75,75,0,1
11-01-2025,"Dry Fruits, Nuts & Seeds",PULMAKHANA 100 GM,2,180,170,10,1
11-01-2025,Pooja & Spiritual Items,DASANGAM DHOOP POWDER 50GM,12,43,43,0,1
11-01-2025,Spices & Seasonings,SAJEERA,15,60,40,20,1
11-01-2025,Spices & Seasonings,DRY MANGO POWDER,15,45,45,0,1
11-01-2025,Personal Care & Cosmetics,MYSORE SANDAL,10,69,69,0,1
11-01-2025,Spices & Seasonings,SATHVI ANASAPUVUU 25GM,15,90,65,25,1
11-01-2025,Pooja & Spiritual Items,BALAJI GUGGAL DHOOP 10STK,12,70,70,0,1
11-01-2025,Spices & Seasonings,Japatri 25GM,15,100,80,20,1
11-01-2025,Snacks & Ready-to-Eat,GB SALT COOKIES,14,60,55,5,1
11-01-2025,Personal Care & Cosmetics,CLOSEUP,10,67,67,0,1
11-01-2025,"Grains, Flours & Dals",KORRALU (FOXTAIL M) 500GM,4,65,55,10,1
11-01-2025,"Grains, Flours & Dals",SAMALU (Little millet) 500 gms,4,85,65,20,1
11-01-2025,Beverages,ASSAM TEA GINGER TEA POWDER 250GM,1,199,199,0,1
11-01-2025,"Grains, Flours & Dals",SRILATHA RICE RAVVA 500GM,4,35,35,0,1
11-01-2025,"Grains, Flours & Dals",turdal 1kg,4,440,390,50,2
11-01-2025,Oils & Ghee,Groundnut oil 5 L,9,1800,"1,600.00",200,1
11-01-2025,Snacks & Ready-to-Eat,ANNAPURNA APPALAM,14,70,70,0,2
11-01-2025,"Grains, Flours & Dals",JOWAR WHITE 1 KG,4,80,70,10,1
11-01-2025,Pooja & Spiritual Items,BALAJI BEL PHOOL STICKS 90GM,12,60,60,0,1
11-01-2025,"Grains, Flours & Dals",Multigrain 1 kg,4,100,85,15,1
11-01-2025,Pooja & Spiritual Items,GOMATHA AGARBATHI,12,150,150,0,2
11-01-2025,"Grains, Flours & Dals",HS Multimillet idly R 500 gms,4,130,130,0,2
11-01-2025,Snacks & Ready-to-Eat,MAAGAANI JOWAR M COOKIES 120GM,14,149,149,0,1
11-01-2025,Snacks & Ready-to-Eat,KURNOOL MARMURA,14,70,55,15,1
11-01-2025,"Dry Fruits, Nuts & Seeds",PULMAKHANA 100 GM,2,180,170,10,1
11-01-2025,Household & Cleaning,TIDE DOUBLE POWER JASMINE &amp;ROSE,6,66,66,0,1
11-01-2025,Spices & Seasonings,Turmeric powder 250 gms,15,100,75,25,1
11-01-2025,Spices & Seasonings,Masala Karam 500 gms,15,260,240,20,1
11-01-2025,"Grains, Flours & Dals",Wheat Flour 1 kg,4,70,60,10,1
11-01-2025,Snacks & Ready-to-Eat,NGT CHATPATTA CHANA 90GM,14,25,25,0,1
11-01-2025,"Grains, Flours & Dals",Wheat Flour 1 kg,4,140,120,20,2
11-01-2025,"Grains, Flours & Dals",RICE FLOUR 1KG,4,140,110,30,2
11-01-2025,"Grains, Flours & Dals",RICE FLOUR 500 GM,4,35,28,7,1
11-01-2025,"Grains, Flours & Dals",Chana Flour 500 gms,4,70,65,5,1
11-01-2025,Spices & Seasonings,ROYAL SAFFRON 400GRMS,15,130,130,0,2
11-01-2025,Oils & Ghee,Sesame oil 1 L,9,1180,"1,120.00",60,2
11-01-2025,Snacks & Ready-to-Eat,SATHVI REGIVADA 200GM,14,80,60,20,1
11-01-2025,Oils & Ghee,Groundnut oil 1 L,9,720,660,60,2
11-01-2025,Sweeteners,YB Brown Sugar 1KG,16,140,140,0,1
11-01-2025,Oils & Ghee,Groundnut oil 5 L,9,1800,"1,600.00",200,1
11-01-2025,"Grains, Flours & Dals",RICE FLOUR 500 GM,4,35,28,7,1
11-01-2025,"Grains, Flours & Dals",turdal 1kg,4,440,390,50,2
11-01-2025,Snacks & Ready-to-Eat,RINGS 200GM,14,30,30,0,1
11-01-2025,Snacks & Ready-to-Eat,SD VAMU APPADALU 200GM,14,80,80,0,1
11-01-2025,Oils & Ghee,ANURAG RB OIL,9,120,100,20,1
11-01-2025,Snacks & Ready-to-Eat,VD Minapa papad 200gm,14,60,60,0,1
11-01-2025,Pooja & Spiritual Items,BANDA PUVVU 25GM 25GM,12,80,60,20,1
11-01-2025,Snacks & Ready-to-Eat,VD BELLAM GAVVALU 200GM,14,60,60,0,1
11-01-2025,Snacks & Ready-to-Eat,SESAME LADDU 200GM,14,100,80,20,1
11-01-2025,Personal Care & Cosmetics,PEARS BODY WASH,10,210,210,0,1
11-01-2025,"Grains, Flours & Dals",RAGULU 1 KG,4,140,120,20,2
11-01-2025,Snacks & Ready-to-Eat,VD MYSOREPAK 6PIC,14,100,100,0,1
11-01-2025,Snacks & Ready-to-Eat,ZEEDI,14,140,140,0,2
11-01-2025,"Grains, Flours & Dals",JOWAR YELLOW 1 K,4,180,160,20,2
11-01-2025,"Grains, Flours & Dals",BAJRA 1 KG,4,60,50,10,1
11-01-2025,Snacks & Ready-to-Eat,SD JOWAR WITH PALM JAGGERY 250GM,14,135,135,0,1
11-01-2025,Snacks & Ready-to-Eat,VD ARISELU 5 PIC,14,100,100,0,1
11-01-2025,"Grains, Flours & Dals",Wheat Flour 2 kgs,4,140,120,20,1
11-01-2025,Snacks & Ready-to-Eat,SD KODO MILLET WITH PALM JAGGERY,14,135,135,0,1
11-01-2025,Snacks & Ready-to-Eat,GS Instant Raagi Dosa Mix 400GM,14,198,198,0,2
11-01-2025,"Health, Wellness & Ayurvedic Products",MD Ashwagandha Choornam 100GM,5,170,170,0,1
11-01-2025,Oils & Ghee,Groundnut oil 1 L,9,360,330,30,1
11-01-2025,Spices & Seasonings,Menthulu 250 gms,15,50,45,5,1
11-01-2025,"Dry Fruits, Nuts & Seeds",YELLOW KISHMISH 250GM,2,130,110,20,1
11-01-2025,Snacks & Ready-to-Eat,VD ARISELU 5 PIC,14,100,100,0,1
11-01-2025,Oils & Ghee,Safflower oil 1 L,9,440,400,40,1
11-01-2025,"Grains, Flours & Dals",Arikadu ( kodo),4,140,130,10,1
11-01-2025,Snacks & Ready-to-Eat,NGT CHATPATTA CHANA 90GM,14,25,25,0,1
11-01-2025,Sweeteners,GS Palm Jaggery Powder 400GM,16,180,180,0,1
11-01-2025,"Grains, Flours & Dals",RAGULU 1 KG,4,140,120,20,2
11-01-2025,Sweeteners,YB Brown Sugar 1KG,16,280,280,0,2
11-01-2025,"Grains, Flours & Dals",KORRALU (FOXTAIL M) 1KG,4,150,110,40,1
11-01-2025,Beverages,MUA COFFEE EXT STRONG 250GM,1,140,140,0,1
11-01-2025,"Grains, Flours & Dals",SAMALU (Little millet) 1 kg,4,170,130,40,1
11-01-2025,"Grains, Flours & Dals",UDALU (Barnyard millet) 1 kg,4,140,115,25,1
11-01-2025,Sweeteners,COCONUT SUGAR,16,299,284,15,1
11-01-2025,"Grains, Flours & Dals",ANDU KORRALU (Browntop.m) 1 kg,4,320,290,30,1
11-01-2025,"Dry Fruits, Nuts & Seeds",PULMAKHANA 100 GM,2,180,170,10,1
11-01-2025,"Grains, Flours & Dals",Chana Flour 500 gms,4,70,65,5,1
11-01-2025,Oils & Ghee,CASTOR OIL 200ML,9,100,80,20,1
11-01-2025,"Grains, Flours & Dals",White jowar.F 1 kg,4,100,80,20,1
11-01-2025,"Grains, Flours & Dals",Wheat Flour 1 kg,4,70,60,10,1
11-01-2025,Snacks & Ready-to-Eat,NGT CHATPATTA CHANA 90GM,14,25,25,0,1
11-01-2025,"Grains, Flours & Dals",UDALU (Barnyard millet) 1 kg,4,140,115,25,1
11-01-2025,"Grains, Flours & Dals",RAGI FLOUR 1KG,4,80,70,10,1
11-01-2025,Oils & Ghee,Groundnut oil 1 L,9,360,330,30,1
11-01-2025,"Grains, Flours & Dals",RICE FLOUR 1KG,4,140,110,30,2
11-01-2025,"Grains, Flours & Dals",Bajra Flour 1 kg,4,140,120,20,2
11-01-2025,Sweeteners,YB Brown Sugar 1KG,16,140,140,0,1
11-01-2025,"Grains, Flours & Dals",Green gram 1 kg,4,150,130,20,1
11-01-2025,"Dry Fruits, Nuts & Seeds",Groundnuts 1 kg,2,190,170,20,1
11-01-2025,Personal Care & Cosmetics,INDICA EASY,10,30,30,0,1
11-01-2025,"Grains, Flours & Dals",split green gram 500 gms,4,75,70,5,1
11-01-2025,Snacks & Ready-to-Eat,TILLI CHIKKI,14,15,15,0,3
11-01-2025,"Grains, Flours & Dals",split black gram 1 kg,4,360,340,20,2
11-01-2025,"Grains, Flours & Dals",Multigrain 1 kg,4,100,85,15,1
11-01-2025,Snacks & Ready-to-Eat,VD MYSOREPAK 6PIC,14,100,100,0,1
11-01-2025,"Grains, Flours & Dals",RAGULU 1 KG,4,70,60,10,1
11-01-2025,Personal Care & Cosmetics,SVE TULASI SHAMPOO 200ML,10,210,210,0,1
11-01-2025,"Health, Wellness & Ayurvedic Products",RB Max Protein DESI MASALA 60gm,5,45,45,0,1
11-01-2025,Snacks & Ready-to-Eat,NGT CHATPATTA CHANA 90GM,14,25,25,0,1
11-01-2025,Snacks & Ready-to-Eat,RI SPORTS BAR 40G,14,45,45,0,1
11-01-2025,Snacks & Ready-to-Eat,RI Yogurt Berry Oats 35g,14,45,45,0,1
11-01-2025,Snacks & Ready-to-Eat,ZEEDI,14,70,70,0,1
11-01-2025,Snacks & Ready-to-Eat,HS Ragi biscuits,14,50,50,0,1
11-01-2025,"Dry Fruits, Nuts & Seeds",SD Mango cubes 100gm,2,45,45,0,1
11-01-2025,Snacks & Ready-to-Eat,FUN TIME CRUNCH,14,45,45,0,1
11-01-2025,Snacks & Ready-to-Eat,SF MIGHTY PUFFS,14,25,25,0,1
11-01-2025,Snacks & Ready-to-Eat,MIGHTY PUFFS CHEDDAR CHEESE,14,50,50,0,2
11-01-2025,Snacks & Ready-to-Eat,MARMURA LADDU,14,80,60,20,1
11-01-2025,Snacks & Ready-to-Eat,SATHVI PALLI CHIKKI 200GM,14,100,80,20,1
11-01-2025,Snacks & Ready-to-Eat,VD Pappu Chekkalu 190gm,14,60,60,0,1
11-01-2025,Snacks & Ready-to-Eat,VD MINAPA SUNNUNDALU 12P,14,540,540,0,3
11-01-2025,"Grains, Flours & Dals",Wheat Flour 1 kg,4,280,240,40,4
11-01-2025,Snacks & Ready-to-Eat,VD BELLAM GAVVALU 200GM,14,60,60,0,1
11-01-2025,Snacks & Ready-to-Eat,NGT CHATPATTA CHANA 90GM,14,25,25,0,1
11-01-2025,Snacks & Ready-to-Eat,VD SAGOPAPAD 150GM,14,55,55,0,1
11-01-2025,Snacks & Ready-to-Eat,VD Pappu Chekkalu 190gm,14,120,120,0,2
11-01-2025,"Dry Fruits, Nuts & Seeds",PULMAKHANA 100 GM,2,180,170,10,1
11-01-2025,Milk & Dairy,HERITAGE CURD,7,48,48,0,1
11-01-2025,Snacks & Ready-to-Eat,VD MINAPA SUNNUNDALU 12P,14,180,180,0,1
11-01-2025,Snacks & Ready-to-Eat,SD MASALA GAVVALU 200GM,14,95,95,0,1
11-01-2025,Pooja & Spiritual Items,SST 365 PURE COTTON POOJA,12,60,60,0,2
11-01-2025,Oils & Ghee,Castor oil 500 ml,9,250,200,50,1
11-01-2025,Oils & Ghee,Sesame oil 500ml,9,295,280,15,1
11-01-2025,"Dry Fruits, Nuts & Seeds",FLAX SEEDS 250GM,2,60,50,10,1
11-01-2025,"Dry Fruits, Nuts & Seeds",PUMPKIN SEEDS 250GM,2,200,160,40,1
11-01-2025,"Dry Fruits, Nuts & Seeds",SABJA SEEDS 100GM,2,80,70,10,1
11-01-2025,"Grains, Flours & Dals",CHANA DAL 500GM,4,70,60,10,1
11-01-2025,"Grains, Flours & Dals",CHANA DAL 1KG,4,140,120,20,1
11-01-2025,"Grains, Flours & Dals",RICE FLOUR 1KG,4,140,110,30,2
11-01-2025,"Grains, Flours & Dals",Chana Flour 500 gms,4,70,65,5,1
11-01-2025,"Grains, Flours & Dals",Idly Rava L 1KG,4,120,100,20,2
11-01-2025,Spices & Seasonings,ROYAL SAFFRON 400GRMS,15,130,130,0,2
11-01-2025,"Grains, Flours & Dals",RAGULU 1 KG,4,70,60,10,1
11-01-2025,Spices & Seasonings,GREEN SOUNF,15,60,40,20,1
11-01-2025,"Grains, Flours & Dals",turdal 500 gms,4,110,100,10,1
11-01-2025,Oils & Ghee,Groundnut oil 1 L,9,360,330,30,1
11-01-2025,Spices & Seasonings,DRY MIECHI 200GM,15,80,60,20,1
11-01-2025,"Grains, Flours & Dals",BASMATHI RICE 1KG,4,300,270,30,2
11-01-2025,Pooja & Spiritual Items,GD Aiswarya Deepam 700ML,12,195,195,0,1
11-01-2025,"Dry Fruits, Nuts & Seeds",Groundnuts 500 gms,2,95,85,10,1
11-01-2025,"Grains, Flours & Dals",Chana Flour 500 gms,4,70,65,5,1
11-01-2025,Spices & Seasonings,DRY MIECHI 200GM,15,80,60,20,1
11-01-2025,"Grains, Flours & Dals",CHANA DAL 500GM,4,70,60,10,1
11-01-2025,"Grains, Flours & Dals",SPLIT BLACK GRAM 500 GM,4,90,85,5,1
11-01-2025,Misc,HOME LIKES,8,20,20,0,2
11-01-2025,"Grains, Flours & Dals",Red Chana 500 GM,4,150,120,30,2
11-01-2025,"Dry Fruits, Nuts & Seeds",GF KIMIA DATES 500GM,2,310,190,120,1
11-01-2025,Spices & Seasonings,Avalu small 250 gms,15,60,40,20,1
11-01-2025,Milk & Dairy,SANGAM CURD 450GM,7,76,76,0,2
11-01-2025,Snacks & Ready-to-Eat,VD RED CHILLI RICEPAPAD 150GM,14,50,50,0,1
11-01-2025,Snacks & Ready-to-Eat,SATHVI PALLI CHIKKI 200GM,14,100,80,20,1
11-01-2025,Snacks & Ready-to-Eat,VD Minapa papad 200gm,14,60,60,0,1
11-01-2025,Snacks & Ready-to-Eat,VD GUMMADI VADIYAM,14,75,75,0,1
11-01-2025,Oils & Ghee,BUFFALLO GHEE 500ML,9,410,370,40,1
11-01-2025,Sweeteners,YB Palm Jaggery 250GM,16,200,200,0,1
11-01-2025,Snacks & Ready-to-Eat,SD Flax seeds with dates 250gm,14,270,270,0,2
11-01-2025,"Grains, Flours & Dals",RAGI FLOUR 500GRMS,4,40,35,5,1
11-01-2025,"Grains, Flours & Dals",Wheat Flour 1 kg,4,140,120,20,2
11-01-2025,Oils & Ghee,Sesame oil 1 L,9,590,560,30,1
11-01-2025,Oils & Ghee,Safflower oil 1 L,9,440,400,40,1
11-01-2025,Oils & Ghee,Groundnut oil 1 L,9,360,330,30,1
11-01-2025,Personal Care & Cosmetics,GOW DURBAR NAVA 100GM SOAP,10,400,400,0,10
11-01-2025,"Grains, Flours & Dals",RICE FLOUR 500 GM,4,35,28,7,1
11-01-2025,"Grains, Flours & Dals",Chana Flour 1 kg,4,140,130,10,1
11-01-2025,Spices & Seasonings,PURO Healthy Salt 1KG,15,110,110,0,1
11-01-2025,"Grains, Flours & Dals",WHEAT 1 KG,4,180,150,30,3
11-01-2025,"Grains, Flours & Dals",Wheat Rava M 1KG,4,65,55,10,1
11-01-2025,"Grains, Flours & Dals",turdal 1kg,4,220,195,25,1
11-01-2025,Spices & Seasonings,ROYAL SAFFRON 400GRMS,15,65,65,0,1
11-01-2025,"Grains, Flours & Dals",FLOUR CHARGE,4,96,96,0,8
11-01-2025,"Grains, Flours & Dals",JOWAR YELLOW 1 K,4,450,450,0,5
11-01-2025,Sweeteners,MISHRI 250 GM,16,35,30,5,1
11-01-2025,"Grains, Flours & Dals",Green gram 1 kg,4,150,130,20,1
11-01-2025,"Grains, Flours & Dals",Em jowar idly R 500G,4,75,75,0,1
11-01-2025,"Grains, Flours & Dals",BOMBAY RAVA,4,70,55,15,1
11-01-2025,Spices & Seasonings,GREEN SOUNF,15,60,40,20,1
11-01-2025,"Grains, Flours & Dals",Wheat Flour 1 kg,4,70,60,10,1
11-01-2025,Household & Cleaning,GAJANAND BLACK DRAGN 10STI,6,40,40,0,2
11-01-2025,"Grains, Flours & Dals",RICE FLOUR 500 GM,4,35,28,7,1
11-01-2025,Sweeteners,MISHRI D,16,40,30,10,1
11-01-2025,"Grains, Flours & Dals",Idly Rava L 1KG,4,60,50,10,1
11-01-2025,Milk & Dairy,TOTAL CURD 50GMS,7,10,10,0,1
11-01-2025,Snacks & Ready-to-Eat,ELITE ELAICHI RUSK 200GM,14,35,35,0,1
11-01-2025,Snacks & Ready-to-Eat,ELITE MILK RUSK 200GM,14,35,35,0,1
11-01-2025,Spices & Seasonings,Elaichi 25GM,15,145,120,25,1
11-01-2025,"Grains, Flours & Dals",Multigrain 1 kg,4,100,85,15,1
11-01-2025,"Grains, Flours & Dals",BOMBAY RAVA,4,70,55,15,1
11-01-2025,"Grains, Flours & Dals",Wheat Flour 1 kg,4,70,60,10,1
11-01-2025,Snacks & Ready-to-Eat,VD ATUKULU MIXTURE 175GM,14,60,60,0,1
11-01-2025,Snacks & Ready-to-Eat,VD SAGOPAPAD 150GM,14,55,55,0,1
11-01-2025,Spices & Seasonings,MM Rasam Powder 100GM,15,55,55,0,1
11-01-2025,Spices & Seasonings,RED COPRA 250GMS,15,85,74,11,1
11-01-2025,Snacks & Ready-to-Eat,VD Minapa papad 200gm,14,60,60,0,1
11-01-2025,"Dry Fruits, Nuts & Seeds",Groundnuts 1 kg,2,190,170,20,1
11-01-2025,Snacks & Ready-to-Eat,SD FLAX SEED APPADALU,14,90,90,0,1
11-01-2025,"Grains, Flours & Dals",Chana Flour 1 kg,4,140,130,10,1
11-01-2025,Spices & Seasonings,Chilli powder 500 gms,15,290,210,80,1
11-01-2025,Oils & Ghee,Groundnut oil 1 L,9,720,660,60,2
11-01-2025,"Grains, Flours & Dals",RAGI FLOUR 1KG,4,80,70,10,1
11-01-2025,Milk & Dairy,SANGAM FULL CREAM MILK 500ML,7,76,76,0,2
11-01-2025,"Health, Wellness & Ayurvedic Products",MXP CHOCO CLASSIC BAR,5,70,70,0,1
11-01-2025,General Household & Kitchenware,SIRIDHANYALU BOOK,3,200,180,20,1
11-01-2025,"Grains, Flours & Dals",FLOUR CHARGE,4,22.8,22.8,0,1.9
11-01-2025,"Grains, Flours & Dals",Chana Flour 1 kg,4,140,130,10,1
11-01-2025,"Health, Wellness & Ayurvedic Products",MD Neem Leaf Choornam 100GM,5,80,80,0,1
11-01-2025,Spices & Seasonings,Dalchin Chekka 50GM,15,50,40,10,1
11-01-2025,"Grains, Flours & Dals",HS RAGI Idly rava 500 gms,4,70,70,0,1
11-01-2025,"Grains, Flours & Dals",Wheat Rava M 1KG,4,65,55,10,1
11-01-2025,"Dry Fruits, Nuts & Seeds",WALLNUTS 250GM,2,320,290,30,1
11-01-2025,"Grains, Flours & Dals",AISHWARYA SP 1KG,4,240,225,15,3
11-01-2025,"Grains, Flours & Dals",Chana Flour 500 gms,4,70,65,5,1
11-01-2025,"Grains, Flours & Dals",VYS.SP RICE 1 KG,4,1050,975,75,15
11-01-2025,"Grains, Flours & Dals",RICE FLOUR 500 GM,4,35,28,7,1
11-01-2025,Oils & Ghee,BUFFALLO GHEE 500ML,9,410,370,40,1
11-01-2025,Snacks & Ready-to-Eat,SD Aswagandha with palm Jaggery250Gm,14,135,135,0,1
11-01-2025,Snacks & Ready-to-Eat,VD Pappu Chekkalu 190gm,14,120,120,0,2
11-01-2025,Snacks & Ready-to-Eat,BD LITTLE MILLET NOODLES 200G,14,75,75,0,1
11-01-2025,Snacks & Ready-to-Eat,BD RED RICE NOODLES 200G,14,75,75,0,1
11-01-2025,Oils & Ghee,Groundnut oil 1 L,9,1080,990,90,3
11-01-2025,"Grains, Flours & Dals",SAMALU (Little millet) 1 kg,4,170,130,40,1
11-01-2025,"Grains, Flours & Dals",VYS.SP RICE 1 KG,4,70,65,5,1
11-01-2025,Spices & Seasonings,Jeera 100GM,15,50,45,5,1
11-01-2025,Snacks & Ready-to-Eat,Corn Chips 250GM,14,40,35,5,1
11-01-2025,"Grains, Flours & Dals",WHITE BATANI,4,40,30,10,1
11-01-2025,Spices & Seasonings,Coriander seeds 200 gms,15,48,40,8,1
11-01-2025,"Grains, Flours & Dals",SL Suji Rava 500GM,4,32,32,0,1
11-01-2025,Spices & Seasonings,AVALU 100GM,15,25,20,5,1
11-01-2025,Snacks & Ready-to-Eat,VD SAGOPAPAD 150GM,14,110,110,0,2
11-01-2025,"Dry Fruits, Nuts & Seeds",Groundnuts 1 kg,2,190,170,20,1
11-01-2025,Snacks & Ready-to-Eat,VD MINAPA VADIYAM,14,65,65,0,1
11-01-2025,"Grains, Flours & Dals",Red Chana 500 GM,4,75,60,15,1
11-01-2025,Snacks & Ready-to-Eat,VD RICE SAGO PAPAD 150GM,14,110,110,0,2
11-01-2025,Oils & Ghee,Groundnut oil 1 L,9,1800,"1,650.00",150,5
11-01-2025,Sweeteners,MADHUR SUGAR 1KG,16,325,275,50,5
11-01-2025,"Grains, Flours & Dals",turdal 1kg,4,440,390,50,2
11-01-2025,Snacks & Ready-to-Eat,SD Moringa with plam jaggery 250gm,14,135,135,0,1
11-01-2025,Spices & Seasonings,Tamarind 250GMS,15,80,65,15,1
11-01-2025,"Grains, Flours & Dals",VYS.SP.RICE 5 KGS,4,350,325,25,1
11-01-2025,Spices & Seasonings,Coriander seeds 200 gms,15,48,40,8,1
10-01-2025,"Grains, Flours & Dals",KORRALU (FOXTAIL M) 500GM,4,65,55,10,1
10-01-2025,"Dry Fruits, Nuts & Seeds",MAHA BEERA SEEDS 100GM,2,60,60,0,1
10-01-2025,"Grains, Flours & Dals",Arikalu (kodo),4,70,65,5,1
10-01-2025,Beverages,BRU GREEN LABEL 1.2G,1,28,28,0,14
10-01-2025,Spices & Seasonings,DB CRYSTAL SALT 1KG,15,50,50,0,2
10-01-2025,"Dry Fruits, Nuts & Seeds",ALMONDS 250GM,2,280,260,20,1
10-01-2025,"Dry Fruits, Nuts & Seeds",PUMPKIN SEEDS 250GM,2,200,160,40,1
10-01-2025,Oils & Ghee,Groundnut oil 1 L,9,360,330,30,1
10-01-2025,"Dry Fruits, Nuts & Seeds",WATERMELON SEEDS 250GRM,2,320,280,40,1
10-01-2025,Spices & Seasonings,Elaichi 25GM,15,145,120,25,1
10-01-2025,"Grains, Flours & Dals",UDALU (Barnyard millet) 500 gms,4,70,60,10,1
10-01-2025,"Grains, Flours & Dals",ANDU KORRALU (Brown top .mlt) 500,4,160,145,15,1
10-01-2025,"Dry Fruits, Nuts & Seeds",SUNFLOWER SEEDS 250GRM,2,150,130,20,1
10-01-2025,Snacks & Ready-to-Eat,VD BOONDI 175GM,14,60,60,0,1
10-01-2025,Snacks & Ready-to-Eat,SATHVI MIXED CHIKKI 200GM,14,120,100,20,1
10-01-2025,"Grains, Flours & Dals",RAJMA 500GM,4,90,90,0,1
10-01-2025,"Grains, Flours & Dals",Red Bobarlu 500 gms,4,95,85,10,1
10-01-2025,Snacks & Ready-to-Eat,SESAME LADDU 200GM,14,100,80,20,1
10-01-2025,"Grains, Flours & Dals",BASMATHI RICE 1KG,4,300,270,30,2
10-01-2025,Oils & Ghee,Groundnut oil 1 L,9,720,660,60,2
10-01-2025,Beverages,GANTASALA TEJ DRY GINGER COFFEE,1,149,149,0,1
10-01-2025,"Health, Wellness & Ayurvedic Products",MD Triphala Chorrnam 100GM,5,160,160,0,2
10-01-2025,"Health, Wellness & Ayurvedic Products",MD Tulasi Leaf Powder 50GM,5,80,80,0,1
10-01-2025,"Grains, Flours & Dals",Red Chana 250GM,4,35,30,5,1
10-01-2025,"Grains, Flours & Dals",white Bobarlu 500 gms,4,80,75,5,1
10-01-2025,Personal Care & Cosmetics,SVE RED SANDAL SOAP 100GM,10,90,90,0,1
10-01-2025,Snacks & Ready-to-Eat,MILLET PANCAKE CHOCOLATE,14,199,199,0,1
10-01-2025,"Dry Fruits, Nuts & Seeds",BLACK KISMIS 250GM,2,175,140,35,1
10-01-2025,Snacks & Ready-to-Eat,MILK BREAD,14,55,55,0,1
10-01-2025,Spices & Seasonings,ROYAL SAFFRON 400GRMS,15,65,65,0,1
10-01-2025,"Grains, Flours & Dals",BASMATHI RICE 1KG,4,150,135,15,1
10-01-2025,Snacks & Ready-to-Eat,GROUNDNUT LADDU WITH DATES,14,135,135,0,1
10-01-2025,"Grains, Flours & Dals",Green gram 500 gms,4,75,70,5,1
10-01-2025,"Dry Fruits, Nuts & Seeds",SABJA SEEDS 100GM,2,80,70,10,1
10-01-2025,Snacks & Ready-to-Eat,SESAME LADDU 200GM,14,100,80,20,1
10-01-2025,"Grains, Flours & Dals",HS Multimillet upma r 500g,4,65,65,0,1
10-01-2025,Oils & Ghee,Groundnut oil 1 L,9,360,330,30,1
10-01-2025,Sweeteners,MISHRI D,16,40,30,10,1
10-01-2025,"Grains, Flours & Dals",Wheat Rava M 500GM,4,33,30,3,1
10-01-2025,"Dry Fruits, Nuts & Seeds",YELLOW KISHMISH 250GM,2,130,110,20,1
10-01-2025,Snacks & Ready-to-Eat,FUN TIME CRUNCH,14,90,90,0,2
10-01-2025,Sweeteners,SUGAR 1KG,16,120,100,20,2
10-01-2025,Spices & Seasonings,DB SAFRON,15,180,180,0,1
10-01-2025,Snacks & Ready-to-Eat,BLACK SESAME CHIKKI,14,10,10,0,1
10-01-2025,Snacks & Ready-to-Eat,NGT CHATPATTA CHANA 90GM,14,40,40,0,2
10-01-2025,"Grains, Flours & Dals",Red Wheat Flour 1 kg,4,280,260,20,2
10-01-2025,Snacks & Ready-to-Eat,RAGI LADDU,14,120,120,0,1
10-01-2025,Milk & Dairy,SANGAM TONED MILK 500ML,7,60,60,0,2
10-01-2025,Snacks & Ready-to-Eat,RSC ORANGE 100GMS,14,20,20,0,1
10-01-2025,Milk & Dairy,TOTAL CURD 50GMS,7,10,10,0,1
10-01-2025,Snacks & Ready-to-Eat,RAGI LADDU,14,120,120,0,1
10-01-2025,Snacks & Ready-to-Eat,VD MINAPA SUNNUNDALU 12P,14,360,360,0,2
10-01-2025,Snacks & Ready-to-Eat,SD FINGER Millet with palm Jaggery 250gm,14,135,135,0,1
10-01-2025,Snacks & Ready-to-Eat,SD High Protein Laddu 175gm,14,190,190,0,1
10-01-2025,Snacks & Ready-to-Eat,SD High Protein Laddu 175gm,14,190,190,0,1
10-01-2025,Snacks & Ready-to-Eat,SD FINGER Millet with palm Jaggery 250gm,14,135,135,0,1
10-01-2025,Snacks & Ready-to-Eat,VD NUVULU LADDU 9PIC,14,200,200,0,2
10-01-2025,Snacks & Ready-to-Eat,RAGI LADDU,14,120,120,0,1
10-01-2025,Spices & Seasonings,Turmeric powder 250 gms,15,100,75,25,1
10-01-2025,Snacks & Ready-to-Eat,VD Minapa papad 200gm,14,60,60,0,1
10-01-2025,"Grains, Flours & Dals",Chana Flour 500 gms,4,70,65,5,1
10-01-2025,"Grains, Flours & Dals",Chana Flour 1 kg,4,280,260,20,2
10-01-2025,"Grains, Flours & Dals",WHEAT 1 KG,4,60,50,10,1
10-01-2025,"Grains, Flours & Dals",RICE FLOUR 1KG,4,210,165,45,3
10-01-2025,Snacks & Ready-to-Eat,VD RICE MURUKU 150GM,14,50,50,0,1
10-01-2025,Spices & Seasonings,Chilli powder 500 gms,15,870,630,240,3
10-01-2025,Spices & Seasonings,Chilli powder 500 gms,15,290,210,80,1
10-01-2025,"Grains, Flours & Dals",ANDU KORRALU (Brown top .mlt) 500,4,160,145,15,1
10-01-2025,Oils & Ghee,Safflower oil 1 L,9,880,800,80,2
10-01-2025,"Grains, Flours & Dals",SAMALU (Little millet) 500 gms,4,85,65,20,1
10-01-2025,Oils & Ghee,Coconut oil 500 ml,9,440,400,40,2
10-01-2025,"Grains, Flours & Dals",UDALU (Barnyard millet) 500 gms,4,70,60,10,1
10-01-2025,Spices & Seasonings,Vamu 100GM,15,60,50,10,1
10-01-2025,"Grains, Flours & Dals",Wheat Flour 1 kg,4,140,120,20,2
10-01-2025,Personal Care & Cosmetics,Soapnut 250GM,10,60,45,15,1
10-01-2025,Oils & Ghee,Sesame oil 1 L,9,1180,"1,120.00",60,2
10-01-2025,Spices & Seasonings,PRO ORG MUSTARD SMALL -RAI 200G,15,84,84,0,1
10-01-2025,Spices & Seasonings,Elaichi 25GM,15,145,120,25,1
10-01-2025,"Dry Fruits, Nuts & Seeds",SD Mango cubes 100gm,2,45,45,0,1
10-01-2025,Oils & Ghee,BUFFALLO GHEE 500ML,9,410,370,40,1
10-01-2025,"Grains, Flours & Dals",KORRALU (FOXTAIL M) 500GM,4,65,55,10,1
10-01-2025,Spices & Seasonings,JEERA 250 gms,15,125,105,20,1
10-01-2025,Spices & Seasonings,ROYAL SAFFRON,15,125,125,0,1
10-01-2025,Oils & Ghee,Groundnut oil 1 L,9,360,330,30,1
10-01-2025,Oils & Ghee,Groundnut oil 1 L,9,720,660,60,2
10-01-2025,"Grains, Flours & Dals",WHEAT 1 KG,4,180,150,30,3
10-01-2025,"Grains, Flours & Dals",Multigrain 1 kg,4,100,85,15,1
10-01-2025,Snacks & Ready-to-Eat,RINGS 200GM,14,30,30,0,1
10-01-2025,Spices & Seasonings,DRY MIECHI 200GM,15,80,60,20,1
10-01-2025,"Dry Fruits, Nuts & Seeds",Groundnuts 1 kg,2,190,170,20,1
10-01-2025,"Grains, Flours & Dals",CHANA DAL 500GM,4,140,120,20,2
10-01-2025,"Grains, Flours & Dals",split green gram 1 kg,4,150,140,10,1
10-01-2025,Snacks & Ready-to-Eat,VD NUVULU CHEGODI 175GM,14,60,60,0,1
10-01-2025,Oils & Ghee,Groundnut oil 1 L,9,360,330,30,1
10-01-2025,Snacks & Ready-to-Eat,SD Thati thandra 200gm,14,150,150,0,1
10-01-2025,Spices & Seasonings,NUVVULU 500GM,15,320,260,60,2
10-01-2025,"Dry Fruits, Nuts & Seeds",SATHVI CHIA SEEDS 100GM,2,100,80,20,1
10-01-2025,Snacks & Ready-to-Eat,VD PAPPU CHEGODI 200GM,14,60,60,0,1
10-01-2025,"Grains, Flours & Dals",Red Bobarlu 500 gms,4,95,85,10,1
10-01-2025,Snacks & Ready-to-Eat,VD SAGOPAPAD 150GM,14,55,55,0,1
10-01-2025,"Grains, Flours & Dals",Red Chana 250GM,4,35,30,5,1
10-01-2025,Snacks & Ready-to-Eat,VD Minapa papad 200gm,14,60,60,0,1
10-01-2025,Snacks & Ready-to-Eat,VD RICE PAPAD 150GM,14,50,50,0,1
10-01-2025,"Grains, Flours & Dals",Chana Flour 500 gms,4,70,65,5,1
10-01-2025,Pooja & Spiritual Items,GD Aiswarya Deepam 700ML,12,195,195,0,1
10-01-2025,"Grains, Flours & Dals",RICE FLOUR 500 GM,4,35,28,7,1
10-01-2025,Oils & Ghee,Groundnut oil 1 L,9,360,330,30,1
10-01-2025,Spices & Seasonings,PRO ORG BLACK PEPPER WHOLE 100G,15,210,210,0,1
10-01-2025,Spices & Seasonings,SH MUSTARD 100GM,15,30,30,0,1
10-01-2025,Spices & Seasonings,PRO ORG AJWAIN 100G,15,105,105,0,1
10-01-2025,Pickles & Cooking Pastes,SD AMALA PICKLE,11,110,110,0,1
10-01-2025,Spices & Seasonings,SH CLOVES 30GM,15,95,95,0,1
10-01-2025,Spices & Seasonings,SH CASSIA STICKS 50GM,15,75,75,0,1
10-01-2025,Spices & Seasonings,Jeera 100GM,15,50,45,5,1
10-01-2025,"Grains, Flours & Dals",CHANA DAL 500GM,4,70,60,10,1
10-01-2025,Snacks & Ready-to-Eat,SUNNUNDALU,14,120,120,0,1
10-01-2025,"Grains, Flours & Dals",Chana Flour 500 gms,4,70,65,5,1
10-01-2025,Snacks & Ready-to-Eat,MARMURA LADDU,14,80,60,20,1
10-01-2025,"Grains, Flours & Dals",Em Foxtail upma r 500 g,4,109,109,0,1
10-01-2025,"Grains, Flours & Dals",EM kodo upma R 500g,4,129,129,0,1
10-01-2025,"Grains, Flours & Dals",SH RED POHA 500GM,4,75,75,0,1
10-01-2025,"Grains, Flours & Dals",Em little upma R 500g,4,129,129,0,1
10-01-2025,Spices & Seasonings,SREE MARUTHI IDLY KARAM 200GM,15,60,60,0,1
10-01-2025,Snacks & Ready-to-Eat,GS WHEAT GRASS BISCUITS 250GM,14,130,130,0,1
10-01-2025,"Dry Fruits, Nuts & Seeds",SUNFLOWER SEEDS 250GRM,2,150,130,20,1
10-01-2025,"Grains, Flours & Dals",Em Multimillet upma 500g,4,129,129,0,1
10-01-2025,"Grains, Flours & Dals",Em Foxtail upma r 500 g,4,218,218,0,2
10-01-2025,"Grains, Flours & Dals",Em Multimillet idli r 500g,4,129,129,0,1
10-01-2025,"Grains, Flours & Dals",EM kodo upma R 500g,4,129,129,0,1
10-01-2025,"Grains, Flours & Dals",JOWAR UPMA RAVA,4,65,65,0,1
10-01-2025,"Grains, Flours & Dals",Em little upma R 500g,4,258,258,0,2
10-01-2025,"Grains, Flours & Dals",SH RED POHA 500GM,4,75,75,0,1
10-01-2025,"Grains, Flours & Dals",Em little upma R 500g,4,129,129,0,1
10-01-2025,"Grains, Flours & Dals",SH RED POHA 500GM,4,75,75,0,1
10-01-2025,"Grains, Flours & Dals",HS Jowar upma rava 500 gms,4,65,65,0,1
10-01-2025,"Grains, Flours & Dals",Em Multimillet upma 500g,4,129,129,0,1
10-01-2025,"Grains, Flours & Dals",EM kodo upma R 500g,4,129,129,0,1
10-01-2025,"Grains, Flours & Dals",Em Multimillet idli r 500g,4,129,129,0,1
10-01-2025,"Grains, Flours & Dals",Em Foxtail upma r 500 g,4,109,109,0,1
10-01-2025,Milk & Dairy,SANGAM TONED MILK 500ML,7,30,30,0,1
10-01-2025,"Grains, Flours & Dals",White jowar.F 1 kg,4,200,160,40,2
10-01-2025,"Grains, Flours & Dals",Bajra Flour 1 kg,4,140,120,20,2
10-01-2025,"Grains, Flours & Dals",RICE FLOUR 500 GM,4,35,28,7,1
10-01-2025,Milk & Dairy,SANGAM CURD 450GM,7,38,38,0,1
10-01-2025,"Grains, Flours & Dals",Wheat Flour 1 kg,4,140,120,20,2
10-01-2025,"Grains, Flours & Dals",RAGI FLOUR 500GRMS,4,40,35,5,1
10-01-2025,Household & Cleaning,SURFEXCEL BAR 80G,6,10,10,0,1
10-01-2025,"Grains, Flours & Dals",Chana Flour 500 gms,4,70,65,5,1
10-01-2025,Personal Care & Cosmetics,MYSORE SANDAL SOAP 75G,10,42,42,0,1
10-01-2025,Snacks & Ready-to-Eat,SUNNUNDALU,14,120,120,0,1
10-01-2025,Pickles & Cooking Pastes,SD MANGO PICKLE,11,110,110,0,1
10-01-2025,General Household & Kitchenware,RED LINE 20GM,3,75,75,0,1
10-01-2025,Household & Cleaning,VIM MAHA BAR,6,10,10,0,1
10-01-2025,Oils & Ghee,Groundnut oil 1 L,9,360,330,30,1
10-01-2025,Misc,NOVA,8,68,68,0,1
10-01-2025,Pooja & Spiritual Items,BHAVANI GP VATHULU,12,40,40,0,1
10-01-2025,"Grains, Flours & Dals",RAGI FLOUR 1KG,4,80,70,10,1
10-01-2025,"Grains, Flours & Dals",Wheat Flour 1 kg,4,70,60,10,1
10-01-2025,Snacks & Ready-to-Eat,VD MINAPA SUNNUNDALU 12P,14,180,180,0,1
10-01-2025,Snacks & Ready-to-Eat,SATHVI PALLI CHIKKI 200GM,14,100,80,20,1
10-01-2025,"Grains, Flours & Dals",Green gram 1 kg,4,150,130,20,1
10-01-2025,"Grains, Flours & Dals",JOWAR YELLOW 1 K,4,90,90,0,1
10-01-2025,Snacks & Ready-to-Eat,COPRA LADDU 200GM,14,100,80,20,1
10-01-2025,Oils & Ghee,Sesame oil 1 L,9,590,560,30,1
10-01-2025,Snacks & Ready-to-Eat,VD MURUKU 175GM,14,60,60,0,1
10-01-2025,Oils & Ghee,Castor oil 200 ml,9,100,80,20,1
10-01-2025,Personal Care & Cosmetics,REVLON,10,45,45,0,1
10-01-2025,Milk & Dairy,ID PANEER,7,135,135,0,1
10-01-2025,"Grains, Flours & Dals",SL Idly Rava 1KG,4,260,220,40,4
10-01-2025,Oils & Ghee,Groundnut oil 1 L,9,360,330,30,1
10-01-2025,"Grains, Flours & Dals",Wheat Flour 1 kg,4,140,120,20,2
10-01-2025,Oils & Ghee,Sesame oil 1 L,9,590,560,30,1
10-01-2025,Spices & Seasonings,NUVVULU 250GM,15,80,65,15,1
10-01-2025,"Dry Fruits, Nuts & Seeds",Groundnuts 500 gms,2,95,85,10,1
10-01-2025,"Dry Fruits, Nuts & Seeds",SD Mango cubes 100gm,2,45,45,0,1
10-01-2025,Oils & Ghee,Groundnut oil 1 L,9,720,660,60,2
10-01-2025,Oils & Ghee,DB CASTOR OIL 100ML,9,130,130,0,1
10-01-2025,Oils & Ghee,Groundnut oil 1 L,9,720,660,60,2
10-01-2025,"Dry Fruits, Nuts & Seeds",FLAX SEEDS 250GM,2,60,50,10,1
10-01-2025,Oils & Ghee,Groundnut oil 1 L,9,360,330,30,1
10-01-2025,Snacks & Ready-to-Eat,SD Sesame laddu with dates250gm,14,135,135,0,1
10-01-2025,Snacks & Ready-to-Eat,RINGS 200GM,14,30,30,0,1
10-01-2025,Snacks & Ready-to-Eat,KURNOOL MARMURA,14,70,55,15,1
10-01-2025,Oils & Ghee,Groundnut oil 1 L,9,360,330,30,1
10-01-2025,Snacks & Ready-to-Eat,VD RED CHILLI RICEPAPAD 150GM,14,50,50,0,1
10-01-2025,Snacks & Ready-to-Eat,SD Moringa with plam jaggery 250gm,14,135,135,0,1
10-01-2025,"Grains, Flours & Dals",Multigrain 1 kg,4,100,85,15,1
10-01-2025,"Grains, Flours & Dals",Wheat Flour 2 kgs,4,280,240,40,2
10-01-2025,Snacks & Ready-to-Eat,VD RICE MURUKU 150GM,14,50,50,0,1
10-01-2025,Milk & Dairy,BROWN EGGS 1P,7,140,120,20,10
10-01-2025,"Grains, Flours & Dals",RICE FLOUR 1KG,4,70,55,15,1
10-01-2025,"Grains, Flours & Dals",Bajra Flour 1 kg,4,70,60,10,1
10-01-2025,"Grains, Flours & Dals",split green gram 1 kg,4,150,140,10,1
10-01-2025,"Health, Wellness & Ayurvedic Products",MXP CHOCO CLASSIC BAR,5,70,70,0,1
10-01-2025,"Grains, Flours & Dals",Idly Rava L 1KG,4,60,50,10,1
10-01-2025,Snacks & Ready-to-Eat,KURNOOL MARMURA,14,70,55,15,1
10-01-2025,Sweeteners,SUGAR 1KG,16,120,100,20,2
10-01-2025,Snacks & Ready-to-Eat,VD MINAPA MIRCHI PAPAD 195GM,14,60,60,0,1
10-01-2025,"Grains, Flours & Dals",RAJMA 250GM,4,55,45,10,1
10-01-2025,"Grains, Flours & Dals",VYS.SP.RICE BAG 1,4,1800,"1,650.00",150,1
10-01-2025,"Grains, Flours & Dals",Wheat Flour 1 kg,4,140,120,20,2
10-01-2025,"Grains, Flours & Dals",Chana Flour 500 gms,4,70,65,5,1
10-01-2025,Spices & Seasonings,TATA SALT 1KG,15,30,30,0,1
10-01-2025,Oils & Ghee,Groundnut oil 1 L,9,360,330,30,1
10-01-2025,Oils & Ghee,Safflower oil 1 L,9,440,400,40,1
10-01-2025,"Grains, Flours & Dals",PESARA PAPPU 500GMS,4,85,75,10,1
10-01-2025,Pickles & Cooking Pastes,DB Three Mango 1KG,11,28,25,3,1
10-01-2025,Oils & Ghee,Sesame oil 1 L,9,590,560,30,1
10-01-2025,"Dry Fruits, Nuts & Seeds",Groundnuts 500 gms,2,95,85,10,1
10-01-2025,Sweeteners,MISHRI 250 GM,16,35,30,5,1
10-01-2025,Spices & Seasonings,ROYAL SAFFRON 400GRMS,15,130,130,0,2
10-01-2025,Beverages,MARWADI CHAI 100GM,1,75,75,0,1
10-01-2025,Oils & Ghee,Groundnut oil 5 L,9,1800,"1,600.00",200,1
10-01-2025,Snacks & Ready-to-Eat,SATHVI REGIVADA 200GM,14,80,60,20,1
10-01-2025,"Grains, Flours & Dals",FLOUR CHARGE,4,22,22,0,1
10-01-2025,"Grains, Flours & Dals",Multigrain 500 gms,4,50,43,7,1
10-01-2025,Snacks & Ready-to-Eat,BB VERMICELLI 250GM,14,30,30,0,1
10-01-2025,"Grains, Flours & Dals",Multigrain 1 kg,4,100,85,15,1
10-01-2025,"Grains, Flours & Dals",Multigrain 1 kg,4,100,85,15,1
10-01-2025,"Grains, Flours & Dals",White Chana 250 GM,4,60,50,10,1
10-01-2025,"Dry Fruits, Nuts & Seeds",Putnalu 250GM,2,45,38,7,1
10-01-2025,"Dry Fruits, Nuts & Seeds",GF KIMIA DATES 500GM,2,310,190,120,1
10-01-2025,"Grains, Flours & Dals",Wheat Flour 2 kgs,4,140,120,20,1
10-01-2025,Milk & Dairy,SANGAM TONED MILK 500ML,7,30,30,0,1
10-01-2025,"Grains, Flours & Dals",MELMEKER 250GMS,4,60,45,15,1
10-01-2025,Spices & Seasonings,Turmeric powder 250 gms,15,100,75,25,1
10-01-2025,"Dry Fruits, Nuts & Seeds",YELLOW KISHMISH 250GM,2,130,110,20,1
10-01-2025,Milk & Dairy,ID PANEER,7,135,135,0,1
10-01-2025,"Grains, Flours & Dals",Bombay Rava 500GM,4,35,30,5,1
10-01-2025,Spices & Seasonings,NUVVULU 500GM,15,200,170,30,1
10-01-2025,Milk & Dairy,SANGAM CURD 450GM,7,38,38,0,1
10-01-2025,"Grains, Flours & Dals",Wheat Rava M 500GM,4,33,30,3,1
10-01-2025,Spices & Seasonings,SATHVI BIRYANI LEAF 25GM,15,30,20,10,1
10-01-2025,Pooja & Spiritual Items,GD Aiswarya Deepam 700ML,12,195,195,0,1
10-01-2025,Oils & Ghee,Groundnut oil 1 L,9,360,330,30,1
10-01-2025,"Grains, Flours & Dals",RICE FLOUR 1KG,4,70,55,15,1
10-01-2025,Spices & Seasonings,NUVVULU 500GM,15,200,170,30,1
10-01-2025,Snacks & Ready-to-Eat,Corn Chips 250GM,14,80,70,10,2
10-01-2025,"Grains, Flours & Dals",BOMBAY RAVA,4,70,55,15,1
10-01-2025,"Grains, Flours & Dals",DH URAD GOTA 1KG,4,430,380,50,2
10-01-2025,Oils & Ghee,Sesame oil 1 L,9,590,560,30,1
10-01-2025,"Grains, Flours & Dals",Wheat Flour 1 kg,4,140,120,20,2
10-01-2025,"Grains, Flours & Dals",HS Jowar upma rava 500 gms,4,130,130,0,2
10-01-2025,Spices & Seasonings,AVALU 100GM,15,25,20,5,1
10-01-2025,"Grains, Flours & Dals",Idly Rava L 1KG,4,60,50,10,1
10-01-2025,"Grains, Flours & Dals",BAJRA 1 KG,4,60,50,10,1
10-01-2025,Sweeteners,MISHRI D,16,40,30,10,1
10-01-2025,Snacks & Ready-to-Eat,BATANA NGT 70GMS,14,20,20,0,1
10-01-2025,Spices & Seasonings,NUVVULU 250GM,15,80,65,15,1
10-01-2025,Snacks & Ready-to-Eat,SESAME LADDU 200GM,14,100,80,20,1
10-01-2025,"Grains, Flours & Dals",Arikadu ( kodo),4,140,130,10,1
10-01-2025,Snacks & Ready-to-Eat,VD PAPPU CHEGODI 200GM,14,60,60,0,1
10-01-2025,Snacks & Ready-to-Eat,PALLI LADDU 200GMS,14,90,70,20,1
10-01-2025,"Grains, Flours & Dals",KORRALU (FOXTAIL M) 1KG,4,150,110,40,1
10-01-2025,"Grains, Flours & Dals",SAMALU (Little millet) 1 kg,4,170,130,40,1
10-01-2025,Personal Care & Cosmetics,ORAL B KIDS,10,50,50,0,2
10-01-2025,"Grains, Flours & Dals",SH RED POHA 500GM,4,75,75,0,1
10-01-2025,Pooja & Spiritual Items,GD Aiswarya Deepam 700ML,12,390,390,0,2
10-01-2025,"Grains, Flours & Dals",HS BARLEY FLAKES 250GM 1+1,4,59,59,0,1
10-01-2025,"Grains, Flours & Dals",KORRALU (FOXTAIL M) 1KG,4,150,110,40,1
10-01-2025,Pooja & Spiritual Items,GD KUMKUM 50GM,12,30,30,0,1
10-01-2025,"Grains, Flours & Dals",BAJRA 1 KG,4,120,100,20,2
10-01-2025,Sweeteners,YB JAGGERY POWDER 1KG,16,140,140,0,1
10-01-2025,Snacks & Ready-to-Eat,VD Minapa papad 200gm,14,60,60,0,1
10-01-2025,"Grains, Flours & Dals",HS Ragi upma rava 500 gms,4,70,70,0,1
10-01-2025,Snacks & Ready-to-Eat,SD Moringa with plam jaggery 250gm,14,135,135,0,1
10-01-2025,Snacks & Ready-to-Eat,Corn Chips 250GM,14,40,35,5,1
10-01-2025,Snacks & Ready-to-Eat,PUMPKIN CHIKKI 200GM,14,140,120,20,1
10-01-2025,"Dry Fruits, Nuts & Seeds",SD Mango cubes 100gm,2,45,45,0,1
10-01-2025,"Grains, Flours & Dals",JOWAR WHITE 1 KG,4,160,140,20,2
10-01-2025,Snacks & Ready-to-Eat,MARMURA LADDU,14,80,60,20,1
10-01-2025,Snacks & Ready-to-Eat,RSC ORANGE 100GMS,14,40,40,0,2
10-01-2025,"Grains, Flours & Dals",Chana Flour 500 gms,4,70,65,5,1
10-01-2025,"Dry Fruits, Nuts & Seeds",FLAX SEEDS 250GM,2,60,50,10,1
10-01-2025,"Dry Fruits, Nuts & Seeds",PUMPKIN SEEDS 250GM,2,200,160,40,1
10-01-2025,Spices & Seasonings,NUVVULU 250GM,15,100,85,15,1
10-01-2025,"Grains, Flours & Dals",RICE FLOUR 1KG,4,70,55,15,1
10-01-2025,"Grains, Flours & Dals",Idly Rava L 1KG,4,120,100,20,2
10-01-2025,Snacks & Ready-to-Eat,GB SALT COOKIES,14,120,110,10,2
10-01-2025,"Grains, Flours & Dals",MELMEKER 250GMS,4,60,45,15,1
10-01-2025,Snacks & Ready-to-Eat,VD MINAPA MIRCHI PAPAD 195GM,14,60,60,0,1
10-01-2025,"Grains, Flours & Dals",SRILALITHA MAIDA FLOUR 500G,4,64,64,0,2
10-01-2025,Pooja & Spiritual Items,GD Dhoop Sticks 26GM,12,20,20,0,1
10-01-2025,Spices & Seasonings,EV Chicken Masala 50GM,15,48,48,0,1
10-01-2025,Snacks & Ready-to-Eat,GB SALT COOKIES,14,120,110,10,2
10-01-2025,"Grains, Flours & Dals",Chana Flour 1 kg,4,140,130,10,1
10-01-2025,"Grains, Flours & Dals",DOCTOR RICE DIABETIC SFR 1KG,4,120,120,0,1
10-01-2025,Pickles & Cooking Pastes,SD MANGO PICKLE,11,110,110,0,1
10-01-2025,"Grains, Flours & Dals",PRO SOYA CHUNKS 200G,4,79,79,0,1
10-01-2025,Spices & Seasonings,Dalchin Chekka 50GM,15,50,40,10,1
10-01-2025,"Grains, Flours & Dals",Red Bobarlu 500 gms,4,95,85,10,1
10-01-2025,Spices & Seasonings,Gasagasalu 50GM,15,130,110,20,1
10-01-2025,Spices & Seasonings,MM Mutton Masala 50GM,15,42,42,0,1
10-01-2025,Snacks & Ready-to-Eat,JUNNU POWDER 100GM,14,140,140,0,2
10-01-2025,Snacks & Ready-to-Eat,NGT CHATPATTA CHANA 90GM,14,50,50,0,2
10-01-2025,Snacks & Ready-to-Eat,GB SALT COOKIES,14,180,165,15,3
10-01-2025,Oils & Ghee,Groundnut oil 5 L,9,1800,"1,600.00",200,1
10-01-2025,General Household & Kitchenware,MATCH BOX,3,20,20,0,1
10-01-2025,Pooja & Spiritual Items,GD Aiswarya Deepam 700ML,12,195,195,0,1
10-01-2025,Household & Cleaning,TIDE DOUBLE POWER LEMON &amp;MINT,6,132,132,0,1
10-01-2025,Pooja & Spiritual Items,SWAATHI GATTI DEEPAM VATTULU,12,30,30,0,1
10-01-2025,Spices & Seasonings,NUVVULU 250GM,15,80,65,15,1
10-01-2025,"Grains, Flours & Dals",Red Bobarlu 500 gms,4,95,85,10,1
10-01-2025,Spices & Seasonings,Chilli powder 500 gms,15,290,210,80,1
10-01-2025,Personal Care & Cosmetics,MARGO,10,45,42,3,1
10-01-2025,Snacks & Ready-to-Eat,ANNAPURNA APPALAM,14,35,35,0,1
10-01-2025,"Dry Fruits, Nuts & Seeds",Groundnuts 500 gms,2,95,85,10,1
10-01-2025,"Health, Wellness & Ayurvedic Products",DWI MANDARA TAILAM 100ML,5,160,160,0,1
10-01-2025,Snacks & Ready-to-Eat,VD BOONDI 175GM,14,60,60,0,1
10-01-2025,Spices & Seasonings,NUVVULU 250GM,15,100,85,15,1
10-01-2025,Sweeteners,ACHU BELLAM 1KG,16,300,240,60,3
10-01-2025,Snacks & Ready-to-Eat,PEANUT CANDY,14,45,45,0,1
10-01-2025,Personal Care & Cosmetics,PARACHUTE 45ML,10,20,20,0,1
10-01-2025,Snacks & Ready-to-Eat,MARMURA LADDU,14,80,60,20,1
10-01-2025,Snacks & Ready-to-Eat,VD SANNAPUSA 175GM,14,60,60,0,1
10-01-2025,Oils & Ghee,Freedom Rice Bran Oil 1L,9,194,180,14,1
10-01-2025,Snacks & Ready-to-Eat,OK PENNE 400GM,14,120,120,0,1
10-01-2025,"Grains, Flours & Dals",FLOUR CHARGE,4,72,72,0,6
10-01-2025,Spices & Seasonings,SV Oregano 15GM,15,110,110,0,1
10-01-2025,Snacks & Ready-to-Eat,DISANO MACARONI 400GM,14,55,55,0,1
10-01-2025,Oils & Ghee,Sesame oil 500ml,9,295,280,15,1
10-01-2025,"Grains, Flours & Dals",SA Multi Grain Mix 500GM,4,318,318,0,2
10-01-2025,"Dry Fruits, Nuts & Seeds",SD Mango cubes 200gm,2,90,90,0,1
10-01-2025,Snacks & Ready-to-Eat,GB SALT COOKIES,14,60,55,5,1
10-01-2025,Snacks & Ready-to-Eat,MARMURA LADDU,14,80,60,20,1
10-01-2025,"Grains, Flours & Dals",Chana Flour 500 gms,4,70,65,5,1
10-01-2025,Snacks & Ready-to-Eat,Corn Chips 250GM,14,40,35,5,1
10-01-2025,"Grains, Flours & Dals",THICK POHA 500GM,4,40,35,5,1
10-01-2025,Snacks & Ready-to-Eat,Sprouted Ragi Biscuits 450GM,14,150,150,0,1
10-01-2025,"Grains, Flours & Dals",PESARA PAPPU 500GMS,4,85,75,10,1
10-01-2025,Snacks & Ready-to-Eat,NGT CHATPATTA CHANA 90GM,14,25,25,0,1
10-01-2025,Snacks & Ready-to-Eat,MARMURA LADDU,14,80,60,20,1
10-01-2025,"Grains, Flours & Dals",FLOUR CHARGE,4,72,72,0,6
10-01-2025,Spices & Seasonings,Dalchin Chekka 50GM,15,50,40,10,1
10-01-2025,Baking & Cooking Aids,Baking Soda 50GM,0,20,20,0,1
10-01-2025,Sweeteners,ACHU BELLAM 1KG,16,200,160,40,2
10-01-2025,"Grains, Flours & Dals",THICK POHA 500GM,4,40,35,5,1
10-01-2025,Spices & Seasonings,NUVVULU 250GM,15,80,65,15,1
10-01-2025,Snacks & Ready-to-Eat,VD PAPPU CHEGODI 200GM,14,60,60,0,1
10-01-2025,Oils & Ghee,Sesame oil 1 L,9,590,560,30,1
10-01-2025,Snacks & Ready-to-Eat,VD CORNFLAKES MIXTURE 175GM,14,60,60,0,1
10-01-2025,Spices & Seasonings,Vamu 100GM,15,60,50,10,1
10-01-2025,"Dry Fruits, Nuts & Seeds",ANJEER 250GM,2,400,360,40,1
10-01-2025,"Grains, Flours & Dals",SL Suji Rava 500GM,4,32,32,0,1
10-01-2025,Snacks & Ready-to-Eat,MARMURA LADDU,14,80,60,20,1
10-01-2025,"Dry Fruits, Nuts & Seeds",Groundnuts 500 gms,2,95,85,10,1
10-01-2025,"Dry Fruits, Nuts & Seeds",Groundnuts 1 kg,2,190,170,20,1
10-01-2025,Milk & Dairy,HERITAGE CURD,7,48,48,0,1
10-01-2025,"Grains, Flours & Dals",WHITE BATANI,4,40,30,10,1
10-01-2025,"Grains, Flours & Dals",DESI CHANA,4,25,25,0,1
10-01-2025,Snacks & Ready-to-Eat,BATANA NGT 70GMS,14,20,20,0,1
10-01-2025,"Grains, Flours & Dals",SL Idly Rava 1KG,4,130,110,20,2
10-01-2025,Snacks & Ready-to-Eat,SD KODO MILLET WITH PALM JAGGERY,14,135,135,0,1
10-01-2025,Snacks & Ready-to-Eat,SD Vamu with palm jaggery 250gm,14,135,135,0,1
10-01-2025,Oils & Ghee,Coconut oil 1 L,9,880,800,80,2
10-01-2025,Snacks & Ready-to-Eat,SD JOWAR WITH PALM JAGGERY 250GM,14,135,135,0,1
10-01-2025,Snacks & Ready-to-Eat,SD Bajra with palm Jaggery 250gm,14,135,135,0,1
10-01-2025,"Grains, Flours & Dals",Yellow jowar .F1 kg,4,330,300,30,3
10-01-2025,Spices & Seasonings,PRO ORG FENUGREEK 200GM,15,86,86,0,1
10-01-2025,Snacks & Ready-to-Eat,KURNOOL MARMURA,14,70,55,15,1
10-01-2025,Snacks & Ready-to-Eat,VD SAGOPAPAD 150GM,14,55,55,0,1
10-01-2025,Pooja & Spiritual Items,GD Ramayana Sandal 75GM,12,60,60,0,1
10-01-2025,"Grains, Flours & Dals",RICE FLOUR 500 GM,4,105,84,21,3
10-01-2025,Spices & Seasonings,ROYAL SAFFRON,15,125,125,0,1
10-01-2025,Sweeteners,ACHU BELLAM 1KG,16,100,80,20,1
10-01-2025,"Grains, Flours & Dals",THICK POHA 500GM,4,40,35,5,1
10-01-2025,"Grains, Flours & Dals",Wheat Flour 1 kg,4,210,180,30,3
10-01-2025,Snacks & Ready-to-Eat,VD RICE MURUKU 150GM,14,50,50,0,1
10-01-2025,Household & Cleaning,VIM 300GM,6,90,90,0,3
10-01-2025,"Grains, Flours & Dals",DH URAD GOTA 1KG,4,215,190,25,1
10-01-2025,"Grains, Flours & Dals",HS Jowar upma rava 500 gms,4,130,130,0,2
10-01-2025,Household & Cleaning,SRI OS BLEACHING POWDER100GM,6,65,65,0,1
10-01-2025,Snacks & Ready-to-Eat,SD Ginger Candy 100g,14,60,60,0,1
10-01-2025,"Grains, Flours & Dals",HS Multimillet idly R 500 gms,4,65,65,0,1
10-01-2025,Snacks & Ready-to-Eat,HS Ragi biscuits,14,50,50,0,1
10-01-2025,Oils & Ghee,Groundnut oil 1 L,9,360,330,30,1
10-01-2025,Snacks & Ready-to-Eat,BATANA NGT 70GMS,14,20,20,0,1
10-01-2025,Snacks & Ready-to-Eat,PALLI LADDU 200GMS,14,90,70,20,1
10-01-2025,Oils & Ghee,Safflower oil 1 L,9,440,400,40,1
10-01-2025,Oils & Ghee,Sesame oil 1 L,9,1180,"1,120.00",60,2
10-01-2025,Snacks & Ready-to-Eat,VD ATUKULU MIXTURE 175GM,14,60,60,0,1
10-01-2025,Oils & Ghee,Coconut oil 500 ml,9,220,200,20,1
10-01-2025,Oils & Ghee,Sesame oil 500ml,9,295,280,15,1
10-01-2025,Snacks & Ready-to-Eat,GS INSTANT KORRA DOSA MIX 400GM,14,120,120,0,1
10-01-2025,Snacks & Ready-to-Eat,VD Pappu Chekkalu 190gm,14,60,60,0,1
10-01-2025,Snacks & Ready-to-Eat,GS INSTANT RAGI DOSA MIX,14,99,99,0,1
10-01-2025,"Grains, Flours & Dals",BARLEY SEEDS 1KG,4,80,70,10,0.5
10-01-2025,Oils & Ghee,Groundnut oil 1 L,9,1080,990,90,3
10-01-2025,General Household & Kitchenware,RED LINE 20GM,3,75,75,0,1
10-01-2025,Snacks & Ready-to-Eat,MAAGAANI M JOWAR PASTA 200GM,14,199,199,0,1
10-01-2025,"Grains, Flours & Dals",Yellow jowar .F1 kg,4,110,100,10,1
10-01-2025,"Grains, Flours & Dals",Multigrain 1 kg,4,300,255,45,3
10-01-2025,Oils & Ghee,Coconut oil 1 L,9,880,800,80,2
10-01-2025,Snacks & Ready-to-Eat,SESAME LADDU 200GM,14,100,80,20,1
10-01-2025,Snacks & Ready-to-Eat,VD DRY FRUIT PUTHAREKULU,14,240,240,0,2
10-01-2025,Snacks & Ready-to-Eat,GB SALT COOKIES,14,60,55,5,1
10-01-2025,Snacks & Ready-to-Eat,SD Sesame laddu with dates250gm,14,270,270,0,2
10-01-2025,Snacks & Ready-to-Eat,GROUNDNUT LADDU WITH DATES,14,405,405,0,3
10-01-2025,Snacks & Ready-to-Eat,SD Flax seeds with dates 250gm,14,135,135,0,1
10-01-2025,Sweeteners,YB JAGGERY POWDER 500GMS,16,225,225,0,3
10-01-2025,"Grains, Flours & Dals",Wheat Flour 1 kg,4,70,60,10,1
10-01-2025,Pooja & Spiritual Items,GD SANDAL 150GM,12,110,110,0,1
10-01-2025,Spices & Seasonings,TATA SALT 1KG,15,60,60,0,2
10-01-2025,Personal Care & Cosmetics,MYSORE SANDAL,10,138,138,0,2
10-01-2025,"Grains, Flours & Dals",Wheat Flour 1 kg,4,70,60,10,1
10-01-2025,Personal Care & Cosmetics,COLGATE KIDS 2 PLUS,10,60,60,0,2
10-01-2025,Snacks & Ready-to-Eat,VD NUVULU CHEGODI 175GM,14,60,60,0,1
10-01-2025,Snacks & Ready-to-Eat,SATHVI MIXED CHIKKI 200GM,14,240,200,40,2
10-01-2025,"Health, Wellness & Ayurvedic Products",MH Millets Malt 500GM,5,200,190,10,1
10-01-2025,Snacks & Ready-to-Eat,VD GUMMADI VADIYAM,14,75,75,0,1
10-01-2025,Snacks & Ready-to-Eat,SD GINGER CANDY 200GM,14,120,120,0,1
10-01-2025,Pooja & Spiritual Items,SWASTIK CAMPHORE,12,90,90,0,1
10-01-2025,Oils & Ghee,Groundnut oil 1 L,9,360,330,30,1
10-01-2025,"Grains, Flours & Dals",Wheat Rava S 1KG,4,65,55,10,1
10-01-2025,"Grains, Flours & Dals",Sathya Javva Wheat Rava 500GM,4,190,190,0,2
10-01-2025,"Grains, Flours & Dals",THICK POHA 500GM,4,40,35,5,1
10-01-2025,"Grains, Flours & Dals",DH URAD GOTA 1KG,4,430,380,50,2
10-01-2025,Spices & Seasonings,Elaichi 25GM,15,145,120,25,1
10-01-2025,Spices & Seasonings,ROYAL SAFFRON,15,125,125,0,1
10-01-2025,Spices & Seasonings,NUVVULU 250GM,15,100,85,15,1
10-01-2025,Sweeteners,KAMAL JAGGERY 500GM,16,120,120,0,3
10-01-2025,Oils & Ghee,Freedom Rice Bran Oil 1L,9,582,540,42,3
10-01-2025,Personal Care & Cosmetics,COLGATE ACTIVE SALT,10,20,20,0,1
10-01-2025,Oils & Ghee,Groundnut oil 1 L,9,1800,"1,650.00",150,5
10-01-2025,Spices & Seasonings,YB PINK ROCK SALT 1KG,15,120,120,0,1
10-01-2025,Pooja & Spiritual Items,ZED BLACK PREMIUM STICKS 3 IN 1 100G,12,60,60,0,1
10-01-2025,Milk & Dairy,SANGAM FULL CREAM MILK 500ML,7,38,38,0,1
10-01-2025,Spices & Seasonings,Vamu 100GM,15,120,100,20,2
10-01-2025,Snacks & Ready-to-Eat,NGT CHATPATTA CHANA 90GM,14,25,25,0,1
10-01-2025,"Grains, Flours & Dals",Multigrain 1 kg,4,100,85,15,1
10-01-2025,"Grains, Flours & Dals",MAAGAANI LOW GI SP 1KG,4,525,525,0,5
10-01-2025,Snacks & Ready-to-Eat,SATHVI MIXED CHIKKI 200GM,14,120,100,20,1
10-01-2025,Milk & Dairy,SANGAM TONED MILK 500ML,7,30,30,0,1
10-01-2025,Snacks & Ready-to-Eat,SATHVI PALLI CHIKKI 200GM,14,100,80,20,1
10-01-2025,"Grains, Flours & Dals",DESI CHANA,4,50,50,0,2
10-01-2025,Spices & Seasonings,Tamarind 250GMS,15,160,130,30,2
10-01-2025,Spices & Seasonings,Masala Karam 500 gms,15,260,240,20,1
10-01-2025,Household & Cleaning,VIM TROPICAL LEMON FRESHNESS 250ML,6,55,55,0,1
10-01-2025,General Household & Kitchenware,NIPPO,3,18,18,0,1
10-01-2025,Household & Cleaning,VIM EXTRA 110GM,6,10,10,0,1
10-01-2025,Snacks & Ready-to-Eat,URBAN MARMURA 450GM,14,60,55,5,1
10-01-2025,"Grains, Flours & Dals",AISHWARYA SP 1KG,4,80,75,5,1
10-01-2025,Pickles & Cooking Pastes,CHICKEN PICKLE 200GM,11,300,280,20,1
10-01-2025,Pickles & Cooking Pastes,SD MANGO TOKKU,11,110,110,0,1
10-01-2025,Oils & Ghee,Groundnut oil 500ml,9,180,165,15,1
10-01-2025,Oils & Ghee,Castor oil 200 ml,9,100,80,20,1
10-01-2025,Snacks & Ready-to-Eat,MP CHOCO ALMOND COOKIE,14,60,60,0,1
10-01-2025,Personal Care & Cosmetics,ORGANIC SPONGE LOOFAH,10,70,70,0,1
10-01-2025,"Grains, Flours & Dals",FLOUR CHARGE,4,117.5,117.5,0,4.7
10-01-2025,"Grains, Flours & Dals",RICE FLOUR 500 GM,4,70,56,14,2
10-01-2025,Spices & Seasonings,NUVVULU 250GM,15,100,85,15,1
10-01-2025,"Grains, Flours & Dals",RICE FLOUR 1KG,4,70,55,15,1
10-01-2025,"Grains, Flours & Dals",Wheat Rava M 1KG,4,65,55,10,1
10-01-2025,"Grains, Flours & Dals",Wheat Rava M 500GM,4,33,30,3,1
10-01-2025,"Grains, Flours & Dals",split green gram 1 kg,4,300,280,20,2
10-01-2025,Household & Cleaning,ROOPERI PITAMBARI SILVER 50ML,6,110,110,0,1
10-01-2025,"Grains, Flours & Dals",turdal 1kg,4,220,195,25,1
10-01-2025,"Grains, Flours & Dals",SL Idly Rava 1KG,4,65,55,10,1
10-01-2025,Sweeteners,MADHUR SUGAR 1KG,16,195,165,30,3
10-01-2025,"Grains, Flours & Dals",CHANA DAL 500GM,4,70,60,10,1
10-01-2025,Spices & Seasonings,Black Till 250GM,15,90,75,15,1
10-01-2025,Beverages,BRU GREEN LABEL 1.2G,1,10,10,0,5
10-01-2025,Snacks & Ready-to-Eat,SH PUFFED RICE 500GM,14,112,112,0,1
10-01-2025,"Grains, Flours & Dals",PESARA PAPPU 500GMS,4,85,75,10,1
10-01-2025,"Dry Fruits, Nuts & Seeds",Putnalu 250GM,2,45,38,7,1
10-01-2025,Oils & Ghee,Sesame oil 1 L,9,590,560,30,1
10-01-2025,Snacks & Ready-to-Eat,SESAME LADDU 200GM,14,100,80,20,1
10-01-2025,Snacks & Ready-to-Eat,MAAGAANI JOWAR M COOKIES 120GM,14,149,149,0,1
10-01-2025,"Dry Fruits, Nuts & Seeds",SD Mango cubes 100gm,2,45,45,0,1
10-01-2025,Snacks & Ready-to-Eat,SF COOKIES CHOCO RAGI,14,99,99,0,1
10-01-2025,Snacks & Ready-to-Eat,SF MIGHTY PUFFS,14,25,25,0,1
10-01-2025,"Grains, Flours & Dals",Chana Flour 500 gms,4,140,130,10,2
10-01-2025,"Grains, Flours & Dals",Multigrain 1 kg,4,100,85,15,1
10-01-2025,Sweeteners,MADHUR SUGAR 1KG,16,65,55,10,1
10-01-2025,"Grains, Flours & Dals",RICE FLOUR 1KG,4,210,165,45,3
10-01-2025,Milk & Dairy,BROWN EGGS TRAY 30P,7,360,330,30,1
10-01-2025,Pooja & Spiritual Items,VRP APOORVA JAVADHU POW,12,35,35,0,1
10-01-2025,Oils & Ghee,Groundnut oil 5 L,9,1800,"1,600.00",200,1
10-01-2025,"Grains, Flours & Dals",Em Multimillet idli r 500g,4,129,129,0,1
10-01-2025,"Grains, Flours & Dals",Em Multimillet upma 500g,4,129,129,0,1
10-01-2025,"Grains, Flours & Dals",Wheat Flour 2 kgs,4,140,120,20,1
10-01-2025,"Grains, Flours & Dals",VYS.SP.RICE BAG 1,4,1800,"1,650.00",150,1
10-01-2025,Snacks & Ready-to-Eat,SATHVI REGIVADA 200GM,14,80,60,20,1
10-01-2025,Snacks & Ready-to-Eat,SESAME CHIKKI,14,240,200,40,2
10-01-2025,"Grains, Flours & Dals",RAGI FLOUR 500GRMS,4,40,35,5,1
10-01-2025,"Grains, Flours & Dals",Wheat Flour 2 kgs,4,140,120,20,1
10-01-2025,Milk & Dairy,TOTAL CURD 50GMS,7,20,20,0,2
10-01-2025,"Dry Fruits, Nuts & Seeds",Groundnuts 500 gms,2,95,85,10,1
10-01-2025,Snacks & Ready-to-Eat,VD MINAPA SUNNUNDALU 12P,14,180,180,0,1
10-01-2025,Snacks & Ready-to-Eat,TILLI CHIKKI,14,30,30,0,6
10-01-2025,Snacks & Ready-to-Eat,SATHVI PALLI CHIKKI 200GM,14,100,80,20,1
10-01-2025,"Dry Fruits, Nuts & Seeds",PUMPKIN SEEDS 250GM,2,200,160,40,1
10-01-2025,"Dry Fruits, Nuts & Seeds",WATERMELON SEEDS 250GRM,2,320,280,40,1
10-01-2025,"Dry Fruits, Nuts & Seeds",SUNFLOWER SEEDS 250GRM,2,150,130,20,1
10-01-2025,"Dry Fruits, Nuts & Seeds",PULMAKHANA 100 GM,2,180,170,10,1
10-01-2025,Snacks & Ready-to-Eat,VD ARISELU 5 PIC,14,100,100,0,1
10-01-2025,Snacks & Ready-to-Eat,TILLI CHIKKI,14,10,10,0,2
10-01-2025,Misc,NOVA,8,68,68,0,1
10-01-2025,General Household & Kitchenware,RED LINE 20GM,3,75,75,0,1
10-01-2025,Oils & Ghee,Freedom Rice Bran Oil 1L,9,388,360,28,2
10-01-2025,Misc,NOVA,8,68,68,0,1
10-01-2025,"Grains, Flours & Dals",FLOUR CHARGE,4,52.8,52.8,0,4.4
10-01-2025,Personal Care & Cosmetics,ORGANIC SPONGE LOOFAH,10,70,70,0,1
10-01-2025,"Grains, Flours & Dals",Chana Flour 500 gms,4,70,65,5,1
10-01-2025,"Grains, Flours & Dals",Wheat Flour 1 kg,4,35,30,5,0.5
10-01-2025,Snacks & Ready-to-Eat,SD Vamu with palm jaggery 250gm,14,135,135,0,1
10-01-2025,Spices & Seasonings,RED COPRA 250GMS,15,85,74,11,1
10-01-2025,Spices & Seasonings,RED COPRA 500GM,15,170,148,22,1
10-01-2025,Milk & Dairy,SANGAM FULL CREAM MILK 500ML,7,38,38,0,1
10-01-2025,Oils & Ghee,Sesame oil 1 L,9,590,560,30,1
10-01-2025,"Dry Fruits, Nuts & Seeds",Groundnuts 1 kg,2,190,170,20,1
10-01-2025,"Grains, Flours & Dals",split green gram 500 gms,4,75,70,5,1
10-01-2025,Oils & Ghee,Groundnut oil 1 L,9,720,660,60,2
10-01-2025,Snacks & Ready-to-Eat,PALLI LADDU 200GMS,14,90,70,20,1
10-01-2025,"Grains, Flours & Dals",Sathya Javva Wheat Rava 500GM,4,475,475,0,5
10-01-2025,Oils & Ghee,Groundnut oil 1 L,9,360,330,30,1
09-01-2025,Snacks & Ready-to-Eat,SD Atreyapuram DRY Fruit ghee,14,150,150,0,1
09-01-2025,Snacks & Ready-to-Eat,VD JAGGERY GHEE 12PIC,14,180,180,0,1
09-01-2025,"Dry Fruits, Nuts & Seeds",PLAIN PISTA 250GM,2,660,550,110,1
09-01-2025,Oils & Ghee,Coconut oil 500 ml,9,440,400,40,2
09-01-2025,"Grains, Flours & Dals",KORRALU (FOXTAIL M) 1KG,4,150,110,40,1
09-01-2025,Snacks & Ready-to-Eat,SATHVI MIXED CHIKKI 200GM,14,120,100,20,1
09-01-2025,Snacks & Ready-to-Eat,SATHVI PALLI CHIKKI 200GM,14,100,80,20,1
09-01-2025,Sweeteners,GS Palm Jaggery Powder 400GM,16,540,540,0,3
09-01-2025,Snacks & Ready-to-Eat,SESAME LADDU 200GM,14,100,80,20,1
09-01-2025,Oils & Ghee,Groundnut oil 1 L,9,360,330,30,1
09-01-2025,"Grains, Flours & Dals",RAGI FLOUR 1KG,4,80,70,10,1
09-01-2025,"Grains, Flours & Dals",VL Sabdana 500GM,4,77,77,0,1
09-01-2025,"Grains, Flours & Dals",Multigrain 1 kg,4,100,85,15,1
09-01-2025,"Grains, Flours & Dals",MAAGAANI LOW GI SP 1KG,4,525,525,0,5
09-01-2025,Personal Care & Cosmetics,COW DURBAR 7 HERBS SHAMPOO,10,125,125,0,1
09-01-2025,Oils & Ghee,Groundnut oil 500ml,9,180,165,15,1
09-01-2025,Snacks & Ready-to-Eat,AQUAGRANO DOSA BATTER,14,69,69,0,1
09-01-2025,Snacks & Ready-to-Eat,ELITE ELAICHI RUSK 200GM,14,35,35,0,1
09-01-2025,Milk & Dairy,BROWN EGGS 1P,7,140,120,20,10
09-01-2025,Snacks & Ready-to-Eat,FUN TIME CRUNCH,14,45,45,0,1
09-01-2025,Household & Cleaning,LIZOL CITRUS 625ML,6,149,149,0,1
09-01-2025,"Health, Wellness & Ayurvedic Products",MH Womens Malt 500GM,5,250,240,10,1
09-01-2025,Sweeteners,GS Organic Jaggery Powder 600GM,16,99,99,0,1
09-01-2025,"Grains, Flours & Dals",MAAGAANI LOW GI SP 1KG,4,149,115,34,1
09-01-2025,"Grains, Flours & Dals",SA YELLOW JOWAR RAVA 500GM,4,95,95,0,1
09-01-2025,"Dry Fruits, Nuts & Seeds",PULMAKHANA 100 GM,2,180,170,10,1
09-01-2025,"Dry Fruits, Nuts & Seeds",SD Mango cubes 100gm,2,45,45,0,1
09-01-2025,Spices & Seasonings,PRO HIMALAYAN PINK SALT 500GM,15,68,68,0,1
09-01-2025,"Dry Fruits, Nuts & Seeds",PN ORGANIC MAKHANA 50GM,2,125,125,0,1
09-01-2025,Oils & Ghee,Sesame oil 1 L,9,590,560,30,1
09-01-2025,Sweeteners,GS Palm Jaggery Powder 400GM,16,180,180,0,1
09-01-2025,Snacks & Ready-to-Eat,KHARJURAM DRY FRUIT LADDU,14,180,180,0,1
09-01-2025,"Grains, Flours & Dals",SA Multi Grain Mix 500GM,4,159,159,0,1
09-01-2025,Spices & Seasonings,Turmeric powder 250 gms,15,100,75,25,1
09-01-2025,Snacks & Ready-to-Eat,KHARJURAM DRY FRUIT LADDU,14,180,180,0,1
09-01-2025,Snacks & Ready-to-Eat,FUN TIME CRUNCH,14,45,45,0,1
09-01-2025,Snacks & Ready-to-Eat,GS SORGHUM SNACKS 150GM,14,60,60,0,1
09-01-2025,Snacks & Ready-to-Eat,VD Pappu Chekkalu 190gm,14,60,60,0,1
09-01-2025,Snacks & Ready-to-Eat,RAGI LADDU,14,120,120,0,1
09-01-2025,Snacks & Ready-to-Eat,BLACK SESAME CHIKKI,14,45,45,0,1
09-01-2025,Snacks & Ready-to-Eat,SESAME LADDU 200GM,14,100,80,20,1
09-01-2025,Snacks & Ready-to-Eat,PEANUT CANDY,14,45,45,0,1
09-01-2025,Snacks & Ready-to-Eat,VD NUVULU CHEGODI 175GM,14,60,60,0,1
09-01-2025,Snacks & Ready-to-Eat,ZEEDI,14,70,70,0,1
09-01-2025,"Grains, Flours & Dals",EM Ragi idli R 500G,4,300,300,0,4
09-01-2025,Snacks & Ready-to-Eat,VD PESARA PAPAD 195GM,14,70,70,0,1
09-01-2025,"Grains, Flours & Dals",FLOUR CHARGE,4,36,36,0,3
09-01-2025,"Grains, Flours & Dals",VGR rice 1 kg,4,70,65,5,1
09-01-2025,Oils & Ghee,Groundnut oil 1 L,9,360,330,30,1
09-01-2025,"Grains, Flours & Dals",AS Maize Rava 500GM,4,42,38,4,1
09-01-2025,Oils & Ghee,Groundnut oil 1 L,9,720,660,60,2
09-01-2025,Sweeteners,YB Brown Sugar 1KG,16,140,140,0,1
09-01-2025,"Health, Wellness & Ayurvedic Products",NEELI LEAF CHOORNAM,5,330,330,0,3
09-01-2025,Personal Care & Cosmetics,MULTANI MITTI CHOORNAM,10,40,40,0,1
09-01-2025,Snacks & Ready-to-Eat,SESAME LADDU 200GM,14,100,80,20,1
09-01-2025,Sweeteners,NATURAL HONEY 250GM,16,150,130,20,1
09-01-2025,Spices & Seasonings,Vamu 100GM,15,60,50,10,1
09-01-2025,"Grains, Flours & Dals",split green gram 1 kg,4,150,140,10,1
09-01-2025,"Grains, Flours & Dals",Chana Flour 1 kg,4,140,130,10,1
09-01-2025,Household & Cleaning,VIM MAHA BAR,6,30,30,0,3
09-01-2025,Pooja & Spiritual Items,BALAJI DESH MERE 220GM,12,150,150,0,1
09-01-2025,"Grains, Flours & Dals",Chana Flour 500 gms,4,140,130,10,2
09-01-2025,"Grains, Flours & Dals",FLOUR CHARGE,4,48,48,0,4
09-01-2025,"Grains, Flours & Dals",White jowar.F 1 kg,4,100,80,20,1
09-01-2025,"Dry Fruits, Nuts & Seeds",YELLOW KISHMISH 250GM,2,130,110,20,1
09-01-2025,Oils & Ghee,Groundnut oil 500ml,9,180,165,15,1
09-01-2025,"Grains, Flours & Dals",turdal 500 gms,4,110,100,10,1
09-01-2025,"Grains, Flours & Dals",RICE FLOUR 500 GM,4,35,28,7,1
09-01-2025,Spices & Seasonings,SONTI 50GM,15,30,20,10,1
09-01-2025,"Grains, Flours & Dals",Wheat Rava M 500GM,4,66,60,6,2
09-01-2025,"Grains, Flours & Dals",VGR RICE 5 KGS,4,350,325,25,1
09-01-2025,"Grains, Flours & Dals",Multigrain 1 kg,4,100,85,15,1
09-01-2025,"Grains, Flours & Dals",RAGI FLOUR 500GRMS,4,40,35,5,1
09-01-2025,"Grains, Flours & Dals",EM Ragi idli R 500G,4,75,75,0,1
09-01-2025,"Grains, Flours & Dals",RAGULU 1 KG,4,70,60,10,1
09-01-2025,"Grains, Flours & Dals",PESARA PAPPU 500GMS,4,85,75,10,1
09-01-2025,"Grains, Flours & Dals",Green gram 500 gms,4,75,70,5,1
09-01-2025,"Grains, Flours & Dals",Wheat Flour 1 kg,4,70,60,10,1
09-01-2025,Spices & Seasonings,NUVVULU 250GM,15,80,65,15,1
09-01-2025,"Grains, Flours & Dals",DH URAD GOTA 1KG,4,430,380,50,2
09-01-2025,Oils & Ghee,Sesame oil 1 L,9,590,560,30,1
09-01-2025,"Grains, Flours & Dals",Idly Rava L 1KG,4,60,50,10,1
09-01-2025,"Grains, Flours & Dals",Chittimuthaylu rice 1 kg,4,160,140,20,1
09-01-2025,Spices & Seasonings,JEERA 250 gms,15,125,105,20,1
09-01-2025,"Dry Fruits, Nuts & Seeds",Groundnuts 1 kg,2,190,170,20,1
09-01-2025,Oils & Ghee,Groundnut oil 1 L,9,360,330,30,1
09-01-2025,Snacks & Ready-to-Eat,COPRA LADDU 200GM,14,100,80,20,1
09-01-2025,Oils & Ghee,Groundnut oil 1 L,9,360,330,30,1
09-01-2025,Snacks & Ready-to-Eat,SD Sesame laddu with dates250gm,14,135,135,0,1
09-01-2025,"Grains, Flours & Dals",CHANA DAL 500GM,4,70,60,10,1
09-01-2025,Snacks & Ready-to-Eat,KURNOOL MARMURA,14,140,110,30,2
09-01-2025,"Dry Fruits, Nuts & Seeds",PULMAKHANA 100 GM,2,180,170,10,1
09-01-2025,Snacks & Ready-to-Eat,VD DAHI MIRCHI(SALTED) 100GM,14,45,45,0,1
09-01-2025,"Grains, Flours & Dals",WHITE BATANI,4,40,30,10,1
09-01-2025,Snacks & Ready-to-Eat,RINGS 200GM,14,30,30,0,1
09-01-2025,"Grains, Flours & Dals",RICE FLOUR 500 GM,4,35,28,7,1
09-01-2025,"Grains, Flours & Dals",Wheat Flour 1 kg,4,210,180,30,3
09-01-2025,"Dry Fruits, Nuts & Seeds",SATHVI CHIA SEEDS 100GM,2,200,160,40,2
09-01-2025,Spices & Seasonings,Tamarind 250GMS,15,80,65,15,1
09-01-2025,"Grains, Flours & Dals",HS jowar idly rava 500 gms,4,130,130,0,2
09-01-2025,Oils & Ghee,cow ghee 500 ml,9,430,390,40,1
09-01-2025,"Grains, Flours & Dals",DH URAD GOTA 1KG,4,215,190,25,1
09-01-2025,Snacks & Ready-to-Eat,SATHVI REGIVADA 200GM,14,80,60,20,1
09-01-2025,"Dry Fruits, Nuts & Seeds",Groundnuts 1 kg,2,190,170,20,1
09-01-2025,"Grains, Flours & Dals",Green gram 1 kg,4,150,130,20,1
09-01-2025,Sweeteners,SUGAR 1KG,16,60,50,10,1
09-01-2025,Spices & Seasonings,RED COPRA 250GMS,15,85,74,11,1
09-01-2025,"Grains, Flours & Dals",White jowar.F 1 kg,4,100,80,20,1
09-01-2025,Snacks & Ready-to-Eat,BD RED RICE NOODLES 200G,14,70,70,0,1
09-01-2025,"Grains, Flours & Dals",Red Wheat Flour 1 kg,4,140,130,10,1
09-01-2025,Snacks & Ready-to-Eat,BD KODO MILLET NOODLES 200GM,14,150,150,0,2
09-01-2025,Snacks & Ready-to-Eat,BD BARELY NOODLES 200G,14,70,70,0,1
09-01-2025,"Grains, Flours & Dals",Wheat Flour 1 kg,4,70,60,10,1
09-01-2025,"Grains, Flours & Dals",White Chana 500GM,4,120,100,20,1
09-01-2025,Personal Care & Cosmetics,COLGATE ACTIVE SALT,10,20,20,0,1
09-01-2025,"Grains, Flours & Dals",RICE FLOUR 1KG,4,70,55,15,1
09-01-2025,"Grains, Flours & Dals",SL Suji Rava 500GM,4,32,32,0,1
09-01-2025,"Grains, Flours & Dals",SRILATHA RICE RAVVA 500GM,4,35,35,0,1
09-01-2025,"Grains, Flours & Dals",Multigrain 1 kg,4,200,170,30,2
09-01-2025,"Dry Fruits, Nuts & Seeds",SD Mango cubes 100gm,2,45,45,0,1
09-01-2025,Snacks & Ready-to-Eat,BLACK SESAME CHIKKI,14,20,20,0,4
09-01-2025,"Grains, Flours & Dals",JOWAR YELLOW 1 K,4,90,90,0,1
09-01-2025,"Grains, Flours & Dals",JOWAR WHITE 1 KG,4,80,70,10,1
09-01-2025,Spices & Seasonings,Turmeric powder 250 gms,15,100,75,25,1
09-01-2025,"Grains, Flours & Dals",FLOUR CHARGE,4,15,15,0,1.25
09-01-2025,"Grains, Flours & Dals",turdal 500 gms,4,110,100,10,1
09-01-2025,Spices & Seasonings,NUVVULU 500GM,15,160,130,30,1
09-01-2025,"Grains, Flours & Dals",Wheat Flour 1 kg,4,70,60,10,1
09-01-2025,"Grains, Flours & Dals",Multigrain 1 kg,4,100,85,15,1
09-01-2025,"Grains, Flours & Dals",Wheat Flour 1 kg,4,140,120,20,2
09-01-2025,"Grains, Flours & Dals",JOWAR WHITE 1 KG,4,80,70,10,1
09-01-2025,Pooja & Spiritual Items,SWASTIK CAMPHORE,12,90,90,0,1
09-01-2025,Snacks & Ready-to-Eat,VD DAHI MIRCHI(SALTED) 100GM,14,45,45,0,1
09-01-2025,"Grains, Flours & Dals",SRILALITHA MAIDA FLOUR 500G,4,32,32,0,1
09-01-2025,"Grains, Flours & Dals",KORRALU (FOXTAIL M) 1KG,4,300,220,80,2
09-01-2025,"Grains, Flours & Dals",Red Wheat Flour 1 kg,4,140,130,10,1
09-01-2025,Milk & Dairy,TOTAL CURD 50GMS,7,10,10,0,1
09-01-2025,Sweeteners,YB JAGGERY POWDER 500GMS,16,75,75,0,1
09-01-2025,Snacks & Ready-to-Eat,NGT CHATPATTA CHANA 90GM,14,25,25,0,1
09-01-2025,"Dry Fruits, Nuts & Seeds",SALTED PISTA 250GM,2,400,350,50,1
09-01-2025,Spices & Seasonings,SREE MARUTHI IDLY KARAM 200GM,15,60,60,0,1
09-01-2025,Personal Care & Cosmetics,MD Bath Powder 100GM,10,40,40,0,1
09-01-2025,"Grains, Flours & Dals",Wheat Flour 1 kg,4,140,120,20,2
09-01-2025,"Dry Fruits, Nuts & Seeds",SD Mango cubes 100gm,2,45,45,0,1
09-01-2025,Snacks & Ready-to-Eat,VD SAGOPAPAD 150GM,14,55,55,0,1
09-01-2025,Snacks & Ready-to-Eat,RINGS 200GM,14,30,30,0,1
09-01-2025,"Dry Fruits, Nuts & Seeds",BLACK KISMIS 250GM,2,175,140,35,1
09-01-2025,Sweeteners,SUGAR 500 GM,16,30,25,5,1
09-01-2025,"Grains, Flours & Dals",SPLIT BLACK GRAM 500 GM,4,90,85,5,1
09-01-2025,Snacks & Ready-to-Eat,SD RAGI GAVVALU,14,95,95,0,1
09-01-2025,Beverages,BRU GREEN LABEL 1.2G,1,48,48,0,24
09-01-2025,"Grains, Flours & Dals",SABDANA,4,40,35,5,1
09-01-2025,Sweeteners,YB JAGGERY POWDER 500GMS,16,75,75,0,1
09-01-2025,"Grains, Flours & Dals",URAD DALL,4,95,85,10,1
09-01-2025,Personal Care & Cosmetics,HERBAL BATH POWDER 200GM,10,80,80,0,1
09-01-2025,"Grains, Flours & Dals",RICE FLOUR 1KG,4,70,55,15,1
09-01-2025,Snacks & Ready-to-Eat,VD NUVULU CHEGODI 175GM,14,60,60,0,1
09-01-2025,"Grains, Flours & Dals",VYS.SP RICE 1 KG,4,420,390,30,6
09-01-2025,"Grains, Flours & Dals",Wheat Flour 1 kg,4,70,60,10,1
09-01-2025,Snacks & Ready-to-Eat,SATHVI REGIVADA 200GM,14,80,60,20,1
09-01-2025,"Grains, Flours & Dals",FLOUR CHARGE,4,48,48,0,4
09-01-2025,Oils & Ghee,Groundnut oil 1 L,9,360,330,30,1
09-01-2025,"Grains, Flours & Dals",Wheat Rava M 500GM,4,33,30,3,1
09-01-2025,"Dry Fruits, Nuts & Seeds",SATHVI CHIA SEEDS 100GM,2,200,160,40,2
09-01-2025,Sweeteners,Mishri 500GM,16,70,60,10,1
09-01-2025,"Dry Fruits, Nuts & Seeds",Groundnuts 500 gms,2,95,85,10,1
09-01-2025,Spices & Seasonings,DB CRYSTAL SALT 1KG,15,25,25,0,1
09-01-2025,Spices & Seasonings,DB CRYSTAL SALT 1KG,15,25,25,0,1
09-01-2025,"Grains, Flours & Dals",turdal 500 gms,4,110,100,10,1
09-01-2025,Pickles & Cooking Pastes,DB Three Mango 1KG,11,28,25,3,1
09-01-2025,"Grains, Flours & Dals",URAD DALL,4,95,85,10,1
09-01-2025,Snacks & Ready-to-Eat,NGT CHATPATTA CHANA 90GM,14,25,25,0,1
09-01-2025,Snacks & Ready-to-Eat,PALLI LADDU 200GMS,14,90,70,20,1
09-01-2025,Snacks & Ready-to-Eat,RSC ORANGE 100GMS,14,20,20,0,1
09-01-2025,"Dry Fruits, Nuts & Seeds",KAJU HALF 250GM,2,310,290,20,1
09-01-2025,"Dry Fruits, Nuts & Seeds",ALMONDS 250GM,2,280,260,20,1
09-01-2025,"Grains, Flours & Dals",RAGI FLOUR 1KG,4,80,70,10,1
09-01-2025,"Grains, Flours & Dals",split green gram 1 kg,4,150,140,10,1
09-01-2025,Oils & Ghee,Groundnut oil 5 L,9,1800,"1,600.00",200,1
09-01-2025,"Grains, Flours & Dals",RICE FLOUR 1KG,4,140,110,30,2
09-01-2025,Sweeteners,YB Brown Sugar 1KG,16,140,140,0,1
09-01-2025,Snacks & Ready-to-Eat,VD RED CHILLI RICEPAPAD 150GM,14,50,50,0,1
09-01-2025,"Grains, Flours & Dals",Wheat Rava M 500GM,4,66,60,6,2
09-01-2025,Spices & Seasonings,NUVVULU 500GM,15,160,130,30,1
09-01-2025,Spices & Seasonings,YB PINK ROCK SALT 1KG,15,240,240,0,2
09-01-2025,Snacks & Ready-to-Eat,VD RICE MURUKU 150GM,14,50,50,0,1
09-01-2025,"Grains, Flours & Dals",Wheat Flour 1 kg,4,140,120,20,2
09-01-2025,"Grains, Flours & Dals",RAGI FLOUR 500GRMS,4,80,70,10,2
09-01-2025,"Grains, Flours & Dals",SRILATHA RICE RAVVA 500GM,4,35,35,0,1
09-01-2025,"Grains, Flours & Dals",HS Jowar upma rava 500 gms,4,65,65,0,1
09-01-2025,Pickles & Cooking Pastes,DB Three Mango 1KG,11,28,25,3,1
09-01-2025,"Grains, Flours & Dals",SL Suji Rava 500GM,4,64,64,0,2
09-01-2025,"Grains, Flours & Dals",Yellow jowar .F1 kg,4,110,100,10,1
09-01-2025,Snacks & Ready-to-Eat,RINGS 200GM,14,60,60,0,2
09-01-2025,"Grains, Flours & Dals",VYS.SP.RICE 10 KGS,4,700,650,50,1
09-01-2025,Milk & Dairy,HRITAGE TONED MILK 500ML,7,30,30,0,1
09-01-2025,"Grains, Flours & Dals",SRILATHA RICE RAVVA 500GM,4,70,70,0,2
09-01-2025,"Grains, Flours & Dals",AISHWARYA SP 1KG,4,400,375,25,5
09-01-2025,"Grains, Flours & Dals",Chana Flour 500 gms,4,70,65,5,1
09-01-2025,Snacks & Ready-to-Eat,VD MINAPA VADIYAM,14,65,65,0,1
09-01-2025,Snacks & Ready-to-Eat,VD PESARA PAPAD 195GM,14,70,70,0,1
09-01-2025,"Grains, Flours & Dals",Chana Flour 500 gms,4,70,65,5,1
09-01-2025,Snacks & Ready-to-Eat,VD MINAPA VADIYAM,14,130,130,0,2
09-01-2025,Snacks & Ready-to-Eat,SD SESAME PAPAD,14,80,80,0,1
09-01-2025,"Grains, Flours & Dals",RICE FLOUR 500 GM,4,35,28,7,1
09-01-2025,"Grains, Flours & Dals",Bajra Flour 1 kg,4,70,60,10,1
09-01-2025,"Grains, Flours & Dals",Em Multimillet upma 500g,4,129,129,0,1
09-01-2025,"Grains, Flours & Dals",EM jowar upma R 500G,4,150,150,0,2
09-01-2025,Oils & Ghee,Coconut oil 1 L,9,880,800,80,2
09-01-2025,Sweeteners,MADHUR SUGAR 1KG,16,65,55,10,1
09-01-2025,Spices & Seasonings,Telaga Pindi 500GM,15,320,280,40,4
09-01-2025,Snacks & Ready-to-Eat,VD DRY FRUIT PUTHAREKULU,14,120,120,0,1
09-01-2025,"Grains, Flours & Dals",RAGI FLOUR 1KG,4,80,70,10,1
09-01-2025,Snacks & Ready-to-Eat,MARMURA LADDU,14,80,60,20,1
09-01-2025,"Grains, Flours & Dals",Wheat Flour 1 kg,4,210,180,30,3
09-01-2025,"Grains, Flours & Dals",Wheat Flour 1 kg,4,70,60,10,1
09-01-2025,"Grains, Flours & Dals",split green gram 500 gms,4,75,70,5,1
09-01-2025,Snacks & Ready-to-Eat,TILLI CHIKKI,14,5,5,0,1
09-01-2025,"Grains, Flours & Dals",Chana Flour 500 gms,4,70,65,5,1
09-01-2025,Milk & Dairy,SANGAM TONED MILK 500ML,7,60,60,0,2
09-01-2025,Beverages,BISLERI 100ml,1,10,10,0,1
09-01-2025,Milk & Dairy,HRITAGE TONED MILK 500ML,7,30,30,0,1
09-01-2025,"Dry Fruits, Nuts & Seeds",MAHA BEERA SEEDS 100GM,2,60,60,0,1
09-01-2025,Snacks & Ready-to-Eat,MIGHTY PUFFS CHEDDAR CHEESE,14,25,25,0,1
09-01-2025,"Grains, Flours & Dals",RAGI FLOUR 1KG,4,80,70,10,1
09-01-2025,Oils & Ghee,Sesame oil 1 L,9,590,560,30,1
09-01-2025,"Grains, Flours & Dals",Wheat Flour 1 kg,4,140,120,20,2
09-01-2025,Oils & Ghee,Safflower oil 1 L,9,440,400,40,1
09-01-2025,Snacks & Ready-to-Eat,GANTASALA GINGER CANDY 200GM,14,105,105,0,1
09-01-2025,Snacks & Ready-to-Eat,VD JAGGERY GHEE 250GM,14,180,180,0,1
09-01-2025,Oils & Ghee,BUFFALLO GHEE 500ML,9,410,370,40,1
09-01-2025,Spices & Seasonings,SD Redgram Karam Powder 100GM,15,65,65,0,1
09-01-2025,Oils & Ghee,Sesame oil 1 L,9,590,560,30,1
09-01-2025,"Grains, Flours & Dals",Sathya Javva Wheat Rava 500GM,4,95,95,0,1
09-01-2025,Oils & Ghee,Groundnut oil 1 L,9,720,660,60,2
09-01-2025,"Grains, Flours & Dals",Chittimuthaylu rice 1 kg,4,160,140,20,1
09-01-2025,Milk & Dairy,BROWN EGGS TRAY 30P,7,360,330,30,1
09-01-2025,"Grains, Flours & Dals",CHANA DAL 500GM,4,280,240,40,4
09-01-2025,"Grains, Flours & Dals",FLOUR CHARGE,4,48,48,0,4
09-01-2025,"Dry Fruits, Nuts & Seeds",Groundnuts 1 kg,2,190,170,20,1
09-01-2025,Beverages,GANTASALA GREEN TEA 100GM,1,149,149,0,1
09-01-2025,Oils & Ghee,Groundnut oil 1 L,9,720,660,60,2
09-01-2025,"Grains, Flours & Dals",turdal 1kg,4,220,195,25,1
09-01-2025,"Grains, Flours & Dals",Urad dall 1 Kg,4,185,170,15,1
09-01-2025,"Health, Wellness & Ayurvedic Products",MD Hibiscus Flower Choornam 30GM,5,100,100,0,1
09-01-2025,Oils & Ghee,Coconut oil 1 L,9,880,800,80,2
09-01-2025,Oils & Ghee,Castor oil 500 ml,9,250,200,50,1
09-01-2025,"Grains, Flours & Dals",MAAGAANI SP RICE 20 KGS,4,2300,"1,960.00",340,1
09-01-2025,Spices & Seasonings,Masala Karam 500 gms,15,260,240,20,1
09-01-2025,Oils & Ghee,Coconut oil 500 ml,9,220,200,20,1
09-01-2025,Oils & Ghee,Sesame oil 500ml,9,295,280,15,1
09-01-2025,"Health, Wellness & Ayurvedic Products",AMLA PACHAK,5,100,100,0,1
09-01-2025,"Grains, Flours & Dals",White jowar.F 1 kg,4,100,80,20,1
09-01-2025,Pickles & Cooking Pastes,SD TOMATO PICKLE,11,110,110,0,1
09-01-2025,"Grains, Flours & Dals",BARLEY SEEDS 250GMS,4,40,35,5,1
09-01-2025,Milk & Dairy,HERITAGE CURD,7,48,48,0,1
09-01-2025,"Grains, Flours & Dals",SABDANA,4,40,35,5,1
09-01-2025,"Grains, Flours & Dals",RAGI FLOUR 500GRMS,4,40,35,5,1
09-01-2025,Snacks & Ready-to-Eat,SD FINGER Millet with palm Jaggery 250gm,14,135,135,0,1
09-01-2025,"Dry Fruits, Nuts & Seeds",BLACK KISMIS 250GM,2,175,140,35,1
09-01-2025,Oils & Ghee,Safflower oil 1 L,9,440,400,40,1
09-01-2025,"Dry Fruits, Nuts & Seeds",GF DATES 500GM,2,156,156,0,1
09-01-2025,Snacks & Ready-to-Eat,NGT CHATPATTA CHANA 90GM,14,50,50,0,2
09-01-2025,"Grains, Flours & Dals",VYS.SP.RICE 5 KGS,4,350,325,25,1
09-01-2025,Snacks & Ready-to-Eat,SD Moringa with plam jaggery 250gm,14,135,135,0,1
09-01-2025,Pooja & Spiritual Items,SS DASANGAM CONE 20PICS,12,45,45,0,1
09-01-2025,"Health, Wellness & Ayurvedic Products",DWI EUCALYPTUS 8ML,5,80,80,0,1
09-01-2025,"Grains, Flours & Dals",PESARA PAPPU 500GMS,4,85,75,10,1
09-01-2025,Snacks & Ready-to-Eat,SATHVI REGIVADA 200GM,14,80,60,20,1
09-01-2025,Pooja & Spiritual Items,PACHI KARPURAM 25GM,12,90,90,0,1
09-01-2025,"Grains, Flours & Dals",YB BLACK RICE 500GM,4,150,150,0,1
09-01-2025,Pooja & Spiritual Items,VRP APOORVA JAVADHU POW,12,35,35,0,1
09-01-2025,Spices & Seasonings,TM MIRCH POWDER 200GM,15,163,163,0,1
09-01-2025,Snacks & Ready-to-Eat,SD JOWAR WITH PALM JAGGERY 250GM,14,135,135,0,1
09-01-2025,Snacks & Ready-to-Eat,VD RICE PAPAD 150GM,14,50,50,0,1
09-01-2025,Pooja & Spiritual Items,SWASTIK CAMPHORE,12,90,90,0,1
09-01-2025,"Grains, Flours & Dals",Wheat Flour 1 kg,4,70,60,10,1
09-01-2025,Sweeteners,YB Brown Sugar 1KG,16,140,140,0,1
09-01-2025,Oils & Ghee,Groundnut oil 1 L,9,360,330,30,1
09-01-2025,Spices & Seasonings,ROYAL SAFFRON,15,1250,"1,250.00",0,10
09-01-2025,Snacks & Ready-to-Eat,BB ROASTED VERMICELLY 500GM,14,70,70,0,1
09-01-2025,"Grains, Flours & Dals",White jowar.F 1 kg,4,100,80,20,1
09-01-2025,Personal Care & Cosmetics,SANTOOR,10,30,30,0,1
09-01-2025,Household & Cleaning,SURF EXCEL 150GM,6,20,20,0,1
09-01-2025,Household & Cleaning,SRFR EXCEL,6,20,20,0,2
09-01-2025,"Grains, Flours & Dals",DH URAD GOTA 1KG,4,430,380,50,2
09-01-2025,"Grains, Flours & Dals",Green gram 500 gms,4,75,70,5,1
09-01-2025,Spices & Seasonings,Telaga Pindi 250 GM,15,40,35,5,1
09-01-2025,Spices & Seasonings,Turmeric powder 250 gms,15,100,75,25,1
09-01-2025,"Grains, Flours & Dals",split green gram 500 gms,4,75,70,5,1
09-01-2025,"Dry Fruits, Nuts & Seeds",Groundnuts 1 kg,2,190,170,20,1
09-01-2025,"Dry Fruits, Nuts & Seeds",PUTNALU 500GMS,2,180,152,28,2
09-01-2025,Sweeteners,YB Brown Sugar 500GM,16,75,75,0,1
09-01-2025,Oils & Ghee,Groundnut oil 1 L,9,360,330,30,1
09-01-2025,"Grains, Flours & Dals",turdal 1kg,4,220,195,25,1
09-01-2025,"Grains, Flours & Dals",SL Idly Rava 1KG,4,65,55,10,1
09-01-2025,Oils & Ghee,Groundnut oil 1 L,9,360,330,30,1
09-01-2025,Spices & Seasonings,Dalchin Chekka 50GM,15,50,40,10,1
09-01-2025,"Grains, Flours & Dals",split green gram 1 kg,4,150,140,10,1
09-01-2025,Snacks & Ready-to-Eat,BATANA NGT 70GMS,14,20,20,0,1
09-01-2025,Snacks & Ready-to-Eat,VD RICE SAGO PAPAD 150GM,14,55,55,0,1
09-01-2025,"Grains, Flours & Dals",HS Multimillet idly R 500 gms,4,65,65,0,1
09-01-2025,"Grains, Flours & Dals",SH RED POHA 500GM,4,75,75,0,1
09-01-2025,Oils & Ghee,Sesame oil 1 L,9,590,560,30,1
09-01-2025,Snacks & Ready-to-Eat,RINGS 200GM,14,60,60,0,2
09-01-2025,Snacks & Ready-to-Eat,SH PUFFED RICE 500GM,14,112,112,0,1
09-01-2025,"Grains, Flours & Dals",DESI CHANA,4,50,50,0,2
09-01-2025,Snacks & Ready-to-Eat,3D PAPAD,14,80,80,0,2
09-01-2025,Snacks & Ready-to-Eat,MIX MILLET NOODLES,14,75,75,0,1
09-01-2025,"Dry Fruits, Nuts & Seeds",Groundnuts 500 gms,2,95,85,10,1
09-01-2025,"Grains, Flours & Dals",turdal 1kg,4,220,195,25,1
09-01-2025,Snacks & Ready-to-Eat,VD RED CHILLI RICEPAPAD 150GM,14,50,50,0,1
09-01-2025,Snacks & Ready-to-Eat,VD MINAPA VADIYAM,14,65,65,0,1
09-01-2025,Snacks & Ready-to-Eat,VD Pappu Chekkalu 190gm,14,60,60,0,1
09-01-2025,Oils & Ghee,BUFFALLO GHEE 500ML,9,410,370,40,1
09-01-2025,Oils & Ghee,GRB GHEE 100ML,9,103,103,0,1
09-01-2025,"Dry Fruits, Nuts & Seeds",PUTNALU 500GMS,2,90,76,14,1
09-01-2025,"Dry Fruits, Nuts & Seeds",Groundnuts 1 kg,2,190,170,20,1
09-01-2025,Sweeteners,SUGAR 1KG,16,120,100,20,2
09-01-2025,"Grains, Flours & Dals",Idly Rava L 1KG,4,60,50,10,1
09-01-2025,"Grains, Flours & Dals",Urad dall 1 Kg,4,370,340,30,2
09-01-2025,"Grains, Flours & Dals",turdal 1kg,4,440,390,50,2
09-01-2025,"Grains, Flours & Dals",CHANA DAL 1KG,4,140,120,20,1
09-01-2025,"Dry Fruits, Nuts & Seeds",PUMPKIN SEEDS 250GM,2,200,160,40,1
09-01-2025,"Dry Fruits, Nuts & Seeds",ALMONDS 250GM,2,280,260,20,1
09-01-2025,"Grains, Flours & Dals",Multigrain 1 kg,4,100,85,15,1
09-01-2025,"Dry Fruits, Nuts & Seeds",SUNFLOWER SEEDS 250GRM,2,150,130,20,1
09-01-2025,"Grains, Flours & Dals",THICK POHA 500GM,4,40,35,5,1
09-01-2025,Personal Care & Cosmetics,GAYATHRI KUMKUDUKAYA,10,150,150,0,1
09-01-2025,Oils & Ghee,Coconut oil 500 ml,9,220,200,20,1
09-01-2025,Snacks & Ready-to-Eat,SESAME LADDU 200GM,14,100,80,20,1
09-01-2025,Snacks & Ready-to-Eat,GB SALT COOKIES,14,60,55,5,1
09-01-2025,Spices & Seasonings,SWEET SOUNF,15,20,20,0,1
09-01-2025,Spices & Seasonings,SD IDLY KARAM,15,130,130,0,2
09-01-2025,Snacks & Ready-to-Eat,BATANA NGT 70GMS,14,20,20,0,1
09-01-2025,Pooja & Spiritual Items,SREE REAL KASTURI STICKS 90GM,12,72,72,0,1
09-01-2025,Oils & Ghee,Coconut oil 500 ml,9,220,200,20,1
09-01-2025,"Grains, Flours & Dals",VYS.SP.RICE 5 KGS,4,350,325,25,1
09-01-2025,Household & Cleaning,COCKROACH AND ANT KILLER,6,50,50,0,2
09-01-2025,Spices & Seasonings,Vamu 100GM,15,60,50,10,1
09-01-2025,"Grains, Flours & Dals",FLOUR CHARGE,4,36,36,0,3
09-01-2025,Beverages,BRU GREEN LABEL 1.2G,1,10,10,0,5
09-01-2025,Snacks & Ready-to-Eat,MIGHTY PUFFS CHEDDAR CHEESE,14,50,50,0,2
09-01-2025,"Dry Fruits, Nuts & Seeds",YELLOW KISHMISH 250GM,2,130,110,20,1
09-01-2025,Snacks & Ready-to-Eat,SD Aswagandha with palm Jaggery250Gm,14,135,135,0,1
09-01-2025,Snacks & Ready-to-Eat,KHARJURAM DRY FRUIT LADDU,14,180,180,0,1
09-01-2025,Oils & Ghee,Groundnut oil 1 L,9,360,330,30,1
09-01-2025,Spices & Seasonings,sf red chilli,15,85,85,0,1
09-01-2025,"Grains, Flours & Dals",MAAGAANI LOW GI SP 1KG,4,210,210,0,2
09-01-2025,Oils & Ghee,Sesame oil 1 L,9,590,560,30,1
09-01-2025,Sweeteners,YB JAGGERY POWDER 500GMS,16,75,75,0,1
09-01-2025,"Grains, Flours & Dals",MAAGAANI SP RICE 5KGS,4,649,560,89,1
09-01-2025,Sweeteners,Mishri 500GM,16,70,60,10,1
09-01-2025,Spices & Seasonings,Elaichi 25GM,15,145,120,25,1
09-01-2025,Sweeteners,MISHRI D,16,40,30,10,1
09-01-2025,"Grains, Flours & Dals",White jowar.F 1 kg,4,100,80,20,1
09-01-2025,"Grains, Flours & Dals",Wheat Flour 1 kg,4,70,60,10,1
09-01-2025,Oils & Ghee,Groundnut oil 1 L,9,360,330,30,1
09-01-2025,Snacks & Ready-to-Eat,COPRA LADDU 200GM,14,100,80,20,1
09-01-2025,Milk & Dairy,SANGAM CURD 450GM,7,38,38,0,1
09-01-2025,Snacks & Ready-to-Eat,VD PAPPU CHEGODI 200GM,14,60,60,0,1
09-01-2025,Snacks & Ready-to-Eat,PALLI LADDU 200GMS,14,90,70,20,1
09-01-2025,Oils & Ghee,Coconut oil 500 ml,9,220,200,20,1
09-01-2025,Snacks & Ready-to-Eat,VD DAHI MIRCHI(SALTED) 100GM,14,45,45,0,1
09-01-2025,Snacks & Ready-to-Eat,MARMURA LADDU,14,80,60,20,1
09-01-2025,"Dry Fruits, Nuts & Seeds",DIANUTS 500GM,2,120,120,0,1
09-01-2025,Spices & Seasonings,Masala Karam 500 gms,15,260,240,20,1
09-01-2025,Sweeteners,GS Palm Jaggery Powder 400GM,16,180,180,0,1
09-01-2025,"Grains, Flours & Dals",VYS.SP.RICE 5 KGS,4,350,325,25,1
09-01-2025,Milk & Dairy,BROWN EGGS TRAY 30P,7,360,330,30,1
09-01-2025,Snacks & Ready-to-Eat,SS IDLY BATTER 1KG,14,60,60,0,1
09-01-2025,"Grains, Flours & Dals",VYS.SP.RICE 5 KGS,4,350,325,25,1
09-01-2025,Snacks & Ready-to-Eat,JUNNU POWDER 100GM,14,70,70,0,1
09-01-2025,Snacks & Ready-to-Eat,VD GUMMADI VADIYAM,14,75,75,0,1
09-01-2025,Milk & Dairy,SANGAM TONED MILK 500ML,7,30,30,0,1
09-01-2025,Milk & Dairy,SANGAM CURD 450GM,7,38,38,0,1
08-01-2025,"Grains, Flours & Dals",SAMALU (Little millet) 1 kg,4,170,130,40,1
08-01-2025,Snacks & Ready-to-Eat,MILK BREAD,14,30,30,0,1
08-01-2025,"Grains, Flours & Dals",KORRALU (FOXTAIL M) 1KG,4,150,110,40,1
08-01-2025,Sweeteners,Natural Honey 500 gms,16,280,240,40,1
08-01-2025,"Grains, Flours & Dals",Chana Flour 1 kg,4,140,130,10,1
08-01-2025,Pooja & Spiritual Items,GD Kailash 60 GM,12,60,60,0,1
08-01-2025,Pooja & Spiritual Items,BALAJI BEL PHOOL DHOOP STICKS 10STK,12,70,70,0,1
08-01-2025,Spices & Seasonings,Menthulu 500 gms,15,100,90,10,1
08-01-2025,Spices & Seasonings,NUVVULU 250GM,15,100,85,15,1
08-01-2025,Personal Care & Cosmetics,DABUR RED PASTE 50GM,10,25,25,0,1
08-01-2025,"Grains, Flours & Dals",Wheat Flour 1 kg,4,70,60,10,1
08-01-2025,"Health, Wellness & Ayurvedic Products",RAMA BALM 10ML,5,40,40,0,1
08-01-2025,Oils & Ghee,Sesame oil 500ml,9,295,280,15,1
08-01-2025,Beverages,BRU GREEN LABEL 1.2G,1,96,96,0,48
08-01-2025,"Grains, Flours & Dals",White jowar.F 1 kg,4,100,80,20,1
08-01-2025,Spices & Seasonings,JEERA 250 gms,15,125,105,20,1
08-01-2025,Pooja & Spiritual Items,BALAJI GOLDEN SPIRIT 100G,12,85,85,0,1
08-01-2025,Spices & Seasonings,SWEET SOUNF,15,20,20,0,1
08-01-2025,Snacks & Ready-to-Eat,NGT CHATPATTA CHANA 90GM,14,25,25,0,1
08-01-2025,Milk & Dairy,BROWN EGGS 1P,7,28,24,4,2
08-01-2025,Milk & Dairy,BROWN EGGS 1P,7,84,72,12,6
08-01-2025,Milk & Dairy,HERITAGE CURD,7,48,48,0,1
08-01-2025,Oils & Ghee,Safflower oil 500 ml,9,220,200,20,1
08-01-2025,Snacks & Ready-to-Eat,MARMURA LADDU,14,80,60,20,1
08-01-2025,Oils & Ghee,Safflower oil 5 L,9,4400,"3,900.00",500,2
08-01-2025,Pooja & Spiritual Items,999 SINGAPORE DHOOP POW 50GM,12,35,35,0,1
08-01-2025,Oils & Ghee,Sesame oil 500ml,9,295,280,15,1
08-01-2025,Snacks & Ready-to-Eat,RINGS 200GM,14,30,30,0,1
08-01-2025,Snacks & Ready-to-Eat,TILLI CHIKKI,14,125,125,0,1
08-01-2025,Snacks & Ready-to-Eat,PEANUT CHILLI,14,135,135,0,27
08-01-2025,Milk & Dairy,BROWN EGGS 1P,7,168,144,24,12
08-01-2025,"Grains, Flours & Dals",VYS.SP.RICE 5 KGS,4,350,325,25,1
08-01-2025,Snacks & Ready-to-Eat,BLACK SESAME CHIKKI,14,20,20,0,2
08-01-2025,"Grains, Flours & Dals",turdal 500 gms,4,110,100,10,1
08-01-2025,Spices & Seasonings,GS GARLIC KARAM 100GM,15,75,75,0,1
08-01-2025,Spices & Seasonings,ROYAL SAFFRON,15,125,125,0,1
08-01-2025,Pooja & Spiritual Items,SWASTIK PURE CAMPHOR 50GM,12,90,90,0,1
08-01-2025,"Grains, Flours & Dals",Wheat Flour 1 kg,4,210,180,30,3
08-01-2025,Spices & Seasonings,YB PINK ROCK SALT 1KG,15,120,120,0,1
08-01-2025,"Grains, Flours & Dals",RAGI FLOUR 500GRMS,4,40,35,5,1
08-01-2025,Snacks & Ready-to-Eat,VD GUMMADI VADIYAM,14,75,75,0,1
08-01-2025,Snacks & Ready-to-Eat,KHARJURAM DRY FRUIT LADDU,14,180,180,0,1
08-01-2025,Sweeteners,PN ORGANIC BROWN SUGAR 500GM,16,156,156,0,2
08-01-2025,Spices & Seasonings,SH TAMARIND SEEDLESS 500GM,15,260,260,0,1
08-01-2025,Sweeteners,Natural Honey 1 kg,16,560,480,80,1
08-01-2025,Oils & Ghee,Safflower oil 1 L,9,440,400,40,1
08-01-2025,Snacks & Ready-to-Eat,SATHVI REGIVADA 200GM,14,80,60,20,1
08-01-2025,Oils & Ghee,Groundnut oil 1 L,9,360,330,30,1
08-01-2025,Milk & Dairy,BROWN EGGS TRAY 30P,7,360,330,30,1
08-01-2025,Personal Care & Cosmetics,MADDI ALOEVERA SHAMPOO 500ML,10,300,300,0,1
08-01-2025,Oils & Ghee,Safflower oil 500 ml,9,220,200,20,1
08-01-2025,Oils & Ghee,Coconut oil 500 ml,9,220,200,20,1
08-01-2025,Oils & Ghee,Mustard oil 500 ml,9,220,195,25,1
08-01-2025,Oils & Ghee,Safflower oil 1 L,9,880,800,80,2
08-01-2025,Snacks & Ready-to-Eat,MILK BREAD,14,55,55,0,1
08-01-2025,Snacks & Ready-to-Eat,RAGI LADDU,14,120,120,0,1
08-01-2025,"Grains, Flours & Dals",split black gram 1 kg,4,180,170,10,1
08-01-2025,Spices & Seasonings,DRY MIECHI 200GM,15,80,60,20,1
08-01-2025,Snacks & Ready-to-Eat,MIGHTY PUFF,14,25,25,0,1
08-01-2025,"Grains, Flours & Dals",turdal 1kg,4,220,195,25,1
08-01-2025,General Household & Kitchenware,CLASSMATE,3,22,22,0,1
08-01-2025,Snacks & Ready-to-Eat,VD PANIPURI 100GM,14,30,30,0,1
08-01-2025,"Grains, Flours & Dals",VYS.SP.RICE 10 KGS,4,700,650,50,1
08-01-2025,"Grains, Flours & Dals",Brown RICE 1KG,4,35,32.5,2.5,0.5
08-01-2025,"Grains, Flours & Dals",SL Idly Rava 1KG,4,65,55,10,1
08-01-2025,"Grains, Flours & Dals",SF BESAN 500GM,4,100,100,0,1
08-01-2025,"Grains, Flours & Dals",SH ORGANIC MOONG YELLOW 500GM,4,158,158,0,1
08-01-2025,"Grains, Flours & Dals",PRO NATURE CHANNA DAL500GM,4,124,124,0,1
08-01-2025,"Grains, Flours & Dals",GS WHEAT POHA 200 GM,4,60,60,0,1
08-01-2025,"Grains, Flours & Dals",Wheat Flour 1 kg,4,210,180,30,3
08-01-2025,Milk & Dairy,BROWN EGGS TRAY 30P,7,360,330,30,1
08-01-2025,Snacks & Ready-to-Eat,GANTASALA GINGER CANDY 200GM,14,105,105,0,1
08-01-2025,Oils & Ghee,Coconut oil 500 ml,9,220,200,20,1
08-01-2025,Snacks & Ready-to-Eat,JUNNU POWDER 100GM,14,70,70,0,1
08-01-2025,Snacks & Ready-to-Eat,SATHVI REGIVADA 200GM,14,80,60,20,1
08-01-2025,Pooja & Spiritual Items,BALAJI BEL PHOOL STICKS 90GM,12,60,60,0,1
08-01-2025,Snacks & Ready-to-Eat,COPRA LADDU 200GM,14,100,80,20,1
08-01-2025,Oils & Ghee,Groundnut oil 500ml,9,360,330,30,2
08-01-2025,Misc,HOME LIKES,8,10,10,0,1
08-01-2025,Snacks & Ready-to-Eat,MILK BREAD,14,55,55,0,1
08-01-2025,Snacks & Ready-to-Eat,SD Groundnut with palm jaggery 250gm,14,135,135,0,1
08-01-2025,"Grains, Flours & Dals",Urad dall 1 Kg,4,185,170,15,1
08-01-2025,"Dry Fruits, Nuts & Seeds",Groundnuts 1 kg,2,190,170,20,1
08-01-2025,"Dry Fruits, Nuts & Seeds",YELLOW KISHMISH 250GM,2,130,110,20,1
08-01-2025,Oils & Ghee,Groundnut oil 1 L,9,360,330,30,1
08-01-2025,"Grains, Flours & Dals",SL Idly Rava 1KG,4,65,55,10,1
08-01-2025,Snacks & Ready-to-Eat,VD MIXTURE 175 GM,14,60,60,0,1
08-01-2025,Snacks & Ready-to-Eat,VD VAMUPUSA 175GM,14,120,120,0,2
08-01-2025,Snacks & Ready-to-Eat,VD ARISELU 5 PIC,14,100,100,0,1
08-01-2025,Snacks & Ready-to-Eat,RINGS 200GM,14,30,30,0,1
08-01-2025,Snacks & Ready-to-Eat,RSC ORANGE 100GMS,14,20,20,0,1
08-01-2025,Spices & Seasonings,ROYAL SAFFRON 400GRMS,15,65,65,0,1
08-01-2025,Milk & Dairy,TOTAL CURD 50GMS,7,10,10,0,1
08-01-2025,Snacks & Ready-to-Eat,BATANA NGT 70GMS,14,20,20,0,1
08-01-2025,Snacks & Ready-to-Eat,SALTED PHALLI,14,25,25,0,1
08-01-2025,Spices & Seasonings,ROYAL SAFFRON,15,125,125,0,1
08-01-2025,Spices & Seasonings,NUVVULU 250GM,15,80,65,15,1
08-01-2025,Snacks & Ready-to-Eat,MARMURA LADDU,14,80,60,20,1
08-01-2025,"Health, Wellness & Ayurvedic Products",RAMA BALM 10ML,5,40,40,0,1
08-01-2025,Snacks & Ready-to-Eat,SF COOKIES CHOCO RAGI,14,99,99,0,1
08-01-2025,Snacks & Ready-to-Eat,VD MINAPA SUNNUNDALU 12P,14,180,180,0,1
08-01-2025,Household & Cleaning,SURF EXCEL MATIC FL 1L,6,250,250,0,1
08-01-2025,Personal Care & Cosmetics,UVIS ROSEWATER 100ML,10,49,49,0,1
08-01-2025,Snacks & Ready-to-Eat,MILK BREAD,14,30,30,0,1
08-01-2025,Personal Care & Cosmetics,Soapnut 250GM,10,120,90,30,2
08-01-2025,"Grains, Flours & Dals",HS jowar idly rava 500 gms,4,130,130,0,2
08-01-2025,Oils & Ghee,Groundnut oil 1 L,9,720,660,60,2
08-01-2025,Sweeteners,MISHRI D,16,40,30,10,1
08-01-2025,Snacks & Ready-to-Eat,SATHVI MIXED CHIKKI 200GM,14,120,100,20,1
08-01-2025,"Grains, Flours & Dals",FLOUR CHARGE,4,18,18,0,1.5
08-01-2025,"Grains, Flours & Dals",Urad dall 1 Kg,4,46.25,42.5,3.75,0.25
08-01-2025,"Grains, Flours & Dals",VGR rice 1 kg,4,70,65,5,1
08-01-2025,Snacks & Ready-to-Eat,VD PAPPU CHEGODI 200GM,14,60,60,0,1
08-01-2025,"Grains, Flours & Dals",CHANA DAL 1KG,4,35,30,5,0.25
08-01-2025,Oils & Ghee,Groundnut oil 1 L,9,720,660,60,2
08-01-2025,Spices & Seasonings,ROYAL SAFFRON,15,125,125,0,1
08-01-2025,Snacks & Ready-to-Eat,ID PAROTA,14,99,99,0,1
08-01-2025,"Grains, Flours & Dals",RAGI FLOUR 500GRMS,4,40,35,5,1
08-01-2025,"Grains, Flours & Dals",Em kodo idli R 500G,4,129,129,0,1
08-01-2025,"Grains, Flours & Dals",Em Multimillet idli r 500g,4,129,129,0,1
08-01-2025,Snacks & Ready-to-Eat,VD DAHI MIRCHI(SALTED) 100GM,14,90,90,0,2
08-01-2025,Spices & Seasonings,DRY MIECHI 200GM,15,160,120,40,2
08-01-2025,"Grains, Flours & Dals",RICE FLOUR 500 GM,4,210,168,42,6
08-01-2025,Oils & Ghee,Freedom Rice Bran Oil 1L,9,388,360,28,2
08-01-2025,"Grains, Flours & Dals",Chana Flour 1 kg,4,280,260,20,2
08-01-2025,Oils & Ghee,Groundnut oil 1 L,9,360,330,30,1
08-01-2025,Snacks & Ready-to-Eat,VD DRY FRUIT PUTHAREKULU,14,120,120,0,1
08-01-2025,"Grains, Flours & Dals",RICE FLOUR 1KG,4,350,275,75,5
08-01-2025,"Grains, Flours & Dals",split green gram 1 kg,4,150,140,10,1
08-01-2025,Snacks & Ready-to-Eat,PUMPKIN CHIKKI 200GM,14,140,120,20,1
08-01-2025,Spices & Seasonings,DRY MIRCHI 500GM,15,150,120,30,1
08-01-2025,"Health, Wellness & Ayurvedic Products",AMLAKI CHOORNAM,5,100,100,0,1
08-01-2025,Snacks & Ready-to-Eat,MARMURA LADDU,14,80,60,20,1
08-01-2025,Oils & Ghee,Groundnut oil 1 L,9,360,330,30,1
08-01-2025,"Grains, Flours & Dals",Wheat Flour 1 kg,4,70,60,10,1
08-01-2025,Oils & Ghee,Safflower oil 1 L,9,440,400,40,1
08-01-2025,Snacks & Ready-to-Eat,SATHVI REGIVADA 200GM,14,80,60,20,1
08-01-2025,"Grains, Flours & Dals",Chittimuthaylu rice 1 kg,4,160,140,20,1
08-01-2025,"Health, Wellness & Ayurvedic Products",GD 27 HERBS OIL 120ML,5,150,150,0,1
08-01-2025,Personal Care & Cosmetics,DWI ALOEVERA 100GM,10,180,180,0,2
08-01-2025,Snacks & Ready-to-Eat,SALTED PHALLI,14,25,25,0,1
08-01-2025,Personal Care & Cosmetics,KHADI ALOEVERA SHAMPOO,10,199,199,0,1
08-01-2025,"Health, Wellness & Ayurvedic Products",MH Womens Malt 500GM,5,500,480,20,2
08-01-2025,Personal Care & Cosmetics,DWI ALOEVERA 100GM,10,90,90,0,1
08-01-2025,Oils & Ghee,Coconut oil 1 L,9,440,400,40,1
08-01-2025,Oils & Ghee,Sesame oil 1 L,9,590,560,30,1
08-01-2025,Oils & Ghee,Safflower oil 1 L,9,440,400,40,1
08-01-2025,Oils & Ghee,Sesame oil 1 L,9,590,560,30,1
08-01-2025,Oils & Ghee,Groundnut oil 1 L,9,360,330,30,1
08-01-2025,Sweeteners,Natural Honey 500 gms,16,840,720,120,3
08-01-2025,Oils & Ghee,Groundnut oil 1 L,9,1080,990,90,3
08-01-2025,"Grains, Flours & Dals",turdal 1kg,4,440,390,50,2
08-01-2025,Spices & Seasonings,NUVVULU 250GM,15,200,170,30,2
08-01-2025,Household & Cleaning,LIZOL CITRUS 625ML,6,149,149,0,1
08-01-2025,Household & Cleaning,SURF EXCEL MATIC FL 1L,6,250,250,0,1
08-01-2025,"Grains, Flours & Dals",RICE FLOUR 500 GM,4,140,112,28,4
08-01-2025,"Grains, Flours & Dals",RICE FLOUR 1KG,4,70,55,15,1
08-01-2025,Spices & Seasonings,ROYAL SAFFRON,15,250,250,0,2
08-01-2025,Milk & Dairy,SANGAM CURD 450GM,7,76,76,0,2
08-01-2025,Spices & Seasonings,DRY MIRCHI 1KG,15,600,480,120,2
08-01-2025,"Grains, Flours & Dals",Urad dall 1 Kg,4,370,340,30,2
08-01-2025,Sweeteners,SUGAR 1KG,16,120,100,20,2
08-01-2025,"Dry Fruits, Nuts & Seeds",PUTNALU 500GMS,2,360,304,56,4
08-01-2025,Spices & Seasonings,Tamarind 500GM,15,160,130,30,1
08-01-2025,Spices & Seasonings,RED COPRA 250GMS,15,85,74,11,1
08-01-2025,"Dry Fruits, Nuts & Seeds",Groundnuts 1 kg,2,190,170,20,1
08-01-2025,"Grains, Flours & Dals",Wheat Flour 1 kg,4,210,180,30,3
08-01-2025,Spices & Seasonings,Chilli powder 500 gms,15,290,210,80,1
08-01-2025,Household & Cleaning,LIZOL JAQSMINE 500ML,6,116,116,0,1
08-01-2025,Oils & Ghee,Safflower oil 1 L,9,880,800,80,2
08-01-2025,"Grains, Flours & Dals",Wheat Flour 1 kg,4,210,180,30,3
08-01-2025,Pooja & Spiritual Items,AMRUTHA SURABHI,12,80,80,0,1
08-01-2025,Pooja & Spiritual Items,SREE REAL KASTURI CUP SAMBRANI,12,81,81,0,1
08-01-2025,Pooja & Spiritual Items,BALAJI KASTURI DHOOP STICKS,12,70,70,0,1
08-01-2025,Oils & Ghee,Groundnut oil 1 L,9,360,330,30,1
08-01-2025,Sweeteners,YB JAGGERY POWDER 500GMS,16,75,75,0,1
08-01-2025,Spices & Seasonings,Masala Karam 500 gms,15,260,240,20,1
08-01-2025,Snacks & Ready-to-Eat,SESAME CHIKKI,14,120,100,20,1
08-01-2025,"Grains, Flours & Dals",RICE FLOUR 1KG,4,70,55,15,1
08-01-2025,Snacks & Ready-to-Eat,MARMURA LADDU,14,80,60,20,1
08-01-2025,Personal Care & Cosmetics,ORGANIC SPONGE LOOFAH,10,70,70,0,1
08-01-2025,Snacks & Ready-to-Eat,SATHVI PALLI CHIKKI 200GM,14,100,80,20,1
08-01-2025,"Grains, Flours & Dals",SA YELLOW JOWAR RAVA 500GM,4,95,95,0,1
08-01-2025,"Grains, Flours & Dals",EM jowar upma R 500G,4,75,75,0,1
08-01-2025,Snacks & Ready-to-Eat,RI Yogurt Berry Oats 35g,14,45,45,0,1
08-01-2025,Milk & Dairy,BROWN EGGS 1P,7,70,60,10,5
08-01-2025,Oils & Ghee,Mustard oil 1 L,9,440,390,50,1
08-01-2025,Oils & Ghee,Groundnut oil 1 L,9,360,330,30,1
08-01-2025,Household & Cleaning,VIM EXTRA 110GM,6,30,30,0,3
08-01-2025,"Grains, Flours & Dals",SL Idly Rava 1KG,4,65,55,10,1
08-01-2025,Pooja & Spiritual Items,HAND MADE VOTHULU,12,50,50,0,1
08-01-2025,Spices & Seasonings,Elaichi 25GM,15,145,120,25,1
08-01-2025,Snacks & Ready-to-Eat,PALLI LADDU 200GMS,14,90,70,20,1
08-01-2025,"Grains, Flours & Dals",Wheat Flour 1 kg,4,70,60,10,1
08-01-2025,Snacks & Ready-to-Eat,SESAME LADDU 200GM,14,100,80,20,1
08-01-2025,Oils & Ghee,Safflower oil 1 L,9,440,400,40,1
08-01-2025,Snacks & Ready-to-Eat,SD Atreyapuram DRY Fruit ghee,14,150,150,0,1
08-01-2025,Snacks & Ready-to-Eat,BATANA NGT 70GMS,14,20,20,0,1
08-01-2025,Oils & Ghee,Groundnut oil 1 L,9,720,660,60,2
08-01-2025,Oils & Ghee,Sesame oil 500ml,9,295,280,15,1
08-01-2025,Spices & Seasonings,ROYAL SAFFRON 400GRMS,15,65,65,0,1
08-01-2025,"Grains, Flours & Dals",DESI CHANA,4,25,25,0,1
08-01-2025,Pooja & Spiritual Items,GD Dhoop Sticks 26GM,12,40,40,0,2
08-01-2025,"Grains, Flours & Dals",VYS.SP.RICE 5 KGS,4,350,325,25,1
08-01-2025,Snacks & Ready-to-Eat,PUMPKIN CHIKKI 200GM,14,140,120,20,1
08-01-2025,Personal Care & Cosmetics,GAYATHRI KUMKUDUKAYA,10,150,150,0,1
08-01-2025,Pooja & Spiritual Items,GD Kailash 60 GM,12,120,120,0,2
08-01-2025,"Grains, Flours & Dals",SA Multi Grain Mix 500GM,4,159,159,0,1
08-01-2025,"Dry Fruits, Nuts & Seeds",MAHA BEERA SEEDS 100GM,2,60,60,0,1
08-01-2025,"Grains, Flours & Dals",SRILALITHA MAIDA FLOUR 500G,4,32,32,0,1
08-01-2025,Snacks & Ready-to-Eat,SD Moringa with plam jaggery 250gm,14,135,135,0,1
08-01-2025,"Grains, Flours & Dals",Em Multimillet upma 500g,4,258,258,0,2
08-01-2025,"Dry Fruits, Nuts & Seeds",SATHVI CHIA SEEDS 100GM,2,200,160,40,2
08-01-2025,Pooja & Spiritual Items,BALAJI KEWDA DHOOP STICKS 10STK,12,70,70,0,1
08-01-2025,Personal Care & Cosmetics,VICCO TURMERIC SKIN CREAM 15G,10,77,77,0,1
08-01-2025,Oils & Ghee,Sesame oil 1 L,9,590,560,30,1
08-01-2025,Personal Care & Cosmetics,SVE KHADI CARROT GEL 100GM,10,145,145,0,1
08-01-2025,Snacks & Ready-to-Eat,BATANA NGT 70GMS,14,20,20,0,1
08-01-2025,Oils & Ghee,Groundnut oil 1 L,9,360,330,30,1
08-01-2025,Snacks & Ready-to-Eat,ZEEDI,14,70,70,0,1
08-01-2025,Snacks & Ready-to-Eat,MARMURA LADDU,14,80,60,20,1
08-01-2025,Snacks & Ready-to-Eat,GANTASALA GINGER CANDY 200GM,14,105,105,0,1
08-01-2025,"Grains, Flours & Dals",FLOUR CHARGE,4,297.5,297.5,0,11.9
08-01-2025,"Grains, Flours & Dals",DESI CHANA,4,25,25,0,1
08-01-2025,Snacks & Ready-to-Eat,VD DAHI MIRCHI(SALTED) 100GM,14,45,45,0,1
08-01-2025,"Grains, Flours & Dals",SA Sprouted Ragi Flour 500GM,4,69,69,0,1
08-01-2025,Milk & Dairy,HRITAGE TONED MILK 500ML,7,30,30,0,1
08-01-2025,Household & Cleaning,COMFORT EAU DE PARFUM 210ML,6,65,65,0,1
08-01-2025,Sweeteners,YB Brown Sugar 500GM,16,75,75,0,1
08-01-2025,"Grains, Flours & Dals",VYS.SP RICE 1 KG,4,140,130,10,2
08-01-2025,Snacks & Ready-to-Eat,SATHVI REGIVADA 200GM,14,80,60,20,1
08-01-2025,"Dry Fruits, Nuts & Seeds",SUNFLOWER SEEDS 250GRM,2,150,130,20,1
08-01-2025,"Grains, Flours & Dals",VYS.SP RICE 1 KG,4,210,195,15,3
08-01-2025,Oils & Ghee,Sesame oil 1 L,9,590,560,30,1
08-01-2025,Oils & Ghee,Groundnut oil 1 L,9,360,330,30,1
08-01-2025,"Grains, Flours & Dals",SL Idly Rava 1KG,4,130,110,20,2
08-01-2025,Spices & Seasonings,ROYAL SAFFRON,15,125,125,0,1
08-01-2025,"Dry Fruits, Nuts & Seeds",PUMPKIN SEEDS 250GM,2,200,160,40,1
08-01-2025,"Dry Fruits, Nuts & Seeds",WATERMELON SEEDS 250GRM,2,320,280,40,1
08-01-2025,Snacks & Ready-to-Eat,SATHVI MIXED CHIKKI 200GM,14,120,100,20,1
08-01-2025,Milk & Dairy,SANGAM TONED MILK 500ML,7,30,30,0,1
08-01-2025,Sweeteners,YB JAGGERY POWDER 1KG,16,280,280,0,2
08-01-2025,"Grains, Flours & Dals",VGR rice 1 kg,4,140,130,10,2
08-01-2025,"Dry Fruits, Nuts & Seeds",CASHEW 250GM,2,340,310,30,1
08-01-2025,"Grains, Flours & Dals",Chana Flour 500 gms,4,70,65,5,1
08-01-2025,"Grains, Flours & Dals",SPLIT BLACK GRAM 500 GM,4,90,85,5,1
08-01-2025,Spices & Seasonings,TATA SALT 1KG,15,30,30,0,1
08-01-2025,"Grains, Flours & Dals",Wheat Flour 1 kg,4,140,120,20,2
08-01-2025,"Grains, Flours & Dals",Multigrain 1 kg,4,100,85,15,1
08-01-2025,Personal Care & Cosmetics,SANTOOR,10,36,36,0,1
08-01-2025,Spices & Seasonings,SONTI 50GM,15,30,20,10,1
08-01-2025,Snacks & Ready-to-Eat,TILLI CHIKKI,14,5,5,0,1
08-01-2025,Spices & Seasonings,ROYAL SAFFRON 400GRMS,15,65,65,0,1
08-01-2025,Snacks & Ready-to-Eat,JUNNU POWDER 100GM,14,70,70,0,1
08-01-2025,Milk & Dairy,HRITAGE TONED MILK 500ML,7,30,30,0,1
08-01-2025,"Grains, Flours & Dals",SL Idly Rava 1KG,4,65,55,10,1
08-01-2025,Snacks & Ready-to-Eat,MARMURA LADDU,14,80,60,20,1
08-01-2025,Oils & Ghee,Sesame oil 1 L,9,1180,"1,120.00",60,2
08-01-2025,"Health, Wellness & Ayurvedic Products",SHIKAKAI CHOORNAM,5,80,80,0,1
08-01-2025,"Health, Wellness & Ayurvedic Products",MD Fenugreek Choornam 100GM,5,80,80,0,1
08-01-2025,"Health, Wellness & Ayurvedic Products",MD Bringaraj Choornam 100GM,5,80,80,0,1
08-01-2025,"Grains, Flours & Dals",VYS.SP.RICE BAG 1,4,1800,"1,650.00",150,1
08-01-2025,Oils & Ghee,Groundnut oil 1 L,9,360,330,30,1
08-01-2025,Sweeteners,YB JAGGERY POWDER 500GMS,16,75,75,0,1
08-01-2025,Snacks & Ready-to-Eat,VD DAHI MIRCHI(SALTED) 100GM,14,45,45,0,1
08-01-2025,"Grains, Flours & Dals",DR.RICE 5KG,4,600,600,0,1
08-01-2025,"Grains, Flours & Dals",Multigrain 1 kg,4,100,85,15,1
08-01-2025,Snacks & Ready-to-Eat,TILLI CHIKKI,14,5,5,0,1
08-01-2025,Snacks & Ready-to-Eat,PEANUT CHILLI,14,5,5,0,1
08-01-2025,Oils & Ghee,Groundnut oil 1 L,9,360,330,30,1
08-01-2025,"Grains, Flours & Dals",Multigrain 1 kg,4,200,170,30,2
08-01-2025,Spices & Seasonings,SREE MARUTHI IDLY KARAM 200GM,15,60,60,0,1
08-01-2025,Spices & Seasonings,YB PINK ROCK SALT 1KG,15,120,120,0,1
08-01-2025,Snacks & Ready-to-Eat,SATHVI MIXED CHIKKI 200GM,14,240,200,40,2
08-01-2025,"Grains, Flours & Dals",MAAGAANI SP RICE 20 KGS,4,2300,"1,960.00",340,1
08-01-2025,"Dry Fruits, Nuts & Seeds",Groundnuts 1 kg,2,190,170,20,1
08-01-2025,Snacks & Ready-to-Eat,ANNAPURNA APPALAM,14,35,35,0,1
08-01-2025,Snacks & Ready-to-Eat,VD DAHI MIRCHI(SALTED) 100GM,14,45,45,0,1
08-01-2025,Snacks & Ready-to-Eat,SATHVI PALLI CHIKKI 200GM,14,200,160,40,2
08-01-2025,Oils & Ghee,Coconut oil 500 ml,9,220,200,20,1
08-01-2025,"Dry Fruits, Nuts & Seeds",SUNFLOWER SEEDS 250GRM,2,150,130,20,1
08-01-2025,Snacks & Ready-to-Eat,SESAME CHIKKI,14,120,100,20,1
08-01-2025,"Dry Fruits, Nuts & Seeds",PUMPKIN SEEDS 250GM,2,200,160,40,1
08-01-2025,Pooja & Spiritual Items,GD Sree Chandan 50GM,12,50,50,0,1
08-01-2025,"Health, Wellness & Ayurvedic Products",ZANDU ULTRA POWER BALM 8ML,5,50,50,0,1
08-01-2025,Spices & Seasonings,Tamarind 500GM,15,160,130,30,1
08-01-2025,Personal Care & Cosmetics,HIMALAYA LIP BALM 10GM,10,80,80,0,2
08-01-2025,Oils & Ghee,BUFFALLO GHEE 500ML,9,410,370,40,1
08-01-2025,"Dry Fruits, Nuts & Seeds",PUMPKIN SEEDS 250GM,2,200,160,40,1
08-01-2025,Oils & Ghee,Black Sesame oil 500 ml,9,220,190,30,1
08-01-2025,Personal Care & Cosmetics,MD Bath Powder 100GM,10,40,40,0,1
08-01-2025,"Dry Fruits, Nuts & Seeds",SUNFLOWER SEEDS 250GRM,2,150,130,20,1
08-01-2025,Oils & Ghee,Coconut oil 500 ml,9,220,200,20,1
08-01-2025,Snacks & Ready-to-Eat,MIGHTY PUFFS CHEDDAR CHEESE,14,25,25,0,1
08-01-2025,"Health, Wellness & Ayurvedic Products",RB Max Protein PERI PERI 60gm,5,45,45,0,1
08-01-2025,"Grains, Flours & Dals",split black gram 500 gms,4,180,170,10,2
08-01-2025,Sweeteners,KAMAL JAGGERY 500GM,16,80,76,4,2
08-01-2025,"Grains, Flours & Dals",CORN FOUR 250GM,4,40,35,5,1
08-01-2025,"Grains, Flours & Dals",BARLEY FLOUR 250GM,4,45,40,5,1
08-01-2025,"Grains, Flours & Dals",Wheat Rava M 500GM,4,66,60,6,2
08-01-2025,"Dry Fruits, Nuts & Seeds",FLAX SEEDS 250GM,2,60,50,10,1
08-01-2025,Spices & Seasonings,Chilli powder 500 gms,15,290,210,80,1
08-01-2025,Household & Cleaning,VIM EXTRA 110GM,6,70,70,0,7
08-01-2025,Spices & Seasonings,ROYAL SAFFRON,15,250,250,0,2
08-01-2025,Oils & Ghee,Groundnut oil 1 L,9,360,330,30,1
08-01-2025,Oils & Ghee,Sesame oil 500ml,9,295,280,15,1
08-01-2025,Oils & Ghee,Mustard oil 500 ml,9,220,195,25,1
08-01-2025,Milk & Dairy,BROWN EGGS 1P,7,84,72,12,6
08-01-2025,"Grains, Flours & Dals",Em kodo idli R 500G,4,129,129,0,1
08-01-2025,Snacks & Ready-to-Eat,VD VAMUPUSA 175GM,14,60,60,0,1
08-01-2025,Snacks & Ready-to-Eat,VD ATUKULU MIXTURE 175GM,14,60,60,0,1
08-01-2025,"Dry Fruits, Nuts & Seeds",FLAX SEEDS 250GM,2,60,50,10,1
08-01-2025,"Grains, Flours & Dals",Em Multimillet idli r 500g,4,129,129,0,1
08-01-2025,"Grains, Flours & Dals",JOWAR YELLOW 1 K,4,180,180,0,2
08-01-2025,"Grains, Flours & Dals",CHANA DAL 500GM,4,70,60,10,1
08-01-2025,"Dry Fruits, Nuts & Seeds",Groundnuts 500 gms,2,95,85,10,1
08-01-2025,"Grains, Flours & Dals",Bajra Flour 1 kg,4,70,60,10,1
08-01-2025,"Grains, Flours & Dals",RAGI FLOUR 1KG,4,80,70,10,1
08-01-2025,"Grains, Flours & Dals",Wheat Flour 1 kg,4,70,60,10,1
08-01-2025,"Grains, Flours & Dals",FLOUR CHARGE,4,65,65,0,2.6
08-01-2025,"Grains, Flours & Dals",Chana Flour 500 gms,4,70,65,5,1
08-01-2025,"Grains, Flours & Dals",FLOUR CHARGE,4,60,60,0,2.4
08-01-2025,Spices & Seasonings,Black Till 250GM,15,90,75,15,1
08-01-2025,Spices & Seasonings,AV Iodized Salt 1KG,15,28,25,3,1
08-01-2025,Spices & Seasonings,Turmeric powder 250 gms,15,100,75,25,1
08-01-2025,Personal Care & Cosmetics,MD Henna Choornam 100GM,10,80,80,0,1
08-01-2025,"Grains, Flours & Dals",Wheat Flour 1 kg,4,70,60,10,1
08-01-2025,Spices & Seasonings,Masala Karam 500 gms,15,260,240,20,1
08-01-2025,Spices & Seasonings,PURO Healthy Salt Crystal 1KG,15,135,135,0,1
08-01-2025,Oils & Ghee,Freedom Rice Bran Oil 1L,9,194,180,14,1
08-01-2025,Spices & Seasonings,EV Chicken Masala 50GM,15,48,48,0,1
08-01-2025,"Grains, Flours & Dals",White jowar.F 1 kg,4,100,80,20,1
08-01-2025,"Grains, Flours & Dals",BARLEY SEEDS 250GMS,4,40,35,5,1
08-01-2025,"Dry Fruits, Nuts & Seeds",PULMAKHANA 100 GM,2,180,170,10,1
08-01-2025,Pooja & Spiritual Items,GD Sambrani Cup Dhoop 10 PC,12,96,96,0,1
08-01-2025,"Grains, Flours & Dals",Wheat Flour 1 kg,4,140,120,20,2
08-01-2025,"Dry Fruits, Nuts & Seeds",PUMPKIN SEEDS 250GM,2,200,160,40,1
08-01-2025,Milk & Dairy,TOTAL CURD 50GMS,7,10,10,0,1
08-01-2025,"Grains, Flours & Dals",DESI CHANA,4,25,25,0,1
08-01-2025,Sweeteners,GS Palm Jaggery Powder 400GM,16,180,180,0,1
08-01-2025,Oils & Ghee,Sesame oil 1 L,9,590,560,30,1
08-01-2025,Snacks & Ready-to-Eat,SATHVI REGIVADA 200GM,14,80,60,20,1
08-01-2025,"Grains, Flours & Dals",SA Sprouted Ragi Flour 500GM,4,69,69,0,1
08-01-2025,"Grains, Flours & Dals",SABDANA 500GM,4,180,140,40,2
08-01-2025,"Grains, Flours & Dals",Red Bobarlu 1 kg,4,190,170,20,1
08-01-2025,"Grains, Flours & Dals",Wheat Flour 2 kgs,4,140,120,20,1
08-01-2025,"Dry Fruits, Nuts & Seeds",SUNFLOWER SEEDS 250GRM,2,300,260,40,2
08-01-2025,"Grains, Flours & Dals",THICK POHA 1KG,4,80,70,10,1
08-01-2025,"Grains, Flours & Dals",RAGULU 1 KG,4,70,60,10,1
08-01-2025,Spices & Seasonings,Masala Karam 500 gms,15,260,240,20,1
08-01-2025,"Grains, Flours & Dals",MAAGAANI LOW GI SP 1KG,4,240,210,30,2
08-01-2025,Spices & Seasonings,Vamu 100GM,15,60,50,10,1
08-01-2025,"Dry Fruits, Nuts & Seeds",FLAX SEEDS 250GM,2,120,100,20,2
08-01-2025,"Dry Fruits, Nuts & Seeds",PUMPKIN SEEDS 250GM,2,400,320,80,2
08-01-2025,Spices & Seasonings,ROYAL SAFFRON,15,375,375,0,3
08-01-2025,"Grains, Flours & Dals",split green gram 1 kg,4,150,140,10,1
08-01-2025,"Grains, Flours & Dals",WHEAT 1 KG,4,30,25,5,0.5
08-01-2025,"Grains, Flours & Dals",BARLEY SEEDS 1KG,4,160,140,20,1
08-01-2025,Spices & Seasonings,RED COPRA 500GM,15,340,296,44,2
08-01-2025,"Grains, Flours & Dals",turdal 1kg,4,440,390,50,2
08-01-2025,Spices & Seasonings,Elaichi 100GM,15,580,450,130,1
08-01-2025,Spices & Seasonings,AV Iodized Salt 1KG,15,56,50,6,2
08-01-2025,Spices & Seasonings,Coriander seeds 200 gms,15,48,40,8,1
08-01-2025,"Grains, Flours & Dals",PESARA PAPPU 1 KG,4,170,145,25,1
08-01-2025,Spices & Seasonings,Tamarind 500GM,15,160,130,30,1
08-01-2025,"Grains, Flours & Dals",Urad dall 1 Kg,4,185,170,15,1
08-01-2025,"Dry Fruits, Nuts & Seeds",Groundnuts 1 kg,2,190,170,20,1
08-01-2025,"Dry Fruits, Nuts & Seeds",PUTNALU 500GMS,2,270,228,42,3
08-01-2025,"Grains, Flours & Dals",CHANA DAL 500GM,4,70,60,10,1
08-01-2025,Spices & Seasonings,JEERA 250 gms,15,250,210,40,2
08-01-2025,Sweeteners,SUGAR 1KG,16,120,100,20,2
08-01-2025,"Grains, Flours & Dals",BAJRA 1 KG,4,60,50,10,1
08-01-2025,Spices & Seasonings,AVALU 100GM,15,25,20,5,1
08-01-2025,Spices & Seasonings,DB CRYSTAL SALT 1KG,15,25,25,0,1
08-01-2025,Spices & Seasonings,Miriyalu 50GM,15,200,160,40,2
08-01-2025,"Grains, Flours & Dals",MULTIGRAIN 2.5 KG,4,250,210,40,1
08-01-2025,"Grains, Flours & Dals",SPLIT BLACK GRAM 500 GM,4,90,85,5,1
08-01-2025,"Grains, Flours & Dals",split black gram 1 kg,4,180,170,10,1
08-01-2025,"Grains, Flours & Dals",JOWAR YELLOW 1 K,4,180,180,0,2
08-01-2025,Snacks & Ready-to-Eat,KURNOOL MARMURA,14,140,110,30,2
08-01-2025,"Grains, Flours & Dals",POORI ATTA 1KG,4,70,60,10,1
08-01-2025,"Dry Fruits, Nuts & Seeds",SH GROUNDNUT 250GM,2,85,85,0,1
08-01-2025,Spices & Seasonings,NUVVULU 500GM,15,200,170,30,1
08-01-2025,"Grains, Flours & Dals",RAGI FLOUR 500GRMS,4,40,35,5,1
08-01-2025,"Grains, Flours & Dals",Wheat Flour 1 kg,4,70,60,10,1
08-01-2025,"Grains, Flours & Dals",Chana Flour 500 gms,4,70,65,5,1
08-01-2025,"Grains, Flours & Dals",MAAGAANI SP RICE 5KGS,4,1298,"1,120.00",178,2
08-01-2025,"Health, Wellness & Ayurvedic Products",RB Max Protein Fruit &amp;Nut 50g,5,75,75,0,1
08-01-2025,Spices & Seasonings,SWASTIKS GINGER&amp;GARLIC,15,49,49,0,1
08-01-2025,Oils & Ghee,Groundnut oil 500ml,9,180,165,15,1
08-01-2025,Milk & Dairy,SANGAM FULL CREAM MILK 500ML,7,38,38,0,1
08-01-2025,Oils & Ghee,Safflower oil 1 L,9,440,400,40,1
08-01-2025,Oils & Ghee,Mustard oil 1 L,9,440,390,50,1
08-01-2025,Household & Cleaning,SURF EXCEL QUICK WASH 500GM,6,99,99,0,1
08-01-2025,Pooja & Spiritual Items,SWASTIK PURE CAMPHOR 7GM,12,20,20,0,1
08-01-2025,Snacks & Ready-to-Eat,SD Moringa with plam jaggery 250gm,14,135,135,0,1
08-01-2025,Personal Care & Cosmetics,KHADI LIME FRESH 125 GM,10,80,80,0,1
08-01-2025,Personal Care & Cosmetics,KHADI LEMONGRASS SOAP 125GM,10,80,80,0,1
08-01-2025,Personal Care & Cosmetics,KHADI ACTIVATED CHARCOAL SOAP,10,80,80,0,1
08-01-2025,Snacks & Ready-to-Eat,GB SALT COOKIES,14,60,55,5,1
08-01-2025,"Grains, Flours & Dals",Wheat Flour 1 kg,4,140,120,20,2
08-01-2025,"Grains, Flours & Dals",RAGI FLOUR 500GRMS,4,40,35,5,1
08-01-2025,"Grains, Flours & Dals",THICK POHA 500GM,4,40,35,5,1
08-01-2025,Snacks & Ready-to-Eat,NGT CHATPATTA CHANA 90GM,14,50,50,0,2
08-01-2025,"Grains, Flours & Dals",Bombay Rava 500GM,4,35,30,5,1
08-01-2025,Snacks & Ready-to-Eat,ANNAPURNA APPALAM,14,35,35,0,1
08-01-2025,Snacks & Ready-to-Eat,RINGS 200GM,14,30,30,0,1
08-01-2025,Snacks & Ready-to-Eat,RSC ORANGE 100GMS,14,20,20,0,1
08-01-2025,Snacks & Ready-to-Eat,VD DAHI MIRCHI(SALTED) 100GM,14,45,45,0,1
08-01-2025,"Grains, Flours & Dals",AISHWARYA SP 1KG,4,160,150,10,2
08-01-2025,"Grains, Flours & Dals",VYS HMT 26KG,4,1750,"1,750.00",0,1
08-01-2025,Household & Cleaning,VIM EXTRA 110GM,6,10,10,0,1
08-01-2025,Milk & Dairy,BROWN EGGS 1P,7,140,120,20,10
08-01-2025,"Grains, Flours & Dals",Wheat Flour 1 kg,4,70,60,10,1
08-01-2025,"Grains, Flours & Dals",Red Wheat Flour 1 kg,4,140,130,10,1
08-01-2025,Oils & Ghee,Groundnut oil 1 L,9,360,330,30,1
08-01-2025,Personal Care & Cosmetics,MADDI BATH POWDER 400GM,10,150,140,10,1
08-01-2025,Snacks & Ready-to-Eat,JUNNU POWDER 100GM,14,140,140,0,2
08-01-2025,"Grains, Flours & Dals",RAGI FLOUR 500GRMS,4,40,35,5,1
08-01-2025,"Grains, Flours & Dals",Wheat Flour 2 kgs,4,280,240,40,2
08-01-2025,"Grains, Flours & Dals",White jowar.F 1 kg,4,100,80,20,1
08-01-2025,"Grains, Flours & Dals",Chana Flour 500 gms,4,70,65,5,1
08-01-2025,Snacks & Ready-to-Eat,VD BOONDI 175GM,14,60,60,0,1
08-01-2025,"Grains, Flours & Dals",White jowar.F 1 kg,4,100,80,20,1
08-01-2025,Oils & Ghee,Black Sesame oil 1 L,9,440,380,60,1
08-01-2025,Oils & Ghee,Groundnut oil 1 L,9,360,330,30,1
07-01-2025,Snacks & Ready-to-Eat,SATHVI REGIVADA 200GM,14,80,60,20,1
07-01-2025,Snacks & Ready-to-Eat,PALLI LADDU 200GMS,14,90,70,20,1
07-01-2025,Snacks & Ready-to-Eat,NGT CHATPATTA CHANA 90GM,14,25,25,0,1
07-01-2025,"Grains, Flours & Dals",RAGI FLOUR 1KG,4,80,70,10,1
07-01-2025,Spices & Seasonings,NUVVULU 250GM,15,100,85,15,1
07-01-2025,Baking & Cooking Aids,MTR GULAB JAMUN MIX 190GM,0,80,80,0,1
07-01-2025,"Grains, Flours & Dals",Chana Flour 500 gms,4,70,65,5,1
07-01-2025,Oils & Ghee,BUFFALLO GHEE 500ML,9,410,370,40,1
07-01-2025,"Dry Fruits, Nuts & Seeds",Putnalu 250GM,2,45,38,7,1
07-01-2025,Oils & Ghee,Groundnut oil 1 L,9,360,330,30,1
07-01-2025,Spices & Seasonings,NUVVULU 250GM,15,100,85,15,1
07-01-2025,Sweeteners,YB JAGGERY POWDER 1KG,16,140,140,0,1
07-01-2025,Snacks & Ready-to-Eat,HS Ragi biscuits,14,50,50,0,1
07-01-2025,Snacks & Ready-to-Eat,SD Little Millet WITH PLAM JAGGERY,14,135,135,0,1
07-01-2025,"Grains, Flours & Dals",Wheat Rava M 500GM,4,99,90,9,3
07-01-2025,"Grains, Flours & Dals",turdal 1kg,4,440,390,50,2
07-01-2025,"Grains, Flours & Dals",MAATEJA rice 1 kg,4,720,690,30,10
07-01-2025,"Grains, Flours & Dals",Wheat Flour 2 kgs,4,140,120,20,1
07-01-2025,"Grains, Flours & Dals",Arikadu ( kodo),4,140,130,10,1
07-01-2025,"Grains, Flours & Dals",SAMALU (Little millet) 500 gms,4,85,65,20,1
07-01-2025,"Grains, Flours & Dals",THICK POHA 1KG,4,80,70,10,1
07-01-2025,"Dry Fruits, Nuts & Seeds",Groundnuts 500 gms,2,190,170,20,2
07-01-2025,Snacks & Ready-to-Eat,BB VERMICELLI 1KG,14,95,90,5,1
07-01-2025,"Grains, Flours & Dals",Green gram 1 kg,4,150,130,20,1
07-01-2025,"Grains, Flours & Dals",PESARA PAPPU 1 KG,4,170,145,25,1
07-01-2025,"Grains, Flours & Dals",Urad dall 1 Kg,4,185,170,15,1
07-01-2025,"Grains, Flours & Dals",RICE FLOUR 1KG,4,70,55,15,1
07-01-2025,Spices & Seasonings,ROYAL SAFFRON,15,125,125,0,1
07-01-2025,"Grains, Flours & Dals",Bajra Flour 1 kg,4,70,60,10,1
07-01-2025,Oils & Ghee,Groundnut oil 1 L,9,360,330,30,1
07-01-2025,"Dry Fruits, Nuts & Seeds",FLAX SEEDS 250GM,2,60,50,10,1
07-01-2025,"Grains, Flours & Dals",DESI CHANA,4,25,25,0,1
07-01-2025,Oils & Ghee,Safflower oil 1 L,9,440,400,40,1
07-01-2025,Milk & Dairy,BROWN EGGS 1P,7,168,144,24,12
07-01-2025,Oils & Ghee,Sesame oil 1 L,9,590,560,30,1
07-01-2025,"Grains, Flours & Dals",Wheat Flour 1 kg,4,70,60,10,1
07-01-2025,Snacks & Ready-to-Eat,BLACK SESAME CHIKKI,14,5,5,0,1
07-01-2025,Snacks & Ready-to-Eat,TILLI CHIKKI,14,25,25,0,5
07-01-2025,"Grains, Flours & Dals",Chana Flour 500 gms,4,70,65,5,1
07-01-2025,"Dry Fruits, Nuts & Seeds",PUMPKIN SEEDS 250GM,2,200,160,40,1
07-01-2025,Pooja & Spiritual Items,GD Aiswarya Deepam 700ML,12,195,195,0,1
07-01-2025,"Grains, Flours & Dals",SA Multi Grain Mix 500GM,4,159,159,0,1
07-01-2025,"Dry Fruits, Nuts & Seeds",SUNFLOWER SEEDS 250GRM,2,150,130,20,1
07-01-2025,Snacks & Ready-to-Eat,SESAME LADDU 200GM,14,100,80,20,1
07-01-2025,Snacks & Ready-to-Eat,SALTED PHALLI,14,65,65,0,1
07-01-2025,Snacks & Ready-to-Eat,VD Pappu Chekkalu 190gm,14,60,60,0,1
07-01-2025,Milk & Dairy,BROWN EGGS TRAY 30P,7,360,330,30,1
07-01-2025,"Grains, Flours & Dals",Em Little idli R 500g,4,129,129,0,1
07-01-2025,"Grains, Flours & Dals",EM Foxtail idli r 500 g,4,109,109,0,1
07-01-2025,Spices & Seasonings,Masala Karam 500 gms,15,260,240,20,1
07-01-2025,Snacks & Ready-to-Eat,VD MINAPA SUNNUNDALU 12P,14,180,180,0,1
07-01-2025,"Grains, Flours & Dals",FLOUR CHARGE,4,24,24,0,2
07-01-2025,"Grains, Flours & Dals",RICE FLOUR 1KG,4,140,110,30,2
07-01-2025,Oils & Ghee,Groundnut oil 1 L,9,720,660,60,2
07-01-2025,Milk & Dairy,BROWN EGGS TRAY 30P,7,360,330,30,1
07-01-2025,"Grains, Flours & Dals",turdal 1kg,4,220,195,25,1
07-01-2025,Oils & Ghee,Groundnut oil 1 L,9,720,660,60,2
07-01-2025,Oils & Ghee,Sesame oil 1 L,9,590,560,30,1
07-01-2025,Oils & Ghee,Coconut oil 1 L,9,440,400,40,1
07-01-2025,"Grains, Flours & Dals",PESARA PAPPU 500GMS,4,85,75,10,1
07-01-2025,Spices & Seasonings,Tamarind 500GM,15,160,130,30,1
07-01-2025,"Dry Fruits, Nuts & Seeds",PULMAKHANA 100 GM,2,360,340,20,2
07-01-2025,"Grains, Flours & Dals",CHANA DAL 500GM,4,70,60,10,1
07-01-2025,"Dry Fruits, Nuts & Seeds",Groundnuts 1 kg,2,190,170,20,1
07-01-2025,Snacks & Ready-to-Eat,RSC ORANGE 100GMS,14,20,20,0,1
07-01-2025,Snacks & Ready-to-Eat,VD Minapa papad 200gm,14,60,60,0,1
07-01-2025,"Grains, Flours & Dals",FLOUR CHARGE,4,20,20,0,1
07-01-2025,Snacks & Ready-to-Eat,RINGS 200GM,14,30,30,0,1
07-01-2025,Snacks & Ready-to-Eat,COPRA LADDU 200GM,14,100,80,20,1
07-01-2025,Sweeteners,YB JAGGERY POWDER 500GMS,16,75,75,0,1
07-01-2025,Personal Care & Cosmetics,MD Bath Powder 100GM,10,40,40,0,1
07-01-2025,Snacks & Ready-to-Eat,BLACK SESAME CHIKKI,14,45,45,0,1
07-01-2025,Snacks & Ready-to-Eat,VD VAMUPUSA 175GM,14,60,60,0,1
07-01-2025,Snacks & Ready-to-Eat,VD MURUKU 175GM,14,60,60,0,1
07-01-2025,Snacks & Ready-to-Eat,VD RIBBON PAKODI 175GM,14,60,60,0,1
07-01-2025,Milk & Dairy,HRITAGE TONED MILK 500ML,7,30,30,0,1
07-01-2025,"Grains, Flours & Dals",DESI CHANA,4,25,25,0,1
07-01-2025,"Dry Fruits, Nuts & Seeds",Groundnuts 1 kg,2,190,170,20,1
07-01-2025,Snacks & Ready-to-Eat,SALTED PHALLI,14,65,65,0,1
07-01-2025,Snacks & Ready-to-Eat,VD MAIDA CHEGODI 175GM,14,60,60,0,1
07-01-2025,Snacks & Ready-to-Eat,Popcorn Seeds 250GM,14,45,40,5,1
07-01-2025,Snacks & Ready-to-Eat,SATHVI PALLI CHIKKI 200GM,14,100,80,20,1
07-01-2025,"Grains, Flours & Dals",Chana Flour 500 gms,4,70,65,5,1
07-01-2025,Milk & Dairy,HERITAGE CURD,7,48,48,0,1
07-01-2025,Snacks & Ready-to-Eat,SS IDLY BATTER 1KG,14,60,60,0,1
07-01-2025,Oils & Ghee,Groundnut oil 1 L,9,720,660,60,2
07-01-2025,Spices & Seasonings,ROYAL SAFFRON 400GRMS,15,65,65,0,1
07-01-2025,Sweeteners,Natural Honey 1 kg,16,560,480,80,1
07-01-2025,"Grains, Flours & Dals",Chana Flour 1 kg,4,280,260,20,2
07-01-2025,Pooja & Spiritual Items,GD Ramayana Sandal 75GM,12,60,60,0,1
07-01-2025,"Grains, Flours & Dals",KORRALU (FOXTAIL M) 500GM,4,65,55,10,1
07-01-2025,Spices & Seasonings,Tamarind 250GMS,15,80,65,15,1
07-01-2025,Spices & Seasonings,Chilli powder 500 gms,15,290,210,80,1
07-01-2025,"Grains, Flours & Dals",RAGULU 1 KG,4,35,30,5,0.5
07-01-2025,Milk & Dairy,BROWN EGGS 1P,7,140,120,20,10
07-01-2025,Snacks & Ready-to-Eat,PALLI LADDU 200GMS,14,90,70,20,1
07-01-2025,"Grains, Flours & Dals",Chana Flour 500 gms,4,70,65,5,1
07-01-2025,Snacks & Ready-to-Eat,VD DAHI MIRCHI(SALTED) 100GM,14,45,45,0,1
07-01-2025,Pooja & Spiritual Items,BALAJI GUGGAL DHOOP 10STK,12,70,70,0,1
07-01-2025,Pooja & Spiritual Items,BALAJI KASTURI DHOOP STICKS,12,70,70,0,1
07-01-2025,Pooja & Spiritual Items,BALAJI BEL PHOOL DHOOP STICKS 10STK,12,70,70,0,1
07-01-2025,"Grains, Flours & Dals",RICE FLOUR 1KG,4,70,55,15,1
07-01-2025,"Grains, Flours & Dals",Wheat Flour 1 kg,4,70,60,10,1
07-01-2025,Oils & Ghee,Sesame oil 1 L,9,590,560,30,1
07-01-2025,Snacks & Ready-to-Eat,SD Vamu with palm jaggery 250gm,14,135,135,0,1
07-01-2025,Pooja & Spiritual Items,AMRUTHA SURABHI,12,80,80,0,1
07-01-2025,Pooja & Spiritual Items,SREE REAL KASTURI CUP SAMBRANI,12,81,81,0,1
07-01-2025,"Grains, Flours & Dals",Multigrain 1 kg,4,100,85,15,1
07-01-2025,Milk & Dairy,SANGAM FULL CREAM MILK 500ML,7,38,38,0,1
07-01-2025,Milk & Dairy,BROWN EGGS 1P,7,140,120,20,10
07-01-2025,Milk & Dairy,SANGAM TONED MILK 500ML,7,30,30,0,1
07-01-2025,Snacks & Ready-to-Eat,VD DAHI MIRCHI(SALTED) 100GM,14,45,45,0,1
07-01-2025,Sweeteners,SUGAR 1KG,16,60,50,10,1
07-01-2025,"Grains, Flours & Dals",Urad dall 1 Kg,4,185,170,15,1
07-01-2025,Snacks & Ready-to-Eat,VD MINAPA VADIYAM,14,65,65,0,1
07-01-2025,Spices & Seasonings,Miriyalu 50GM,15,100,80,20,1
07-01-2025,"Grains, Flours & Dals",Chana Flour 500 gms,4,70,65,5,1
07-01-2025,Spices & Seasonings,Turmeric powder 250 gms,15,100,75,25,1
07-01-2025,Spices & Seasonings,Jeera 100GM,15,50,45,5,1
07-01-2025,"Grains, Flours & Dals",PESARA PAPPU 500GMS,4,85,75,10,1
07-01-2025,Personal Care & Cosmetics,COCONUT BATH SCRUBBER,10,40,40,0,1
07-01-2025,"Grains, Flours & Dals",turdal 500 gms,4,110,100,10,1
07-01-2025,Baking & Cooking Aids,Baking Soda 50GM,0,20,15,5,1
07-01-2025,"Grains, Flours & Dals",Chana Flour 500 gms,4,70,65,5,1
07-01-2025,"Grains, Flours & Dals",White jowar.F 1 kg,4,100,80,20,1
07-01-2025,"Grains, Flours & Dals",Wheat Flour 1 kg,4,70,60,10,1
07-01-2025,"Grains, Flours & Dals",White jowar.F 1 kg,4,100,80,20,1
07-01-2025,Snacks & Ready-to-Eat,MIX MILLET NOODLES,14,75,75,0,1
07-01-2025,Snacks & Ready-to-Eat,VD SAGOPAPAD 150GM,14,55,55,0,1
07-01-2025,Snacks & Ready-to-Eat,VD Minapa papad 200gm,14,60,60,0,1
07-01-2025,"Grains, Flours & Dals",Wheat Flour 2 kgs,4,140,120,20,1
07-01-2025,Oils & Ghee,Sesame oil 1 L,9,590,560,30,1
07-01-2025,Snacks & Ready-to-Eat,SATHVI REGIVADA 200GM,14,80,60,20,1
07-01-2025,Milk & Dairy,BROWN EGGS TRAY 30P,7,360,330,30,1
07-01-2025,Personal Care & Cosmetics,HERBAL BATH POWDER 200GM,10,80,80,0,1
07-01-2025,Oils & Ghee,Groundnut oil 1 L,9,360,330,30,1
07-01-2025,Spices & Seasonings,NUVVULU 250GM,15,100,85,15,1
07-01-2025,"Grains, Flours & Dals",RICE FLOUR 500 GM,4,35,28,7,1
07-01-2025,Oils & Ghee,Groundnut oil 1 L,9,360,330,30,1
07-01-2025,"Grains, Flours & Dals",Green gram 500 gms,4,75,70,5,1
07-01-2025,Spices & Seasonings,Chilli powder 500 gms,15,290,210,80,1
07-01-2025,"Health, Wellness & Ayurvedic Products",PULIPIRI WARTS REMOVER 9GM,5,125,125,0,1
07-01-2025,"Grains, Flours & Dals",URAD DALL,4,95,85,10,1
07-01-2025,Beverages,BRU GREEN LABEL 1.2G,1,48,48,0,24
07-01-2025,"Grains, Flours & Dals",CHANA DAL 500GM,4,70,60,10,1
07-01-2025,Spices & Seasonings,DRY MIECHI 200GM,15,80,60,20,1
07-01-2025,Snacks & Ready-to-Eat,VD SANNAPUSA 175GM,14,60,60,0,1
07-01-2025,Snacks & Ready-to-Eat,VD DAHI MIRCHI(SALTED) 100GM,14,45,45,0,1
07-01-2025,"Dry Fruits, Nuts & Seeds",YELLOW KISHMISH 250GM,2,130,110,20,1
07-01-2025,Milk & Dairy,HERITAGE CURD,7,48,48,0,1
07-01-2025,Snacks & Ready-to-Eat,COPRA LADDU 200GM,14,100,80,20,1
07-01-2025,Sweeteners,PN ORGANIC JAGGERY POWDER 400GM,16,86,86,0,1
07-01-2025,Snacks & Ready-to-Eat,SATHVI REGIVADA 200GM,14,160,120,40,2
07-01-2025,"Grains, Flours & Dals",PRO ORG SONAMASOORI RICE,4,128,128,0,1
07-01-2025,Snacks & Ready-to-Eat,SF CHOCO CRUNCH,14,299,299,0,1
07-01-2025,"Dry Fruits, Nuts & Seeds",SABJA SEEDS 100GM,2,80,70,10,1
07-01-2025,Snacks & Ready-to-Eat,MB LITTLE MILLET NOODLES 180G,14,95,95,0,1
07-01-2025,Oils & Ghee,Coconut oil 1 L,9,440,400,40,1
07-01-2025,Snacks & Ready-to-Eat,PALLI LADDU 200GMS,14,90,70,20,1
07-01-2025,Snacks & Ready-to-Eat,VD MIXTURE 175 GM,14,60,60,0,1
07-01-2025,Snacks & Ready-to-Eat,SD Atreyapuram DRY Fruit ghee,14,150,150,0,1
07-01-2025,"Grains, Flours & Dals",turdal 1kg,4,220,195,25,1
07-01-2025,"Grains, Flours & Dals",SAMALU (Little millet) 1 kg,4,170,130,40,1
07-01-2025,Sweeteners,SD PALM JAGGERY 500GM,16,200,200,0,1
07-01-2025,"Grains, Flours & Dals",KORRALU (FOXTAIL M) 1KG,4,150,110,40,1
07-01-2025,Snacks & Ready-to-Eat,PN ORGANIC PUFFED RICE 200GM,14,55,55,0,1
07-01-2025,"Grains, Flours & Dals",ANDU KORRALU (Browntop.m) 1 kg,4,320,290,30,1
07-01-2025,"Grains, Flours & Dals",White jowar.F 1 kg,4,100,80,20,1
07-01-2025,"Grains, Flours & Dals",split black gram 1 kg,4,180,170,10,1
07-01-2025,Oils & Ghee,Sesame oil 500ml,9,295,280,15,1
07-01-2025,"Dry Fruits, Nuts & Seeds",PUTNALU 500GMS,2,90,76,14,1
07-01-2025,Oils & Ghee,Coconut oil 1 L,9,440,400,40,1
07-01-2025,Oils & Ghee,Safflower oil 1 L,9,440,400,40,1
07-01-2025,"Grains, Flours & Dals",Wheat Flour 1 kg,4,70,60,10,1
07-01-2025,"Grains, Flours & Dals",Arikadu ( kodo),4,140,130,10,1
07-01-2025,"Grains, Flours & Dals",UDALU (Barnyard millet) 500 gms,4,70,60,10,1
07-01-2025,"Grains, Flours & Dals",SA WHITE JOWAR RAVA 500GM,4,69,69,0,1
07-01-2025,"Grains, Flours & Dals",White jowar.F 1 kg,4,100,80,20,1
07-01-2025,Snacks & Ready-to-Eat,FUN TIME CRUNCH,14,45,45,0,1
07-01-2025,"Grains, Flours & Dals",Arikalu (kodo),4,70,65,5,1
07-01-2025,"Grains, Flours & Dals",KORRALU (FOXTAIL M) 500GM,4,65,55,10,1
07-01-2025,"Grains, Flours & Dals",Em Little idli R 500g,4,129,129,0,1
07-01-2025,"Grains, Flours & Dals",EM Ragi idli R 500G,4,75,75,0,1
07-01-2025,"Grains, Flours & Dals",Wheat Rava S 1KG,4,65,55,10,1
07-01-2025,"Grains, Flours & Dals",SAMALU (Little millet) 500 gms,4,85,65,20,1
07-01-2025,"Grains, Flours & Dals",Em kodo idli R 500G,4,129,129,0,1
07-01-2025,"Grains, Flours & Dals",Wheat Flour 1 kg,4,70,60,10,1
07-01-2025,"Grains, Flours & Dals",Wheat Flour 1 kg,4,70,60,10,1
07-01-2025,"Grains, Flours & Dals",White jowar.F 1 kg,4,100,80,20,1
07-01-2025,"Dry Fruits, Nuts & Seeds",PUMPKIN SEEDS 250GM,2,200,160,40,1
07-01-2025,"Grains, Flours & Dals",RAGI FLOUR 1KG,4,80,70,10,1
07-01-2025,Snacks & Ready-to-Eat,SD barnyard Millet with palm jaggery,14,270,270,0,2
07-01-2025,Beverages,ASSAM MASALA TEA,1,199,199,0,1
07-01-2025,"Dry Fruits, Nuts & Seeds",Groundnuts 1 kg,2,380,340,40,2
07-01-2025,Snacks & Ready-to-Eat,SF COOKIES CHOCO RAGI,14,99,99,0,1
07-01-2025,Snacks & Ready-to-Eat,SALTED PHALLI,14,130,130,0,2
07-01-2025,Snacks & Ready-to-Eat,PALLI LADDU 200GMS,14,90,70,20,1
07-01-2025,"Grains, Flours & Dals",DH URAD GOTA 1KG,4,215,190,25,1
07-01-2025,Oils & Ghee,Freedom Rice Bran Oil 1L,9,194,180,14,1
07-01-2025,"Grains, Flours & Dals",RICE FLOUR 1KG,4,70,55,15,1
07-01-2025,"Grains, Flours & Dals",Wheat Rava S 1KG,4,65,55,10,1
07-01-2025,"Grains, Flours & Dals",Multigrain 1 kg,4,100,85,15,1
07-01-2025,"Grains, Flours & Dals",Multigrain 1 kg,4,100,85,15,1
07-01-2025,"Grains, Flours & Dals",FLOUR CHARGE,4,96,96,0,8
07-01-2025,Snacks & Ready-to-Eat,URBAN MARMURA 450GM,14,60,55,5,1
07-01-2025,"Grains, Flours & Dals",RICE FLOUR 1KG,4,70,55,15,1
07-01-2025,"Grains, Flours & Dals",SH ROASTED SOOJI 500GM,4,66,59,7,1
07-01-2025,"Grains, Flours & Dals",WHEAT 1 KG,4,480,400,80,8
07-01-2025,Oils & Ghee,Coconut oil 500 ml,9,220,200,20,1
07-01-2025,Sweeteners,GS Organic Jaggery Powder 600GM,16,99,99,0,1
07-01-2025,Oils & Ghee,Safflower oil 1 L,9,880,800,80,2
07-01-2025,"Grains, Flours & Dals",RAGI FLOUR 1KG,4,80,70,10,1
07-01-2025,Personal Care & Cosmetics,KHADI Aloevera Moisturizing Face,10,225,225,0,1
07-01-2025,"Grains, Flours & Dals",White jowar.F 1 kg,4,100,80,20,1
07-01-2025,"Grains, Flours & Dals",Wheat Flour 1 kg,4,70,60,10,1
07-01-2025,"Grains, Flours & Dals",ANDU KORRALU (Brown top .mlt) 500,4,160,145,15,1
07-01-2025,"Grains, Flours & Dals",UDALU (Barnyard millet) 1 kg,4,140,115,25,1
07-01-2025,Oils & Ghee,Groundnut oil 1 L,9,360,330,30,1
07-01-2025,Spices & Seasonings,ROYAL SAFFRON 400GRMS,15,130,130,0,2
07-01-2025,"Dry Fruits, Nuts & Seeds",Groundnuts 1 kg,2,190,170,20,1
07-01-2025,Spices & Seasonings,Vamu 100GM,15,60,50,10,1
07-01-2025,"Dry Fruits, Nuts & Seeds",Putnalu 250GM,2,45,38,7,1
07-01-2025,Spices & Seasonings,NUVVULU 250GM,15,80,70,10,1
07-01-2025,Oils & Ghee,ANURAG RB OIL,9,120,100,20,1
07-01-2025,Snacks & Ready-to-Eat,SUNNUNDALU,14,120,100,20,1
07-01-2025,"Grains, Flours & Dals",RAGULU 1 KG,4,35,30,5,0.5
07-01-2025,"Health, Wellness & Ayurvedic Products",AMLAKI CHOORNAM,5,200,200,0,2
07-01-2025,Beverages,BRU GREEN LABEL 1.2G,1,24,24,0,12
07-01-2025,"Grains, Flours & Dals",DESI CHANA,4,25,25,0,1
07-01-2025,Oils & Ghee,Groundnut oil 1 L,9,360,330,30,1
07-01-2025,"Grains, Flours & Dals",Wheat Flour 2 kgs,4,140,120,20,1
07-01-2025,Snacks & Ready-to-Eat,VD BELLAM GAVVALU 200GM,14,60,60,0,1
07-01-2025,Snacks & Ready-to-Eat,Sprouted Ragi Biscuits 450GM,14,300,300,0,2
07-01-2025,Snacks & Ready-to-Eat,RSC ORANGE 100GMS,14,40,40,0,2
07-01-2025,"Dry Fruits, Nuts & Seeds",BLACK KISMIS 250GM,2,175,140,35,1
07-01-2025,Spices & Seasonings,RED COPRA 250GMS,15,85,74,11,1
07-01-2025,"Dry Fruits, Nuts & Seeds",Groundnuts 1 kg,2,190,170,20,1
07-01-2025,Beverages,BRU GREEN LABEL 1.2G,1,24,24,0,12
07-01-2025,"Grains, Flours & Dals",ANDU KORRALU (Browntop.m) 1 kg,4,320,290,30,1
07-01-2025,"Grains, Flours & Dals",Urad dall 1 Kg,4,185,170,15,1
07-01-2025,"Grains, Flours & Dals",Green gram 1 kg,4,150,130,20,1
07-01-2025,Personal Care & Cosmetics,CC BLACKHEAD CLEARING SCRUB,10,90,90,0,1
07-01-2025,"Dry Fruits, Nuts & Seeds",YELLOW KISHMISH 250GM,2,130,110,20,1
07-01-2025,Oils & Ghee,Coconut oil 1 L,9,440,400,40,1
07-01-2025,Oils & Ghee,Safflower oil 1 L,9,440,400,40,1
07-01-2025,"Dry Fruits, Nuts & Seeds",SATHVI CHIA SEEDS 100GM,2,100,80,20,1
07-01-2025,"Grains, Flours & Dals",Arikadu ( kodo),4,280,260,20,2
07-01-2025,"Grains, Flours & Dals",HS jowar idly rava 500 gms,4,65,65,0,1
07-01-2025,"Grains, Flours & Dals",ANDU KORRALU (Brown top .mlt) 500,4,160,150,10,1
07-01-2025,Oils & Ghee,Sesame oil 1 L,9,590,560,30,1
07-01-2025,"Grains, Flours & Dals",SAMALU (Little millet) 1 kg,4,340,260,80,2
07-01-2025,"Dry Fruits, Nuts & Seeds",FLAX SEEDS 250GM,2,60,50,10,1
07-01-2025,Oils & Ghee,Groundnut oil 1 L,9,360,330,30,1
07-01-2025,"Grains, Flours & Dals",KORRALU (FOXTAIL M) 1KG,4,300,220,80,2
07-01-2025,"Grains, Flours & Dals",UDALU (Barnyard millet) 1 kg,4,280,230,50,2
07-01-2025,Snacks & Ready-to-Eat,BATANA NGT 70GMS,14,40,40,0,2
07-01-2025,"Dry Fruits, Nuts & Seeds",PUMPKIN SEEDS 250GM,2,200,160,40,1
07-01-2025,Spices & Seasonings,RED COPRA 250GMS,15,85,74,11,1
07-01-2025,Snacks & Ready-to-Eat,ANNAPURNA APPALAM,14,35,35,0,1
07-01-2025,"Grains, Flours & Dals",PLAIN OATS 1KG,4,52.5,52.5,0,0.25
07-01-2025,Milk & Dairy,BROWN EGGS 1P,7,84,72,12,6
07-01-2025,Pickles & Cooking Pastes,DB Three Mango 1KG,11,56,50,6,2
07-01-2025,"Dry Fruits, Nuts & Seeds",SUNFLOWER SEEDS 250GRM,2,150,130,20,1
07-01-2025,Snacks & Ready-to-Eat,NGT CHATPATTA CHANA 90GM,14,50,50,0,2
07-01-2025,Snacks & Ready-to-Eat,AQUAGRANO DOSA BATTER,14,69,69,0,1
07-01-2025,Oils & Ghee,Groundnut oil 1 L,9,360,330,30,1
07-01-2025,Spices & Seasonings,TM MIRCH POWDER 200GM,15,163,163,0,1
07-01-2025,"Grains, Flours & Dals",CHANA DAL 1KG,4,140,120,20,1
07-01-2025,Oils & Ghee,Groundnut oil 1 L,9,360,330,30,1
07-01-2025,Snacks & Ready-to-Eat,BATANA NGT 70GMS,14,20,20,0,1
07-01-2025,"Grains, Flours & Dals",Multigrain 1 kg,4,100,85,15,1
07-01-2025,"Grains, Flours & Dals",Chana Flour 500 gms,4,70,65,5,1
07-01-2025,Snacks & Ready-to-Eat,Popcorn Seeds 250GM,14,45,40,5,1
07-01-2025,Snacks & Ready-to-Eat,MIGHTY PUFF,14,25,25,0,1
07-01-2025,"Grains, Flours & Dals",SRILALITHA MAIDA FLOUR 500G,4,32,32,0,1
07-01-2025,"Health, Wellness & Ayurvedic Products",RB FRUITS &amp;seeds Cranberries,5,45,45,0,1
07-01-2025,"Health, Wellness & Ayurvedic Products",RB Max Protein Fruit &amp;Nut 50g,5,75,75,0,1
07-01-2025,"Grains, Flours & Dals",THIN POHA 500GM,4,40,35,5,1
07-01-2025,"Grains, Flours & Dals",Chana Flour 500 gms,4,140,130,10,2
07-01-2025,"Grains, Flours & Dals",split black gram 1 kg,4,180,170,10,1
07-01-2025,"Grains, Flours & Dals",DESI CHANA,4,25,25,0,1
07-01-2025,Snacks & Ready-to-Eat,SD Atreyapuram DRY Fruit ghee,14,150,150,0,1
07-01-2025,Oils & Ghee,Groundnut oil 1 L,9,360,330,30,1
07-01-2025,"Dry Fruits, Nuts & Seeds",Groundnuts 1 kg,2,190,170,20,1
07-01-2025,Spices & Seasonings,DRY MIECHI 200GM,15,80,60,20,1
07-01-2025,Oils & Ghee,Sesame oil 1 L,9,590,560,30,1
07-01-2025,Milk & Dairy,BROWN EGGS 1P,7,168,144,24,12
07-01-2025,Oils & Ghee,Groundnut oil 500ml,9,180,165,15,1
07-01-2025,Spices & Seasonings,ROYAL SAFFRON 400GRMS,15,130,130,0,2
07-01-2025,"Grains, Flours & Dals",THIN POHA 500GM,4,40,35,5,1
07-01-2025,Oils & Ghee,Safflower oil 500 ml,9,220,200,20,1
07-01-2025,Snacks & Ready-to-Eat,GANTASALA BITTER GUARD SNACKS,14,60,60,0,1
07-01-2025,"Grains, Flours & Dals",Urad dall 1 Kg,4,185,170,15,1
07-01-2025,"Grains, Flours & Dals",KORRALU (FOXTAIL M) 500GM,4,65,55,10,1
07-01-2025,"Grains, Flours & Dals",Arikalu (kodo),4,70,65,5,1
07-01-2025,"Grains, Flours & Dals",THIN POHA 500GM,4,40,35,5,1
07-01-2025,"Grains, Flours & Dals",Red Chana 250GM,4,35,30,5,1
07-01-2025,"Grains, Flours & Dals",white Bobarlu 500 gms,4,80,75,5,1
07-01-2025,Snacks & Ready-to-Eat,SD black sesme laddu with dates 175gm,14,135,135,0,1
07-01-2025,Spices & Seasonings,Vamu 100GM,15,60,50,10,1
07-01-2025,"Grains, Flours & Dals",SAMALU (Little millet) 500 gms,4,85,65,20,1
07-01-2025,Snacks & Ready-to-Eat,SD Thati thandra 200gm,14,150,150,0,1
07-01-2025,Snacks & Ready-to-Eat,SD Ginger Candy 100g,14,60,60,0,1
07-01-2025,Spices & Seasonings,PRO SESAME 200GM,15,142,142,0,1
07-01-2025,Snacks & Ready-to-Eat,BATANA NGT 70GMS,14,80,80,0,4
07-01-2025,Snacks & Ready-to-Eat,PALLI LADDU 200GMS,14,180,140,40,2
07-01-2025,"Grains, Flours & Dals",VYS.SP RICE 1 KG,4,315,292.5,22.5,4.5
07-01-2025,Snacks & Ready-to-Eat,VD VAMUPUSA 175GM,14,60,60,0,1
07-01-2025,Snacks & Ready-to-Eat,SATHVI REGIVADA 200GM,14,80,60,20,1
07-01-2025,Snacks & Ready-to-Eat,SH PUFFED RICE 500GM,14,112,112,0,1
07-01-2025,"Grains, Flours & Dals",Black gram 500 gms,4,75,70,5,1
07-01-2025,Spices & Seasonings,ROYAL SAFFRON 400GRMS,15,65,65,0,1
07-01-2025,"Grains, Flours & Dals",PESARA PAPPU 1 KG,4,170,145,25,1
07-01-2025,Sweeteners,YB JAGGERY POWDER 1KG,16,140,140,0,1
07-01-2025,"Grains, Flours & Dals",White jowar.F 1 kg,4,100,80,20,1
07-01-2025,"Grains, Flours & Dals",Chana Flour 1 kg,4,140,130,10,1
07-01-2025,General Household & Kitchenware,MATCH BOX,3,20,20,0,1
07-01-2025,Personal Care & Cosmetics,UVIS ROSEWATER 100ML,10,49,49,0,1
07-01-2025,Spices & Seasonings,NUVVULU 500GM,15,200,170,30,1
07-01-2025,"Grains, Flours & Dals",Bajra Flour 1 kg,4,70,60,10,1
07-01-2025,"Grains, Flours & Dals",HS RAGI Idly rava 500 gms,4,70,70,0,1
07-01-2025,Oils & Ghee,Coconut oil 500 ml,9,220,200,20,1
07-01-2025,Beverages,ASSAM TEA GINGER TEA POWDER 250GM,1,199,199,0,1
07-01-2025,"Grains, Flours & Dals",PESARA PAPPU 500GMS,4,85,75,10,1
07-01-2025,Spices & Seasonings,Chilli powder 500 gms,15,290,210,80,1
07-01-2025,Beverages,TAJ MAHAL 100GM,1,95,95,0,1
07-01-2025,"Grains, Flours & Dals",Bombay Rava 500GM,4,35,30,5,1
07-01-2025,"Grains, Flours & Dals",POORI ATTA 1KG,4,60,55,5,1
07-01-2025,"Grains, Flours & Dals",FLOUR CHARGE,4,42,42,0,3.5
07-01-2025,Spices & Seasonings,RED COPRA 250GMS,15,85,74,11,1
07-01-2025,Baking & Cooking Aids,GONDH 50GRMS,0,100,80,20,2
07-01-2025,"Dry Fruits, Nuts & Seeds",WATERMELON SEEDS 250GRM,2,320,280,40,1
07-01-2025,"Dry Fruits, Nuts & Seeds",PUMPKIN SEEDS 250GM,2,200,160,40,1
07-01-2025,Pooja & Spiritual Items,GD Sree Chandan 50GM,12,50,50,0,1
07-01-2025,"Health, Wellness & Ayurvedic Products",MD Triphala Chorrnam 100GM,5,80,80,0,1
07-01-2025,Snacks & Ready-to-Eat,ZEEDI,14,70,70,0,1
07-01-2025,Snacks & Ready-to-Eat,SALTED PHALLI,14,65,65,0,1
07-01-2025,"Health, Wellness & Ayurvedic Products",MD Gandha Karchural Choornam 30GM,5,60,60,0,1
07-01-2025,Snacks & Ready-to-Eat,BD PEARL MILLET NOODLES 200G,14,70,70,0,1
07-01-2025,"Health, Wellness & Ayurvedic Products",BRAHMI CHOORNAM 100GM,5,100,100,0,1
07-01-2025,Pooja & Spiritual Items,PACHI KARPURAM 25GM,12,90,90,0,1
07-01-2025,Pooja & Spiritual Items,SS DASANGAM CONE 20PICS,12,45,45,0,1
07-01-2025,Snacks & Ready-to-Eat,PALLI LADDU 200GMS,14,90,70,20,1
07-01-2025,Pooja & Spiritual Items,GOMATHA AGARBATHI,12,75,75,0,1
07-01-2025,Spices & Seasonings,EVEREST PANI PURI MASALA 50GM,15,40,40,0,1
07-01-2025,"Grains, Flours & Dals",RAGI FLOUR 500GRMS,4,40,35,5,1
07-01-2025,"Grains, Flours & Dals",Bombay Rava 500GM,4,35,30,5,1
07-01-2025,"Grains, Flours & Dals",VGR rice 1 kg,4,140,130,10,2
07-01-2025,"Grains, Flours & Dals",CORN FOUR 250GM,4,40,35,5,1
07-01-2025,"Grains, Flours & Dals",Chana Flour 500 gms,4,70,65,5,1
07-01-2025,Snacks & Ready-to-Eat,Pani Poori Chips 250GM,14,50,40,10,1
07-01-2025,"Grains, Flours & Dals",SRILALITHA MAIDA FLOUR 500G,4,32,32,0,1
07-01-2025,"Grains, Flours & Dals",WHITE BATANI,4,40,30,10,1
07-01-2025,Milk & Dairy,SANGAM TONED MILK 500ML,7,30,30,0,1
07-01-2025,"Grains, Flours & Dals",Chana Flour 500 gms,4,70,65,5,1
07-01-2025,Snacks & Ready-to-Eat,NGT CHATPATTA CHANA 90GM,14,50,50,0,2
07-01-2025,"Dry Fruits, Nuts & Seeds",ANJEER 250GM,2,400,360,40,1
07-01-2025,Snacks & Ready-to-Eat,NGT CHATPATTA CHANA 90GM,14,25,25,0,1
07-01-2025,Snacks & Ready-to-Eat,SESAME LADDU 200GM,14,100,80,20,1
07-01-2025,"Grains, Flours & Dals",MELMEKER 250GMS,4,60,45,15,1
07-01-2025,Personal Care & Cosmetics,OVAL BODY LOOFAH,10,55,55,0,1
07-01-2025,"Grains, Flours & Dals",Chana Flour 500 gms,4,70,65,5,1
07-01-2025,"Dry Fruits, Nuts & Seeds",CASHEW 250GM,2,340,310,30,1
07-01-2025,"Dry Fruits, Nuts & Seeds",PUMPKIN SEEDS 250GM,2,200,160,40,1
07-01-2025,"Dry Fruits, Nuts & Seeds",ALMONDS 250GM,2,280,260,20,1
07-01-2025,"Grains, Flours & Dals",RAGI FLOUR 1KG,4,80,70,10,1
07-01-2025,"Grains, Flours & Dals",BASMATHI RICE 1KG,4,150,135,15,1
07-01-2025,"Grains, Flours & Dals",RAGI FLOUR 1KG,4,80,70,10,1
07-01-2025,Snacks & Ready-to-Eat,TILLI CHIKKI,14,125,125,0,1
07-01-2025,Snacks & Ready-to-Eat,RSC ORANGE 100GMS,14,60,60,0,3
07-01-2025,Snacks & Ready-to-Eat,PALLI LADDU 200GMS,14,180,140,40,2
07-01-2025,"Grains, Flours & Dals",Multigrain 1 kg,4,100,85,15,1
07-01-2025,"Grains, Flours & Dals",Wheat Rava M 500GM,4,66,60,6,2
07-01-2025,Sweeteners,MADHUR SUGAR 1KG,16,65,55,10,1
07-01-2025,"Grains, Flours & Dals",Red Wheat Flour 1 kg,4,140,130,10,1
07-01-2025,"Grains, Flours & Dals",CHANA DAL 500GM,4,70,60,10,1
07-01-2025,Snacks & Ready-to-Eat,SALTED PHALLI,14,65,65,0,1
07-01-2025,"Grains, Flours & Dals",PESARA PAPPU 500GMS,4,85,75,10,1
07-01-2025,Snacks & Ready-to-Eat,NGT CHATPATTA CHANA 90GM,14,25,25,0,1
07-01-2025,"Grains, Flours & Dals",DH URAD GOTA 1KG,4,215,190,25,1
07-01-2025,Spices & Seasonings,Vamu 100GM,15,60,50,10,1
07-01-2025,"Grains, Flours & Dals",SH WHITE POHA,4,75,75,0,1
07-01-2025,Snacks & Ready-to-Eat,ELITE MILK RUSK 200GM,14,70,70,0,2
07-01-2025,Oils & Ghee,Groundnut oil 1 L,9,720,660,60,2
07-01-2025,Oils & Ghee,Groundnut oil 1 L,9,1080,990,90,3
07-01-2025,"Grains, Flours & Dals",RAGI FLOUR 1KG,4,80,70,10,1
07-01-2025,Snacks & Ready-to-Eat,SF RED MIX 90GM,14,40,40,0,1
07-01-2025,Snacks & Ready-to-Eat,RSC ORANGE 100GMS,14,20,20,0,1
07-01-2025,"Grains, Flours & Dals",VGR rice 1 kg,4,350,325,25,5
07-01-2025,"Grains, Flours & Dals",AISHWARYA SP 1KG,4,400,375,25,5
07-01-2025,"Grains, Flours & Dals",RAGI FLOUR 1KG,4,80,70,10,1
07-01-2025,Oils & Ghee,Groundnut oil 1 L,9,360,330,30,1
07-01-2025,Snacks & Ready-to-Eat,SESAME LADDU 200GM,14,100,80,20,1
07-01-2025,"Health, Wellness & Ayurvedic Products",ORGANIC MORINGA POWER 100GM,5,249,249,0,1
07-01-2025,Snacks & Ready-to-Eat,VD SAGOPAPAD 150GM,14,55,55,0,1
07-01-2025,Snacks & Ready-to-Eat,SD Aswagandha with palm Jaggery250Gm,14,135,135,0,1
07-01-2025,Oils & Ghee,BUFFALLO GHEE 500ML,9,410,370,40,1
07-01-2025,Oils & Ghee,Coconut oil 1 L,9,440,400,40,1
07-01-2025,Oils & Ghee,Coconut oil 1 L,9,440,400,40,1
07-01-2025,"Grains, Flours & Dals",Arikadu ( kodo),4,140,130,10,1
07-01-2025,"Grains, Flours & Dals",SAMALU (Little millet) 1 kg,4,170,130,40,1
07-01-2025,"Grains, Flours & Dals",UDALU (Barnyard millet) 1 kg,4,140,115,25,1
07-01-2025,"Grains, Flours & Dals",KORRALU (FOXTAIL M) 1KG,4,150,110,40,1
07-01-2025,"Grains, Flours & Dals",ANDU KORRALU (Browntop.m) 1 kg,4,320,290,30,1
07-01-2025,Beverages,BRU GREEN LABEL 200G,1,140,140,0,1
07-01-2025,Beverages,BRU GREEN LABEL 1.2G,1,20,20,0,10
07-01-2025,"Grains, Flours & Dals",JOWAR WHITE 1 KG,4,80,70,10,1
07-01-2025,"Grains, Flours & Dals",SRILALITHA MAIDA FLOUR 500G,4,32,32,0,1
07-01-2025,Sweeteners,YB FOREST HONEY 250GM,16,360,360,0,2
07-01-2025,Personal Care & Cosmetics,OVAL BODY LOOFAH,10,55,55,0,1
07-01-2025,"Grains, Flours & Dals",YB NAVARA RICE 500GM,4,100,100,0,1
07-01-2025,Snacks & Ready-to-Eat,MILK BREAD,14,55,55,0,1
07-01-2025,Spices & Seasonings,Turmeric powder 250 gms,15,100,75,25,1
07-01-2025,Pooja & Spiritual Items,GB Bharatha Woods 75GM,12,60,60,0,1
07-01-2025,Personal Care & Cosmetics,KHADI LEMONGRASS SOAP 125GM,10,80,80,0,1
07-01-2025,Personal Care & Cosmetics,KHADI ALMOND SOAP 125GM,10,80,80,0,1
07-01-2025,Milk & Dairy,BROWN EGGS TRAY 30P,7,360,330,30,1
07-01-2025,Pooja & Spiritual Items,GD Ramayana Sandal 75GM,12,60,60,0,1
07-01-2025,Oils & Ghee,Groundnut oil 1 L,9,360,330,30,1
07-01-2025,Sweeteners,MADHUR SUGAR 1KG,16,65,55,10,1
07-01-2025,Oils & Ghee,Black Sesame oil 500 ml,9,220,190,30,1
07-01-2025,Personal Care & Cosmetics,HERBAL BATH POWDER 200GM,10,80,80,0,1
07-01-2025,Spices & Seasonings,Jeera 100GM,15,50,45,5,1
07-01-2025,"Dry Fruits, Nuts & Seeds",Putnalu 250GM,2,45,38,7,1
07-01-2025,"Dry Fruits, Nuts & Seeds",Groundnuts 500 gms,2,95,85,10,1
06-01-2025,Oils & Ghee,Sesame oil 500ml,9,295,280,15,1
06-01-2025,Oils & Ghee,Groundnut oil 5 L,9,1800,"1,600.00",200,1
06-01-2025,Oils & Ghee,Groundnut oil 1 L,9,360,330,30,1
06-01-2025,"Grains, Flours & Dals",MUSTARD CAKE,4,50,50,0,1
06-01-2025,Personal Care & Cosmetics,SVE MULTANI MITTI SOAP 100GM,10,90,90,0,1
06-01-2025,"Health, Wellness & Ayurvedic Products",MADDI NEEM OIL 100ML,5,110,110,0,1
06-01-2025,Personal Care & Cosmetics,DWI FOOT CARE 30G,10,90,90,0,1
06-01-2025,Personal Care & Cosmetics,DWI NEEM TULSI SOAP 100GM,10,150,150,0,2
06-01-2025,"Dry Fruits, Nuts & Seeds",Putnalu 250GM,2,90,76,14,2
06-01-2025,"Grains, Flours & Dals",CHANA DAL 500GM,4,70,60,10,1
06-01-2025,Snacks & Ready-to-Eat,Popcorn Seeds 250GM,14,45,40,5,1
06-01-2025,"Dry Fruits, Nuts & Seeds",Groundnuts 1 kg,2,190,170,20,1
06-01-2025,Snacks & Ready-to-Eat,BD LITTLE MILLET NOODLES 200G,14,75,75,0,1
06-01-2025,Snacks & Ready-to-Eat,PEANUT CHILLI,14,5,5,0,1
06-01-2025,Snacks & Ready-to-Eat,TILLI CHIKKI,14,5,5,0,1
06-01-2025,"Grains, Flours & Dals",UDALU (Barnyard millet) 1 kg,4,140,115,25,1
06-01-2025,"Grains, Flours & Dals",SAMALU (Little millet) 1 kg,4,170,130,40,1
06-01-2025,"Grains, Flours & Dals",KORRALU (FOXTAIL M) 1KG,4,150,110,40,1
06-01-2025,"Grains, Flours & Dals",Arikadu ( kodo),4,140,130,10,1
06-01-2025,Snacks & Ready-to-Eat,VD MURUKU 175GM,14,60,60,0,1
06-01-2025,"Grains, Flours & Dals",Wheat Flour 1 kg,4,70,60,10,1
06-01-2025,Snacks & Ready-to-Eat,VD VAMUPUSA 175GM,14,60,60,0,1
06-01-2025,Snacks & Ready-to-Eat,VD Pappu Chekkalu 190gm,14,60,60,0,1
06-01-2025,Spices & Seasonings,Turmeric powder 250 gms,15,100,75,25,1
06-01-2025,Snacks & Ready-to-Eat,VD SANNAPUSA 175GM,14,60,60,0,1
06-01-2025,"Grains, Flours & Dals",BARLEY FLOUR 500GM,4,90,80,10,1
06-01-2025,Spices & Seasonings,SAMBAR POWDER 200GM,15,150,130,20,1
06-01-2025,Oils & Ghee,Groundnut oil 1 L,9,720,660,60,2
06-01-2025,"Grains, Flours & Dals",Wheat Flour 1 kg,4,140,120,20,2
06-01-2025,Oils & Ghee,Sesame oil 500ml,9,295,280,15,1
06-01-2025,"Grains, Flours & Dals",VGR RICE bag 1,4,1899,"1,650.00",249,1
06-01-2025,"Grains, Flours & Dals",UDALU (Barnyard millet) 1 kg,4,140,115,25,1
06-01-2025,"Grains, Flours & Dals",SAMALU (Little millet) 1 kg,4,170,130,40,1
06-01-2025,"Dry Fruits, Nuts & Seeds",PUMPKIN SEEDS 250GM,2,200,160,40,1
06-01-2025,"Grains, Flours & Dals",KORRALU (FOXTAIL M) 1KG,4,150,110,40,1
06-01-2025,"Grains, Flours & Dals",BARLEY SEEDS 250GMS,4,40,35,5,1
06-01-2025,Spices & Seasonings,Black Till 250GM,15,360,300,60,4
06-01-2025,"Grains, Flours & Dals",SL Suji Rava 500GM,4,32,32,0,1
06-01-2025,"Grains, Flours & Dals",Arikadu ( kodo),4,140,130,10,1
06-01-2025,"Grains, Flours & Dals",ANDU KORRALU (Brown top .mlt) 500,4,320,300,20,2
06-01-2025,"Dry Fruits, Nuts & Seeds",SUNFLOWER SEEDS 250GRM,2,150,130,20,1
06-01-2025,"Grains, Flours & Dals",HS jowar idly rava 500 gms,4,65,65,0,1
06-01-2025,"Dry Fruits, Nuts & Seeds",SATHVI CHIA SEEDS 100GM,2,100,80,20,1
06-01-2025,"Grains, Flours & Dals",RAGULU 1 KG,4,35,30,5,0.5
06-01-2025,Snacks & Ready-to-Eat,ZEEDI,14,70,70,0,1
06-01-2025,"Grains, Flours & Dals",BAJRA 1 KG,4,30,25,5,0.5
06-01-2025,"Grains, Flours & Dals",KORRALU (FOXTAIL M) 500GM,4,65,55,10,1
06-01-2025,"Grains, Flours & Dals",BARLEY SEEDS 250GMS,4,40,35,5,1
06-01-2025,Spices & Seasonings,SATHVI GREEN SOUNF 100GM,15,60,40,20,1
06-01-2025,"Grains, Flours & Dals",Multigrain 1 kg,4,100,85,15,1
06-01-2025,"Grains, Flours & Dals",EM Ragi idli R 500G,4,75,75,0,1
06-01-2025,Snacks & Ready-to-Eat,PEANUT CHILLI,14,10,10,0,2
06-01-2025,Snacks & Ready-to-Eat,SD BLACK GRAM PAPADS,14,160,160,0,2
06-01-2025,"Dry Fruits, Nuts & Seeds",GF KIMIA DATES 500GM,2,310,190,120,1
06-01-2025,"Grains, Flours & Dals",Wheat Flour 1 kg,4,140,120,20,2
06-01-2025,Oils & Ghee,Safflower oil 1 L,9,440,400,40,1
06-01-2025,Spices & Seasonings,Masala Karam 500 gms,15,260,240,20,1
06-01-2025,Personal Care & Cosmetics,MULTANI MITTI CHOORNAM,10,40,40,0,1
06-01-2025,"Grains, Flours & Dals",CHANA DAL 1KG,4,140,120,20,1
06-01-2025,Snacks & Ready-to-Eat,BLACK SESAME CHIKKI,14,5,5,0,1
06-01-2025,"Grains, Flours & Dals",FLOUR CHARGE,4,30,30,0,2.5
06-01-2025,"Health, Wellness & Ayurvedic Products",MD Tulasi Leaf Powder 50GM,5,240,240,0,3
06-01-2025,"Grains, Flours & Dals",RAGI FLOUR 500GRMS,4,40,35,5,1
06-01-2025,Oils & Ghee,Groundnut oil 1 L,9,720,660,60,2
06-01-2025,"Grains, Flours & Dals",turdal 500 gms,4,110,100,10,1
06-01-2025,"Grains, Flours & Dals",CHANA DAL 500GM,4,70,60,10,1
06-01-2025,"Dry Fruits, Nuts & Seeds",Putnalu 250GM,2,45,38,7,1
06-01-2025,"Grains, Flours & Dals",PESARA PAPPU 500GMS,4,85,75,10,1
06-01-2025,Spices & Seasonings,Gasagasalu 50GM,15,130,110,20,1
06-01-2025,Oils & Ghee,Coconut oil 500 ml,9,220,200,20,1
06-01-2025,Oils & Ghee,Safflower oil 1 L,9,440,400,40,1
06-01-2025,Oils & Ghee,GANTASALA A2 COW GHEE 250ML,9,299,299,0,1
06-01-2025,Oils & Ghee,Freedom Rice Bran Oil 1L,9,194,180,14,1
06-01-2025,Milk & Dairy,TOTAL CURD 50GMS,7,10,10,0,1
06-01-2025,"Grains, Flours & Dals",JOWAR WHITE 1 KG,4,80,70,10,1
06-01-2025,"Grains, Flours & Dals",Urad dall 1 Kg,4,370,340,30,2
06-01-2025,Beverages,RED LABEL 100GM,1,50,50,0,1
06-01-2025,"Grains, Flours & Dals",BOMBAY RAVA,4,140,110,30,2
06-01-2025,Sweeteners,MADHUR SUGAR 1KG,16,65,55,10,1
06-01-2025,Oils & Ghee,Freedom Rice Bran Oil 1L,9,194,180,14,1
06-01-2025,"Health, Wellness & Ayurvedic Products",DWI LAVANGA TAILA 20ML,5,60,60,0,1
06-01-2025,Spices & Seasonings,Chilli powder 500 gms,15,290,210,80,1
06-01-2025,Spices & Seasonings,Jeera 100GM,15,50,45,5,1
06-01-2025,Spices & Seasonings,Chilli powder 1 kg,15,2900,"2,100.00",800,5
06-01-2025,Oils & Ghee,Safflower oil 1 L,9,440,400,40,1
06-01-2025,Snacks & Ready-to-Eat,SS IDLY BATTER 1KG,14,60,60,0,1
06-01-2025,"Grains, Flours & Dals",Bombay Rava 500GM,4,35,30,5,1
06-01-2025,Spices & Seasonings,AV Iodized Salt 1KG,15,56,50,6,2
06-01-2025,Oils & Ghee,Groundnut oil 1 L,9,360,330,30,1
06-01-2025,Personal Care & Cosmetics,GOW DURBAR 75G,10,60,60,0,1
06-01-2025,"Grains, Flours & Dals",turdal 500 gms,4,110,100,10,1
06-01-2025,Pooja & Spiritual Items,GD Kailash 60 GM,12,60,60,0,1
06-01-2025,"Grains, Flours & Dals",Wheat Rava M 500GM,4,33,30,3,1
06-01-2025,Spices & Seasonings,DB CRYSTAL SALT 1KG,15,25,25,0,1
06-01-2025,Pooja & Spiritual Items,GD JASMINE 75GM,12,60,60,0,1
06-01-2025,Spices & Seasonings,AVALU 100GM,15,25,20,5,1
06-01-2025,"Dry Fruits, Nuts & Seeds",Groundnuts 1 kg,2,380,340,40,2
06-01-2025,"Grains, Flours & Dals",BAJRA 1 KG,4,120,100,20,2
06-01-2025,"Grains, Flours & Dals",Urad dall 1 Kg,4,370,340,30,2
06-01-2025,Snacks & Ready-to-Eat,ANNAPURNA APPALAM,14,70,70,0,2
06-01-2025,"Grains, Flours & Dals",Idly Rava L 1KG,4,120,100,20,2
06-01-2025,"Grains, Flours & Dals",BLACK GRAM 1KG,4,300,280,20,2
06-01-2025,"Dry Fruits, Nuts & Seeds",PUTNALU 500GMS,2,90,76,14,1
06-01-2025,"Grains, Flours & Dals",JOWAR YELLOW 1 K,4,180,180,0,2
06-01-2025,Sweeteners,SUGAR 1KG,16,60,50,10,1
06-01-2025,"Dry Fruits, Nuts & Seeds",YELLOW KISHMISH 250GM,2,130,110,20,1
06-01-2025,Sweeteners,SUGAR 500 GM,16,30,25,5,1
06-01-2025,"Grains, Flours & Dals",DESI CHANA,4,25,25,0,1
06-01-2025,"Dry Fruits, Nuts & Seeds",KAJU HALF 250GM,2,310,290,20,1
06-01-2025,Snacks & Ready-to-Eat,SALTED PHALLI,14,65,65,0,1
06-01-2025,"Grains, Flours & Dals",SH ROASTED SOOJI 500GM,4,66,59,7,1
06-01-2025,Oils & Ghee,Mustard oil 1 L,9,440,390,50,1
06-01-2025,Oils & Ghee,Castor oil 200 ml,9,100,80,20,1
06-01-2025,Spices & Seasonings,Chilli powder 500 gms,15,580,420,160,2
06-01-2025,"Grains, Flours & Dals",White jowar.F 1 kg,4,100,80,20,1
06-01-2025,"Grains, Flours & Dals",KORRALU (FOXTAIL M) 500GM,4,65,55,10,1
06-01-2025,Snacks & Ready-to-Eat,PN ORGANIC PUFFED RICE 200GM,14,55,55,0,1
06-01-2025,Personal Care & Cosmetics,Soapnut 500GM,10,120,120,0,1
06-01-2025,Snacks & Ready-to-Eat,SF MIGHTY PUFFS,14,25,25,0,1
06-01-2025,Oils & Ghee,Groundnut oil 1 L,9,360,330,30,1
06-01-2025,Snacks & Ready-to-Eat,RAGI LADDU,14,120,120,0,1
06-01-2025,"Grains, Flours & Dals",Idly Rava L 1KG,4,60,50,10,1
06-01-2025,"Grains, Flours & Dals",VYS.SP.RICE 5 KGS,4,350,325,25,1
06-01-2025,Snacks & Ready-to-Eat,SUNNUNDALU 200GM,14,120,120,0,1
06-01-2025,Household & Cleaning,VIM 300GM,6,30,30,0,1
06-01-2025,"Grains, Flours & Dals",Wheat Flour 1 kg,4,210,180,30,3
06-01-2025,"Grains, Flours & Dals",UDALU (Barnyard millet) 1 kg,4,280,230,50,2
06-01-2025,Oils & Ghee,Groundnut oil 1 L,9,360,330,30,1
06-01-2025,Oils & Ghee,Sesame oil 500ml,9,295,280,15,1
06-01-2025,"Grains, Flours & Dals",MELMEKER 250GMS,4,60,45,15,1
06-01-2025,Snacks & Ready-to-Eat,KURNOOL MARMURA,14,70,55,15,1
06-01-2025,Beverages,BRU GREEN LABEL 1.2G,1,24,24,0,12
06-01-2025,"Grains, Flours & Dals",VYS.SP RICE 1 KG,4,140,130,10,2
06-01-2025,"Grains, Flours & Dals",RAGI FLOUR 1KG,4,80,70,10,1
06-01-2025,"Grains, Flours & Dals",KORRALU (FOXTAIL M) 500GM,4,65,55,10,1
06-01-2025,Snacks & Ready-to-Eat,SD Vamu with palm jaggery 250gm,14,135,135,0,1
06-01-2025,"Dry Fruits, Nuts & Seeds",DRIED KIWI 200GM,2,145,130,15,1
06-01-2025,"Dry Fruits, Nuts & Seeds",PULMAKHANA 100 GM,2,180,170,10,1
06-01-2025,Beverages,TAJ MAHAL 250GM,1,235,235,0,1
06-01-2025,Oils & Ghee,Groundnut oil 1 L,9,360,330,30,1
06-01-2025,Snacks & Ready-to-Eat,VD ATUKULU MIXTURE 175GM,14,60,60,0,1
06-01-2025,"Grains, Flours & Dals",Arikadu ( kodo),4,140,130,10,1
06-01-2025,Snacks & Ready-to-Eat,NGT CHATPATTA CHANA 90GM,14,25,25,0,1
06-01-2025,Snacks & Ready-to-Eat,PALLI LADDU 200GMS,14,90,70,20,1
06-01-2025,Snacks & Ready-to-Eat,SD Moringa with plam jaggery 250gm,14,135,135,0,1
06-01-2025,"Dry Fruits, Nuts & Seeds",SUNFLOWER SEEDS 250GRM,2,150,130,20,1
06-01-2025,"Grains, Flours & Dals",PESARA PAPPU 1 KG,4,170,145,25,1
06-01-2025,"Grains, Flours & Dals",SAMALU (Little millet) 1 kg,4,170,130,40,1
06-01-2025,Pickles & Cooking Pastes,SD GINGER PICKLE 250GM,11,110,110,0,1
06-01-2025,"Grains, Flours & Dals",UDALU (Barnyard millet) 1 kg,4,140,115,25,1
06-01-2025,"Dry Fruits, Nuts & Seeds",FLAX SEEDS 250GM,2,60,50,10,1
06-01-2025,"Dry Fruits, Nuts & Seeds",PUMPKIN SEEDS 250GM,2,200,160,40,1
06-01-2025,"Grains, Flours & Dals",RAGI FLOUR 1KG,4,80,70,10,1
06-01-2025,"Grains, Flours & Dals",KORRALU (FOXTAIL M) 1KG,4,150,110,40,1
06-01-2025,Personal Care & Cosmetics,UVIS HENNA 100GM,10,75,75,0,1
06-01-2025,"Health, Wellness & Ayurvedic Products",SHIKAKAI CHOORNAM,5,80,80,0,1
06-01-2025,"Grains, Flours & Dals",Wheat Flour 1 kg,4,70,60,10,1
06-01-2025,"Grains, Flours & Dals",white Bobarlu 500 gms,4,80,75,5,1
06-01-2025,"Grains, Flours & Dals",Red Chana 500 GM,4,75,60,15,1
06-01-2025,Sweeteners,Natural Honey 500 gms,16,280,240,40,1
06-01-2025,Sweeteners,YB Brown Sugar 500GM,16,75,75,0,1
06-01-2025,"Grains, Flours & Dals",SABDANA,4,40,35,5,1
06-01-2025,"Health, Wellness & Ayurvedic Products",NEELI LEAF CHOORNAM,5,110,110,0,1
06-01-2025,Pooja & Spiritual Items,ZED BLACK PREMIUM STICKS 3 IN 1 100G,12,60,60,0,1
06-01-2025,"Grains, Flours & Dals",SAMALU (Little millet) 500 gms,4,85,65,20,1
06-01-2025,Spices & Seasonings,Tamarind 250GMS,15,160,130,30,2
06-01-2025,"Grains, Flours & Dals",SRILALITHA MAIDA FLOUR 500G,4,32,32,0,1
06-01-2025,Sweeteners,MISHRI 250 GM,16,35,30,5,1
06-01-2025,Milk & Dairy,BROWN EGGS 1P,7,84,72,12,6
06-01-2025,Spices & Seasonings,Jeera 100GM,15,50,45,5,1
06-01-2025,"Grains, Flours & Dals",URAD DALL,4,95,85,10,1
06-01-2025,"Grains, Flours & Dals",RAGULU 1 KG,4,140,120,20,2
06-01-2025,Oils & Ghee,Groundnut oil 500ml,9,180,165,15,1
06-01-2025,"Grains, Flours & Dals",WHEAT 1 KG,4,120,100,20,2
06-01-2025,Beverages,TAJ MAHAL 100GM,1,95,95,0,1
06-01-2025,Sweeteners,SUGAR 500 GM,16,30,25,5,1
06-01-2025,Snacks & Ready-to-Eat,MIX MILLET NOODLES,14,75,75,0,1
06-01-2025,Sweeteners,MISHRI 250 GM,16,35,30,5,1
06-01-2025,"Health, Wellness & Ayurvedic Products",MORINGA LEAF POWDER M,5,80,75,5,1
06-01-2025,"Grains, Flours & Dals",MELMEKER 250GMS,4,60,45,15,1
06-01-2025,"Dry Fruits, Nuts & Seeds",DRYDATES 250GM,2,150,120,30,1
06-01-2025,Spices & Seasonings,Chilli powder 500 gms,15,290,210,80,1
06-01-2025,Snacks & Ready-to-Eat,NGT CHATPATTA CHANA 90GM,14,25,25,0,1
06-01-2025,Oils & Ghee,Sesame oil 1 L,9,590,560,30,1
06-01-2025,Oils & Ghee,Groundnut oil 1 L,9,360,330,30,1
06-01-2025,"Grains, Flours & Dals",PRO ORG IDLY RAVA 1KG,4,145,145,0,1
06-01-2025,Household & Cleaning,VIM TROPICAL LEMON FRESHNESS 250ML,6,55,55,0,1
06-01-2025,"Grains, Flours & Dals",PN ORGANIC URAD WHITE WHOLE 500GM,4,158,158,0,1
06-01-2025,Personal Care & Cosmetics,WHISPER NIGHTS XXL+350MM 6PADS,10,130,130,0,1
06-01-2025,Snacks & Ready-to-Eat,MB PEARL MILLET NOODLES 180GM,14,95,95,0,1
06-01-2025,Milk & Dairy,BROWN EGGS 1P,7,56,48,8,4
06-01-2025,"Grains, Flours & Dals",Wheat Flour 1 kg,4,140,120,20,2
06-01-2025,Snacks & Ready-to-Eat,BD BARELY NOODLES 200G,14,75,75,0,1
06-01-2025,"Grains, Flours & Dals",RICE FLOUR 500 GM,4,35,28,7,1
06-01-2025,Snacks & Ready-to-Eat,FOXTAIL NOODLES,14,75,75,0,1
06-01-2025,"Dry Fruits, Nuts & Seeds",PUMPKIN SEEDS 250GM,2,200,160,40,1
06-01-2025,Sweeteners,MADHUR SUGAR 1KG,16,65,55,10,1
06-01-2025,Snacks & Ready-to-Eat,BB ROASTED VERMICELLY 850GM,14,117,117,0,1
06-01-2025,Sweeteners,YB FOREST HONEY 250GM,16,180,180,0,1
06-01-2025,"Dry Fruits, Nuts & Seeds",PN ORGANIC MAKHANA 50GM,2,125,125,0,1
06-01-2025,Sweeteners,YB JAGGERY POWDER 1KG,16,280,280,0,2
06-01-2025,"Grains, Flours & Dals",CHANA DAL 1KG,4,140,120,20,1
06-01-2025,Oils & Ghee,DWI VATADATEL 50ML,9,155,155,0,1
06-01-2025,"Grains, Flours & Dals",RED WHEAT 1 KG,4,650,600,50,5
06-01-2025,"Grains, Flours & Dals",Multigrain 1 kg,4,100,85,15,1
06-01-2025,"Grains, Flours & Dals",VYS.SP.RICE BAG 1,4,1800,"1,650.00",150,1
06-01-2025,Sweeteners,YB JAGGERY POWDER 500GMS,16,75,75,0,1
06-01-2025,Spices & Seasonings,Chilli powder 500 gms,15,290,210,80,1
06-01-2025,Oils & Ghee,Groundnut oil 5 L,9,1800,"1,600.00",200,1
06-01-2025,"Grains, Flours & Dals",HS Multimillet idly R 500 gms,4,65,65,0,1
06-01-2025,"Grains, Flours & Dals",HS RAGI Idly rava 500 gms,4,70,70,0,1
06-01-2025,Snacks & Ready-to-Eat,GANTASALA FLAX SEEDS SPICY,14,90,90,0,1
06-01-2025,Spices & Seasonings,GS Moringa Leaves Spicy Powder 100GM,15,180,180,0,2
06-01-2025,"Grains, Flours & Dals",VYS.SP.RICE 5 KGS,4,350,325,25,1
06-01-2025,"Grains, Flours & Dals",Multigrain 1 kg,4,100,85,15,1
06-01-2025,Spices & Seasonings,JEERA 250 gms,15,125,105,20,1
06-01-2025,Oils & Ghee,UVIS MUSTARD OIL 100ML,9,110,110,0,1
06-01-2025,"Grains, Flours & Dals",Yellow jowar .F1 kg,4,110,100,10,1
06-01-2025,Snacks & Ready-to-Eat,SALTED PHALLI,14,65,65,0,1
06-01-2025,"Grains, Flours & Dals",Black uluvalu 500 gms,4,90,70,20,1
06-01-2025,"Dry Fruits, Nuts & Seeds",CASHEW 250GM,2,340,310,30,1
06-01-2025,Personal Care & Cosmetics,COLGATE STRONG TEETH,10,20,20,0,1
06-01-2025,"Grains, Flours & Dals",SH RED POHA 500GM,4,75,75,0,1
06-01-2025,Beverages,BISLERI WATER 1L,1,20,20,0,1
06-01-2025,"Grains, Flours & Dals",BOMBAY RAVA,4,70,55,15,1
06-01-2025,Milk & Dairy,HRITAGE TONED MILK 500ML,7,30,30,0,1
06-01-2025,Snacks & Ready-to-Eat,SATHVI PALLI CHIKKI 200GM,14,100,80,20,1
06-01-2025,Milk & Dairy,SANGAM TONED MILK 500ML,7,30,30,0,1
06-01-2025,Pooja & Spiritual Items,SWASTIK CAMPHOR 25GM,12,45,45,0,1
06-01-2025,Oils & Ghee,Groundnut oil 1 L,9,360,330,30,1
06-01-2025,Oils & Ghee,Cow ghee 500 ml,9,430,390,40,1
06-01-2025,Oils & Ghee,Coconut oil 1 L,9,440,400,40,1
06-01-2025,"Grains, Flours & Dals",SRILATHA RICE RAVVA 500GM,4,35,35,0,1
06-01-2025,"Grains, Flours & Dals",Red Chana 250GM,4,35,30,5,1
06-01-2025,Personal Care & Cosmetics,MADDI BATH POWDER 400GM,10,150,140,10,1
06-01-2025,Oils & Ghee,Black Sesame oil 1 L,9,880,760,120,2
06-01-2025,Pooja & Spiritual Items,GD Ramayana Sandal 75GM,12,60,60,0,1
06-01-2025,Oils & Ghee,Groundnut oil 5 L,9,1800,"1,600.00",200,1
06-01-2025,Personal Care & Cosmetics,HIMALAYA LIP BALM 10GM,10,40,40,0,1
06-01-2025,"Grains, Flours & Dals",Multigrain 1 kg,4,100,85,15,1
06-01-2025,"Grains, Flours & Dals",Wheat Flour 1 kg,4,70,60,10,1
06-01-2025,"Grains, Flours & Dals",POORI ATTA 1KG,4,70,60,10,1
06-01-2025,Spices & Seasonings,DRY MIECHI 200GM,15,80,60,20,1
06-01-2025,"Dry Fruits, Nuts & Seeds",ALMONDS 250GM,2,280,260,20,1
06-01-2025,Snacks & Ready-to-Eat,COPRA LADDU 200GM,14,100,80,20,1
06-01-2025,"Dry Fruits, Nuts & Seeds",PUMPKIN SEEDS 250GM,2,200,160,40,1
06-01-2025,Oils & Ghee,Groundnut oil 1 L,9,720,660,60,2
06-01-2025,Sweeteners,Natural Honey 500 gms,16,280,240,40,1
06-01-2025,Sweeteners,NATURAL HONEY 250GM,16,150,130,20,1
06-01-2025,Snacks & Ready-to-Eat,PEANUT CHIKKI 450GM,14,125,125,0,1
06-01-2025,Personal Care & Cosmetics,HERBAL BATH POWDER,10,160,160,0,1
06-01-2025,Pooja & Spiritual Items,SWASTIK CAMPHORE,12,180,180,0,2
06-01-2025,Snacks & Ready-to-Eat,VD GUMMADI VADIYAM,14,75,75,0,1
06-01-2025,"Grains, Flours & Dals",WHITE POHA SH,4,75,75,0,1
06-01-2025,"Grains, Flours & Dals",SL Suji Rava 500GM,4,32,32,0,1
06-01-2025,Snacks & Ready-to-Eat,MORINGA LEAVES PAPAD 200GM,14,90,90,0,1
06-01-2025,Beverages,BRU GREEN LABEL 1.2G,1,42,42,0,21
06-01-2025,Spices & Seasonings,AVALU 100GM,15,25,20,5,1
06-01-2025,"Grains, Flours & Dals",Green Batani 250GM,4,55,45,10,1
06-01-2025,Snacks & Ready-to-Eat,SD RED CHILLY PAPADS,14,80,80,0,1
06-01-2025,Snacks & Ready-to-Eat,VD MINAPA VADIYAM,14,65,65,0,1
06-01-2025,"Grains, Flours & Dals",RICE FLOUR 500 GM,4,35,28,7,1
06-01-2025,Snacks & Ready-to-Eat,ZEEDI,14,70,70,0,1
06-01-2025,"Health, Wellness & Ayurvedic Products",MD Kasturi Pasupu Choornam 50GM,5,80,80,0,1
06-01-2025,Personal Care & Cosmetics,SUNNUPINDI SOAP UVS,10,99,99,0,1
06-01-2025,Snacks & Ready-to-Eat,SD Thati thandra 200gm,14,150,150,0,1
06-01-2025,Sweeteners,MISHRI D,16,40,30,10,1
06-01-2025,"Grains, Flours & Dals",Green gram 500 gms,4,75,70,5,1
06-01-2025,"Grains, Flours & Dals",Sathya Javva Wheat Rava 500GM,4,190,190,0,2
06-01-2025,Snacks & Ready-to-Eat,JUNNU POWDER 100GM,14,70,70,0,1
06-01-2025,Snacks & Ready-to-Eat,VD PAPPU CHEGODI 200GM,14,60,60,0,1
06-01-2025,"Grains, Flours & Dals",SRILATHA RICE RAVVA 500GM,4,70,70,0,2
06-01-2025,"Grains, Flours & Dals",DH URAD GOTA 1KG,4,215,190,25,1
06-01-2025,Snacks & Ready-to-Eat,NGT CHATPATTA CHANA 90GM,14,25,25,0,1
06-01-2025,Beverages,ASSAM TEA GINGER TEA POWDER 250GM,1,199,199,0,1
06-01-2025,Spices & Seasonings,Telaga Pindi 250 GM,15,40,35,5,1
06-01-2025,Snacks & Ready-to-Eat,SESAME LADDU 200GM,14,100,80,20,1
06-01-2025,"Grains, Flours & Dals",URAD DALL,4,95,85,10,1
06-01-2025,"Grains, Flours & Dals",UDALU (Barnyard millet) 500 gms,4,70,60,10,1
06-01-2025,"Grains, Flours & Dals",SAMALU (Little millet) 500 gms,4,85,65,20,1
06-01-2025,Snacks & Ready-to-Eat,NGT CHATPATTA CHANA 90GM,14,25,25,0,1
06-01-2025,"Grains, Flours & Dals",ANDU KORRALU (Brown top .mlt) 500,4,160,145,15,1
06-01-2025,Snacks & Ready-to-Eat,PALLI LADDU 200GMS,14,90,70,20,1
06-01-2025,Snacks & Ready-to-Eat,GB SALT COOKIES,14,60,55,5,1
06-01-2025,"Grains, Flours & Dals",Arikalu (kodo),4,70,65,5,1
06-01-2025,"Grains, Flours & Dals",SA WHITE JOWAR RAVA 500GM,4,69,69,0,1
06-01-2025,"Grains, Flours & Dals",KORRALU (FOXTAIL M) 500GM,4,65,55,10,1
06-01-2025,"Grains, Flours & Dals",POORI ATTA 1KG,4,70,60,10,1
06-01-2025,"Grains, Flours & Dals",Black gram 500 gms,4,75,70,5,1
06-01-2025,Snacks & Ready-to-Eat,COPRA LADDU 200GM,14,100,80,20,1
06-01-2025,Pooja & Spiritual Items,GD Kailash 60 GM,12,60,60,0,1
06-01-2025,Oils & Ghee,GANTASALA A2 COW GHEE 250ML,9,299,299,0,1
06-01-2025,Pooja & Spiritual Items,SWASTIK CAMPHORE,12,90,90,0,1
06-01-2025,Snacks & Ready-to-Eat,VD SANNAPUSA 175GM,14,60,60,0,1
06-01-2025,Snacks & Ready-to-Eat,VD NUVULU CHEGODI 175GM,14,60,60,0,1
06-01-2025,Snacks & Ready-to-Eat,PALLI LADDU 200GMS,14,90,70,20,1
06-01-2025,Oils & Ghee,Safflower oil 1 L,9,440,400,40,1
06-01-2025,"Grains, Flours & Dals",Multigrain 1 kg,4,200,170,30,2
06-01-2025,"Grains, Flours & Dals",Green gram 1 kg,4,150,130,20,1
06-01-2025,Snacks & Ready-to-Eat,GS INSTANT KORRA DOSA MIX 400GM,14,120,120,0,1
06-01-2025,"Grains, Flours & Dals",SL Idly Rava 1KG,4,65,55,10,1
06-01-2025,Oils & Ghee,Groundnut oil 1 L,9,360,330,30,1
06-01-2025,Personal Care & Cosmetics,SANTOOR,10,30,30,0,1
06-01-2025,"Health, Wellness & Ayurvedic Products",RB Max Protein Soft &Chewy 55gm,5,50,50,0,1
06-01-2025,Personal Care & Cosmetics,COLGATE ACTIVE SALT,10,20,20,0,1
06-01-2025,"Grains, Flours & Dals",Bombay Rava 500GM,4,35,30,5,1
06-01-2025,Household & Cleaning,VIM EXTRA 110GM,6,20,20,0,2
06-01-2025,Oils & Ghee,Groundnut oil 1 L,9,360,330,30,1
06-01-2025,"Health, Wellness & Ayurvedic Products",MD Triphala Chorrnam 100GM,5,60,60,0,1
06-01-2025,"Grains, Flours & Dals",RICE FLOUR 500 GM,4,35,28,7,1
06-01-2025,Spices & Seasonings,Chilli powder 500 gms,15,290,210,80,1
06-01-2025,Spices & Seasonings,RED COPRA 250GMS,15,85,74,11,1
06-01-2025,Snacks & Ready-to-Eat,PN ORGANIC PUFFED RICE 200GM,14,55,55,0,1
06-01-2025,"Grains, Flours & Dals",Green gram 500 gms,4,75,70,5,1
06-01-2025,"Dry Fruits, Nuts & Seeds",Putnalu 250GM,2,90,76,14,2
06-01-2025,"Grains, Flours & Dals",CHANA DAL 1KG,4,140,120,20,1
06-01-2025,Snacks & Ready-to-Eat,BATANA NGT 70GMS,14,100,100,0,5
06-01-2025,"Grains, Flours & Dals",turdal 1kg,4,220,195,25,1
06-01-2025,"Dry Fruits, Nuts & Seeds",Groundnuts 1 kg,2,190,170,20,1
06-01-2025,"Grains, Flours & Dals",Urad dall 1 Kg,4,370,340,30,2
06-01-2025,"Grains, Flours & Dals",split green gram 500 gms,4,75,70,5,1
06-01-2025,"Dry Fruits, Nuts & Seeds",Groundnuts 1 kg,2,190,170,20,1
06-01-2025,"Grains, Flours & Dals",RAGI FLOUR 500GRMS,4,40,35,5,1
06-01-2025,"Dry Fruits, Nuts & Seeds",PUMPKIN SEEDS 250GM,2,200,160,40,1
06-01-2025,"Dry Fruits, Nuts & Seeds",FLAX SEEDS 250GM,2,60,50,10,1
06-01-2025,Spices & Seasonings,NUVVULU 500GM,15,600,510,90,3
06-01-2025,Snacks & Ready-to-Eat,PEANUT CANDY,14,45,45,0,1
06-01-2025,General Household & Kitchenware,MATCH BOX,3,20,20,0,1
06-01-2025,Snacks & Ready-to-Eat,BATANA NGT 70GMS,14,40,40,0,2
06-01-2025,Spices & Seasonings,SONTI 50GM,15,30,20,10,1
06-01-2025,Spices & Seasonings,ROYAL SAFFRON,15,250,250,0,2
06-01-2025,"Grains, Flours & Dals",FLOUR CHARGE,4,75,75,0,1
06-01-2025,Snacks & Ready-to-Eat,GB SALT COOKIES,14,60,55,5,1
06-01-2025,Spices & Seasonings,Japatri 25GM,15,100,80,20,1
06-01-2025,"Grains, Flours & Dals",THICK POHA 500GM,4,40,35,5,1
06-01-2025,"Dry Fruits, Nuts & Seeds",SALTED PISTA 250GM,2,400,350,50,1
06-01-2025,"Grains, Flours & Dals",Em jowar idly R 500G,4,75,75,0,1
06-01-2025,"Grains, Flours & Dals",KORRALU (FOXTAIL M) 1KG,4,150,110,40,1
06-01-2025,"Dry Fruits, Nuts & Seeds",ALMONDS 250GM,2,280,260,20,1
06-01-2025,Oils & Ghee,Sesame oil 500ml,9,295,280,15,1
06-01-2025,"Dry Fruits, Nuts & Seeds",WALLNUTS 250GM,2,320,290,30,1
06-01-2025,Spices & Seasonings,Masala Karam 500 gms,15,260,240,20,1
06-01-2025,Oils & Ghee,Sesame oil 1 L,9,590,560,30,1
06-01-2025,"Grains, Flours & Dals",RAGULU 1 KG,4,35,30,5,0.5
06-01-2025,"Dry Fruits, Nuts & Seeds",SUNFLOWER SEEDS 250GRM,2,150,130,20,1
06-01-2025,Sweeteners,YB JAGGERY POWDER 1KG,16,140,140,0,1
06-01-2025,"Health, Wellness & Ayurvedic Products",GS Wheat Grass Powder 100GMS,5,349,349,0,1
06-01-2025,"Grains, Flours & Dals",BAJRA 1 KG,4,30,25,5,0.5
06-01-2025,Spices & Seasonings,ROYAL SAFFRON,15,125,125,0,1
06-01-2025,"Dry Fruits, Nuts & Seeds",FLAX SEEDS 250GM,2,60,50,10,1
06-01-2025,"Dry Fruits, Nuts & Seeds",PUMPKIN SEEDS 250GM,2,200,160,40,1
06-01-2025,"Dry Fruits, Nuts & Seeds",WATERMELON SEEDS 250GRM,2,320,280,40,1
06-01-2025,Snacks & Ready-to-Eat,SALTED PHALLI,14,25,25,0,1
06-01-2025,"Grains, Flours & Dals",RAGI FLOUR 500GRMS,4,40,35,5,1
06-01-2025,"Dry Fruits, Nuts & Seeds",PULMAKHANA 100 GM,2,180,170,10,1
06-01-2025,Pooja & Spiritual Items,GB Bharatha Woods 75GM,12,60,60,0,1
06-01-2025,"Grains, Flours & Dals",Brown RICE 1KG,4,70,65,5,1
06-01-2025,"Grains, Flours & Dals",COW B rice 1 kg,4,72,69,3,1
06-01-2025,Snacks & Ready-to-Eat,VD NUVULU CHEGODI 175GM,14,60,60,0,1
06-01-2025,Snacks & Ready-to-Eat,PEANUT CHILLI,14,30,30,0,6
06-01-2025,Snacks & Ready-to-Eat,MARMURA LADDU,14,80,60,20,1
06-01-2025,Snacks & Ready-to-Eat,GB SALT COOKIES,14,60,55,5,1
06-01-2025,"Grains, Flours & Dals",DESI CHANA,4,25,25,0,1
06-01-2025,Snacks & Ready-to-Eat,VD ATUKULU MIXTURE 175GM,14,60,60,0,1
06-01-2025,"Grains, Flours & Dals",PESARA PAPPU 500GMS,4,85,75,10,1
06-01-2025,Oils & Ghee,Mustard oil 500 ml,9,220,195,25,1
06-01-2025,"Grains, Flours & Dals",DM LOW GI SP 1KG,4,475,475,0,5
06-01-2025,Spices & Seasonings,TM MIRCH POWDER 200GM,15,163,163,0,1
06-01-2025,Snacks & Ready-to-Eat,ZEEDI,14,70,70,0,1
06-01-2025,Oils & Ghee,Coconut oil 1 L,9,440,400,40,1
06-01-2025,Snacks & Ready-to-Eat,GS WHEAT GRASS BISCUITS 250GM,14,130,130,0,1
06-01-2025,"Dry Fruits, Nuts & Seeds",GF DATES 500GM,2,156,149,7,1
06-01-2025,Personal Care & Cosmetics,DWI ALOEVERA 100GM,10,90,90,0,1
06-01-2025,Pickles & Cooking Pastes,SD GINGER PICKLE 250GM,11,110,110,0,1
06-01-2025,"Health, Wellness & Ayurvedic Products",HARITHAKI CHOORNAM,5,60,60,0,1
06-01-2025,"Grains, Flours & Dals",turdal 1kg,4,220,195,25,1
06-01-2025,Household & Cleaning,VIM EXTRA 110GM,6,50,50,0,5
06-01-2025,"Grains, Flours & Dals",turdal 500 gms,4,110,100,10,1
06-01-2025,"Grains, Flours & Dals",URAD DALL,4,95,85,10,1
06-01-2025,Spices & Seasonings,Jeera 100GM,15,50,45,5,1
06-01-2025,"Grains, Flours & Dals",Urad dall 1 Kg,4,185,170,15,1
06-01-2025,"Grains, Flours & Dals",CHANA DAL 500GM,4,70,60,10,1
06-01-2025,Sweeteners,SUGAR 1KG,16,60,50,10,1
06-01-2025,Personal Care & Cosmetics,MYSORE SANDAL SOAP 75G,10,84,84,0,2
06-01-2025,"Grains, Flours & Dals",Idly Rava L 1KG,4,120,100,20,2
06-01-2025,Oils & Ghee,Groundnut oil 1 L,9,360,330,30,1
06-01-2025,Oils & Ghee,Sesame oil 1 L,9,590,560,30,1
06-01-2025,"Dry Fruits, Nuts & Seeds",ANJEER 250GM,2,400,360,40,1
06-01-2025,Spices & Seasonings,NUVVULU 500GM,15,160,140,20,1
06-01-2025,"Dry Fruits, Nuts & Seeds",GF KIMIA DATES 500GM,2,310,190,120,1
06-01-2025,"Grains, Flours & Dals",Urad dall 1 Kg,4,185,170,15,1
06-01-2025,"Grains, Flours & Dals",split green gram 500 gms,4,75,70,5,1
06-01-2025,Spices & Seasonings,TATA SALT 1KG,15,60,60,0,2
06-01-2025,Spices & Seasonings,DRY MIECHI 200GM,15,80,60,20,1
06-01-2025,Sweeteners,SUGAR 1KG,16,120,100,20,2
06-01-2025,Sweeteners,Natural Honey 500 gms,16,280,240,40,1
06-01-2025,Sweeteners,KAMAL JAGGERY 500GM,16,80,80,0,2
06-01-2025,"Grains, Flours & Dals",RICE FLOUR 1KG,4,70,55,15,1
06-01-2025,Snacks & Ready-to-Eat,urban murmura,14,60,55,5,1
06-01-2025,Snacks & Ready-to-Eat,NGT CHATPATTA CHANA 90GM,14,50,50,0,2
06-01-2025,"Dry Fruits, Nuts & Seeds",Groundnuts 500 gms,2,95,85,10,1
06-01-2025,Sweeteners,YB Brown Sugar 500GM,16,75,75,0,1
06-01-2025,"Grains, Flours & Dals",turdal 1kg,4,220,195,25,1
06-01-2025,Spices & Seasonings,PURO Healthy Salt 1KG,15,110,110,0,1
06-01-2025,Household & Cleaning,VIM TROPICAL LEMON FRESHNESS 250ML,6,55,55,0,1
06-01-2025,Household & Cleaning,SURF EXCEL 150GM,6,40,40,0,2
06-01-2025,Milk & Dairy,BROWN EGGS 1P,7,84,72,12,6
06-01-2025,Snacks & Ready-to-Eat,SESAME LADDU 200GM,14,100,80,20,1
06-01-2025,Oils & Ghee,Sesame oil 1 L,9,590,560,30,1
06-01-2025,"Grains, Flours & Dals",Yellow jowar.F 2 kgs,4,220,200,20,1
06-01-2025,Snacks & Ready-to-Eat,GB SALT COOKIES,14,60,55,5,1
06-01-2025,Snacks & Ready-to-Eat,MIGHTY PUFF,14,50,50,0,2
06-01-2025,"Grains, Flours & Dals",Multigrain 500 gms,4,250,215,35,5
06-01-2025,Snacks & Ready-to-Eat,SF MIGHTY PUFFS,14,25,25,0,1
06-01-2025,"Grains, Flours & Dals",PESARA PAPPU 1 KG,4,170,145,25,1
06-01-2025,Snacks & Ready-to-Eat,BD PEARL MILLET NOODLES 200G,14,70,70,0,1
06-01-2025,Oils & Ghee,Mustard oil 1 L,9,440,390,50,1
06-01-2025,"Grains, Flours & Dals",PN ORGANIC KALA CHANA 500GM,4,119,119,0,1
06-01-2025,Spices & Seasonings,Menthulu 250 gms,15,50,45,5,1
06-01-2025,Snacks & Ready-to-Eat,BD LITTLE MILLET NOODLES 200G,14,75,75,0,1
06-01-2025,"Grains, Flours & Dals",White jowar.F 1 kg,4,200,160,40,2
06-01-2025,Oils & Ghee,Sesame oil 5 L,9,2950,"2,750.00",200,1
06-01-2025,Snacks & Ready-to-Eat,BD RAGI NOODLES,14,75,75,0,1
06-01-2025,Snacks & Ready-to-Eat,FOXTAIL NOODLES,14,75,75,0,1
06-01-2025,Oils & Ghee,Groundnut oil 1 L,9,1080,990,90,3
06-01-2025,Oils & Ghee,Coconut oil 1 L,9,440,400,40,1
06-01-2025,Spices & Seasonings,Chilli powder 500 gms,15,580,420,160,2
06-01-2025,Oils & Ghee,Safflower oil 1 L,9,1320,"1,200.00",120,3
06-01-2025,Milk & Dairy,BROWN EGGS 1P,7,140,120,20,10
06-01-2025,"Grains, Flours & Dals",Wheat Flour 1 kg,4,70,60,10,1
06-01-2025,Snacks & Ready-to-Eat,VD CORNFLAKES MIXTURE 175GM,14,60,60,0,1
06-01-2025,"Dry Fruits, Nuts & Seeds",Groundnuts 1 kg,2,190,170,20,1
06-01-2025,Sweeteners,SUGAR 1KG,16,60,50,10,1
06-01-2025,"Grains, Flours & Dals",SL Suji Rava 500GM,4,32,32,0,1
06-01-2025,Snacks & Ready-to-Eat,DOSA BATTER 1KG,14,60,60,0,1
06-01-2025,"Grains, Flours & Dals",MAATEJA rice 26 kg,4,1750,"1,750.00",0,1
06-01-2025,"Grains, Flours & Dals",MAATEJA rice 1 kg,4,72,69,3,1
06-01-2025,Snacks & Ready-to-Eat,BROWN BREAD,14,55,55,0,1
06-01-2025,Household & Cleaning,HARPIC POWER PLUS 10X ADV 500ML,6,110,110,0,1
06-01-2025,Snacks & Ready-to-Eat,KURNOOL MARMURA,14,70,55,15,1
06-01-2025,"Grains, Flours & Dals",Yellow jowar .F1 kg,4,110,100,10,1
06-01-2025,"Grains, Flours & Dals",RAGI FLOUR 1KG,4,80,70,10,1
06-01-2025,"Grains, Flours & Dals",Multigrain 1 kg,4,100,85,15,1
06-01-2025,Household & Cleaning,VIM 300GM,6,30,30,0,1
06-01-2025,General Household & Kitchenware,WDN HDI PONGANALU,3,280,280,0,1
06-01-2025,Personal Care & Cosmetics,MD Henna Choornam 100GM,10,80,80,0,1
06-01-2025,Spices & Seasonings,AVALU 100GM,15,25,20,5,1
06-01-2025,Spices & Seasonings,JEERA 250 gms,15,125,105,20,1
06-01-2025,Spices & Seasonings,sf red chilli,15,85,85,0,1
06-01-2025,Milk & Dairy,BROWN EGGS 1P,7,140,120,20,10
06-01-2025,Sweeteners,GS Palm Jaggery Powder 400GM,16,180,180,0,1
06-01-2025,Snacks & Ready-to-Eat,SATHVI REGIVADA 200GM,14,80,60,20,1
06-01-2025,"Grains, Flours & Dals",Yellow jowar.F 500 gms,4,55,50,5,1
06-01-2025,"Grains, Flours & Dals",SA YELLOW JOWAR RAVA 500GM,4,95,95,0,1
06-01-2025,"Grains, Flours & Dals",SA YELLOW JOWAR RAVA 500GM,4,95,95,0,1
06-01-2025,"Grains, Flours & Dals",YB RED RICE 500GM,4,75,65,10,1
06-01-2025,"Grains, Flours & Dals",SAMALU (Little millet) 500 gms,4,75,65,10,1
05-01-2025,Snacks & Ready-to-Eat,NGT CHATPATTA CHANA 90GM,14,25,25,0,1
05-01-2025,"Grains, Flours & Dals",VGR rice 1 kg,4,350,325,25,5
05-01-2025,Snacks & Ready-to-Eat,MIGHTY PUFF,14,25,25,0,1
05-01-2025,"Grains, Flours & Dals",MAATEJA rice 1 kg,4,432,414,18,6
05-01-2025,"Grains, Flours & Dals",RAGI FLOUR 1KG,4,80,70,10,1
05-01-2025,Spices & Seasonings,Chilli powder 500 gms,15,290,210,80,1
05-01-2025,"Grains, Flours & Dals",Wheat Flour 1 kg,4,70,60,10,1
05-01-2025,"Grains, Flours & Dals",Wheat Flour 1 kg,4,140,120,20,2
05-01-2025,"Grains, Flours & Dals",SA Sprouted Ragi Flour 500GM,4,69,69,0,1
05-01-2025,"Grains, Flours & Dals",Red uluvalu 500 gms,4,180,150,30,2
05-01-2025,Oils & Ghee,Safflower oil 1 L,9,880,800,80,2
05-01-2025,Oils & Ghee,Coconut oil 1 L,9,440,400,40,1
05-01-2025,Snacks & Ready-to-Eat,PALLI LADDU 200GMS,14,90,70,20,1
05-01-2025,Snacks & Ready-to-Eat,ZEEDI,14,70,70,0,1
05-01-2025,Oils & Ghee,Groundnut oil 1 L,9,360,330,30,1
05-01-2025,Snacks & Ready-to-Eat,PEANUT CHILLI,14,10,10,0,2
05-01-2025,Snacks & Ready-to-Eat,RSC ORANGE 100GMS,14,20,20,0,1
05-01-2025,"Grains, Flours & Dals",SA YELLOW JOWAR RAVA 500GM,4,95,95,0,1
05-01-2025,"Grains, Flours & Dals",JOWAR YELLOW 1 K,4,180,180,0,2
05-01-2025,"Grains, Flours & Dals",split black gram 1 kg,4,180,170,10,1
05-01-2025,Snacks & Ready-to-Eat,SATHVI REGIVADA 200GM,14,80,60,20,1
05-01-2025,"Grains, Flours & Dals",Red Bobarlu 1 kg,4,190,170,20,1
05-01-2025,"Grains, Flours & Dals",EM jowar upma R 500G,4,150,150,0,2
05-01-2025,"Grains, Flours & Dals",UDALU (Barnyard millet) 500 gms,4,70,60,10,1
05-01-2025,Spices & Seasonings,MTR Sambar Powder 200GM,15,150,150,0,1
05-01-2025,Snacks & Ready-to-Eat,SD Vamu with palm jaggery 250gm,14,135,135,0,1
05-01-2025,Spices & Seasonings,Elaichi 25GM,15,145,120,25,1
05-01-2025,Snacks & Ready-to-Eat,VD PAPPU CHEGODI 200GM,14,60,60,0,1
05-01-2025,Spices & Seasonings,Vamu 100GM,15,60,50,10,1
05-01-2025,Snacks & Ready-to-Eat,COPRA LADDU 200GM,14,100,80,20,1
05-01-2025,"Grains, Flours & Dals",UDALU (Barnyard millet) 1 kg,4,140,115,25,1
05-01-2025,Spices & Seasonings,FLAXSEED KARAM,15,75,75,0,1
05-01-2025,Spices & Seasonings,GS Moringa Leaves Spicy Powder 100GM,15,90,90,0,1
05-01-2025,"Grains, Flours & Dals",Wheat Rava M 500GM,4,66,60,6,2
05-01-2025,Oils & Ghee,Safflower oil 5 L,9,2200,"1,950.00",250,1
05-01-2025,Snacks & Ready-to-Eat,SESAME CHIKKI,14,120,100,20,1
05-01-2025,Spices & Seasonings,RED COPRA 500GM,15,340,296,44,2
05-01-2025,Snacks & Ready-to-Eat,BATANA NGT 70GMS,14,20,20,0,1
05-01-2025,"Grains, Flours & Dals",Wheat Flour 1 kg,4,70,60,10,1
05-01-2025,Snacks & Ready-to-Eat,PALLI LADDU 200GMS,14,90,70,20,1
05-01-2025,"Grains, Flours & Dals",Multigrain 1 kg,4,200,170,30,2
05-01-2025,Sweeteners,GS A2 Buffalo Ghee 500ML,16,550,550,0,1
05-01-2025,Oils & Ghee,BUFFALLO GHEE 500ML,9,820,740,80,2
05-01-2025,"Grains, Flours & Dals",Urad dall 1 Kg,4,185,170,15,1
05-01-2025,Milk & Dairy,SANGAM CURD 450GM,7,38,38,0,1
05-01-2025,Personal Care & Cosmetics,SVE TURMERIC SOAP 100GM,10,90,90,0,1
05-01-2025,Pooja & Spiritual Items,SWASTIK CAMPHOR 25GM,12,90,90,0,2
05-01-2025,General Household & Kitchenware,MATCH BOX,3,20,20,0,1
05-01-2025,Pooja & Spiritual Items,GD Aiswarya Deepam 700ML,12,195,195,0,1
05-01-2025,Spices & Seasonings,PRO ORG CORIANDER WHOLE 100G,15,70,70,0,1
05-01-2025,"Grains, Flours & Dals",Multigrain 1 kg,4,100,85,15,1
05-01-2025,Spices & Seasonings,SH TAMARIND SEEDLESS 500GM,15,260,260,0,1
05-01-2025,Personal Care & Cosmetics,SVE MULTANI MITTI SOAP 100GM,10,90,90,0,1
05-01-2025,Personal Care & Cosmetics,SEV TULASI SOAP 100GM,10,90,90,0,1
05-01-2025,Spices & Seasonings,Turmeric powder 250 gms,15,100,75,25,1
05-01-2025,"Grains, Flours & Dals",White jowar.F 1 kg,4,100,80,20,1
05-01-2025,Personal Care & Cosmetics,SVE SUNNI PINDI SCRUBSOAP 100GM,10,100,100,0,1
05-01-2025,Pooja & Spiritual Items,SWASTIK PURE CAMPHOR 50GM,12,180,180,0,2
05-01-2025,Oils & Ghee,Sesame oil 500ml,9,295,280,15,1
05-01-2025,Spices & Seasonings,Tamarind 500GM,15,160,130,30,1
05-01-2025,"Grains, Flours & Dals",SAMALU (Little millet) 1 kg,4,170,130,40,1
05-01-2025,"Grains, Flours & Dals",turdal 1kg,4,220,195,25,1
05-01-2025,"Grains, Flours & Dals",SL Idly Rava 1KG,4,195,165,30,3
05-01-2025,Sweeteners,ACHUBELLAM 500GM,16,100,80,20,2
05-01-2025,Oils & Ghee,Black Sesame oil 1 L,9,440,380,60,1
05-01-2025,"Grains, Flours & Dals",KORRALU (FOXTAIL M) 1KG,4,300,220,80,2
05-01-2025,Pooja & Spiritual Items,BALAJI DESH MERE 220GM,12,150,150,0,1
05-01-2025,Spices & Seasonings,Menthulu 500 gms,15,100,90,10,1
05-01-2025,"Grains, Flours & Dals",Arikadu ( kodo),4,280,260,20,2
05-01-2025,Spices & Seasonings,Vamu 100GM,15,120,100,20,2
05-01-2025,Oils & Ghee,Safflower oil 1 L,9,880,800,80,2
05-01-2025,Household & Cleaning,SRFR EXCEL,6,280,280,0,28
05-01-2025,Milk & Dairy,HERITAGE CURD,7,48,48,0,1
05-01-2025,"Grains, Flours & Dals",idly/Dosa rice 1 kg,4,70,60,10,1
05-01-2025,"Grains, Flours & Dals",CHANA DAL 500GM,4,70,60,10,1
05-01-2025,Snacks & Ready-to-Eat,SD FLAX SEED APPADALU,14,90,90,0,1
05-01-2025,Pooja & Spiritual Items,HAND MADE VOTHULU,12,150,150,0,3
05-01-2025,Spices & Seasonings,PN ORGANIC PINK SALT 1KG,15,124,124,0,1
05-01-2025,"Grains, Flours & Dals",MELMEKER 250GMS,4,60,45,15,1
05-01-2025,Snacks & Ready-to-Eat,DOSA BATTER 1KG,14,60,60,0,1
05-01-2025,"Grains, Flours & Dals",BARLEY SEEDS 250GMS,4,40,35,5,1
05-01-2025,"Grains, Flours & Dals",DESI CHANA,4,25,25,0,1
05-01-2025,Pooja & Spiritual Items,GOMATHA AGARBATHI,12,75,75,0,1
05-01-2025,Personal Care & Cosmetics,Soapnut 250GM,10,60,45,15,1
05-01-2025,"Grains, Flours & Dals",Red Bobarlu 1 kg,4,190,170,20,1
05-01-2025,Sweeteners,NATURAL HONEY 250GM,16,150,130,20,1
05-01-2025,"Grains, Flours & Dals",THICK POHA 500GM,4,40,35,5,1
05-01-2025,Household & Cleaning,SURFEXCEL BAR 80G,6,10,10,0,1
05-01-2025,"Grains, Flours & Dals",Sathya Javva Wheat Rava 500GM,4,95,95,0,1
05-01-2025,"Grains, Flours & Dals",split black gram 500 gms,4,90,85,5,1
05-01-2025,Snacks & Ready-to-Eat,VD ATUKULU MIXTURE 175GM,14,60,60,0,1
05-01-2025,"Grains, Flours & Dals",White Chana 250 GM,4,60,50,10,1
05-01-2025,"Grains, Flours & Dals",Em jowar idly R 500G,4,75,75,0,1
05-01-2025,Sweeteners,SUGAR 500 GM,16,30,25,5,1
05-01-2025,Beverages,BRU GREEN LABEL 1.2G,1,24,24,0,12
05-01-2025,"Grains, Flours & Dals",Brown RICE 1KG,4,70,65,5,1
05-01-2025,Snacks & Ready-to-Eat,SALTED PHALLI,14,65,65,0,1
05-01-2025,Snacks & Ready-to-Eat,SATHVI PALLI CHIKKI 200GM,14,100,80,20,1
05-01-2025,"Grains, Flours & Dals",turdal 500 gms,4,110,100,10,1
05-01-2025,Oils & Ghee,Groundnut oil 1 L,9,360,330,30,1
05-01-2025,Snacks & Ready-to-Eat,ZEEDI,14,70,70,0,1
05-01-2025,"Dry Fruits, Nuts & Seeds",GF DATES 500GM,2,156,149,7,1
05-01-2025,Snacks & Ready-to-Eat,PALLI LADDU 200GMS,14,90,70,20,1
05-01-2025,Snacks & Ready-to-Eat,SATHVI REGIVADA 200GM,14,80,60,20,1
05-01-2025,Snacks & Ready-to-Eat,MARMURA LADDU,14,80,60,20,1
05-01-2025,"Grains, Flours & Dals",BASMATHI RICE 1KG,4,150,135,15,1
05-01-2025,"Dry Fruits, Nuts & Seeds",Groundnuts 1 kg,2,190,170,20,1
05-01-2025,"Grains, Flours & Dals",YB CHITTIMUTYALU RICE 1KG,4,200,160,40,1
05-01-2025,Oils & Ghee,Groundnut oil 1 L,9,720,660,60,2
05-01-2025,"Grains, Flours & Dals",turdal 1kg,4,220,195,25,1
05-01-2025,Spices & Seasonings,Telaga Pindi 250 GM,15,80,70,10,2
05-01-2025,Oils & Ghee,Coconut oil 1 L,9,440,400,40,1
05-01-2025,Oils & Ghee,Sesame oil 1 L,9,590,560,30,1
05-01-2025,"Grains, Flours & Dals",Wheat Flour 1 kg,4,140,120,20,2
05-01-2025,Snacks & Ready-to-Eat,FUN TIME CRUNCH,14,45,45,0,1
05-01-2025,Milk & Dairy,TOTAL CURD 50GMS,7,20,20,0,2
05-01-2025,Oils & Ghee,Coconut oil 1 L,9,440,400,40,1
05-01-2025,Snacks & Ready-to-Eat,PALLI LADDU 200GMS,14,90,70,20,1
05-01-2025,Personal Care & Cosmetics,DABUR RED PASTE 50GM,10,50,50,0,2
05-01-2025,Beverages,BRU GREEN LABEL 100G,1,65,65,0,1
05-01-2025,Spices & Seasonings,DRY MIECHI 200GM,15,80,60,20,1
05-01-2025,"Dry Fruits, Nuts & Seeds",Groundnuts 500 gms,2,190,170,20,2
05-01-2025,"Grains, Flours & Dals",DESI CHANA,4,25,25,0,1
05-01-2025,"Grains, Flours & Dals",Wheat Rava M 500GM,4,66,60,6,2
05-01-2025,Snacks & Ready-to-Eat,BATANA NGT 70GMS,14,20,20,0,1
05-01-2025,"Grains, Flours & Dals",CHANA DAL 1KG,4,140,120,20,1
05-01-2025,"Grains, Flours & Dals",Yellow jowar .F1 kg,4,110,100,10,1
05-01-2025,Personal Care & Cosmetics,VETIVER BATH SCRUB,10,40,40,0,1
05-01-2025,Personal Care & Cosmetics,ORGANIC SPONGE LOOFAH,10,70,70,0,1
05-01-2025,"Grains, Flours & Dals",MAAGAANI LOW GI SP 1KG,4,149,115,34,1
05-01-2025,Oils & Ghee,Sesame oil 1 L,9,590,560,30,1
05-01-2025,Sweeteners,SD PALM JAGGERY 500GM,16,200,200,0,1
05-01-2025,Personal Care & Cosmetics,COCONUT BATH SCRUBBER,10,40,40,0,1
05-01-2025,"Grains, Flours & Dals",RAGULU 1 KG,4,140,120,20,2
05-01-2025,Snacks & Ready-to-Eat,VD SANNAPUSA 175GM,14,60,60,0,1
05-01-2025,"Grains, Flours & Dals",Chana Flour 1 kg,4,140,130,10,1
05-01-2025,Oils & Ghee,Groundnut oil 5 L,9,1800,"1,600.00",200,1
05-01-2025,Oils & Ghee,Sesame oil 1 L,9,590,560,30,1
05-01-2025,"Grains, Flours & Dals",split black gram 500 gms,4,90,85,5,1
05-01-2025,Spices & Seasonings,Jeera 100GM,15,50,45,5,1
05-01-2025,Oils & Ghee,Groundnut oil 1 L,9,360,330,30,1
05-01-2025,Snacks & Ready-to-Eat,ONION RINGS,14,50,50,0,1
05-01-2025,"Dry Fruits, Nuts & Seeds",SUNFLOWER SEEDS 250GRM,2,150,130,20,1
05-01-2025,"Dry Fruits, Nuts & Seeds",WATERMELON SEEDS 250GRM,2,320,280,40,1
05-01-2025,Household & Cleaning,VIM EXTRA 110GM,6,30,30,0,3
05-01-2025,Pickles & Cooking Pastes,DB Three Mango 1KG,11,28,25,3,1
05-01-2025,Snacks & Ready-to-Eat,VD MYSOREPAK 6PIC,14,100,100,0,1
05-01-2025,Spices & Seasonings,SWEET SOUNF,15,20,20,0,1
05-01-2025,Oils & Ghee,Groundnut oil 1 L,9,720,660,60,2
05-01-2025,"Dry Fruits, Nuts & Seeds",PUMPKIN SEEDS 250GM,2,200,160,40,1
05-01-2025,"Dry Fruits, Nuts & Seeds",SUNFLOWER SEEDS 250GRM,2,150,130,20,1
05-01-2025,Snacks & Ready-to-Eat,VD MINAPA VADIYAM,14,65,65,0,1
05-01-2025,Personal Care & Cosmetics,KAIPO ACT CHARCOAL TP 100G,10,90,90,0,1
05-01-2025,Pooja & Spiritual Items,GB Bharatha Woods 75GM,12,60,60,0,1
05-01-2025,Pooja & Spiritual Items,GD Kailash 60 GM,12,60,60,0,1
05-01-2025,Pooja & Spiritual Items,GD Ramayana Sandal 75GM,12,60,60,0,1
05-01-2025,Pooja & Spiritual Items,GD Bhagavatha Mallika 75GM,12,60,60,0,1
05-01-2025,Snacks & Ready-to-Eat,SD Vamu with palm jaggery 250gm,14,135,135,0,1
05-01-2025,Oils & Ghee,Sesame oil 1 L,9,590,560,30,1
05-01-2025,Oils & Ghee,Safflower oil 1 L,9,880,800,80,2
05-01-2025,Oils & Ghee,Groundnut oil 1 L,9,360,330,30,1
05-01-2025,"Grains, Flours & Dals",turdal 1kg,4,220,195,25,1
05-01-2025,Oils & Ghee,Groundnut oil 1 L,9,360,330,30,1
05-01-2025,Spices & Seasonings,TATA SALT 1KG,15,60,60,0,2
05-01-2025,Sweeteners,SUGAR 1KG,16,180,150,30,3
05-01-2025,Spices & Seasonings,AVALU 100GM,15,25,20,5,1
05-01-2025,Snacks & Ready-to-Eat,PN ORGANIC PUFFED RICE 200GM,14,55,55,0,1
05-01-2025,Beverages,BRU GREEN LABEL 100G,1,65,65,0,1
05-01-2025,Oils & Ghee,Safflower oil 1 L,9,440,400,40,1
05-01-2025,"Dry Fruits, Nuts & Seeds",Putnalu 250GM,2,90,76,14,2
05-01-2025,Oils & Ghee,Sesame oil 1 L,9,590,560,30,1
05-01-2025,"Grains, Flours & Dals",RAGI FLOUR 500GRMS,4,40,35,5,1
05-01-2025,Spices & Seasonings,Vamu 100GM,15,60,50,10,1
05-01-2025,"Grains, Flours & Dals",COW B rice 1 kg,4,360,345,15,5
05-01-2025,"Grains, Flours & Dals",PRO ORG KABULI CHANNA 500GM,4,196,196,0,1
05-01-2025,"Grains, Flours & Dals",RICE FLOUR 1KG,4,70,55,15,1
05-01-2025,"Grains, Flours & Dals",MELMEKER 250GMS,4,60,45,15,1
05-01-2025,Spices & Seasonings,JEERA 250 gms,15,125,105,20,1
05-01-2025,Snacks & Ready-to-Eat,SALTED PHALLI,14,65,65,0,1
05-01-2025,Oils & Ghee,Sesame oil 1 L,9,590,560,30,1
05-01-2025,Milk & Dairy,BROWN EGGS TRAY 30P,7,360,330,30,1
05-01-2025,Personal Care & Cosmetics,UVIS ROSEWATER 100ML,10,49,49,0,1
05-01-2025,Snacks & Ready-to-Eat,RAGI LADDU,14,120,120,0,1
05-01-2025,Oils & Ghee,Flaxseed oil 500 ml,9,300,270,30,1
05-01-2025,"Dry Fruits, Nuts & Seeds",SATHVI CHIA SEEDS 100GM,2,100,80,20,1
05-01-2025,Oils & Ghee,Coconut oil 500 ml,9,220,200,20,1
05-01-2025,"Grains, Flours & Dals",RAGI FLOUR 500GRMS,4,40,35,5,1
05-01-2025,"Grains, Flours & Dals",Wheat Flour 1 kg,4,350,300,50,5
05-01-2025,Oils & Ghee,Safflower oil 1 L,9,440,400,40,1
05-01-2025,Milk & Dairy,BROWN EGGS 1P,7,84,72,12,6
05-01-2025,Oils & Ghee,Groundnut oil 1 L,9,360,330,30,1
05-01-2025,Snacks & Ready-to-Eat,BLACK SESAME CHIKKI,14,5,5,0,1
05-01-2025,"Grains, Flours & Dals",VGR rice 1 kg,4,350,325,25,5
05-01-2025,Snacks & Ready-to-Eat,SD Bajra with palm Jaggery 250gm,14,135,135,0,1
05-01-2025,Snacks & Ready-to-Eat,MIGHTY PUFF,14,25,25,0,1
05-01-2025,Snacks & Ready-to-Eat,PALLI LADDU 200GMS,14,90,70,20,1
05-01-2025,Snacks & Ready-to-Eat,SD KODO MILLET WITH PALM JAGGERY,14,135,135,0,1
05-01-2025,Snacks & Ready-to-Eat,SD barnyard Millet with palm jaggery,14,135,135,0,1
05-01-2025,Snacks & Ready-to-Eat,SD KODO MILLET WITH PALM JAGGERY,14,135,135,0,1
05-01-2025,Snacks & Ready-to-Eat,SD Aswagandha with palm Jaggery250Gm,14,135,135,0,1
05-01-2025,Snacks & Ready-to-Eat,SD Bajra with palm Jaggery 250gm,14,135,135,0,1
05-01-2025,Oils & Ghee,DWI SESAME OIL 100ML,9,100,100,0,1
05-01-2025,Oils & Ghee,Castor oil 200 ml,9,100,80,20,1
05-01-2025,Spices & Seasonings,SATHVI BIRYANI LEAF 25GM,15,30,20,10,1
05-01-2025,"Grains, Flours & Dals",RAGI FLOUR 1KG,4,80,70,10,1
05-01-2025,"Grains, Flours & Dals",JOWAR WHITE 1 KG,4,40,35,5,0.5
05-01-2025,"Grains, Flours & Dals",BAJRA 1 KG,4,30,25,5,0.5
05-01-2025,Snacks & Ready-to-Eat,PEANUT CHILLI,14,10,10,0,2
05-01-2025,Snacks & Ready-to-Eat,ID CHAPATI,14,79,79,0,1
05-01-2025,"Grains, Flours & Dals",Arikalu (kodo),4,70,65,5,1
05-01-2025,"Grains, Flours & Dals",JOWAR YELLOW 1 K,4,45,45,0,0.5
05-01-2025,"Grains, Flours & Dals",ANDU KORRALU (Brown top .mlt) 500,4,160,145,15,1
05-01-2025,"Grains, Flours & Dals",UDALU (Barnyard millet) 500 gms,4,70,60,10,1
05-01-2025,"Grains, Flours & Dals",Foxtail millet 500 gms,4,65,55,10,1
05-01-2025,"Grains, Flours & Dals",SAMALU (Little millet) 500 gms,4,85,65,20,1
05-01-2025,Snacks & Ready-to-Eat,VD RICE MURUKU 150GM,14,50,50,0,1
05-01-2025,Oils & Ghee,Groundnut oil 500ml,9,180,165,15,1
05-01-2025,"Grains, Flours & Dals",FLOUR CHARGE,4,43.2,43.2,0,3.6
05-01-2025,Oils & Ghee,Sesame oil 500ml,9,295,280,15,1
05-01-2025,"Grains, Flours & Dals",Idly Rava L 1KG,4,120,100,20,2
05-01-2025,General Household & Kitchenware,DURACELL ULTRA,3,150,150,0,3
05-01-2025,"Grains, Flours & Dals",JOWAR WHITE 1 KG,4,160,140,20,2
05-01-2025,"Dry Fruits, Nuts & Seeds",Groundnuts 500 gms,2,95,85,10,1
05-01-2025,Spices & Seasonings,JEERA 250 gms,15,125,105,20,1
05-01-2025,Spices & Seasonings,SATHVI ANASAPUVUU 25GM,15,90,65,25,1
05-01-2025,Oils & Ghee,ANURAG RB OIL,9,120,100,20,1
05-01-2025,"Dry Fruits, Nuts & Seeds",PULMAKHANA 100 GM,2,360,340,20,2
05-01-2025,"Grains, Flours & Dals",split black gram 1 kg,4,540,510,30,3
05-01-2025,"Grains, Flours & Dals",Wheat Flour 2 kgs,4,140,120,20,1
05-01-2025,Snacks & Ready-to-Eat,PALLI LADDU 200GMS,14,180,140,40,2
05-01-2025,Oils & Ghee,Groundnut oil 1 L,9,360,330,30,1
05-01-2025,Snacks & Ready-to-Eat,COPRA LADDU 200GM,14,100,80,20,1
05-01-2025,"Grains, Flours & Dals",RICE FLOUR 500 GM,4,35,28,7,1
05-01-2025,"Grains, Flours & Dals",HS Multimillet upma r 500g,4,130,130,0,2
05-01-2025,"Grains, Flours & Dals",SAMALU (Little millet) 1 kg,4,340,260,80,2
05-01-2025,Spices & Seasonings,PUTNALA KARAM POWDER 100GM,15,65,65,0,1
05-01-2025,Personal Care & Cosmetics,COW DURBAR 7 HERBS SHAMPOO,10,125,125,0,1
05-01-2025,Snacks & Ready-to-Eat,GANTASALA FLAX SEEDS SPICY,14,90,90,0,1
05-01-2025,Personal Care & Cosmetics,SVE KHADI CARROT GEL 100GM,10,145,145,0,1
05-01-2025,Snacks & Ready-to-Eat,BB ROASTED VERMICELLY 500GM,14,70,70,0,1
05-01-2025,Snacks & Ready-to-Eat,SF MILLET PANCAKE CLASSIC 150GM,14,149,149,0,1
05-01-2025,"Health, Wellness & Ayurvedic Products",RB Max Protein NUTS &SEEDS 55gm,5,50,50,0,1
05-01-2025,"Grains, Flours & Dals",DOCTOR RICE DIABETIC SFR 1KG,4,120,120,0,1
05-01-2025,"Grains, Flours & Dals",SL Idly Rava 1KG,4,65,55,10,1
05-01-2025,"Grains, Flours & Dals",CORN FLOUR,4,80,70,10,1
05-01-2025,Spices & Seasonings,Menthulu 250 gms,15,50,45,5,1
05-01-2025,Personal Care & Cosmetics,HERBAL ROSE SPRAY 250ML,10,225,225,0,1
05-01-2025,"Health, Wellness & Ayurvedic Products",ZINDA TILISMATH 5ML,5,70,70,0,1
05-01-2025,"Health, Wellness & Ayurvedic Products",RB Max Protein PERI PERI 60gm,5,45,45,0,1
05-01-2025,Snacks & Ready-to-Eat,SF MIGHTY PUFFS,14,25,25,0,1
05-01-2025,Snacks & Ready-to-Eat,MIGHTY PUFFS CHEDDAR CHEESE,14,25,25,0,1
05-01-2025,Personal Care & Cosmetics,PAPAYA GEL,10,140,140,0,1
05-01-2025,Spices & Seasonings,DRY MIECHI 200GM,15,80,60,20,1
05-01-2025,Snacks & Ready-to-Eat,MP CHOCO ALMOND COOKIE,14,60,60,0,1
05-01-2025,Snacks & Ready-to-Eat,SF NOODLES CLKASSIC MASALA,14,129,129,0,1
05-01-2025,General Household & Kitchenware,SIRIDHANYALU BOOK,3,200,180,20,1
05-01-2025,"Dry Fruits, Nuts & Seeds",PULMAKHANA 100 GM,2,180,170,10,1
05-01-2025,Snacks & Ready-to-Eat,SF VERMICELLI,14,139,139,0,1
05-01-2025,Snacks & Ready-to-Eat,SF CHOCO CRUNCH,14,299,299,0,1
05-01-2025,Snacks & Ready-to-Eat,MILLET NOODLES CURRY MASALA,14,129,129,0,1
05-01-2025,Spices & Seasonings,NUVVULU 500GM,15,160,140,20,1
05-01-2025,"Health, Wellness & Ayurvedic Products",EUCALYPTUS OIL,5,199,199,0,1
05-01-2025,"Grains, Flours & Dals",VL Sabdana 500GM,4,77,77,0,1
05-01-2025,"Health, Wellness & Ayurvedic Products",RB Max Protein Classic Creamy,5,169,169,0,1
05-01-2025,"Health, Wellness & Ayurvedic Products",BRINGARAJ POWDER,5,70,70,0,1
05-01-2025,Oils & Ghee,Coconut oil 1 L,9,1320,"1,200.00",120,3
05-01-2025,"Grains, Flours & Dals",Multigrain 1 kg,4,300,255,45,3
05-01-2025,"Health, Wellness & Ayurvedic Products",AMLAKI CHOORNAM,5,100,100,0,1
05-01-2025,Spices & Seasonings,Dalchin Chekka 50GM,15,50,40,10,1
05-01-2025,"Grains, Flours & Dals",RAGI FLOUR 1KG,4,80,70,10,1
05-01-2025,Personal Care & Cosmetics,HERBAL BATH POWDER 200GM,10,80,80,0,1
05-01-2025,"Grains, Flours & Dals",BARLEY FLOUR 250GM,4,45,40,5,1
05-01-2025,Oils & Ghee,Sesame oil 500ml,9,295,280,15,1
05-01-2025,"Health, Wellness & Ayurvedic Products",MH Millets Malt 500GM,5,200,190,10,1
05-01-2025,Sweeteners,SUGAR 500 GM,16,30,25,5,1
05-01-2025,"Dry Fruits, Nuts & Seeds",Groundnuts 1 kg,2,190,170,20,1
05-01-2025,"Dry Fruits, Nuts & Seeds",PUTNALU 500GMS,2,90,76,14,1
05-01-2025,"Grains, Flours & Dals",Urad dall 1 Kg,4,555,510,45,3
05-01-2025,"Health, Wellness & Ayurvedic Products",RAMA BALM 10ML,5,40,40,0,1
05-01-2025,"Grains, Flours & Dals",Idly Rava L 1KG,4,180,150,30,3
05-01-2025,"Grains, Flours & Dals",CHANA DAL 500GM,4,70,60,10,1
05-01-2025,Personal Care & Cosmetics,DABUR RED PASTE 50GM,10,75,75,0,3
05-01-2025,Spices & Seasonings,Jeera 100GM,15,50,45,5,1
05-01-2025,Oils & Ghee,Sesame oil 1 L,9,590,560,30,1
05-01-2025,"Grains, Flours & Dals",PESARA PAPPU 500GMS,4,85,75,10,1
05-01-2025,"Grains, Flours & Dals",SRILATHA RICE RAVVA 500GM,4,105,105,0,3
05-01-2025,"Grains, Flours & Dals",PRO ORG MEDIUM POHA 500G,4,78,78,0,1
05-01-2025,"Grains, Flours & Dals",turdal 500 gms,4,110,100,10,1
05-01-2025,"Grains, Flours & Dals",RICE FLOUR 500 GM,4,35,28,7,1
05-01-2025,Snacks & Ready-to-Eat,RAGI LADDU,14,120,120,0,1
05-01-2025,Snacks & Ready-to-Eat,KHARJURAM DRY FRUIT LADDU,14,180,180,0,1
05-01-2025,Oils & Ghee,Sesame oil 500ml,9,295,280,15,1
05-01-2025,Spices & Seasonings,Masala Karam 500 gms,15,260,240,20,1
05-01-2025,Oils & Ghee,Sesame oil 1 L,9,590,560,30,1
05-01-2025,"Grains, Flours & Dals",RAGI FLOUR 500GRMS,4,40,35,5,1
05-01-2025,"Grains, Flours & Dals",Wheat Flour 2 kgs,4,140,120,20,1
05-01-2025,"Grains, Flours & Dals",RICE FLOUR 500 GM,4,35,28,7,1
05-01-2025,Oils & Ghee,Groundnut oil 1 L,9,360,330,30,1
05-01-2025,"Grains, Flours & Dals",Chana Flour 500 gms,4,70,65,5,1
05-01-2025,"Grains, Flours & Dals",Chana Flour 500 gms,4,70,65,5,1
05-01-2025,Spices & Seasonings,ELACHI 25 GM,15,145,120,25,1
05-01-2025,"Grains, Flours & Dals",BARLEY FLOUR 250GM,4,45,40,5,1
05-01-2025,"Grains, Flours & Dals",BASMATHI RICE 1KG,4,150,135,15,1
05-01-2025,Sweeteners,YB Brown Sugar 500GM,16,150,150,0,2
05-01-2025,"Grains, Flours & Dals",split urad dall 500 gms,4,90,80,10,1
05-01-2025,Misc,HOME LIKES,8,10,10,0,1
05-01-2025,"Grains, Flours & Dals",CORN FOUR 250GM,4,40,35,5,1
05-01-2025,Pooja & Spiritual Items,BANDA PUVVU 25GM 25GM,12,80,60,20,1
05-01-2025,Sweeteners,YB JAGGERY POWDER 500GMS,16,75,75,0,1
05-01-2025,Snacks & Ready-to-Eat,ELITE MILK RUSK 200GM,14,35,35,0,1
05-01-2025,Pooja & Spiritual Items,PACHI KARPURAM 25GM,12,180,180,0,2
05-01-2025,Oils & Ghee,Safflower oil 1 L,9,440,400,40,1
05-01-2025,Spices & Seasonings,YB PINK ROCK SALT 1KG,15,120,120,0,1
05-01-2025,"Health, Wellness & Ayurvedic Products",YB APPLE CIDER VINEGAR500ML,5,500,500,0,1
05-01-2025,"Grains, Flours & Dals",Wheat Flour 1 kg,4,70,60,10,1
05-01-2025,Sweeteners,GS JAGGERY NUGGETS 500GM,16,120,120,0,1
05-01-2025,Household & Cleaning,VIM EXTRA 110GM,6,20,20,0,2
05-01-2025,Household & Cleaning,HERBAL FLOOR CLEANER 500ML,6,116,116,0,1
05-01-2025,Oils & Ghee,Freedom Rice Bran Oil 1L,9,194,180,14,1
05-01-2025,Oils & Ghee,Groundnut oil 5 L,9,1800,"1,600.00",200,1
05-01-2025,Snacks & Ready-to-Eat,VD NUVULU CHEGODI 175GM,14,60,60,0,1
05-01-2025,Snacks & Ready-to-Eat,SD Moringa with plam jaggery 250gm,14,135,135,0,1
05-01-2025,"Grains, Flours & Dals",Idly Rava L 1KG,4,60,50,10,1
05-01-2025,Snacks & Ready-to-Eat,BB VERMICELLY 500GM,14,53,53,0,1
05-01-2025,Personal Care & Cosmetics,Khadi Red Onion Shampoo 200ML,10,199,199,0,1
05-01-2025,Oils & Ghee,Groundnut oil 1 L,9,360,330,30,1
05-01-2025,Sweeteners,YB JAGGERY POWDER 1KG,16,140,140,0,1
05-01-2025,Snacks & Ready-to-Eat,RAGI LADDU,14,120,120,0,1
05-01-2025,Spices & Seasonings,SV Oregano 15GM,15,110,110,0,1
05-01-2025,Beverages,BRU GREEN LABEL 1.2G,1,48,48,0,24
05-01-2025,Beverages,RED LABEL NATURAL CARE 100G,1,65,65,0,1
05-01-2025,Oils & Ghee,Sesame oil 1 L,9,590,560,30,1
05-01-2025,Oils & Ghee,Safflower oil 1 L,9,440,400,40,1
05-01-2025,Sweeteners,YB Palm Jaggery 250GM,16,200,200,0,1
05-01-2025,Sweeteners,GS Organic Jaggery Powder 600GM,16,99,99,0,1
05-01-2025,"Grains, Flours & Dals",RAGULU 1 KG,4,70,60,10,1
05-01-2025,Oils & Ghee,Mustard oil 1 L,9,440,390,50,1
05-01-2025,Snacks & Ready-to-Eat,SD KODO MILLET WITH PALM JAGGERY,14,135,135,0,1
05-01-2025,Oils & Ghee,Groundnut oil 1 L,9,360,330,30,1
05-01-2025,"Grains, Flours & Dals",split black gram 1 kg,4,180,170,10,1
05-01-2025,"Dry Fruits, Nuts & Seeds",SD Mango cubes 100gm,2,45,45,0,1
05-01-2025,Snacks & Ready-to-Eat,SD Vamu with palm jaggery 250gm,14,270,270,0,2
05-01-2025,Oils & Ghee,Sesame oil 1 L,9,1180,"1,120.00",60,2
05-01-2025,"Health, Wellness & Ayurvedic Products",EUCALYPTUS OIL,5,199,199,0,1
05-01-2025,Beverages,AT Super Strong Tea 250GM,1,199,199,0,1
05-01-2025,Snacks & Ready-to-Eat,VD MURUKU 175GM,14,60,60,0,1
05-01-2025,Spices & Seasonings,Black Till 250GM,15,90,75,15,1
05-01-2025,Beverages,BRU GREEN LABEL 1.2G,1,48,48,0,24
05-01-2025,Snacks & Ready-to-Eat,GANTASALA BITTER GUARD SNACKS,14,60,60,0,1
05-01-2025,"Dry Fruits, Nuts & Seeds",PUMPKIN SEEDS 250GM,2,200,160,40,1
05-01-2025,Oils & Ghee,Groundnut oil 1 L,9,360,330,30,1
05-01-2025,"Dry Fruits, Nuts & Seeds",WATERMELON SEEDS 250GRM,2,320,280,40,1
05-01-2025,"Dry Fruits, Nuts & Seeds",SABJA SEEDS 100GM,2,80,70,10,1
05-01-2025,"Dry Fruits, Nuts & Seeds",SUNFLOWER SEEDS 250GRM,2,150,130,20,1
05-01-2025,Oils & Ghee,Coconut oil 500 ml,9,220,200,20,1
05-01-2025,Snacks & Ready-to-Eat,Corn Chips 250GM,14,40,35,5,1
05-01-2025,Oils & Ghee,Sesame oil 1 L,9,590,560,30,1
05-01-2025,Snacks & Ready-to-Eat,PALLI LADDU 200GMS,14,90,70,20,1
05-01-2025,"Grains, Flours & Dals",RAGI FLOUR 500GRMS,4,40,35,5,1
05-01-2025,Snacks & Ready-to-Eat,COPRA LADDU 200GM,14,100,80,20,1
05-01-2025,"Dry Fruits, Nuts & Seeds",PUMPKIN SEEDS 250GM,2,200,160,40,1
05-01-2025,"Dry Fruits, Nuts & Seeds",WATERMELON SEEDS 250GRM,2,320,280,40,1
05-01-2025,"Dry Fruits, Nuts & Seeds",ALMONDS 250GM,2,560,520,40,2
05-01-2025,Oils & Ghee,Sesame oil 500ml,9,295,280,15,1
05-01-2025,"Dry Fruits, Nuts & Seeds",WALLNUTS 250GM,2,320,290,30,1
05-01-2025,Oils & Ghee,Mustard oil 500 ml,9,220,195,25,1
05-01-2025,Oils & Ghee,Coconut oil 500 ml,9,220,200,20,1
05-01-2025,Snacks & Ready-to-Eat,PEANUT CANDY,14,45,45,0,1
05-01-2025,Snacks & Ready-to-Eat,Popcorn Seeds 250GM,14,45,40,5,1
05-01-2025,Snacks & Ready-to-Eat,FUN TIME CRUNCH,14,45,45,0,1
05-01-2025,Snacks & Ready-to-Eat,SD Bajra with palm Jaggery 250gm,14,135,135,0,1
05-01-2025,Snacks & Ready-to-Eat,MARMURA LADDU,14,80,60,20,1
05-01-2025,Beverages,BRU GREEN LABEL 1.2G,1,48,48,0,24
05-01-2025,Snacks & Ready-to-Eat,VD MINAPA SUNNUNDALU 12P,14,360,360,0,2
05-01-2025,"Grains, Flours & Dals",MELMEKER 250GMS,4,60,45,15,1
05-01-2025,Pickles & Cooking Pastes,CHICKEN PICKLE 200GM,11,600,560,40,2
05-01-2025,Snacks & Ready-to-Eat,VD CORNFLAKES MIXTURE 175GM,14,60,60,0,1
05-01-2025,Household & Cleaning,VIM TROPICAL LEMON FRESHNESS 250ML,6,55,55,0,1
05-01-2025,Snacks & Ready-to-Eat,BLACK SESAME CHIKKI,14,20,20,0,2
05-01-2025,"Dry Fruits, Nuts & Seeds",SATHVI CHIA SEEDS 100GM,2,100,80,20,1
05-01-2025,Spices & Seasonings,SD Redgram Karam Powder 100GM,15,65,65,0,1
05-01-2025,Spices & Seasonings,FLAXSEED KARAM,15,75,75,0,1
05-01-2025,Snacks & Ready-to-Eat,PEANUT CANDY,14,45,45,0,1
05-01-2025,Snacks & Ready-to-Eat,WHITE SESAME CHIKKI,14,20,20,0,2
05-01-2025,"Dry Fruits, Nuts & Seeds",Groundnuts 500 gms,2,95,85,10,1
05-01-2025,Spices & Seasonings,Chilli powder 500 gms,15,290,210,80,1
05-01-2025,Personal Care & Cosmetics,GAYATHRI KUMKUDUKAYA,10,150,150,0,1
05-01-2025,"Grains, Flours & Dals",FLOUR CHARGE,4,12,12,0,1
05-01-2025,Spices & Seasonings,ROYAL SAFFRON,15,125,125,0,1
05-01-2025,"Grains, Flours & Dals",turdal 500 gms,4,110,100,10,1
05-01-2025,"Grains, Flours & Dals",Wheat Rava M 500GM,4,33,30,3,1
05-01-2025,"Grains, Flours & Dals",SL Idly Rava 1KG,4,65,55,10,1
05-01-2025,"Dry Fruits, Nuts & Seeds",Groundnuts 500 gms,2,95,85,10,1
05-01-2025,"Grains, Flours & Dals",Urad dall 1 Kg,4,185,170,15,1
05-01-2025,"Grains, Flours & Dals",DESI CHANA,4,25,25,0,1
05-01-2025,"Grains, Flours & Dals",THIN POHA 500GM,4,40,35,5,1
05-01-2025,"Grains, Flours & Dals",White jowar.F 1 kg,4,100,80,20,1
05-01-2025,Spices & Seasonings,ROYAL SAFFRON 400GRMS,15,65,65,0,1
05-01-2025,"Dry Fruits, Nuts & Seeds",YELLOW KISHMISH 250GM,2,130,110,20,1
05-01-2025,Sweeteners,SUGAR 1KG,16,60,50,10,1
05-01-2025,Spices & Seasonings,YB PINK ROCK SALT 1KG,15,120,120,0,1
05-01-2025,"Grains, Flours & Dals",RAGI FLOUR 500GRMS,4,40,35,5,1
05-01-2025,Spices & Seasonings,NUVVULU 250GM,15,80,70,10,1
05-01-2025,Spices & Seasonings,Jeera 100GM,15,50,45,5,1
05-01-2025,Sweeteners,YB JAGGERY POWDER 500GMS,16,75,75,0,1
05-01-2025,"Grains, Flours & Dals",Multigrain 1 kg,4,100,85,15,1
05-01-2025,"Health, Wellness & Ayurvedic Products",AMLAKI CHOORNAM,5,100,100,0,1
05-01-2025,"Health, Wellness & Ayurvedic Products",SHIKAKAI CHOORNAM,5,80,80,0,1
05-01-2025,"Health, Wellness & Ayurvedic Products",RB Max Protein Fruit &amp;Nut 50g,5,75,75,0,1
05-01-2025,Milk & Dairy,TOTAL CURD 50GMS,7,10,10,0,1
05-01-2025,"Grains, Flours & Dals",SABDANA,4,40,35,5,1
05-01-2025,"Grains, Flours & Dals",BAJRA 1 KG,4,30,25,5,0.5
05-01-2025,Oils & Ghee,Groundnut oil 500ml,9,180,165,15,1
05-01-2025,"Grains, Flours & Dals",SAMALU (Little millet) 1 kg,4,170,130,40,1
05-01-2025,"Grains, Flours & Dals",Arikadu ( kodo),4,140,130,10,1
05-01-2025,Milk & Dairy,BROWN EGGS 1P,7,140,120,20,10
05-01-2025,Spices & Seasonings,ROYAL SAFFRON,15,125,125,0,1
05-01-2025,Spices & Seasonings,NUVVULU 250GM,15,100,85,15,1
05-01-2025,Sweeteners,NATURAL HONEY 250GM,16,150,130,20,1
05-01-2025,Oils & Ghee,Sesame oil 1 L,9,590,560,30,1
05-01-2025,"Grains, Flours & Dals",HS jowar idly rava 500 gms,4,65,65,0,1
05-01-2025,Snacks & Ready-to-Eat,SATHVI REGIVADA 200GM,14,80,60,20,1
05-01-2025,Snacks & Ready-to-Eat,SATHVI PALLI CHIKKI 200GM,14,100,80,20,1
05-01-2025,Snacks & Ready-to-Eat,GANTASALA BITTER GUARD SNACKS,14,60,60,0,1
05-01-2025,"Health, Wellness & Ayurvedic Products",MD Uttareni Choornam 50GM,5,120,120,0,1
05-01-2025,Snacks & Ready-to-Eat,PEANUT CHILLI,14,25,25,0,5
05-01-2025,Snacks & Ready-to-Eat,TILLI CHIKKI,14,35,35,0,7
05-01-2025,Snacks & Ready-to-Eat,NGT CHATPATTA CHANA 90GM,14,25,25,0,1
05-01-2025,Snacks & Ready-to-Eat,WHITE SESAME CHIKKI,14,20,20,0,2
05-01-2025,"Grains, Flours & Dals",EM Ragi upma R 500g,4,75,75,0,1
05-01-2025,Oils & Ghee,Groundnut oil 1 L,9,360,330,30,1
05-01-2025,"Grains, Flours & Dals",Em little upma R 500g,4,129,129,0,1
05-01-2025,Snacks & Ready-to-Eat,SD FINGER Millet with palm Jaggery 250gm,14,135,135,0,1
05-01-2025,"Grains, Flours & Dals",WHEAT 1 KG,4,300,250,50,5
05-01-2025,"Grains, Flours & Dals",Wheat Rava M 500GM,4,66,60,6,2
05-01-2025,"Grains, Flours & Dals",FLOUR CHARGE,4,60,60,0,5
05-01-2025,"Grains, Flours & Dals",RAGI FLOUR 500GRMS,4,40,35,5,1
05-01-2025,"Grains, Flours & Dals",AMMA RICE RAVA 500GRMS,4,42,42,0,1
05-01-2025,Oils & Ghee,Safflower oil 1 L,9,440,400,40,1
05-01-2025,Snacks & Ready-to-Eat,ID PAROTA,14,99,99,0,1
05-01-2025,"Grains, Flours & Dals",Multigrain 1 kg,4,100,85,15,1
05-01-2025,Oils & Ghee,Sesame oil 1 L,9,590,560,30,1
05-01-2025,Milk & Dairy,BROWN EGGS TRAY 30P,7,360,330,30,1
05-01-2025,Household & Cleaning,VIM COOLING FRESHNESS MINT,6,20,20,0,1
05-01-2025,Beverages,BRU GREEN LABEL 1.2G,1,48,48,0,24
05-01-2025,Snacks & Ready-to-Eat,SF COOKIES CHOCO RAGI,14,99,99,0,1
05-01-2025,"Grains, Flours & Dals",Red Chana 250GM,4,35,30,5,1
05-01-2025,"Dry Fruits, Nuts & Seeds",Groundnuts 500 gms,2,95,85,10,1
05-01-2025,"Grains, Flours & Dals",POORI ATTA 1KG,4,70,60,10,1
05-01-2025,Beverages,BRU GREEN LABEL 1.2G,1,6,6,0,3
05-01-2025,Oils & Ghee,Safflower oil 1 L,9,880,800,80,2
05-01-2025,"Grains, Flours & Dals",Wheat Flour 1 kg,4,70,60,10,1
05-01-2025,Snacks & Ready-to-Eat,Corn Chips 250GM,14,40,35,5,1
05-01-2025,"Health, Wellness & Ayurvedic Products",RB Max Protein Oats &Raisins 55gm,5,50,50,0,1
05-01-2025,Personal Care & Cosmetics,SAIBOL SKIN,10,43,43,0,1
05-01-2025,Personal Care & Cosmetics,GOW DURBAR NAVA 100GM SOAP,10,40,40,0,1
05-01-2025,"Health, Wellness & Ayurvedic Products",RB Max Protein NUTS &SEEDS 55gm,5,50,50,0,1
05-01-2025,"Grains, Flours & Dals",PRO ORG IDLY RAVA 1KG,4,145,145,0,1
05-01-2025,"Grains, Flours & Dals",Wheat Rava M 500GM,4,33,30,3,1
05-01-2025,Snacks & Ready-to-Eat,BB ROASTED VERMICELLY 500GM,14,70,70,0,1
05-01-2025,"Grains, Flours & Dals",PRO ORG MEDIUM POHA 500G,4,156,156,0,2
05-01-2025,Personal Care & Cosmetics,KAIPO NONI TP 100GM,10,90,90,0,1
05-01-2025,"Grains, Flours & Dals",Green Batani 500GM,4,110,90,20,1
05-01-2025,"Dry Fruits, Nuts & Seeds",Groundnuts 1 kg,2,190,170,20,1
05-01-2025,Snacks & Ready-to-Eat,PN ORGANIC PUFFED RICE 200GM,14,55,55,0,1
05-01-2025,Baking & Cooking Aids,MTR GULAB JAMUN MIX 190GM,0,80,80,0,1
05-01-2025,"Grains, Flours & Dals",Green gram 1 kg,4,150,130,20,1
05-01-2025,"Grains, Flours & Dals",SABDANA,4,45,35,10,1
05-01-2025,Oils & Ghee,Sesame oil 1 L,9,590,560,30,1
05-01-2025,"Grains, Flours & Dals",DH URAD GOTA 1KG,4,215,190,25,1
05-01-2025,Snacks & Ready-to-Eat,VD CORNFLAKES MIXTURE 175GM,14,60,60,0,1
05-01-2025,Pickles & Cooking Pastes,SD LEMON PICKLE,11,110,110,0,1
05-01-2025,Personal Care & Cosmetics,COCONUT BATH SCRUBBER,10,40,40,0,1
05-01-2025,Oils & Ghee,Groundnut oil 1 L,9,360,330,30,1
05-01-2025,Snacks & Ready-to-Eat,SD Aswagandha with palm Jaggery250Gm,14,135,135,0,1
05-01-2025,General Household & Kitchenware,CANDLE,3,60,60,0,2
05-01-2025,"Dry Fruits, Nuts & Seeds",Groundnuts 1 kg,2,380,340,40,2
05-01-2025,"Grains, Flours & Dals",Idly Rava L 1KG,4,120,100,20,2
05-01-2025,"Grains, Flours & Dals",Urad dall 1 Kg,4,370,340,30,2
05-01-2025,"Grains, Flours & Dals",KORRALU (FOXTAIL M) 500GM,4,65,55,10,1
05-01-2025,Sweeteners,SUGAR 1KG,16,120,100,20,2
05-01-2025,"Grains, Flours & Dals",CHANA DAL 500GM,4,70,60,10,1
05-01-2025,Spices & Seasonings,ROYAL SAFFRON 400GRMS,15,65,65,0,1
05-01-2025,"Grains, Flours & Dals",turdal 1kg,4,220,195,25,1
05-01-2025,Oils & Ghee,Coconut oil 1 L,9,440,400,40,1
05-01-2025,Pooja & Spiritual Items,GD Sambrani Cup Dhoop 10 PC,12,96,96,0,1
05-01-2025,Snacks & Ready-to-Eat,RAGI LADDU,14,120,120,0,1
05-01-2025,"Health, Wellness & Ayurvedic Products",MD Triphala Chorrnam 100GM,5,60,60,0,1
05-01-2025,Spices & Seasonings,Jeera 100GM,15,50,45,5,1
05-01-2025,Snacks & Ready-to-Eat,GANTASALA GINGER CANDY 200GM,14,210,210,0,2
05-01-2025,Spices & Seasonings,GS Moringa Leaves Spicy Powder 100GM,15,180,180,0,2
05-01-2025,Oils & Ghee,Coconut oil 500 ml,9,440,400,40,2
05-01-2025,"Dry Fruits, Nuts & Seeds",MAHA BEERA SEEDS 100GM,2,60,60,0,1
05-01-2025,"Grains, Flours & Dals",DM LOW GI SP 20KG,4,1800,"1,800.00",0,1
05-01-2025,Snacks & Ready-to-Eat,BD RED RICE NOODLES 200G,14,70,70,0,1
05-01-2025,Spices & Seasonings,TATA SALT 1KG,15,30,30,0,1
05-01-2025,Sweeteners,SUGAR 1KG,16,120,100,20,2
05-01-2025,Snacks & Ready-to-Eat,MIX MILLET NOODLES,14,75,75,0,1
05-01-2025,"Grains, Flours & Dals",turdal 1kg,4,440,390,50,2
05-01-2025,Spices & Seasonings,Jeera 100GM,15,50,45,5,1
05-01-2025,"Grains, Flours & Dals",Wheat Flour 1 kg,4,560,480,80,8
05-01-2025,Spices & Seasonings,Tamarind 250GMS,15,80,75,5,1
05-01-2025,Snacks & Ready-to-Eat,MARMURA LADDU,14,160,120,40,2
05-01-2025,Snacks & Ready-to-Eat,VD Pappu Chekkalu 190gm,14,60,60,0,1
05-01-2025,Snacks & Ready-to-Eat,VD Pappu Chekkalu 190gm,14,60,60,0,1
05-01-2025,Spices & Seasonings,SH TAMARIND SEEDLESS 200 GM,15,130,130,0,1
05-01-2025,Snacks & Ready-to-Eat,SATHVI REGIVADA 200GM,14,80,60,20,1
05-01-2025,"Grains, Flours & Dals",Multigrain 1 kg,4,100,85,15,1
05-01-2025,Sweeteners,Natural Honey 500 gms,16,280,240,40,1
05-01-2025,Oils & Ghee,Groundnut oil 1 L,9,360,330,30,1
05-01-2025,Snacks & Ready-to-Eat,VD SANNAPUSA 175GM,14,60,60,0,1
05-01-2025,Sweeteners,YB JAGGERY POWDER 1KG,16,140,140,0,1
05-01-2025,Snacks & Ready-to-Eat,VD PAPPU CHEGODI 200GM,14,60,60,0,1
05-01-2025,Snacks & Ready-to-Eat,SATHVI REGIVADA 200GM,14,80,60,20,1
05-01-2025,"Grains, Flours & Dals",SAMALU (Little millet) 500 gms,4,85,65,20,1
05-01-2025,"Dry Fruits, Nuts & Seeds",PLAIN PISTA 250GM,2,660,550,110,1
05-01-2025,"Grains, Flours & Dals",DISANO OATS 1KG,4,142,142,0,1
05-01-2025,"Dry Fruits, Nuts & Seeds",BLACK KISMIS 250GM,2,175,140,35,1
05-01-2025,"Grains, Flours & Dals",MELMEKER 250GMS,4,60,45,15,1
05-01-2025,"Dry Fruits, Nuts & Seeds",PULMAKHANA 100 GM,2,180,170,10,1
05-01-2025,"Grains, Flours & Dals",Arikalu (kodo),4,70,65,5,1
05-01-2025,Snacks & Ready-to-Eat,SF MILLET NOODLES MILD MASALA 192GM,14,258,258,0,2
05-01-2025,"Dry Fruits, Nuts & Seeds",KAJU HALF 250GM,2,310,290,20,1
05-01-2025,"Dry Fruits, Nuts & Seeds",WALLNUTS 250GM,2,320,290,30,1
05-01-2025,"Grains, Flours & Dals",split green gram 500 gms,4,75,70,5,1
05-01-2025,"Grains, Flours & Dals",VGR rice 1 kg,4,210,195,15,3
05-01-2025,"Grains, Flours & Dals",SH TUR DAL 500GM,4,165,165,0,1
05-01-2025,Snacks & Ready-to-Eat,VD MURUKU 175GM,14,60,60,0,1
05-01-2025,"Grains, Flours & Dals",Multigrain 1 kg,4,100,85,15,1
05-01-2025,"Grains, Flours & Dals",VYS.SP.RICE 5 KGS,4,350,325,25,1
05-01-2025,"Dry Fruits, Nuts & Seeds",FLAX SEEDS 250GM,2,120,100,20,2
05-01-2025,Milk & Dairy,BROWN EGGS TRAY 30P,7,360,330,30,1
05-01-2025,Oils & Ghee,Groundnut oil 500ml,9,180,165,15,1
05-01-2025,Oils & Ghee,Groundnut oil 1 L,9,360,330,30,1
05-01-2025,Oils & Ghee,Safflower oil 500 ml,9,220,200,20,1
05-01-2025,Oils & Ghee,Sesame oil 500ml,9,295,280,15,1
05-01-2025,Oils & Ghee,Coconut oil 500 ml,9,220,200,20,1
05-01-2025,Oils & Ghee,Mustard oil 500 ml,9,220,195,25,1
05-01-2025,Spices & Seasonings,Gasagasalu 50GM,15,130,110,20,1
05-01-2025,Oils & Ghee,Safflower oil 1 L,9,440,400,40,1
05-01-2025,"Grains, Flours & Dals",Multigrain 1 kg,4,100,85,15,1
05-01-2025,Oils & Ghee,Sesame oil 1 L,9,590,560,30,1
05-01-2025,Spices & Seasonings,RED COPRA 500GM,15,170,148,22,1
05-01-2025,Oils & Ghee,Groundnut oil 1 L,9,720,660,60,2
05-01-2025,"Grains, Flours & Dals",Idly Rava L 1KG,4,120,100,20,2
05-01-2025,Spices & Seasonings,Japatri 25GM,15,100,80,20,1
05-01-2025,Spices & Seasonings,PRO ORG CASSIA 50G,15,85,85,0,1
05-01-2025,Spices & Seasonings,ROYAL SAFFRON 400GRMS,15,65,65,0,1
05-01-2025,"Grains, Flours & Dals",Black gram 500 gms,4,75,70,5,1
05-01-2025,Snacks & Ready-to-Eat,GB SALT COOKIES,14,60,55,5,1
05-01-2025,Oils & Ghee,Safflower oil 1 L,9,1320,"1,200.00",120,3
05-01-2025,Snacks & Ready-to-Eat,PALLI LADDU 200GMS,14,90,70,20,1
05-01-2025,Oils & Ghee,Sesame oil 1 L,9,1180,"1,120.00",60,2
05-01-2025,"Dry Fruits, Nuts & Seeds",PULMAKHANA 100 GM,2,540,510,30,3
05-01-2025,"Grains, Flours & Dals",MELMEKER 250GMS,4,60,45,15,1
05-01-2025,"Grains, Flours & Dals",JOWAR YELLOW 1 K,4,90,90,0,1
05-01-2025,Snacks & Ready-to-Eat,VD Pappu Chekkalu 190gm,14,120,120,0,2
05-01-2025,Oils & Ghee,Mustard oil 1 L,9,440,390,50,1
05-01-2025,Spices & Seasonings,Coconut Powder 250GM,15,90,70,20,1
05-01-2025,"Grains, Flours & Dals",turdal 500 gms,4,110,100,10,1
05-01-2025,Milk & Dairy,BROWN EGGS 1P,7,84,72,12,6
05-01-2025,Personal Care & Cosmetics,DABUR RED PASTE 50GM,10,25,25,0,1
05-01-2025,"Grains, Flours & Dals",SAMALU (Little millet) 500 gms,4,85,65,20,1
05-01-2025,Oils & Ghee,Sesame oil 1 L,9,590,560,30,1
05-01-2025,"Grains, Flours & Dals",Wheat Flour 2 kgs,4,280,240,40,2
05-01-2025,Oils & Ghee,Groundnut oil 1 L,9,720,660,60,2
05-01-2025,"Grains, Flours & Dals",GROUNDNUT CAKE,4,50,45,5,1
05-01-2025,"Grains, Flours & Dals",MELMEKER 250GMS,4,60,45,15,1
05-01-2025,"Grains, Flours & Dals",MUSTARD CAKE,4,50,50,0,1
05-01-2025,Pooja & Spiritual Items,GD Dhoop Sticks 26GM,12,20,20,0,1
05-01-2025,Snacks & Ready-to-Eat,SF VERMICELLI,14,139,139,0,1
05-01-2025,"Grains, Flours & Dals",Wheat Flour 2 kgs,4,140,120,20,1
05-01-2025,Oils & Ghee,Sesame oil 1 L,9,1180,"1,120.00",60,2
05-01-2025,Pooja & Spiritual Items,GD Aiswarya Deepam 700ML,12,195,195,0,1
05-01-2025,Oils & Ghee,Groundnut oil 1 L,9,720,660,60,2
05-01-2025,"Grains, Flours & Dals",VGR rice 1 kg,4,350,325,25,5
05-01-2025,"Grains, Flours & Dals",White jowar.F 1 kg,4,200,160,40,2
05-01-2025,Spices & Seasonings,JEERA 250 gms,15,125,105,20,1
05-01-2025,"Grains, Flours & Dals",VYS.SP.RICE BAG 1,4,1800,"1,650.00",150,1
05-01-2025,Oils & Ghee,Safflower oil 1 L,9,1320,"1,200.00",120,3
05-01-2025,Snacks & Ready-to-Eat,VD RICE MURUKU 150GM,14,50,50,0,1
05-01-2025,"Grains, Flours & Dals",Chana Flour 500 gms,4,70,65,5,1
05-01-2025,"Grains, Flours & Dals",SPLIT BLACK GRAM 500 GM,4,90,85,5,1
05-01-2025,"Grains, Flours & Dals",RAGI FLOUR 1KG,4,80,70,10,1
05-01-2025,Milk & Dairy,BROWN EGGS 1P,7,28,24,4,2
05-01-2025,"Grains, Flours & Dals",MAAGAANI SP RICE 20 KGS,4,2300,"1,960.00",340,1
05-01-2025,Spices & Seasonings,ELACHI 25 GM,15,145,120,25,1
05-01-2025,Milk & Dairy,TOTAL CURD 50GMS,7,10,10,0,1
05-01-2025,Sweeteners,SUGAR 500 GM,16,30,25,5,1
05-01-2025,Spices & Seasonings,RED COPRA 250GMS,15,85,74,11,1
05-01-2025,Snacks & Ready-to-Eat,VD Pappu Chekkalu 190gm,14,60,60,0,1
05-01-2025,Beverages,BRU GREEN LABEL 1.2G,1,48,48,0,24
05-01-2025,Personal Care & Cosmetics,TRESEMME KS KERATIN SMOOTH,10,80,80,0,1
05-01-2025,Snacks & Ready-to-Eat,VD PAPPU CHEGODI 200GM,14,120,120,0,2
05-01-2025,Sweeteners,YB JAGGERY POWDER 500GMS,16,75,75,0,1
05-01-2025,Pickles & Cooking Pastes,SD MANGO TOKKU,11,110,110,0,1
05-01-2025,Snacks & Ready-to-Eat,ZEEDI,14,70,70,0,1
05-01-2025,Personal Care & Cosmetics,LISTERINE MILD TASTE 250ML,10,210,210,0,1
05-01-2025,"Dry Fruits, Nuts & Seeds",DIANUTS 500GM,2,120,120,0,1
05-01-2025,Snacks & Ready-to-Eat,COPRA LADDU 200GM,14,100,80,20,1
05-01-2025,Snacks & Ready-to-Eat,VD RED CHILLI RICEPAPAD 150GM,14,50,50,0,1
05-01-2025,"Grains, Flours & Dals",turdal 1kg,4,220,195,25,1
05-01-2025,Oils & Ghee,Groundnut oil 1 L,9,360,330,30,1
05-01-2025,Pooja & Spiritual Items,GD Dhoop Cones 40GM,12,30,30,0,1
05-01-2025,"Dry Fruits, Nuts & Seeds",PUTNALU 500GMS,2,90,76,14,1
05-01-2025,"Dry Fruits, Nuts & Seeds",Groundnuts 1 kg,2,190,170,20,1
05-01-2025,"Grains, Flours & Dals",Chana Flour 500 gms,4,70,65,5,1
05-01-2025,Pooja & Spiritual Items,GD Dhoop Sticks 26GM,12,20,20,0,1
05-01-2025,"Grains, Flours & Dals",Wheat Flour 2 kgs,4,140,120,20,1
05-01-2025,Pooja & Spiritual Items,BALAJI LAVENDER DOOP STICK 10STK,12,125,125,0,1
05-01-2025,"Grains, Flours & Dals",Wheat Flour 1 kg,4,70,60,10,1
05-01-2025,Oils & Ghee,Sesame oil 1 L,9,1180,"1,120.00",60,2
05-01-2025,"Grains, Flours & Dals",SRI LALITHA SONAMASOORI 5KG,4,880,740,140,2
05-01-2025,Oils & Ghee,Safflower oil 1 L,9,880,800,80,2
05-01-2025,"Grains, Flours & Dals",RICE FLOUR 1KG,4,70,55,15,1
05-01-2025,"Grains, Flours & Dals",Chana Flour 1 kg,4,140,130,10,1
05-01-2025,"Grains, Flours & Dals",BOMBAY RAVA,4,70,55,15,1
05-01-2025,Oils & Ghee,Safflower oil 500 ml,9,220,200,20,1
05-01-2025,"Grains, Flours & Dals",Chittimuthaylu rice 1 kg,4,160,140,20,1
05-01-2025,"Grains, Flours & Dals",DESI CHANA,4,50,50,0,2
05-01-2025,Spices & Seasonings,DB CRYSTAL SALT 1KG,15,25,25,0,1
05-01-2025,"Grains, Flours & Dals",SPLIT BLACK GRAM 500 GM,4,90,85,5,1
05-01-2025,"Grains, Flours & Dals",Bombay Rava 500GM,4,35,30,5,1
05-01-2025,"Grains, Flours & Dals",Wheat Rava M 500GM,4,33,30,3,1
05-01-2025,"Grains, Flours & Dals",URAD DALL,4,95,85,10,1
05-01-2025,Spices & Seasonings,Jeera 100GM,15,50,45,5,1
05-01-2025,Sweeteners,GS Organic Jaggery Powder 600GM,16,99,99,0,1
05-01-2025,Milk & Dairy,BROWN EGGS 1P,7,140,120,20,10
05-01-2025,"Grains, Flours & Dals",Wheat Flour 1 kg,4,70,60,10,1
05-01-2025,"Grains, Flours & Dals",Multigrain 1 kg,4,100,85,15,1
05-01-2025,Spices & Seasonings,DB CRYSTAL SALT 1KG,15,25,25,0,1
05-01-2025,Snacks & Ready-to-Eat,VD DAHI MIRCHI(SALTED) 100GM,14,45,45,0,1
05-01-2025,Spices & Seasonings,Turmeric powder 250 gms,15,100,75,25,1
05-01-2025,Snacks & Ready-to-Eat,BLACK SESAME CHIKKI,14,5,5,0,1
05-01-2025,Spices & Seasonings,ROYAL SAFFRON 400GRMS,15,65,65,0,1
05-01-2025,"Dry Fruits, Nuts & Seeds",ALBUKARA 250GM,2,145,120,25,1
05-01-2025,Snacks & Ready-to-Eat,RSC ORANGE 100GMS,14,20,20,0,1
05-01-2025,Sweeteners,SD PALM JAGGERY 500GM,16,200,200,0,1
05-01-2025,"Grains, Flours & Dals",KORRALU (FOXTAIL M) 1KG,4,150,110,40,1
05-01-2025,"Health, Wellness & Ayurvedic Products",HARITHAKI CHOORNAM,5,60,60,0,1
05-01-2025,Sweeteners,SUGAR 1KG,16,60,50,10,1
05-01-2025,"Grains, Flours & Dals",Arikalu (kodo),4,70,65,5,1
05-01-2025,Snacks & Ready-to-Eat,MB FOXTAIL MILLET NOODLES 180GM,14,95,95,0,1
05-01-2025,Oils & Ghee,Groundnut oil 1 L,9,720,660,60,2
05-01-2025,Oils & Ghee,Coconut oil 500 ml,9,220,200,20,1
05-01-2025,"Grains, Flours & Dals",EM Ragi idli R 500G,4,75,75,0,1
05-01-2025,"Grains, Flours & Dals",VYS.SP.RICE 10 KGS,4,700,650,50,1
05-01-2025,"Grains, Flours & Dals",Em jowar idly R 500G,4,75,75,0,1
05-01-2025,"Grains, Flours & Dals",Multigrain 1 kg,4,100,85,15,1
05-01-2025,"Grains, Flours & Dals",Wheat Flour 2 kgs,4,140,120,20,1
05-01-2025,"Grains, Flours & Dals",White jowar.F 1 kg,4,100,80,20,1
05-01-2025,"Grains, Flours & Dals",Chana Flour 500 gms,4,70,65,5,1
05-01-2025,"Grains, Flours & Dals",KORRALU (FOXTAIL M) 1KG,4,150,110,40,1
05-01-2025,Oils & Ghee,Groundnut oil 1 L,9,360,330,30,1
05-01-2025,Snacks & Ready-to-Eat,RAGI LADDU,14,120,120,0,1
05-01-2025,Oils & Ghee,Coconut oil 500 ml,9,220,200,20,1
05-01-2025,"Grains, Flours & Dals",VYS.SP.RICE 5 KGS,4,350,325,25,1
05-01-2025,Snacks & Ready-to-Eat,PALLI LADDU 200GMS,14,90,70,20,1
05-01-2025,Spices & Seasonings,Elaichi 25GM,15,145,120,25,1
05-01-2025,Snacks & Ready-to-Eat,BB VERMICELLI 250GM,14,30,30,0,1
05-01-2025,Oils & Ghee,Groundnut oil 1 L,9,360,330,30,1
05-01-2025,Spices & Seasonings,Lavangam 50GM,15,60,50,10,1
05-01-2025,Sweeteners,MISHRI D,16,40,30,10,1
05-01-2025,Snacks & Ready-to-Eat,FOXTAIL BIS,14,135,135,0,1
05-01-2025,Snacks & Ready-to-Eat,BD PEARL MILLET NOODLES 200G,14,75,75,0,1
05-01-2025,"Grains, Flours & Dals",BAJRA 1 KG,4,30,25,5,0.5
05-01-2025,Oils & Ghee,Sesame oil 1 L,9,590,560,30,1
05-01-2025,Oils & Ghee,Coconut oil 500 ml,9,220,200,20,1
05-01-2025,"Grains, Flours & Dals",RAGULU 1 KG,4,35,30,5,0.5
05-01-2025,Spices & Seasonings,PURO Healthy Salt 1KG,15,110,110,0,1
05-01-2025,Oils & Ghee,Groundnut oil 1 L,9,720,660,60,2
05-01-2025,"Grains, Flours & Dals",RAGI FLOUR 1KG,4,80,70,10,1
05-01-2025,"Grains, Flours & Dals",SL Suji Rava 500GM,4,32,32,0,1
05-01-2025,"Grains, Flours & Dals",AISHWARYA SP 1KG,4,80,75,5,1
05-01-2025,Snacks & Ready-to-Eat,ANNAPURNA APPALAM,14,35,35,0,1
05-01-2025,"Grains, Flours & Dals",Yellow jowar .F1 kg,4,110,100,10,1
05-01-2025,"Grains, Flours & Dals",HS jowar idly rava 500 gms,4,65,65,0,1
05-01-2025,"Grains, Flours & Dals",HS Jowar upma rava 500 gms,4,65,65,0,1
05-01-2025,"Grains, Flours & Dals",Wheat Flour 1 kg,4,70,60,10,1
05-01-2025,"Grains, Flours & Dals",WHEAT 1 KG,4,480,400,80,8
05-01-2025,"Grains, Flours & Dals",FLOUR CHARGE,4,96,96,0,8
05-01-2025,"Grains, Flours & Dals",AISHWARYA SP 1KG,4,80,75,5,1
05-01-2025,"Grains, Flours & Dals",DESI CHANA,4,25,25,0,1
05-01-2025,Snacks & Ready-to-Eat,SATHVI REGIVADA 200GM,14,80,60,20,1
05-01-2025,"Grains, Flours & Dals",ANDU KORRALU (Brown top .mlt) 500,4,160,150,10,1
05-01-2025,Spices & Seasonings,Chilli powder 500 gms,15,290,210,80,1
05-01-2025,"Grains, Flours & Dals",Arikalu (kodo),4,70,65,5,1
05-01-2025,"Grains, Flours & Dals",KORRALU (FOXTAIL M) 500GM,4,65,55,10,1
05-01-2025,"Grains, Flours & Dals",FLOUR CHARGE,4,48,48,0,4
05-01-2025,Milk & Dairy,BROWN EGGS 1P,7,140,120,20,10
05-01-2025,Spices & Seasonings,Chilli powder 500 gms,15,290,210,80,1
05-01-2025,Snacks & Ready-to-Eat,PEANUT CHILLI,14,20,20,0,4
05-01-2025,Snacks & Ready-to-Eat,SD RED CHILLY PAPADS,14,80,80,0,1
05-01-2025,"Grains, Flours & Dals",Chana Flour 500 gms,4,70,65,5,1
05-01-2025,Oils & Ghee,Groundnut oil 1 L,9,720,660,60,2
05-01-2025,"Grains, Flours & Dals",Multigrain 1 kg,4,100,85,15,1
05-01-2025,Snacks & Ready-to-Eat,GB SALT COOKIES,14,60,55,5,1
05-01-2025,Spices & Seasonings,Turmeric powder 250 gms,15,100,75,25,1
05-01-2025,"Grains, Flours & Dals",Arikalu (kodo),4,70,65,5,1
05-01-2025,"Grains, Flours & Dals",SA Multi Grain Mix 500GM,4,159,159,0,1
05-01-2025,"Grains, Flours & Dals",UDALU (Barnyard millet) 500 gms,4,70,60,10,1
05-01-2025,"Grains, Flours & Dals",SAMALU (Little millet) 500 gms,4,75,65,10,1
05-01-2025,Sweeteners,YB FOREST HONEY 250GM,16,180,180,0,1
05-01-2025,Spices & Seasonings,SWEET SOUNF,15,20,20,0,1
05-01-2025,Snacks & Ready-to-Eat,NGT CHATPATTA CHANA 90GM,14,25,25,0,1
05-01-2025,Beverages,GANTASALA TEJ DRY GINGER COFFEE,1,149,149,0,1
05-01-2025,Snacks & Ready-to-Eat,SD Ginger Candy 100g,14,60,60,0,1
05-01-2025,Pooja & Spiritual Items,GD Aiswarya Deepam 700ML,12,195,195,0,1
05-01-2025,Pooja & Spiritual Items,GD Yagnadhara 31PC,12,70,70,0,1
05-01-2025,"Grains, Flours & Dals",Wheat Flour 1 kg,4,70,60,10,1
05-01-2025,"Grains, Flours & Dals",Em jowar idly R 500G,4,300,300,0,4
05-01-2025,Oils & Ghee,Groundnut oil 1 L,9,720,660,60,2
05-01-2025,"Grains, Flours & Dals",KORRALU (FOXTAIL M) 1KG,4,60,44,16,0.4
05-01-2025,"Grains, Flours & Dals",SAMALU (Little millet) 1 kg,4,68,52,16,0.4
05-01-2025,"Grains, Flours & Dals",UDALU (Barnyard millet) 1 kg,4,56,46,10,0.4
05-01-2025,"Grains, Flours & Dals",FLOUR CHARGE,4,24,24,0,2
05-01-2025,"Grains, Flours & Dals",ANDU KORRALU (Browntop.m) 1 kg,4,128,116,12,0.4
05-01-2025,"Grains, Flours & Dals",Arikadu ( kodo),4,56,52,4,0.4
05-01-2025,"Grains, Flours & Dals",RAGI FLOUR 500GRMS,4,40,35,5,1
05-01-2025,"Dry Fruits, Nuts & Seeds",PULMAKHANA 100 GM,2,180,170,10,1
05-01-2025,"Health, Wellness & Ayurvedic Products",MORINGA LEAF POWDER M,5,160,150,10,2
05-01-2025,Sweeteners,SUGAR 500 GM,16,30,25,5,1
05-01-2025,Spices & Seasonings,PURO Healthy Salt 1KG,15,110,110,0,1
05-01-2025,Personal Care & Cosmetics,HERBAL BATH POWDER 200GM,10,80,80,0,1
05-01-2025,Spices & Seasonings,GS Moringa Leaves Spicy Powder 100GM,15,90,90,0,1
05-01-2025,Spices & Seasonings,LG 50GM,15,92,92,0,1
05-01-2025,Spices & Seasonings,Poonam Mixed Masala 50GM,15,90,60,30,1
05-01-2025,Beverages,ASSAM TEA GINGER TEA POWDER 250GM,1,199,199,0,1
05-01-2025,Sweeteners,NATURAL HONEY 250GM,16,150,130,20,1
05-01-2025,Personal Care & Cosmetics,MD Bath Powder 100GM,10,40,40,0,1
05-01-2025,Personal Care & Cosmetics,GAYATHRI KUMKUDUKAYA,10,150,150,0,1
05-01-2025,Sweeteners,GS Palm Jaggery Powder 400GM,16,360,360,0,2
05-01-2025,"Grains, Flours & Dals",Green gram 500 gms,4,75,70,5,1
05-01-2025,Oils & Ghee,Sesame oil 1 L,9,590,560,30,1
05-01-2025,Snacks & Ready-to-Eat,SD Bajra with palm Jaggery 250gm,14,135,135,0,1
05-01-2025,Sweeteners,YB Brown Sugar 500GM,16,75,75,0,1
05-01-2025,"Grains, Flours & Dals",UDALU (Barnyard millet) 1 kg,4,140,115,25,1
05-01-2025,Milk & Dairy,BROWN EGGS TRAY 30P,7,360,330,30,1
05-01-2025,Snacks & Ready-to-Eat,PEANUT CANDY,14,90,90,0,2
05-01-2025,"Grains, Flours & Dals",KORRALU (FOXTAIL M) 1KG,4,150,110,40,1
05-01-2025,"Grains, Flours & Dals",BARLEY SEEDS 1KG,4,160,140,20,1
05-01-2025,"Dry Fruits, Nuts & Seeds",DRYDATES YELLOW 250GM,2,135,120,15,1
05-01-2025,"Dry Fruits, Nuts & Seeds",ANJEER 250GM,2,400,360,40,1
05-01-2025,Oils & Ghee,Coconut oil 500 ml,9,220,200,20,1
05-01-2025,"Dry Fruits, Nuts & Seeds",SALTED PISTA 250GM,2,400,350,50,1
05-01-2025,"Health, Wellness & Ayurvedic Products",RB Max Protein Chinese Manchurian,5,45,45,0,1
05-01-2025,Sweeteners,GS Palm Jaggery Powder 400GM,16,180,180,0,1
05-01-2025,"Grains, Flours & Dals",SAMALU (Little millet) 500 gms,4,85,65,20,1
05-01-2025,Spices & Seasonings,Jeera 100GM,15,100,90,10,2
05-01-2025,Snacks & Ready-to-Eat,FRUIT BREAD,14,30,30,0,1
05-01-2025,"Dry Fruits, Nuts & Seeds",MAHA BEERA SEEDS 100GM,2,60,60,0,1
05-01-2025,"Grains, Flours & Dals",SPLIT BLACK GRAM 500 GM,4,90,85,5,1
05-01-2025,"Grains, Flours & Dals",Arikalu (kodo),4,70,65,5,1
05-01-2025,Snacks & Ready-to-Eat,MIGHTY PUFFS CHEDDAR CHEESE,14,50,50,0,2
05-01-2025,Snacks & Ready-to-Eat,PN ORGANIC PUFFED RICE 200GM,14,55,55,0,1
05-01-2025,Spices & Seasonings,Japatri 25GM,15,100,80,20,1
05-01-2025,Sweeteners,SUGAR 500 GM,16,30,25,5,1
05-01-2025,Snacks & Ready-to-Eat,SF MIGHTY PUFFS,14,25,25,0,1
05-01-2025,Snacks & Ready-to-Eat,MARMURA LADDU,14,80,60,20,1
05-01-2025,"Dry Fruits, Nuts & Seeds",Groundnuts 1 kg,2,190,170,20,1
05-01-2025,Spices & Seasonings,ELACHI 25 GM,15,145,120,25,1
05-01-2025,Oils & Ghee,ANURAG RB OIL,9,120,100,20,1
05-01-2025,Spices & Seasonings,RED COPRA 500GM,15,170,148,22,1
05-01-2025,Snacks & Ready-to-Eat,COPRA LADDU 200GM,14,100,80,20,1
05-01-2025,Sweeteners,GS A2 Buffalo Ghee 500ML,16,550,550,0,1
05-01-2025,Snacks & Ready-to-Eat,SATHVI PALLI CHIKKI 200GM,14,100,80,20,1
05-01-2025,"Grains, Flours & Dals",split black gram 1 kg,4,180,170,10,1
05-01-2025,Oils & Ghee,Groundnut oil 1 L,9,360,330,30,1
05-01-2025,Snacks & Ready-to-Eat,WHITE SESAME CHIKKI,14,20,20,0,2
05-01-2025,"Grains, Flours & Dals",Multigrain 1 kg,4,300,255,45,3
05-01-2025,Snacks & Ready-to-Eat,BLACK SESAME CHIKKI,14,20,20,0,2
05-01-2025,"Grains, Flours & Dals",BOMBAY RAVA,4,140,110,30,2
05-01-2025,Household & Cleaning,VIM TROPICAL LEMON FRESHNESS 250ML,6,55,55,0,1
05-01-2025,"Grains, Flours & Dals",THICK POHA 500GM,4,80,70,10,2
05-01-2025,Spices & Seasonings,Jeera 100GM,15,50,45,5,1
05-01-2025,Household & Cleaning,SURF EXCEL 150GM,6,40,40,0,2
05-01-2025,Spices & Seasonings,NUVVULU 500GM,15,160,140,20,1
05-01-2025,"Grains, Flours & Dals",PESARA PAPPU 500GMS,4,85,75,10,1
05-01-2025,Spices & Seasonings,AVALU 100GM,15,25,20,5,1
05-01-2025,Spices & Seasonings,Tamarind 500GM,15,160,130,30,1
05-01-2025,"Dry Fruits, Nuts & Seeds",Groundnuts 500 gms,2,285,255,30,3
05-01-2025,"Dry Fruits, Nuts & Seeds",PUTNALU 500GMS,2,270,228,42,3
05-01-2025,"Grains, Flours & Dals",CHANA DAL 500GM,4,70,60,10,1
05-01-2025,"Dry Fruits, Nuts & Seeds",Groundnuts 1 kg,2,190,170,20,1
05-01-2025,Oils & Ghee,ANURAG RB OIL,9,120,100,20,1
05-01-2025,"Grains, Flours & Dals",SRILALITHA MAIDA FLOUR 500G,4,32,32,0,1
05-01-2025,Sweeteners,SUGAR 1KG,16,60,50,10,1
05-01-2025,Snacks & Ready-to-Eat,ANNAPURNA APPALAM,14,35,35,0,1
05-01-2025,"Grains, Flours & Dals",Urad dall 1 Kg,4,370,340,30,2
05-01-2025,Personal Care & Cosmetics,DETTOL ORIGINAL,10,99,99,0,1
05-01-2025,Spices & Seasonings,DRY MIECHI 200GM,15,80,60,20,1
05-01-2025,"Grains, Flours & Dals",Chana Flour 500 gms,4,70,65,5,1
05-01-2025,Snacks & Ready-to-Eat,BB VERMICELLI 1KG,14,95,90,5,1
05-01-2025,"Grains, Flours & Dals",Idly Rava L 1KG,4,240,200,40,4
05-01-2025,"Grains, Flours & Dals",Wheat Rava M 500GM,4,132,120,12,4
05-01-2025,Household & Cleaning,SURF EXCEL BIG BAR 250G,6,32,32,0,1
05-01-2025,"Dry Fruits, Nuts & Seeds",FLAX SEEDS 250GM,2,60,50,10,1
05-01-2025,Spices & Seasonings,ROYAL SAFFRON,15,125,125,0,1
05-01-2025,Household & Cleaning,EXO STEEL SCRUB,6,15,15,0,1
05-01-2025,Household & Cleaning,LIZOL CITRUS 625ML,6,149,149,0,1
05-01-2025,"Grains, Flours & Dals",turdal 1kg,4,440,390,50,2
05-01-2025,Spices & Seasonings,AV Iodized Salt 1KG,15,28,25,3,1
05-01-2025,"Grains, Flours & Dals",RAGI FLOUR 1KG,4,240,210,30,3
05-01-2025,Oils & Ghee,Groundnut oil 1 L,9,360,330,30,1
05-01-2025,Oils & Ghee,Groundnut oil 5 L,9,1800,"1,600.00",200,1
05-01-2025,"Grains, Flours & Dals",Multigrain 1 kg,4,100,85,15,1
05-01-2025,Oils & Ghee,GANTASALA A2 COW GHEE 500ML,9,550,550,0,1
05-01-2025,Snacks & Ready-to-Eat,SESAME LADDU 200GM,14,100,80,20,1
05-01-2025,Oils & Ghee,Groundnut oil 500ml,9,180,165,15,1
05-01-2025,Beverages,BRU GREEN LABEL 100G,1,65,65,0,1
05-01-2025,Snacks & Ready-to-Eat,GANTASALA BIKANEER BHUNDI,14,60,60,0,1
05-01-2025,Snacks & Ready-to-Eat,MARMURA LADDU,14,80,60,20,1
05-01-2025,Snacks & Ready-to-Eat,GS RAGI SNACKS 200GM,14,60,60,0,1
05-01-2025,"Grains, Flours & Dals",RAGI FLOUR 1KG,4,80,70,10,1
05-01-2025,"Grains, Flours & Dals",Wheat Rava M 500GM,4,33,30,3,1
05-01-2025,Milk & Dairy,BROWN EGGS TRAY 30P,7,360,330,30,1
05-01-2025,Spices & Seasonings,Marati Magga 50GM,15,130,110,20,1
05-01-2025,Spices & Seasonings,Turmeric powder 250 gms,15,100,75,25,1
05-01-2025,"Grains, Flours & Dals",Chittimuthaylu rice 1 kg,4,160,140,20,1
05-01-2025,Spices & Seasonings,SATHVI ANASAPUVUU 25GM,15,90,65,25,1
05-01-2025,Spices & Seasonings,SATHVI KARAKAYA 25 GM,15,50,30,20,1
05-01-2025,"Grains, Flours & Dals",AISHWARYA SP 1KG,4,80,75,5,1
05-01-2025,General Household & Kitchenware,MATCH BOX,3,20,20,0,1
05-01-2025,Pooja & Spiritual Items,NAGA SINDHURAM,12,40,40,0,1
05-01-2025,"Grains, Flours & Dals",VYS.SP RICE 1 KG,4,700,650,50,10
05-01-2025,Snacks & Ready-to-Eat,SATHVI REGIVADA 200GM,14,80,60,20,1
05-01-2025,Misc,F1,8,367,348.65,18.35,1
05-01-2025,Oils & Ghee,Sesame oil 1 L,9,1180,"1,120.00",60,2
05-01-2025,Milk & Dairy,BROWN EGGS 1P,7,168,144,24,12
05-01-2025,"Health, Wellness & Ayurvedic Products",MH Millets Malt 500GM,5,200,190,10,1
05-01-2025,Milk & Dairy,HERITAGE CURD,7,48,48,0,1
05-01-2025,"Grains, Flours & Dals",BASMATHI RICE 1KG,4,150,135,15,1
05-01-2025,Milk & Dairy,HRITAGE TONED MILK 500ML,7,30,30,0,1
05-01-2025,"Grains, Flours & Dals",VGR rice 1 kg,4,350,325,25,5
05-01-2025,"Grains, Flours & Dals",Red Chana 500 GM,4,75,60,15,1
05-01-2025,"Grains, Flours & Dals",split urad dall 250 gms,4,45,40,5,1
05-01-2025,Snacks & Ready-to-Eat,KURNOOL MARMURA,14,70,55,15,1
05-01-2025,Snacks & Ready-to-Eat,MARMURA LADDU,14,80,60,20,1
05-01-2025,Personal Care & Cosmetics,GAYATHRI KUMKUDUKAYA,10,150,150,0,1
05-01-2025,"Grains, Flours & Dals",Red Bobarlu 500 gms,4,95,85,10,1
05-01-2025,Oils & Ghee,Sesame oil 1 L,9,590,560,30,1
05-01-2025,Oils & Ghee,Coconut oil 500 ml,9,220,200,20,1
05-01-2025,Oils & Ghee,Safflower oil 1 L,9,440,400,40,1
05-01-2025,"Grains, Flours & Dals",RAJMA 250GM,4,55,45,10,1
05-01-2025,"Grains, Flours & Dals",Wheat Rava M 500GM,4,33,30,3,1
05-01-2025,Snacks & Ready-to-Eat,BATANA NGT 70GMS,14,20,20,0,1
05-01-2025,"Grains, Flours & Dals",Brown RICE 1KG,4,140,130,10,2
05-01-2025,"Grains, Flours & Dals",Wheat Flour 1 kg,4,280,240,40,4
05-01-2025,"Health, Wellness & Ayurvedic Products",MD Guduchi Choornam 100GM,5,110,110,0,1
05-01-2025,Milk & Dairy,SANGAM CURD 450GM,7,38,38,0,1
05-01-2025,"Grains, Flours & Dals",KORRALU (FOXTAIL M) 500GM,4,65,55,10,1
05-01-2025,Snacks & Ready-to-Eat,PEANUT CHILLI,14,60,60,0,12
05-01-2025,Snacks & Ready-to-Eat,VD RIBBON PAKODI 175GM,14,60,60,0,1
05-01-2025,Milk & Dairy,BROWN EGGS TRAY 30P,7,720,660,60,2
05-01-2025,Snacks & Ready-to-Eat,SS IDLY BATTER 1KG,14,60,60,0,1
05-01-2025,Snacks & Ready-to-Eat,PEANUT CHILLI,14,10,10,0,2
05-01-2025,Snacks & Ready-to-Eat,MARMURA LADDU,14,80,60,20,1
05-01-2025,Snacks & Ready-to-Eat,VD BELLAM GAVVALU 200GM,14,60,60,0,1
05-01-2025,"Grains, Flours & Dals",Multigrain 1 kg,4,200,170,30,2
05-01-2025,Pooja & Spiritual Items,BALAJI BEL PHOOL DHOOP STICKS 10STK,12,70,70,0,1
05-01-2025,Pooja & Spiritual Items,BALAJI KASTURI DHOOP STICKS,12,70,70,0,1
05-01-2025,Oils & Ghee,Groundnut oil 1 L,9,720,660,60,2
05-01-2025,Oils & Ghee,Sesame oil 1 L,9,590,560,30,1
05-01-2025,"Grains, Flours & Dals",Multigrain 1 kg,4,100,85,15,1
05-01-2025,Spices & Seasonings,SD IDLY KARAM,15,130,130,0,2
05-01-2025,Spices & Seasonings,NUVVULU 250GM,15,100,85,15,1
05-01-2025,Household & Cleaning,VIM COOLING FRESHNESS MINT,6,20,20,0,1
05-01-2025,Snacks & Ready-to-Eat,BATANA NGT 70GMS,14,20,20,0,1
05-01-2025,Milk & Dairy,ID PANEER,7,135,135,0,1
05-01-2025,Pooja & Spiritual Items,SST PURE COTTON GUBBA WICKS,12,30,30,0,1
05-01-2025,Snacks & Ready-to-Eat,GB SALT COOKIES,14,60,55,5,1
05-01-2025,Personal Care & Cosmetics,HERBAL BATH POWDER,10,160,160,0,1
05-01-2025,"Grains, Flours & Dals",WHITE BATANI 500GM,4,80,60,20,1
05-01-2025,Oils & Ghee,Sesame oil 500ml,9,295,280,15,1
05-01-2025,Snacks & Ready-to-Eat,SF MIGHTY PUFFS,14,25,25,0,1
05-01-2025,"Grains, Flours & Dals",MELMEKER 250GMS,4,60,45,15,1
05-01-2025,Oils & Ghee,Groundnut oil 1 L,9,360,330,30,1
05-01-2025,Oils & Ghee,Mustard oil 1 L,9,440,390,50,1
05-01-2025,Oils & Ghee,Groundnut oil 1 L,9,360,330,30,1
05-01-2025,"Dry Fruits, Nuts & Seeds",GF KIMIA DATES 500GM,2,310,190,120,1
05-01-2025,Oils & Ghee,Coconut oil 1 L,9,440,400,40,1
05-01-2025,"Grains, Flours & Dals",White jowar.F 1 kg,4,200,160,40,2
05-01-2025,Snacks & Ready-to-Eat,GB SALT COOKIES,14,120,110,10,2
05-01-2025,Oils & Ghee,BUFFALLO GHEE 500ML,9,410,370,40,1
05-01-2025,Oils & Ghee,Groundnut oil 1 L,9,360,330,30,1
05-01-2025,Spices & Seasonings,Chilli powder 500 gms,15,290,210,80,1
05-01-2025,Oils & Ghee,Safflower oil 1 L,9,1320,"1,200.00",120,3
05-01-2025,"Grains, Flours & Dals",MAATEJA rice 1 kg,4,144,138,6,2
05-01-2025,Sweeteners,ACHUBELLAM 500GM,16,50,40,10,1
05-01-2025,Oils & Ghee,Groundnut oil 1 L,9,360,330,30,1
05-01-2025,Milk & Dairy,BROWN EGGS 1P,7,84,72,12,6
05-01-2025,"Grains, Flours & Dals",Chana Flour 500 gms,4,70,65,5,1
05-01-2025,Snacks & Ready-to-Eat,KURNOOL MARMURA,14,70,55,15,1
05-01-2025,"Grains, Flours & Dals",split green gram 1 kg,4,150,140,10,1
05-01-2025,"Grains, Flours & Dals",RICE FLOUR 1KG,4,70,55,15,1
05-01-2025,Oils & Ghee,Groundnut oil 1 L,9,360,330,30,1
05-01-2025,Milk & Dairy,BROWN EGGS 1P,7,140,120,20,10
05-01-2025,Spices & Seasonings,YB PINK ROCK SALT 1KG,15,120,120,0,1
05-01-2025,"Grains, Flours & Dals",URAD DALL,4,95,85,10,1
05-01-2025,Milk & Dairy,BROWN EGGS 1P,7,168,144,24,12
05-01-2025,Sweeteners,GS Palm Jaggery Powder 400GM,16,180,180,0,1
05-01-2025,"Dry Fruits, Nuts & Seeds",PUMPKIN SEEDS 250GM,2,200,160,40,1
05-01-2025,"Grains, Flours & Dals",SPLIT BLACK GRAM 500 GM,4,90,85,5,1
05-01-2025,"Dry Fruits, Nuts & Seeds",PULMAKHANA 100 GM,2,180,170,10,1
05-01-2025,"Grains, Flours & Dals",Red Chana 250GM,4,35,30,5,1
04-01-2025,Snacks & Ready-to-Eat,VD PESARA PAPAD 195GM,14,60,60,0,1
04-01-2025,Spices & Seasonings,DRY MIECHI 200GM,15,80,60,20,1
04-01-2025,"Dry Fruits, Nuts & Seeds",Groundnuts 500 gms,2,95,85,10,1
04-01-2025,Personal Care & Cosmetics,SVE PREMIUM PAPAYA SOAP 100GM,10,110,110,0,1
04-01-2025,Personal Care & Cosmetics,GAYATHRI KUMKUDUKAYA,10,150,150,0,1
04-01-2025,"Health, Wellness & Ayurvedic Products",GD 27 HERBS OIL 120ML,5,150,150,0,1
04-01-2025,"Grains, Flours & Dals",Green gram 500 gms,4,75,70,5,1
04-01-2025,"Grains, Flours & Dals",Wheat Flour 1 kg,4,70,60,10,1
04-01-2025,"Grains, Flours & Dals",THICK POHA 500GM,4,40,35,5,1
04-01-2025,Spices & Seasonings,Jeera 100GM,15,100,90,10,2
04-01-2025,Beverages,TAJ MAHAL 100GM,1,95,95,0,1
04-01-2025,Oils & Ghee,Groundnut oil 1 L,9,360,330,30,1
04-01-2025,Spices & Seasonings,ROYAL SAFFRON,15,125,125,0,1
04-01-2025,"Grains, Flours & Dals",JOWAR YELLOW 1 K,4,135,135,0,1.5
04-01-2025,"Grains, Flours & Dals",RAGULU 1 KG,4,35,30,5,0.5
04-01-2025,"Grains, Flours & Dals",Multigrain 1 kg,4,100,85,15,1
04-01-2025,"Dry Fruits, Nuts & Seeds",SUNFLOWER SEEDS 250GRM,2,150,130,20,1
04-01-2025,"Dry Fruits, Nuts & Seeds",PUMPKIN SEEDS 250GM,2,200,160,40,1
04-01-2025,Spices & Seasonings,MG Dasa dinasalu 250gm,15,220,220,0,1
04-01-2025,"Dry Fruits, Nuts & Seeds",WATERMELON SEEDS 250GRM,2,320,280,40,1
04-01-2025,Snacks & Ready-to-Eat,GB SALT COOKIES,14,60,55,5,1
04-01-2025,Snacks & Ready-to-Eat,RSC ORANGE 100GMS,14,20,20,0,1
04-01-2025,"Health, Wellness & Ayurvedic Products",RB FRUITS &amp;seeds Cranberries,5,45,45,0,1
04-01-2025,"Health, Wellness & Ayurvedic Products",RB Max Protein Choco chips 55gm,5,50,50,0,1
04-01-2025,"Health, Wellness & Ayurvedic Products",MXP CHOCO CLASSIC BAR,5,70,70,0,1
04-01-2025,Snacks & Ready-to-Eat,BATANA NGT 70GMS,14,40,40,0,2
04-01-2025,Snacks & Ready-to-Eat,SD Aswagandha with palm Jaggery250Gm,14,135,135,0,1
04-01-2025,"Health, Wellness & Ayurvedic Products",RB Max Protein Choco Almond bar 50g,5,150,150,0,2
04-01-2025,Personal Care & Cosmetics,SVE MULTANI MITTI SOAP 100GM,10,90,90,0,1
04-01-2025,"Grains, Flours & Dals",Bombay Rava 500GM,4,35,30,5,1
04-01-2025,"Grains, Flours & Dals",Wheat Rava M 500GM,4,33,30,3,1
04-01-2025,Personal Care & Cosmetics,SEV TULASI SOAP 100GM,10,90,90,0,1
04-01-2025,"Grains, Flours & Dals",Black uluvalu 250 gms,4,45,45,0,1
04-01-2025,Milk & Dairy,BROWN EGGS TRAY 30P,7,360,330,30,1
04-01-2025,"Dry Fruits, Nuts & Seeds",PUMPKIN SEEDS 250GM,2,200,160,40,1
04-01-2025,"Dry Fruits, Nuts & Seeds",ALMONDS 250GM,2,280,260,20,1
04-01-2025,Spices & Seasonings,SATHVI BIRYANI LEAF 25GM,15,30,20,10,1
04-01-2025,Spices & Seasonings,Menthulu 500 gms,15,100,90,10,1
04-01-2025,Snacks & Ready-to-Eat,SD Atreyapuram DRY Fruit ghee,14,150,150,0,1
04-01-2025,"Grains, Flours & Dals",RICE FLOUR 1KG,4,70,55,15,1
04-01-2025,Snacks & Ready-to-Eat,VD RICE SAGO PAPAD 150GM,14,55,55,0,1
04-01-2025,Spices & Seasonings,Lavangam 50GM,15,60,50,10,1
04-01-2025,"Grains, Flours & Dals",turdal 500 gms,4,110,100,10,1
04-01-2025,Spices & Seasonings,Dalchin Chekka 50GM,15,50,40,10,1
04-01-2025,Snacks & Ready-to-Eat,SS IDLY BATTER 1KG,14,60,60,0,1
04-01-2025,Snacks & Ready-to-Eat,Popcorn Seeds 500GM,14,90,80,10,1
04-01-2025,"Dry Fruits, Nuts & Seeds",DRYDATES 250GM,2,150,120,30,1
04-01-2025,Snacks & Ready-to-Eat,BATANA NGT 70GMS,14,80,80,0,4
04-01-2025,"Grains, Flours & Dals",RAGI FLOUR 1KG,4,400,350,50,5
04-01-2025,"Health, Wellness & Ayurvedic Products",RB Max Protein Choco chips 55gm,5,100,100,0,2
04-01-2025,"Dry Fruits, Nuts & Seeds",Putnalu 250GM,2,45,38,7,1
04-01-2025,Sweeteners,GS Organic Jaggery Powder 600GM,16,99,99,0,1
04-01-2025,Snacks & Ready-to-Eat,VD RIBBON PAKODI 175GM,14,60,60,0,1
04-01-2025,"Grains, Flours & Dals",Green gram 500 gms,4,75,70,5,1
04-01-2025,Beverages,RED LABEL 100GM,1,50,50,0,1
04-01-2025,Snacks & Ready-to-Eat,VD RICE MURUKU 150GM,14,50,50,0,1
04-01-2025,Spices & Seasonings,Elaichi 25GM,15,145,120,25,1
04-01-2025,Spices & Seasonings,Gasagasalu 50GM,15,130,110,20,1
04-01-2025,"Health, Wellness & Ayurvedic Products",RB Max Protein Choco Almond bar 50g,5,75,75,0,1
04-01-2025,Spices & Seasonings,NUVVULU 250GM,15,80,70,10,1
04-01-2025,Spices & Seasonings,Vamu 100GM,15,60,50,10,1
04-01-2025,"Dry Fruits, Nuts & Seeds",SABJA SEEDS 100GM,2,80,70,10,1
04-01-2025,"Dry Fruits, Nuts & Seeds",DRIED KIWI 200GM,2,145,130,15,1
04-01-2025,Spices & Seasonings,Jeera 100GM,15,100,90,10,2
04-01-2025,Spices & Seasonings,MM Kasuri Methi 25GM,15,30,30,0,1
04-01-2025,Snacks & Ready-to-Eat,SF Mighty Puffs Mild Masala 20g,14,50,50,0,2
04-01-2025,"Grains, Flours & Dals",Chana Flour 500 gms,4,70,65,5,1
04-01-2025,Snacks & Ready-to-Eat,VD MAIDA CHEGODI 175GM,14,60,60,0,1
04-01-2025,Snacks & Ready-to-Eat,Popcorn Seeds 250GM,14,45,40,5,1
04-01-2025,Snacks & Ready-to-Eat,RINGS 200GM,14,30,30,0,1
04-01-2025,Spices & Seasonings,Japatri 25GM,15,100,80,20,1
04-01-2025,Snacks & Ready-to-Eat,VD SAGOPAPAD 150GM,14,55,55,0,1
04-01-2025,"Dry Fruits, Nuts & Seeds",CASHEW 250GM,2,340,310,30,1
04-01-2025,Beverages,BRU GREEN LABEL 1.2G,1,48,48,0,24
04-01-2025,"Dry Fruits, Nuts & Seeds",YELLOW KISHMISH 250GM,2,130,110,20,1
04-01-2025,Spices & Seasonings,SATHVI ANASAPUVUU 25GM,15,90,65,25,1
04-01-2025,Snacks & Ready-to-Eat,FUN TIME CRUNCH,14,90,90,0,2
04-01-2025,Spices & Seasonings,Miriyalu 50GM,15,100,80,20,1
04-01-2025,"Dry Fruits, Nuts & Seeds",Groundnuts 500 gms,2,95,85,10,1
04-01-2025,Spices & Seasonings,SATHVI GREEN SOUNF 100GM,15,120,80,40,2
04-01-2025,Spices & Seasonings,Chilli powder 500 gms,15,580,420,160,2
04-01-2025,"Health, Wellness & Ayurvedic Products",MD Aamlaki Choornam 100GM,5,80,80,0,1
04-01-2025,Sweeteners,GS Palm Jaggery Powder 400GM,16,180,180,0,1
04-01-2025,"Grains, Flours & Dals",Multigrain 1 kg,4,100,85,15,1
04-01-2025,Snacks & Ready-to-Eat,BLACK SESAME CHIKKI,14,45,45,0,1
04-01-2025,Snacks & Ready-to-Eat,VD SAGOPAPAD 150GM,14,55,55,0,1
04-01-2025,"Dry Fruits, Nuts & Seeds",BLACK KISMIS 250GM,2,175,140,35,1
04-01-2025,Snacks & Ready-to-Eat,MARMURA LADDU,14,80,60,20,1
04-01-2025,Snacks & Ready-to-Eat,SD JOWAR WITH PALM JAGGERY 250GM,14,135,135,0,1
04-01-2025,"Grains, Flours & Dals",Yellow jowar .F1 kg,4,110,100,10,1
04-01-2025,Personal Care & Cosmetics,HERBAL BATH POWDER 200GM,10,80,80,0,1
04-01-2025,Snacks & Ready-to-Eat,ZEEDI,14,70,70,0,1
04-01-2025,Snacks & Ready-to-Eat,SF Millet Pancake BLUEBEERY 150g,14,25,25,0,1
04-01-2025,"Grains, Flours & Dals",BOBBARA PAPPU 500GM,4,85,80,5,1
04-01-2025,General Household & Kitchenware,MATCH BOX,3,20,20,0,1
04-01-2025,Snacks & Ready-to-Eat,PEANUT CHILLI,14,10,10,0,2
04-01-2025,"Dry Fruits, Nuts & Seeds",Groundnuts 1 kg,2,190,170,20,1
04-01-2025,Spices & Seasonings,JEERA 250 gms,15,125,105,20,1
04-01-2025,Spices & Seasonings,RED COPRA 250GMS,15,85,74,11,1
04-01-2025,Spices & Seasonings,JEERA 250 gms,15,125,105,20,1
04-01-2025,Personal Care & Cosmetics,MADDI BATH POWDER 400GM,10,300,280,20,2
04-01-2025,"Grains, Flours & Dals",Red Wheat Flour 1 kg,4,140,130,10,1
04-01-2025,"Dry Fruits, Nuts & Seeds",Groundnuts 500 gms,2,95,85,10,1
04-01-2025,"Grains, Flours & Dals",Chana Flour 500 gms,4,70,65,5,1
04-01-2025,"Grains, Flours & Dals",CHANA DAL 500GM,4,70,60,10,1
04-01-2025,Sweeteners,YB JAGGERY POWDER 500GMS,16,75,75,0,1
04-01-2025,Pooja & Spiritual Items,GOMATHA AGARBATHI,12,75,75,0,1
04-01-2025,Personal Care & Cosmetics,COLGATE ACTIVE SALT,10,76,76,0,1
04-01-2025,Oils & Ghee,Black Sesame oil 500 ml,9,220,190,30,1
04-01-2025,Household & Cleaning,ROOPERI PITAMBARI SILVER 50ML,6,110,110,0,1
04-01-2025,Pooja & Spiritual Items,BALAJI BEL PHOOL DHOOP STICKS 10STK,12,70,70,0,1
04-01-2025,Pooja & Spiritual Items,BALAJI KEWDA STICKS 220GM,12,150,150,0,1
04-01-2025,Oils & Ghee,Groundnut oil 5 L,9,1800,"1,600.00",200,1
04-01-2025,Beverages,CONTINENTAL XTRA 50GM,1,120,120,0,1
04-01-2025,Milk & Dairy,BROWN EGGS TRAY 30P,7,360,330,30,1
04-01-2025,"Grains, Flours & Dals",SL Idly Rava 1KG,4,130,110,20,2
04-01-2025,Oils & Ghee,Safflower oil 5 L,9,2200,"1,950.00",250,1
04-01-2025,Milk & Dairy,HERITAGE CURD,7,48,48,0,1
04-01-2025,Spices & Seasonings,Chilli powder 500 gms,15,290,210,80,1
04-01-2025,Snacks & Ready-to-Eat,VD MURUKU 175GM,14,60,60,0,1
04-01-2025,Snacks & Ready-to-Eat,VD PAPPU CHEGODI 200GM,14,60,60,0,1
04-01-2025,"Dry Fruits, Nuts & Seeds",SABJA SEEDS 100GM,2,80,70,10,1
04-01-2025,Spices & Seasonings,Dalchin Chekka 50GM,15,50,40,10,1
04-01-2025,Spices & Seasonings,Lavangam 50GM,15,60,50,10,1
04-01-2025,General Household & Kitchenware,WOODEN SPOON BIG,3,40,40,0,1
04-01-2025,Spices & Seasonings,SATHVI BIRYANI LEAF 25GM,15,30,20,10,1
04-01-2025,Sweeteners,ACHUBELLAM 500GM,16,50,40,10,1
04-01-2025,Spices & Seasonings,Miriyalu 50GM,15,100,80,20,1
04-01-2025,Sweeteners,SUGAR 1KG,16,60,50,10,1
04-01-2025,Snacks & Ready-to-Eat,VD Minapa papad 200gm,14,60,60,0,1
04-01-2025,Snacks & Ready-to-Eat,VD DAHI MIRCHI(SALTED) 100GM,14,45,45,0,1
04-01-2025,Spices & Seasonings,SATHVI ANASAPUVUU 25GM,15,90,65,25,1
04-01-2025,Spices & Seasonings,Japatri 25GM,15,100,80,20,1
04-01-2025,Snacks & Ready-to-Eat,VD GUMMADI VADIYAM,14,75,75,0,1
04-01-2025,Sweeteners,YB JAGGERY POWDER 1KG,16,140,140,0,1
04-01-2025,"Dry Fruits, Nuts & Seeds",Groundnuts 1 kg,2,190,170,20,1
04-01-2025,Spices & Seasonings,Jeera 100GM,15,50,45,5,1
04-01-2025,"Grains, Flours & Dals",White Chana 250 GM,4,60,50,10,1
04-01-2025,"Grains, Flours & Dals",RAJMA 250GM,4,55,45,10,1
04-01-2025,Oils & Ghee,Cow ghee 500 ml,9,430,390,40,1
04-01-2025,"Grains, Flours & Dals",turdal 1kg,4,220,195,25,1
04-01-2025,"Grains, Flours & Dals",DM LOW GI SP 1KG,4,118.75,118.75,0,1.25
04-01-2025,"Grains, Flours & Dals",Wheat Flour 1 kg,4,70,60,10,1
04-01-2025,Milk & Dairy,BROWN EGGS 1P,7,140,120,20,10
04-01-2025,Sweeteners,YB JAGGERY POWDER 500GMS,16,75,75,0,1
04-01-2025,Snacks & Ready-to-Eat,VD ATUKULU MIXTURE 175GM,14,60,60,0,1
04-01-2025,"Grains, Flours & Dals",Multigrain 1 kg,4,100,85,15,1
04-01-2025,Oils & Ghee,Groundnut oil 1 L,9,360,330,30,1
04-01-2025,"Grains, Flours & Dals",Em Little idli R 500g,4,129,129,0,1
04-01-2025,"Grains, Flours & Dals",Urad dall 1 Kg,4,185,170,15,1
04-01-2025,"Grains, Flours & Dals",DESI CHANA,4,25,25,0,1
04-01-2025,Personal Care & Cosmetics,OVAL BODY LOOFAH,10,55,55,0,1
04-01-2025,Milk & Dairy,BROWN EGGS 1P,7,56,48,8,4
04-01-2025,"Grains, Flours & Dals",FLOUR CHARGE,4,83,83,0,1
04-01-2025,Pickles & Cooking Pastes,SD GINGER PICKLE 250GM,11,110,110,0,1
04-01-2025,Oils & Ghee,Groundnut oil 1 L,9,360,330,30,1
04-01-2025,Snacks & Ready-to-Eat,ELITE MILK RUSK 200GM,14,35,35,0,1
04-01-2025,Snacks & Ready-to-Eat,TILLI CHIKKI,14,10,10,0,2
04-01-2025,Snacks & Ready-to-Eat,PEANUT CHILLI,14,10,10,0,2
04-01-2025,Personal Care & Cosmetics,SEV TULASI SOAP 100GM,10,540,540,0,6
04-01-2025,Personal Care & Cosmetics,NEEM SOAP 100GM,10,600,600,0,6
04-01-2025,Personal Care & Cosmetics,ASEV LOEVERA SOAP,10,100,100,0,1
04-01-2025,Personal Care & Cosmetics,SVE PREMIUM WILD TURMEIC 100GM,10,440,440,0,4
04-01-2025,"Grains, Flours & Dals",PRO SOYA CHUNKS 200G,4,79,79,0,1
04-01-2025,"Grains, Flours & Dals",FLOUR CHARGE,4,48,48,0,4
04-01-2025,"Grains, Flours & Dals",SA YELLOW JOWAR RAVA 500GM,4,95,95,0,1
04-01-2025,"Grains, Flours & Dals",Red Wheat Flour 1 kg,4,140,130,10,1
04-01-2025,"Grains, Flours & Dals",Chana Flour 1 kg,4,140,130,10,1
04-01-2025,Snacks & Ready-to-Eat,VD ATUKULU MIXTURE 175GM,14,60,60,0,1
04-01-2025,"Grains, Flours & Dals",THICK POHA 500GM,4,40,35,5,1
04-01-2025,Personal Care & Cosmetics,MD Bath Powder 100GM,10,40,40,0,1
04-01-2025,"Dry Fruits, Nuts & Seeds",GF KIMIA DATES 500GM,2,310,190,120,1
04-01-2025,Snacks & Ready-to-Eat,PALLI LADDU 200GMS,14,90,70,20,1
04-01-2025,Spices & Seasonings,YB PINK ROCK SALT 1KG,15,120,120,0,1
04-01-2025,Snacks & Ready-to-Eat,MILK BREAD,14,55,55,0,1
04-01-2025,"Dry Fruits, Nuts & Seeds",Groundnuts 1 kg,2,190,170,20,1
04-01-2025,Spices & Seasonings,ROYAL SAFFRON,15,125,125,0,1
04-01-2025,Household & Cleaning,MONKEY 555,6,160,160,0,1
04-01-2025,Oils & Ghee,Groundnut oil 1 L,9,360,330,30,1
04-01-2025,Snacks & Ready-to-Eat,SD Ginger Candy 100g,14,120,120,0,2
04-01-2025,Oils & Ghee,Groundnut oil 1 L,9,720,660,60,2
04-01-2025,"Grains, Flours & Dals",Bajra Flour 1 kg,4,140,120,20,2
04-01-2025,"Grains, Flours & Dals",YB Red RICE 1 KG,4,150,120,30,1
04-01-2025,Spices & Seasonings,Jeera 100GM,15,50,45,5,1
04-01-2025,Snacks & Ready-to-Eat,SD Flax seeds with dates 250gm,14,135,135,0,1
04-01-2025,Snacks & Ready-to-Eat,SD black sesme laddu with dates 175gm,14,135,135,0,1
04-01-2025,Household & Cleaning,ARIEL,6,330,330,0,1
04-01-2025,Spices & Seasonings,AVALU 100GM,15,25,20,5,1
04-01-2025,"Dry Fruits, Nuts & Seeds",Groundnuts 1 kg,2,190,170,20,1
04-01-2025,Spices & Seasonings,Turmeric powder 250 gms,15,100,75,25,1
04-01-2025,"Grains, Flours & Dals",White jowar.F 1 kg,4,200,160,40,2
04-01-2025,"Grains, Flours & Dals",Chana Flour 500 gms,4,70,65,5,1
04-01-2025,Sweeteners,KAMAL JAGGERY 500GM,16,80,80,0,2
04-01-2025,"Grains, Flours & Dals",SH WHEAT DALIYA 500GM,4,60,60,0,1
04-01-2025,"Grains, Flours & Dals",AMMA RICE RAVA 500GRMS,4,84,84,0,2
04-01-2025,"Grains, Flours & Dals",RAGI FLOUR 500GRMS,4,40,35,5,1
04-01-2025,"Grains, Flours & Dals",Wheat Flour 1 kg,4,70,60,10,1
04-01-2025,"Dry Fruits, Nuts & Seeds",SH GROUNDNUT 500GM,2,163,130,33,1
04-01-2025,"Grains, Flours & Dals",ANDU KORRALU (Brown top .mlt) 500,4,160,145,15,1
04-01-2025,"Grains, Flours & Dals",White Chana 250 GM,4,60,50,10,1
04-01-2025,"Grains, Flours & Dals",Arikadu ( kodo),4,140,130,10,1
04-01-2025,Snacks & Ready-to-Eat,VD RIBBON PAKODI 175GM,14,60,60,0,1
04-01-2025,"Grains, Flours & Dals",FLOUR CHARGE,4,54,54,0,4.5
04-01-2025,"Grains, Flours & Dals",Green Batani 250GM,4,55,45,10,1
04-01-2025,Spices & Seasonings,EVEREST MEAT MASALA 50GM,15,48,48,0,1
04-01-2025,"Grains, Flours & Dals",KORRALU (FOXTAIL M) 1KG,4,150,110,40,1
04-01-2025,"Grains, Flours & Dals",Bombay Rava 500GM,4,35,30,5,1
04-01-2025,Spices & Seasonings,MM CHAT MASALA,15,44,44,0,1
04-01-2025,"Grains, Flours & Dals",UDALU (Barnyard millet) 1 kg,4,140,115,25,1
04-01-2025,Sweeteners,ACHUBELLAM 500GM,16,50,40,10,1
04-01-2025,"Grains, Flours & Dals",SAMALU (Little millet) 1 kg,4,170,130,40,1
04-01-2025,Snacks & Ready-to-Eat,BATANA NGT 70GMS,14,40,40,0,2
04-01-2025,Snacks & Ready-to-Eat,Sprouted Ragi Biscuits 450GM,14,150,150,0,1
04-01-2025,Snacks & Ready-to-Eat,NGT CHATPATTA CHANA 90GM,14,25,25,0,1
04-01-2025,"Grains, Flours & Dals",Wheat Flour 1 kg,4,70,60,10,1
04-01-2025,Snacks & Ready-to-Eat,VD RICE SAGO PAPAD 150GM,14,55,55,0,1
04-01-2025,Snacks & Ready-to-Eat,BATANA NGT 70GMS,14,20,20,0,1
04-01-2025,Snacks & Ready-to-Eat,SD VAMU APPADALU 200GM,14,80,80,0,1
04-01-2025,"Grains, Flours & Dals",Urad dall 1 Kg,4,370,340,30,2
04-01-2025,Snacks & Ready-to-Eat,ANNAPURNA APPALAM,14,35,35,0,1
04-01-2025,"Grains, Flours & Dals",White jowar.F 1 kg,4,100,80,20,1
04-01-2025,"Grains, Flours & Dals",PESARA PAPPU 1 KG,4,170,145,25,1
04-01-2025,Snacks & Ready-to-Eat,KURNOOL MARMURA,14,70,55,15,1
04-01-2025,Snacks & Ready-to-Eat,FUN TIME CRUNCH,14,45,45,0,1
04-01-2025,"Health, Wellness & Ayurvedic Products",VITAMIN C,5,125,125,0,1
04-01-2025,Personal Care & Cosmetics,INDICA EASY,10,30,30,0,1
04-01-2025,"Grains, Flours & Dals",Chana Flour 500 gms,4,70,65,5,1
04-01-2025,"Dry Fruits, Nuts & Seeds",PULMAKHANA 100 GM,2,180,170,10,1
04-01-2025,"Health, Wellness & Ayurvedic Products",RB Max Protein Fruit &amp;Nut 50g,5,75,75,0,1
04-01-2025,Snacks & Ready-to-Eat,NGT CHATPATTA CHANA 90GM,14,25,25,0,1
04-01-2025,Baking & Cooking Aids,SB ACT DRIED YEAST 20GM,0,65,65,0,1
04-01-2025,Snacks & Ready-to-Eat,VD PAPPU CHEGODI 200GM,14,60,60,0,1
04-01-2025,Milk & Dairy,HRITAGE TONED MILK 500ML,7,30,30,0,1
04-01-2025,"Grains, Flours & Dals",Wheat Flour 1 kg,4,140,120,20,2
04-01-2025,Snacks & Ready-to-Eat,RI SPORTS BAR 40G,14,45,45,0,1
04-01-2025,"Grains, Flours & Dals",RAJMA 250GM,4,55,45,10,1
04-01-2025,"Grains, Flours & Dals",Bombay Rava 500GM,4,35,30,5,1
04-01-2025,"Grains, Flours & Dals",turdal 1kg,4,660,585,75,3
04-01-2025,Pooja & Spiritual Items,GD Dhoop Cones 40GM,12,30,30,0,1
04-01-2025,Spices & Seasonings,PURO Healthy Salt 1KG,15,110,110,0,1
04-01-2025,"Grains, Flours & Dals",KORRALU WHOLE,4,30,25,5,1
04-01-2025,Spices & Seasonings,ROYAL SAFFRON,15,125,125,0,1
04-01-2025,"Dry Fruits, Nuts & Seeds",DIANUTS 500GM,2,120,120,0,1
04-01-2025,"Grains, Flours & Dals",Wheat Rava M 500GM,4,33,30,3,1
04-01-2025,"Grains, Flours & Dals",RAGI FLOUR 1KG,4,80,70,10,1
04-01-2025,Household & Cleaning,GAJANAND BLACK DRAGN 10STI,6,20,20,0,1
04-01-2025,Personal Care & Cosmetics,VASELINE 5GM,10,5,5,0,1
04-01-2025,Snacks & Ready-to-Eat,SF Millet Pancake BLUEBEERY 150g,14,75,75,0,3
04-01-2025,Beverages,BRU GREEN LABEL 1.2G,1,24,24,0,12
04-01-2025,"Health, Wellness & Ayurvedic Products",ZINDA TILISMATH 5ML,5,70,70,0,1
04-01-2025,Snacks & Ready-to-Eat,VD PAPPU CHEGODI 200GM,14,60,60,0,1
04-01-2025,"Grains, Flours & Dals",Red Bobarlu 500 gms,4,190,170,20,2
04-01-2025,"Grains, Flours & Dals",DH URAD GOTA 1KG,4,215,190,25,1
04-01-2025,Snacks & Ready-to-Eat,URBAN MARMURA 450GM,14,60,55,5,1
04-01-2025,"Dry Fruits, Nuts & Seeds",PUTNALU 500GMS,2,90,76,14,1
04-01-2025,Spices & Seasonings,DRY MIECHI 200GM,15,80,60,20,1
04-01-2025,Spices & Seasonings,Biryani Leaf 25GM,15,30,20,10,1
04-01-2025,"Grains, Flours & Dals",DESI CHANA,4,50,50,0,2
04-01-2025,Snacks & Ready-to-Eat,VD Pappu Chekkalu 190gm,14,60,60,0,1
04-01-2025,"Grains, Flours & Dals",split green gram 500 gms,4,150,140,10,2
04-01-2025,Milk & Dairy,SANGAM TONED MILK 500ML,7,60,60,0,2
04-01-2025,Snacks & Ready-to-Eat,MILK BREAD,14,30,30,0,1
04-01-2025,Oils & Ghee,Coconut oil 500 ml,9,220,200,20,1
04-01-2025,"Grains, Flours & Dals",Sathya Javva Wheat Rava 500GM,4,95,95,0,1
04-01-2025,Oils & Ghee,Coconut oil 500 ml,9,220,200,20,1
04-01-2025,"Grains, Flours & Dals",VYS.SP RICE 1 KG,4,350,325,25,5
04-01-2025,"Dry Fruits, Nuts & Seeds",YELLOW KISHMISH 250GM,2,130,110,20,1
04-01-2025,"Dry Fruits, Nuts & Seeds",PULMAKHANA 100 GM,2,180,170,10,1
04-01-2025,Snacks & Ready-to-Eat,3D PAPAD,14,40,40,0,1
04-01-2025,Snacks & Ready-to-Eat,VD BOONDI 175GM,14,60,60,0,1
04-01-2025,Personal Care & Cosmetics,BAMBOO TOOTH BRUSH,10,50,50,0,1
04-01-2025,Milk & Dairy,BROWN EGGS 1P,7,84,72,12,6
04-01-2025,"Grains, Flours & Dals",RAGI FLOUR 1KG,4,160,140,20,2
04-01-2025,Personal Care & Cosmetics,KAIPO SANDALWOOD SOAP 100GM,10,60,60,0,1
04-01-2025,Snacks & Ready-to-Eat,ZEEDI,14,70,70,0,1
04-01-2025,"Grains, Flours & Dals",turdal 1kg,4,220,195,25,1
04-01-2025,Milk & Dairy,SANGAM TONED MILK 500ML,7,30,30,0,1
04-01-2025,Milk & Dairy,HRITAGE TONED MILK 500ML,7,30,30,0,1
04-01-2025,"Grains, Flours & Dals",PESARA PAPPU 500GMS,4,85,75,10,1
04-01-2025,Oils & Ghee,Safflower oil 1 L,9,880,800,80,2
04-01-2025,"Grains, Flours & Dals",turdal 1kg,4,660,585,75,3
04-01-2025,Oils & Ghee,Groundnut oil 1 L,9,1440,"1,320.00",120,4
04-01-2025,General Household & Kitchenware,VERMI COMPOST MIX,3,30,30,0,1
04-01-2025,Snacks & Ready-to-Eat,PEANUT CHIKKI 450GM,14,125,125,0,1
04-01-2025,Oils & Ghee,Castor oil 200 ml,9,100,80,20,1
04-01-2025,Milk & Dairy,BROWN EGGS 1P,7,210,180,30,15
04-01-2025,"Dry Fruits, Nuts & Seeds",Groundnuts 1 kg,2,190,170,20,1
04-01-2025,Snacks & Ready-to-Eat,PEANUT CHILLI,14,20,20,0,4
04-01-2025,"Grains, Flours & Dals",Arikalu (kodo),4,70,65,5,1
04-01-2025,"Grains, Flours & Dals",KORRALU (FOXTAIL M) 500GM,4,65,55,10,1
04-01-2025,"Grains, Flours & Dals",JOWAR WHITE 1 KG,4,40,35,5,0.5
04-01-2025,Snacks & Ready-to-Eat,RINGS 200GM,14,30,30,0,1
04-01-2025,Oils & Ghee,Black Sesame oil 500 ml,9,220,190,30,1
04-01-2025,Snacks & Ready-to-Eat,BATANA NGT 70GMS,14,20,20,0,1
04-01-2025,Sweeteners,Mishri 250 GM,16,35,30,5,1
04-01-2025,"Grains, Flours & Dals",RAGULU 1 KG,4,35,30,5,0.5
04-01-2025,"Grains, Flours & Dals",White Chana 250 GM,4,60,50,10,1
04-01-2025,"Grains, Flours & Dals",Wheat Flour 1 kg,4,140,120,20,2
04-01-2025,"Grains, Flours & Dals",Multigrain 1 kg,4,200,170,30,2
04-01-2025,Snacks & Ready-to-Eat,JUNNU POWDER 100GM,14,140,140,0,2
04-01-2025,Spices & Seasonings,AVALU 100GM,15,25,20,5,1
04-01-2025,Sweeteners,Mishri 250 GM,16,35,30,5,1
04-01-2025,Pooja & Spiritual Items,GD Aiswarya Deepam 700ML,12,195,195,0,1
04-01-2025,Personal Care & Cosmetics,REVLON COLOR N CARE,10,135,135,0,3
04-01-2025,"Grains, Flours & Dals",BOBBARA PAPPU 500GM,4,170,160,10,2
04-01-2025,Sweeteners,ACHUBELLAM 500GM,16,50,40,10,1
04-01-2025,Spices & Seasonings,SATHVI GREEN SOUNF 100GM,15,60,40,20,1
04-01-2025,Snacks & Ready-to-Eat,SD Moringa with plam jaggery 250gm,14,135,135,0,1
04-01-2025,"Dry Fruits, Nuts & Seeds",PULMAKHANA 100 GM,2,180,170,10,1
04-01-2025,"Dry Fruits, Nuts & Seeds",Groundnuts 1 kg,2,190,170,20,1
04-01-2025,"Grains, Flours & Dals",Green gram 1 kg,4,150,130,20,1
04-01-2025,"Grains, Flours & Dals",Red Chana 500 GM,4,75,60,15,1
04-01-2025,Spices & Seasonings,DB CRYSTAL SALT 1KG,15,25,25,0,1
04-01-2025,"Grains, Flours & Dals",MIXED FLOUR,4,331,331,0,1
04-01-2025,Snacks & Ready-to-Eat,GB SALT COOKIES,14,60,55,5,1
04-01-2025,"Grains, Flours & Dals",Sathya Javva Wheat Rava 500GM,4,190,190,0,2
04-01-2025,"Grains, Flours & Dals",White Batani 500GM,4,80,60,20,1
04-01-2025,"Dry Fruits, Nuts & Seeds",SALTED PISTA 250GM,2,400,350,50,1
04-01-2025,"Grains, Flours & Dals",RICE FLOUR 1KG,4,70,55,15,1
04-01-2025,Snacks & Ready-to-Eat,RB Choco Delite Almonds Raisins 40g,14,90,90,0,2
04-01-2025,"Grains, Flours & Dals",JOWAR WHITE 1 KG,4,40,35,5,0.5
04-01-2025,Snacks & Ready-to-Eat,VD MURUKU 175GM,14,60,60,0,1
04-01-2025,"Dry Fruits, Nuts & Seeds",DRYDATES YELLOW 250GM,2,135,120,15,1
04-01-2025,"Grains, Flours & Dals",RICE FLOUR 1KG,4,70,55,15,1
04-01-2025,"Grains, Flours & Dals",Idly Rava L 1KG,4,60,50,10,1
04-01-2025,Sweeteners,YB FOREST HONEY 250GM,16,180,180,0,1
04-01-2025,"Grains, Flours & Dals",SRILALITHA MAIDA FLOUR 500G,4,32,32,0,1
04-01-2025,General Household & Kitchenware,VERMI COMPOST MIX,3,30,30,0,1
04-01-2025,Personal Care & Cosmetics,UVIS MULTANI MITTI 200GM,10,90,90,0,1
04-01-2025,"Grains, Flours & Dals",SH JOWAR DALIYA,4,65,65,0,1
04-01-2025,"Grains, Flours & Dals",HS Ragi upma rava 500 gms,4,70,70,0,1
04-01-2025,"Grains, Flours & Dals",UDALU (Barnyard millet) 500 gms,4,70,60,10,1
04-01-2025,Spices & Seasonings,GS Moringa Leaves Spicy Powder 100GM,15,90,90,0,1
04-01-2025,"Grains, Flours & Dals",Green gram 1 kg,4,150,130,20,1
04-01-2025,"Grains, Flours & Dals",Arikalu (kodo),4,70,65,5,1
04-01-2025,Snacks & Ready-to-Eat,RB Choco Delite Almonds Raisins 40g,14,45,45,0,1
04-01-2025,"Grains, Flours & Dals",KORRALU (FOXTAIL M) 500GM,4,65,55,10,1
04-01-2025,"Dry Fruits, Nuts & Seeds",SD Mango cubes 100gm,2,45,45,0,1
04-01-2025,"Grains, Flours & Dals",RICE FLOUR 500 GM,4,35,28,7,1
04-01-2025,Snacks & Ready-to-Eat,SD Atreyapuram DRY Fruit ghee,14,150,150,0,1
04-01-2025,Snacks & Ready-to-Eat,MB FOXTAIL MILLET NOODLES 180GM,14,95,95,0,1
04-01-2025,Pooja & Spiritual Items,GOMATHA AGARBATHI,12,75,75,0,1
04-01-2025,"Grains, Flours & Dals",Sathya Javva Wheat Rava 500GM,4,95,95,0,1
04-01-2025,Snacks & Ready-to-Eat,GS INSTANT KORRA DOSA MIX 400GM,14,240,240,0,2
04-01-2025,"Grains, Flours & Dals",MULTIGRAIN 2.5 KG,4,500,420,80,2
04-01-2025,Snacks & Ready-to-Eat,SD JOWAR WITH PALM JAGGERY 250GM,14,135,135,0,1
04-01-2025,Snacks & Ready-to-Eat,TILLI CHIKKI,14,60,60,0,12
04-01-2025,Snacks & Ready-to-Eat,PEANUT CHILLI,14,30,30,0,6
04-01-2025,Snacks & Ready-to-Eat,RSC ORANGE 100GMS,14,20,20,0,1
04-01-2025,Beverages,BRU GREEN LABEL 1.2G,1,24,24,0,12
04-01-2025,"Grains, Flours & Dals",JOWAR WHITE 1 KG,4,80,65,15,1
04-01-2025,"Dry Fruits, Nuts & Seeds",PUMPKIN SEEDS 250GM,2,400,320,80,2
04-01-2025,"Grains, Flours & Dals",CORN RAVA,4,28,20,8,1
04-01-2025,Snacks & Ready-to-Eat,PEANUT CANDY,14,45,45,0,1
04-01-2025,Spices & Seasonings,NUVVULU 250GM,15,80,70,10,1
04-01-2025,"Dry Fruits, Nuts & Seeds",SUNFLOWER SEEDS 250GRM,2,150,130,20,1
04-01-2025,"Dry Fruits, Nuts & Seeds",DRIED KIWI 200GM,2,145,130,15,1
04-01-2025,Snacks & Ready-to-Eat,BLACK SESAME CHIKKI,14,10,10,0,1
04-01-2025,"Dry Fruits, Nuts & Seeds",SALTED PISTA 250GM,2,400,350,50,1
04-01-2025,Milk & Dairy,SANGAM FULL CREAM MILK 500ML,7,38,38,0,1
04-01-2025,Snacks & Ready-to-Eat,VD CORNFLAKES MIXTURE 175GM,14,60,60,0,1
04-01-2025,Snacks & Ready-to-Eat,VD ATUKULU MIXTURE 175GM,14,60,60,0,1
04-01-2025,"Dry Fruits, Nuts & Seeds",BLACK KISMIS 250GM,2,350,280,70,2
04-01-2025,Snacks & Ready-to-Eat,VD Pappu Chekkalu 190gm,14,60,60,0,1
04-01-2025,"Grains, Flours & Dals",SPLIT BLACK GRAM 500 GM,4,90,85,5,1
04-01-2025,Snacks & Ready-to-Eat,ZEEDI,14,70,70,0,1
04-01-2025,Oils & Ghee,Groundnut oil 1 L,9,720,660,60,2
04-01-2025,Pooja & Spiritual Items,GD WOODS 150GM,12,110,110,0,1
04-01-2025,"Dry Fruits, Nuts & Seeds",SD SUNFLOWER SEEDS WITH DATES,2,135,135,0,1
04-01-2025,Snacks & Ready-to-Eat,VD PAPPU CHEGODI 200GM,14,60,60,0,1
04-01-2025,Snacks & Ready-to-Eat,VD BELLAM GAVVALU 200GM,14,60,60,0,1
04-01-2025,Snacks & Ready-to-Eat,PALLI LADDU 200GMS,14,90,70,20,1
04-01-2025,Snacks & Ready-to-Eat,SATHVI MIXED CHIKKI 200GM,14,120,100,20,1
04-01-2025,Misc,HOME LIKES,8,10,10,0,1
04-01-2025,Snacks & Ready-to-Eat,RINGS 200GM,14,30,30,0,1
04-01-2025,Snacks & Ready-to-Eat,SATHVI PALLI CHIKKI 200GM,14,100,80,20,1
04-01-2025,Milk & Dairy,HERITAGE CURD,7,48,48,0,1
04-01-2025,"Grains, Flours & Dals",Red Chana 500 GM,4,75,60,15,1
04-01-2025,"Grains, Flours & Dals",RAGI FLOUR 500GRMS,4,40,35,5,1
04-01-2025,"Grains, Flours & Dals",Green gram 500 gms,4,75,70,5,1
04-01-2025,Snacks & Ready-to-Eat,TILLI CHIKKI,14,5,5,0,1
04-01-2025,Sweeteners,YB JAGGERY POWDER 1KG,16,140,140,0,1
04-01-2025,Sweeteners,GS Organic Jaggery Powder 600GM,16,99,99,0,1
04-01-2025,Snacks & Ready-to-Eat,BLACK SESAME CHIKKI,14,45,45,0,1
04-01-2025,Snacks & Ready-to-Eat,MB INSTANT NOODLES 165GM,14,90,90,0,1
04-01-2025,Snacks & Ready-to-Eat,Sprouted Ragi Biscuits 450GM,14,150,150,0,1
04-01-2025,Snacks & Ready-to-Eat,SF Cookies Choco Ragi Oat 88g,14,99,99,0,1
04-01-2025,"Grains, Flours & Dals",turdal 500 gms,4,110,100,10,1
04-01-2025,Beverages,BISLERI SODA 750ML,1,20,20,0,1
04-01-2025,Snacks & Ready-to-Eat,PEANUT CANDY,14,45,45,0,1
04-01-2025,Snacks & Ready-to-Eat,TILLI CHIKKI,14,5,5,0,1
04-01-2025,"Grains, Flours & Dals",PESARA PAPPU 1 KG,4,170,145,25,1
04-01-2025,"Grains, Flours & Dals",Idly Rava L 1KG,4,60,50,10,1
04-01-2025,Snacks & Ready-to-Eat,BROWN BREAD ZERO MAIDA 400GM,14,60,60,0,1
04-01-2025,Snacks & Ready-to-Eat,SATHVI MIXED CHIKKI 200GM,14,120,100,20,1
04-01-2025,Snacks & Ready-to-Eat,VD BOONDI 175GM,14,60,60,0,1
04-01-2025,"Grains, Flours & Dals",White jowar.F 1 kg,4,200,160,40,2
04-01-2025,"Grains, Flours & Dals",Sathya Javva Wheat Rava 500GM,4,95,95,0,1
04-01-2025,Oils & Ghee,Coconut oil 1 L,9,440,400,40,1
04-01-2025,"Dry Fruits, Nuts & Seeds",DRIED KIWI 200GM,2,145,130,15,1
04-01-2025,Spices & Seasonings,NUVVULU 250GM,15,80,65,15,1
04-01-2025,Personal Care & Cosmetics,GAYATHRI KUMKUDUKAYA,10,150,150,0,1
04-01-2025,"Dry Fruits, Nuts & Seeds",ANJEER 250GM,2,400,360,40,1
04-01-2025,"Grains, Flours & Dals",Bajra Flour 1 kg,4,70,60,10,1
04-01-2025,Snacks & Ready-to-Eat,COPRA LADDU 200GM,14,100,80,20,1
04-01-2025,Snacks & Ready-to-Eat,SD Thati thandra 200gm,14,150,150,0,1
04-01-2025,Snacks & Ready-to-Eat,VD SAGOPAPAD 150GM,14,55,55,0,1
04-01-2025,Snacks & Ready-to-Eat,RSC ORANGE 100GMS,14,20,20,0,1
04-01-2025,Spices & Seasonings,ROYAL SAFFRON 400GRMS,15,65,65,0,1
04-01-2025,Snacks & Ready-to-Eat,VD SANNAPUSA 175GM,14,60,60,0,1
04-01-2025,Snacks & Ready-to-Eat,SATHVI REGIVADA 200GM,14,80,60,20,1
04-01-2025,Oils & Ghee,Sesame oil 1 L,9,590,560,30,1
04-01-2025,Oils & Ghee,Safflower oil 1 L,9,440,400,40,1
04-01-2025,Snacks & Ready-to-Eat,RI Yogurt Berry Oats 35g,14,45,45,0,1
04-01-2025,Spices & Seasonings,ROYAL SAFFRON 400GRMS,15,130,130,0,2
04-01-2025,Snacks & Ready-to-Eat,SATHVI PALLI CHIKKI 200GM,14,100,80,20,1
04-01-2025,Snacks & Ready-to-Eat,TILLI CHIKKI,14,20,20,0,4
04-01-2025,Snacks & Ready-to-Eat,VD Minapa papad 200gm,14,60,60,0,1
04-01-2025,"Dry Fruits, Nuts & Seeds",PULMAKHANA 100 GM,2,180,170,10,1
04-01-2025,Pooja & Spiritual Items,SWASTIK CAMPHORE,12,90,90,0,1
04-01-2025,Snacks & Ready-to-Eat,MORINGA LEAVES PAPAD 200GM,14,90,90,0,1
04-01-2025,"Dry Fruits, Nuts & Seeds",PUTNALU 500GMS,2,90,76,14,1
04-01-2025,Snacks & Ready-to-Eat,SD SESAME PAPAD,14,80,80,0,1
04-01-2025,Snacks & Ready-to-Eat,VD MINAPA VADIYAM,14,65,65,0,1
04-01-2025,"Grains, Flours & Dals",MELMEKER 250GMS,4,60,45,15,1
04-01-2025,Snacks & Ready-to-Eat,PEANUT CHILLI,14,20,20,0,4
04-01-2025,Snacks & Ready-to-Eat,VD DAHI MIRCHI(SALTED) 100GM,14,90,90,0,2
04-01-2025,Snacks & Ready-to-Eat,OK MACARONI,14,120,120,0,1
04-01-2025,"Grains, Flours & Dals",RAJMA 250GM,4,55,45,10,1
04-01-2025,"Health, Wellness & Ayurvedic Products",RB Max Protein Salt & Caramel Bar 50g,5,75,75,0,1
04-01-2025,Pooja & Spiritual Items,SOSR SWATHHI 365,12,60,60,0,2
04-01-2025,Spices & Seasonings,RED COPRA 500GM,15,170,148,22,1
04-01-2025,Pooja & Spiritual Items,GD Aiswarya Deepam 700ML,12,195,195,0,1
04-01-2025,Spices & Seasonings,LG 50GM,15,92,92,0,1
04-01-2025,Pooja & Spiritual Items,SWAATHI GATTI DEEPAM VATTULU,12,150,150,0,5
04-01-2025,"Grains, Flours & Dals",Multigrain 1 kg,4,200,170,30,2
04-01-2025,"Grains, Flours & Dals",EM jowar upma R 500G,4,75,75,0,1
04-01-2025,Snacks & Ready-to-Eat,Corn Chips 250GM,14,80,70,10,2
04-01-2025,Spices & Seasonings,Telaga Pindi 250 GM,15,40,35,5,1
04-01-2025,"Grains, Flours & Dals",Brown RICE 1KG,4,140,130,10,2
04-01-2025,"Grains, Flours & Dals",BASMATHI RICE 1KG,4,150,135,15,1
04-01-2025,Snacks & Ready-to-Eat,SATHVI MIXED CHIKKI 200GM,14,120,100,20,1
04-01-2025,"Grains, Flours & Dals",DESI CHANA,4,100,100,0,4
04-01-2025,"Grains, Flours & Dals",MELMEKER 250GMS,4,60,45,15,1
04-01-2025,Snacks & Ready-to-Eat,VD MINAPA SUNNUNDALU 12P,14,180,180,0,1
04-01-2025,Oils & Ghee,BUFFALLO GHEE 500ML,9,410,370,40,1
04-01-2025,Snacks & Ready-to-Eat,VD Minapa papad 200gm,14,60,60,0,1
04-01-2025,"Health, Wellness & Ayurvedic Products",RB Max Protein PERI PERI 60gm,5,45,45,0,1
04-01-2025,"Grains, Flours & Dals",Idly Rava L 1KG,4,120,100,20,2
04-01-2025,Snacks & Ready-to-Eat,SD BLACK GRAM PAPADS,14,80,80,0,1
04-01-2025,"Grains, Flours & Dals",split black gram 1 kg,4,360,340,20,2
04-01-2025,"Grains, Flours & Dals",Urad dall 1 Kg,4,185,170,15,1
04-01-2025,Snacks & Ready-to-Eat,RSC ORANGE 100GMS,14,20,20,0,1
04-01-2025,"Health, Wellness & Ayurvedic Products",MXP CREAM ONION,5,45,45,0,1
04-01-2025,"Grains, Flours & Dals",Green gram 1 kg,4,150,130,20,1
04-01-2025,"Dry Fruits, Nuts & Seeds",Groundnuts 1 kg,2,380,340,40,2
04-01-2025,"Dry Fruits, Nuts & Seeds",PUTNALU 500GMS,2,90,76,14,1
04-01-2025,"Grains, Flours & Dals",VL Sabdana 500GM,4,77,77,0,1
04-01-2025,"Grains, Flours & Dals",PRO ORG DALIYA BROKEN WHEAT 500G,4,72,72,0,1
04-01-2025,Sweeteners,Natural Honey 1 kg,16,560,480,80,1
04-01-2025,Spices & Seasonings,NUVVULU 500GM,15,160,130,30,1
04-01-2025,"Grains, Flours & Dals",turdal 1kg,4,220,195,25,1
04-01-2025,"Health, Wellness & Ayurvedic Products",MXP CHOCO CLASSIC BAR,5,140,140,0,2
04-01-2025,"Grains, Flours & Dals",SAMALU (Little millet) 1 kg,4,170,130,40,1
04-01-2025,"Grains, Flours & Dals",PRO ORG KABULI CHANNA 500GM,4,196,196,0,1
04-01-2025,Spices & Seasonings,NUVVULU 250GM,15,100,85,15,1
04-01-2025,Oils & Ghee,Groundnut oil 1 L,9,720,660,60,2
04-01-2025,Oils & Ghee,Groundnut oil 1 L,9,720,660,60,2
04-01-2025,"Grains, Flours & Dals",Bombay Rava 500GM,4,35,30,5,1
04-01-2025,"Grains, Flours & Dals",RAJMA 250GM,4,55,45,10,1
04-01-2025,"Grains, Flours & Dals",KORRALU (FOXTAIL M) 1KG,4,150,110,40,1
04-01-2025,"Grains, Flours & Dals",AS Maize Rava 500GM,4,42,38,4,1
04-01-2025,"Grains, Flours & Dals",RICE FLOUR 500 GM,4,35,28,7,1
04-01-2025,"Grains, Flours & Dals",Kandulu 500GM,4,80,70,10,1
04-01-2025,"Grains, Flours & Dals",white Bobarlu 500 gms,4,80,75,5,1
04-01-2025,"Grains, Flours & Dals",Brown RICE 1KG,4,210,195,15,3
04-01-2025,Spices & Seasonings,AVALU 100GM,15,25,20,5,1
04-01-2025,"Grains, Flours & Dals",Black uluvalu 250 gms,4,45,35,10,1
04-01-2025,Spices & Seasonings,JEERA 250 gms,15,125,105,20,1
04-01-2025,Spices & Seasonings,DRY MIECHI 200GM,15,80,60,20,1
04-01-2025,"Grains, Flours & Dals",SATHVI SABDANA 250GM,4,45,35,10,1
04-01-2025,"Grains, Flours & Dals",split green gram 500 gms,4,75,70,5,1
04-01-2025,Spices & Seasonings,Turmeric powder 250 gms,15,100,75,25,1
04-01-2025,"Grains, Flours & Dals",Idly Rava L 1KG,4,60,50,10,1
04-01-2025,"Dry Fruits, Nuts & Seeds",Groundnuts 500 gms,2,95,85,10,1
04-01-2025,"Grains, Flours & Dals",Red Bobarlu 500 gms,4,95,85,10,1
04-01-2025,Pooja & Spiritual Items,GOMATHA AGARBATHI,12,75,75,0,1
04-01-2025,Spices & Seasonings,NUVVULU 250GM,15,80,65,15,1
04-01-2025,Spices & Seasonings,Chilli powder 500 gms,15,290,210,80,1
04-01-2025,"Grains, Flours & Dals",RAGI FLOUR 500GRMS,4,40,35,5,1
04-01-2025,"Grains, Flours & Dals",Green gram 500 gms,4,75,70,5,1
04-01-2025,"Grains, Flours & Dals",Multigrain 1 kg,4,100,85,15,1
04-01-2025,Oils & Ghee,GANTASALA A2 COW GHEE 500ML,9,550,550,0,1
04-01-2025,Spices & Seasonings,Chilli powder 500 gms,15,580,420,160,2
04-01-2025,Spices & Seasonings,Turmeric powder 250 gms,15,100,75,25,1
04-01-2025,Pooja & Spiritual Items,DASANGAM DHOOP POWDER 50GM,12,43,43,0,1
04-01-2025,Oils & Ghee,BUFFALLO GHEE 500ML,9,820,740,80,2
04-01-2025,"Grains, Flours & Dals",Yellow jowar .F1 kg,4,330,300,30,3
04-01-2025,"Grains, Flours & Dals",Brown RICE 1KG,4,280,260,20,4
04-01-2025,Milk & Dairy,BROWN EGGS TRAY 30P,7,360,330,30,1
04-01-2025,Pooja & Spiritual Items,GD Sree Chandan 50GM,12,50,50,0,1
04-01-2025,Pooja & Spiritual Items,VRP APOORVA JAVADHU POW,12,35,35,0,1
04-01-2025,Pooja & Spiritual Items,SS DASANGAM CONE 20PICS,12,45,45,0,1
04-01-2025,Oils & Ghee,Coconut oil 1 L,9,1320,"1,200.00",120,3
04-01-2025,"Grains, Flours & Dals",BASMATHI RICE 1KG,4,150,135,15,1
04-01-2025,"Grains, Flours & Dals",VGR rice 1 kg,4,350,325,25,5
04-01-2025,"Grains, Flours & Dals",EM kodo upma R 500g,4,129,129,0,1
04-01-2025,"Health, Wellness & Ayurvedic Products",YB APPLE CIDER VINEGAR500ML,5,500,500,0,1
04-01-2025,Snacks & Ready-to-Eat,"SF Cereal For Little Ones Banana,Ragi",14,349,349,0,1
04-01-2025,"Grains, Flours & Dals",HS Multimillet upma r 500g,4,65,65,0,1
04-01-2025,Milk & Dairy,BROWN EGGS TRAY 30P,7,360,330,30,1
04-01-2025,"Grains, Flours & Dals",DR.RICE 5KG,4,600,600,0,1
04-01-2025,Spices & Seasonings,Turmeric powder 250 gms,15,100,75,25,1
04-01-2025,Spices & Seasonings,pickles chilli .pwdr 1 kg,15,175,162.5,12.5,0.25
04-01-2025,Snacks & Ready-to-Eat,VD BOONDI 175GM,14,120,120,0,2
04-01-2025,"Grains, Flours & Dals",Urad dall 1 Kg,4,185,170,15,1
04-01-2025,Spices & Seasonings,PURO Healthy Salt Crystal 1KG,15,135,135,0,1
04-01-2025,Sweeteners,Mishri 250 GM,16,35,30,5,1
04-01-2025,Snacks & Ready-to-Eat,Popcorn Seeds 500GM,14,90,80,10,1
04-01-2025,"Grains, Flours & Dals",turdal 500 gms,4,110,100,10,1
04-01-2025,Oils & Ghee,Groundnut oil 1 L,9,720,660,60,2
04-01-2025,Spices & Seasonings,ROYAL SAFFRON 400GRMS,15,65,65,0,1
04-01-2025,"Grains, Flours & Dals",White jowar.F 1 kg,4,100,80,20,1
04-01-2025,"Grains, Flours & Dals",Idly Rava L 1KG,4,60,50,10,1
04-01-2025,"Grains, Flours & Dals",CHANA DAL 500GM,4,70,60,10,1
04-01-2025,"Grains, Flours & Dals",Urad dall 1 Kg,4,185,170,15,1
04-01-2025,Oils & Ghee,Sesame oil 1 L,9,590,560,30,1
04-01-2025,"Grains, Flours & Dals",Multigrain 1 kg,4,100,85,15,1
04-01-2025,"Grains, Flours & Dals",THICK POHA 1KG,4,80,70,10,1
04-01-2025,Oils & Ghee,Safflower oil 1 L,9,880,800,80,2
04-01-2025,"Grains, Flours & Dals",PESARA PAPPU 500GMS,4,85,75,10,1
04-01-2025,"Grains, Flours & Dals",RAGI FLOUR 500GRMS,4,40,35,5,1
04-01-2025,"Grains, Flours & Dals",Wheat Flour 2 kgs,4,140,120,20,1
04-01-2025,Oils & Ghee,Coconut oil 500 ml,9,220,200,20,1
04-01-2025,"Grains, Flours & Dals",VYS.SP.RICE BAG 1,4,1800,"1,650.00",150,1
04-01-2025,"Grains, Flours & Dals",SAMALU (Little millet) 1 kg,4,170,130,40,1
04-01-2025,"Grains, Flours & Dals",LION OATS 1KG,4,218,218,0,1
04-01-2025,Oils & Ghee,Freedom Rice Bran Oil 1L,9,194,180,14,1
04-01-2025,"Grains, Flours & Dals",Wheat Flour 1 kg,4,70,60,10,1
04-01-2025,"Dry Fruits, Nuts & Seeds",Putnalu 250GM,2,45,38,7,1
04-01-2025,Beverages,RED LABEL NATURAL CARE 100G,1,65,65,0,1
04-01-2025,Oils & Ghee,Sesame oil 500ml,9,295,280,15,1
04-01-2025,Oils & Ghee,Sesame oil 500ml,9,295,280,15,1
04-01-2025,Beverages,RED LABEL NATURAL CARE 100G,1,65,65,0,1
04-01-2025,"Grains, Flours & Dals",LION OATS 1KG,4,218,218,0,1
04-01-2025,Oils & Ghee,Freedom Rice Bran Oil 1L,9,164,164,0,1
04-01-2025,"Grains, Flours & Dals",Wheat Flour 1 kg,4,70,60,10,1
04-01-2025,"Dry Fruits, Nuts & Seeds",Putnalu 250GM,2,45,38,7,1
04-01-2025,"Grains, Flours & Dals",UDALU (Barnyard millet) 500 gms,4,70,60,10,1
04-01-2025,"Grains, Flours & Dals",SAMALU (Little millet) 500 gms,4,85,65,20,1
04-01-2025,"Grains, Flours & Dals",BARLEY FLOUR 250GM,4,45,40,5,1
04-01-2025,"Health, Wellness & Ayurvedic Products",MH Millets Malt 500GM,5,200,190,10,1
04-01-2025,Sweeteners,YB JAGGERY POWDER 1KG,16,140,140,0,1
04-01-2025,Snacks & Ready-to-Eat,Corn Chips 250GM,14,40,35,5,1
04-01-2025,"Grains, Flours & Dals",Red Bobarlu 500 gms,4,95,85,10,1
04-01-2025,"Grains, Flours & Dals",JOWAR YELLOW 1 K,4,90,90,0,1
04-01-2025,"Grains, Flours & Dals",PRO ORG MEDIUM POHA 500G,4,78,78,0,1
04-01-2025,"Grains, Flours & Dals",Red uluvalu 500 gms,4,90,75,15,1
04-01-2025,Snacks & Ready-to-Eat,RINGS 200GM,14,30,30,0,1
04-01-2025,"Grains, Flours & Dals",AISHWARYA SP 1KG,4,400,375,25,5
04-01-2025,Spices & Seasonings,Biryani Leaf 25GM,15,30,20,10,1
04-01-2025,Pooja & Spiritual Items,PUDINA PUVVU,12,60,60,0,1
04-01-2025,Spices & Seasonings,JEERA 250 gms,15,125,105,20,1
04-01-2025,"Dry Fruits, Nuts & Seeds",Groundnuts 1 kg,2,190,170,20,1
04-01-2025,Spices & Seasonings,RED COPRA 250GMS,15,85,74,11,1
04-01-2025,Pooja & Spiritual Items,VOMA PUVVU,12,60,60,0,1
04-01-2025,Spices & Seasonings,Avalu small 250 gms,15,60,40,20,1
04-01-2025,"Grains, Flours & Dals",split black gram 500 gms,4,90,85,5,1
04-01-2025,Spices & Seasonings,Elaichi 25GM,15,145,120,25,1
04-01-2025,Pooja & Spiritual Items,PACHA KARPURAM 10GM,12,60,60,0,1
04-01-2025,Spices & Seasonings,SATHVI GREEN SOUNF 100GM,15,60,40,20,1
04-01-2025,Spices & Seasonings,Dalchin Chekka 50GM,15,100,80,20,2
04-01-2025,Spices & Seasonings,Lavangam 50GM,15,120,100,20,2
04-01-2025,Oils & Ghee,Groundnut oil 500ml,9,180,165,15,1
04-01-2025,Oils & Ghee,Groundnut oil 1 L,9,360,330,30,1
04-01-2025,Oils & Ghee,Sesame oil 500ml,9,295,280,15,1
04-01-2025,"Dry Fruits, Nuts & Seeds",Groundnuts 500 gms,2,95,85,10,1
04-01-2025,Spices & Seasonings,NUVVULU 250GM,15,80,65,15,1
04-01-2025,"Grains, Flours & Dals",UDALU (Barnyard millet) 1 kg,4,140,115,25,1
04-01-2025,"Grains, Flours & Dals",SAMALU (Little millet) 1 kg,4,170,130,40,1
04-01-2025,"Grains, Flours & Dals",Brown RICE 1KG,4,70,65,5,1
04-01-2025,Spices & Seasonings,RED COPRA 250GMS,15,85,74,11,1
04-01-2025,"Grains, Flours & Dals",Yellow jowar .F1 kg,4,110,100,10,1
04-01-2025,Snacks & Ready-to-Eat,KURNOOL MARMURA,14,70,55,15,1
04-01-2025,"Grains, Flours & Dals",Chana Flour 500 gms,4,70,65,5,1
04-01-2025,Snacks & Ready-to-Eat,SD Aswagandha with palm Jaggery250Gm,14,135,135,0,1
04-01-2025,Snacks & Ready-to-Eat,VD MYSOREPAK 6PIC,14,100,100,0,1
04-01-2025,Snacks & Ready-to-Eat,SD FINGER Millet with palm Jaggery 250gm,14,135,135,0,1
04-01-2025,"Grains, Flours & Dals",RICE FLOUR 500 GM,4,35,28,7,1
04-01-2025,Oils & Ghee,Groundnut oil 1 L,9,360,330,30,1
03-01-2025,Milk & Dairy,BROWN EGGS TRAY 30P,7,360,330,30,1
03-01-2025,Snacks & Ready-to-Eat,FOXTAIL NOODLES,14,75,75,0,1
03-01-2025,Snacks & Ready-to-Eat,MAAGAANI M JOWAR PASTA 200GM,14,199,199,0,1
03-01-2025,Snacks & Ready-to-Eat,BB VERMICELLI 1KG,14,95,90,5,1
03-01-2025,"Grains, Flours & Dals",split green gram 500 gms,4,75,70,5,1
03-01-2025,"Grains, Flours & Dals",Chana Flour 500 gms,4,70,65,5,1
03-01-2025,"Grains, Flours & Dals",Multigrain 1 kg,4,200,170,30,2
03-01-2025,Spices & Seasonings,Turmeric powder 250 gms,15,100,75,25,1
03-01-2025,Spices & Seasonings,Turmeric powder 250 gms,15,100,75,25,1
03-01-2025,Spices & Seasonings,Menthulu 250 gms,15,50,45,5,1
03-01-2025,Spices & Seasonings,Coriander seeds 200 gms,15,48,40,8,1
03-01-2025,"Grains, Flours & Dals",SRILALITHA MAIDA FLOUR 500G,4,64,64,0,2
03-01-2025,Spices & Seasonings,AVALU 100GM,15,75,60,15,3
03-01-2025,Spices & Seasonings,SAJEERA,15,60,40,20,1
03-01-2025,"Dry Fruits, Nuts & Seeds",Groundnuts 1 kg,2,570,510,60,3
03-01-2025,Spices & Seasonings,JEERA 250 gms,15,500,420,80,4
03-01-2025,"Grains, Flours & Dals",Green gram 1 kg,4,150,130,20,1
03-01-2025,Sweeteners,SUGAR 1KG,16,60,50,10,1
03-01-2025,Spices & Seasonings,TATA SALT 1KG,15,120,120,0,4
03-01-2025,"Grains, Flours & Dals",POORI ATTA,4,60,55,5,1
03-01-2025,Spices & Seasonings,Miriyalu 50GM,15,200,160,40,2
03-01-2025,"Grains, Flours & Dals",SL Idly Rava 1KG,4,325,275,50,5
03-01-2025,Snacks & Ready-to-Eat,BB VERMICELLI 250GM,14,60,60,0,2
03-01-2025,Oils & Ghee,Groundnut oil 5 L,9,1800,"1,600.00",200,1
03-01-2025,Spices & Seasonings,NUVVULU 500GM,15,200,170,30,1
03-01-2025,Beverages,SUNRISE 50GM,1,135,135,0,1
03-01-2025,Spices & Seasonings,SONTI 50GM,15,60,40,20,2
03-01-2025,Spices & Seasonings,SATHVI GREEN SOUNF 100GM,15,60,40,20,1
03-01-2025,"Grains, Flours & Dals",VL Sabdana 500GM,4,77,77,0,1
03-01-2025,Spices & Seasonings,Marati Magga 50GM,15,390,330,60,3
03-01-2025,Oils & Ghee,Sesame oil 1 L,9,1180,"1,120.00",60,2
03-01-2025,Pooja & Spiritual Items,GD Kumkum 50GM,12,30,30,0,1
03-01-2025,Spices & Seasonings,Masala Karam 500 gms,15,520,480,40,2
03-01-2025,"Grains, Flours & Dals",SA Sprouted Ragi Flour 500GM,4,138,138,0,2
03-01-2025,Spices & Seasonings,Gasagasalu 50GM,15,130,110,20,1
03-01-2025,"Grains, Flours & Dals",DH URAD GOTA 1KG,4,1075,950,125,5
03-01-2025,Milk & Dairy,BROWN EGGS 1P,7,140,120,20,10
03-01-2025,"Dry Fruits, Nuts & Seeds",Groundnuts 1 kg,2,190,170,20,1
03-01-2025,Spices & Seasonings,DB CRYSTAL SALT 1KG,15,50,50,0,2
03-01-2025,Spices & Seasonings,RED COPRA 250GMS,15,170,148,22,2
03-01-2025,Sweeteners,SUGAR 1KG,16,60,50,10,1
03-01-2025,Sweeteners,SUGAR 500GM,16,30,25,5,1
03-01-2025,Beverages,RED LABEL NATURAL CARE 100G,1,65,65,0,1
03-01-2025,"Grains, Flours & Dals",SL Idly Rava 1KG,4,65,55,10,1
03-01-2025,Oils & Ghee,Groundnut oil 500ml,9,180,165,15,1
03-01-2025,Milk & Dairy,BROWN EGGS 1P,7,280,240,40,20
03-01-2025,Oils & Ghee,Coconut oil 500 ml,9,220,200,20,1
03-01-2025,Oils & Ghee,Mustard oil 500 ml,9,220,195,25,1
03-01-2025,Oils & Ghee,Safflower oil 1 L,9,440,400,40,1
03-01-2025,Oils & Ghee,Sesame oil 500ml,9,295,280,15,1
03-01-2025,"Grains, Flours & Dals",RICE FLOUR 500 GM,4,35,28,7,1
03-01-2025,"Grains, Flours & Dals",Wheat Flour 1 kg,4,105,90,15,1.5
03-01-2025,Oils & Ghee,Coconut oil 500 ml,9,220,200,20,1
03-01-2025,Oils & Ghee,Safflower oil 500 ml,9,220,200,20,1
03-01-2025,Snacks & Ready-to-Eat,RAGI LADDU,14,120,120,0,1
03-01-2025,Pickles & Cooking Pastes,SD MAGAYA PICKLE,11,120,120,0,1
03-01-2025,Pickles & Cooking Pastes,SD LEMON PICKLE,11,110,110,0,1
03-01-2025,Snacks & Ready-to-Eat,VD BELLAM GAVVALU 200GM,14,60,60,0,1
03-01-2025,Oils & Ghee,Coconut oil 1 L,9,440,400,40,1
03-01-2025,Oils & Ghee,Sesame oil 500ml,9,295,280,15,1
03-01-2025,Snacks & Ready-to-Eat,SATHVI PALLI CHIKKI 200GM,14,100,80,20,1
03-01-2025,Milk & Dairy,BROWN EGGS 1P,7,140,120,20,10
03-01-2025,"Grains, Flours & Dals",White jowar.F 1 kg,4,100,80,20,1
03-01-2025,"Grains, Flours & Dals",RICE FLOUR 1KG,4,70,55,15,1
03-01-2025,Oils & Ghee,A2 BUFFALO GHEE 250ML,9,299,299,0,1
03-01-2025,Sweeteners,NATURAL HONEY 250GM,16,150,130,20,1
03-01-2025,"Grains, Flours & Dals",PRO ORGANIC MOONG GREEN,4,148,148,0,1
03-01-2025,Snacks & Ready-to-Eat,MARMURA LADDU,14,80,60,20,1
03-01-2025,Milk & Dairy,HRITAGE TONED MILK 500ML,7,30,30,0,1
03-01-2025,"Grains, Flours & Dals",Multigrain 1 kg,4,100,85,15,1
03-01-2025,"Grains, Flours & Dals",Bajra Flour 500 gms,4,35,30,5,1
03-01-2025,"Grains, Flours & Dals",VL Sabdana 500GM,4,77,77,0,1
03-01-2025,"Grains, Flours & Dals",PRO ORGANIC MOONG GREEN,4,148,148,0,1
03-01-2025,"Grains, Flours & Dals",Multigrain 1 kg,4,100,85,15,1
03-01-2025,Spices & Seasonings,Gasagasalu 50GM,15,130,110,20,1
03-01-2025,Snacks & Ready-to-Eat,MAAGAANI M JOWAR PASTA 200GM,14,199,199,0,1
03-01-2025,"Grains, Flours & Dals",LION OATS 1KG,4,218,218,0,1
03-01-2025,"Dry Fruits, Nuts & Seeds",PULMAKHANA 100 GM,2,180,170,10,1
03-01-2025,"Grains, Flours & Dals",CORN FOUR 250GM,4,40,35,5,1
03-01-2025,"Grains, Flours & Dals",RED TURDAL 500GM,4,75,70,5,1
03-01-2025,"Grains, Flours & Dals",BAJRA 1 KG,4,60,50,10,1
03-01-2025,"Grains, Flours & Dals",RAGULU 1 KG,4,70,60,10,1
03-01-2025,"Grains, Flours & Dals",Multigrain 1 kg,4,100,85,15,1
03-01-2025,"Dry Fruits, Nuts & Seeds",MAHA BEERA SEEDS 100GM,2,60,60,0,1
03-01-2025,"Dry Fruits, Nuts & Seeds",SD Mango cubes 100gm,2,90,90,0,2
03-01-2025,Snacks & Ready-to-Eat,KURNOOL MARMURA,14,140,110,30,2
03-01-2025,"Health, Wellness & Ayurvedic Products",MXP CHOCO CLASSIC BAR,5,70,70,0,1
03-01-2025,Oils & Ghee,Mustard oil 500 ml,9,220,195,25,1
03-01-2025,Oils & Ghee,Sesame oil 500ml,9,295,280,15,1
03-01-2025,"Grains, Flours & Dals",Idly Rava L 1KG,4,60,50,10,1
03-01-2025,"Grains, Flours & Dals",Wheat Flour 1 kg,4,70,60,10,1
03-01-2025,"Grains, Flours & Dals",DH URAD GOTA 1KG,4,215,190,25,1
03-01-2025,Oils & Ghee,Coconut oil 500 ml,9,220,200,20,1
03-01-2025,Spices & Seasonings,Telaga Pindi 250 GM,15,40,35,5,1
03-01-2025,Sweeteners,GS JAGGERY NUGGETS 500GM,16,120,120,0,1
03-01-2025,Snacks & Ready-to-Eat,VD MIXTURE 175 GM,14,60,60,0,1
03-01-2025,Snacks & Ready-to-Eat,SESAME LADDU 200GM,14,100,80,20,1
03-01-2025,Snacks & Ready-to-Eat,SD Moringa with plam jaggery 250gm,14,135,135,0,1
03-01-2025,"Grains, Flours & Dals",BASMATHI RICE 1KG,4,150,135,15,1
03-01-2025,Snacks & Ready-to-Eat,SD JOWAR WITH PALM JAGGERY 250GM,14,135,135,0,1
03-01-2025,Snacks & Ready-to-Eat,MARMURA LADDU,14,80,60,20,1
03-01-2025,Sweeteners,ACHU BELLAM 1KG,16,200,160,40,2
03-01-2025,Oils & Ghee,Black Sesame oil 1 L,9,880,760,120,2
03-01-2025,Snacks & Ready-to-Eat,MARMURA LADDU,14,80,60,20,1
03-01-2025,Oils & Ghee,Sesame oil 1 L,9,590,560,30,1
03-01-2025,Milk & Dairy,BROWN EGGS 1P,7,168,144,24,12
03-01-2025,"Grains, Flours & Dals",Green gram 500 gms,4,75,70,5,1
03-01-2025,Oils & Ghee,Groundnut oil 1 L,9,360,330,30,1
03-01-2025,Snacks & Ready-to-Eat,MARMURA LADDU,14,80,60,20,1
03-01-2025,Spices & Seasonings,DB CRYSTAL SALT 1KG,15,50,50,0,2
03-01-2025,Spices & Seasonings,TM MIRCH POWDER 200GM,15,326,326,0,2
03-01-2025,Oils & Ghee,Groundnut oil 1 L,9,360,330,30,1
03-01-2025,Snacks & Ready-to-Eat,PUMPKIN CHIKKI 200GM,14,140,120,20,1
03-01-2025,Snacks & Ready-to-Eat,VD ATUKULU MIXTURE 175GM,14,60,60,0,1
03-01-2025,Oils & Ghee,Sesame oil 1 L,9,590,560,30,1
03-01-2025,Snacks & Ready-to-Eat,NGT CHATPATTA CHANA 90GM,14,25,25,0,1
03-01-2025,Snacks & Ready-to-Eat,MARMURA LADDU,14,160,120,40,2
03-01-2025,"Grains, Flours & Dals",Yellow jowar .F1 kg,4,110,100,10,1
03-01-2025,Snacks & Ready-to-Eat,RINGS 200GM,14,30,30,0,1
03-01-2025,Snacks & Ready-to-Eat,SATHVI MIXED CHIKKI 200GM,14,120,100,20,1
03-01-2025,Snacks & Ready-to-Eat,VD Pappu Chekkalu 190gm,14,60,60,0,1
03-01-2025,Snacks & Ready-to-Eat,VD RICE PAPAD 150GM,14,50,50,0,1
03-01-2025,Oils & Ghee,Freedom Rice Bran Oil 1L,9,194,180,14,1
03-01-2025,"Grains, Flours & Dals",MAATEJA rice 1 kg,4,360,345,15,5
03-01-2025,Snacks & Ready-to-Eat,VD PAPPU CHEGODI 200GM,14,60,60,0,1
03-01-2025,Beverages,BRU GREEN LABEL 1.2G,1,24,24,0,12
03-01-2025,"Grains, Flours & Dals",AISHWARYA SP 25KG,4,1999,"1,825.00",174,1
03-01-2025,Sweeteners,YB JAGGERY POWDER 1KG,16,140,140,0,1
03-01-2025,Snacks & Ready-to-Eat,PEANUT CHILLI,14,30,30,0,6
03-01-2025,"Health, Wellness & Ayurvedic Products",RB Max Protein Choco chips 55gm,5,50,50,0,1
03-01-2025,"Health, Wellness & Ayurvedic Products",RB Max Protein Chinese Manchurian,5,90,90,0,2
03-01-2025,Snacks & Ready-to-Eat,VD PAPPU CHEGODI 200GM,14,60,60,0,1
03-01-2025,Oils & Ghee,Groundnut oil 5 L,9,1800,"1,600.00",200,1
03-01-2025,Spices & Seasonings,PURO Healthy Salt 1KG,15,110,110,0,1
03-01-2025,Oils & Ghee,Sesame oil 500ml,9,295,280,15,1
03-01-2025,Oils & Ghee,Groundnut oil 1 L,9,360,330,30,1
03-01-2025,Snacks & Ready-to-Eat,VD PAPPU CHEGODI 200GM,14,120,120,0,2
03-01-2025,Spices & Seasonings,Tamarind 500GM,15,160,130,30,1
03-01-2025,Beverages,SUNRISE 50GM,1,270,270,0,2
03-01-2025,Oils & Ghee,Groundnut oil 1 L,9,720,660,60,2
03-01-2025,Oils & Ghee,Cow ghee 500 ml,9,430,390,40,1
03-01-2025,Oils & Ghee,Coconut oil 500 ml,9,220,200,20,1
03-01-2025,Oils & Ghee,Safflower oil 1 L,9,880,800,80,2
03-01-2025,"Grains, Flours & Dals",Wheat Flour 1 kg,4,420,360,60,6
03-01-2025,Sweeteners,Natural Honey 1 kg,16,560,480,80,1
03-01-2025,Snacks & Ready-to-Eat,VD RIBBON PAKODI 175GM,14,120,120,0,2
03-01-2025,Spices & Seasonings,SONTI 50GM,15,90,60,30,3
03-01-2025,"Dry Fruits, Nuts & Seeds",Groundnuts 1 kg,2,190,170,20,1
03-01-2025,Sweeteners,SUGAR 500GM,16,30,25,5,1
03-01-2025,Spices & Seasonings,Miriyalu 50GM,15,100,80,20,1
03-01-2025,Beverages,BRU GREEN LABEL 1.2G,1,10,10,0,5
03-01-2025,General Household & Kitchenware,B1 bowl,3,367,348.65,18.35,1
03-01-2025,Oils & Ghee,Cow ghee 500 ml,9,430,390,40,1
03-01-2025,Beverages,TAJ MAHAL 100GM,1,95,95,0,1
03-01-2025,Beverages,TATA CHAKRA GOLD PT 120GM,1,90,90,0,1
03-01-2025,Beverages,3ROSES,1,90,90,0,1
03-01-2025,"Grains, Flours & Dals",Red Chana 250GM,4,35,30,5,1
03-01-2025,"Grains, Flours & Dals",RAGI FLOUR 500GRMS,4,40,35,5,1
03-01-2025,Snacks & Ready-to-Eat,DOSA BATTER 1KG,14,60,60,0,1
03-01-2025,Snacks & Ready-to-Eat,KURNOOL MARMURA,14,70,55,15,1
03-01-2025,Snacks & Ready-to-Eat,SUNNUNDALU,14,120,120,0,1
03-01-2025,"Dry Fruits, Nuts & Seeds",SD Mango cubes 200gm,2,90,90,0,1
03-01-2025,Snacks & Ready-to-Eat,COPRA LADDU 200GM,14,100,80,20,1
03-01-2025,Personal Care & Cosmetics,MD Henna Choornam 100GM,10,240,240,0,3
03-01-2025,"Dry Fruits, Nuts & Seeds",Groundnuts 1 kg,2,190,170,20,1
03-01-2025,Snacks & Ready-to-Eat,PALLI LADDU 200GMS,14,90,70,20,1
03-01-2025,Snacks & Ready-to-Eat,SATHVI REGIVADA 200GM,14,80,60,20,1
03-01-2025,Oils & Ghee,Groundnut oil 1 L,9,360,330,30,1
03-01-2025,Sweeteners,MADHUR SUGAR 1KG,16,65,55,10,1
03-01-2025,"Grains, Flours & Dals",HS Multimillet upma r 500g,4,65,65,0,1
03-01-2025,Milk & Dairy,SANGAM CURD 450GM,7,38,38,0,1
03-01-2025,Snacks & Ready-to-Eat,GB SALT COOKIES,14,60,55,5,1
03-01-2025,Milk & Dairy,SANGAM TONED MILK 500ML,7,60,60,0,2
03-01-2025,Milk & Dairy,BROWN EGGS 1P,7,168,144,24,12
03-01-2025,Oils & Ghee,Coconut oil 1 L,9,440,400,40,1
03-01-2025,Pooja & Spiritual Items,SWAATHI GATTI DEEPAM VATTULU,12,30,30,0,1
03-01-2025,Snacks & Ready-to-Eat,PALLI LADDU 200GMS,14,90,70,20,1
03-01-2025,Snacks & Ready-to-Eat,WHEAT GRASS BISCUITS 250GM,14,130,130,0,1
03-01-2025,Pooja & Spiritual Items,GOW DURBAR GEETHA CAMPHOR,12,60,60,0,1
03-01-2025,Pooja & Spiritual Items,GD Ramayana Sandal 75GM,12,120,120,0,2
03-01-2025,Personal Care & Cosmetics,MD Henna Choornam 100GM,10,80,80,0,1
03-01-2025,Spices & Seasonings,DB CRYSTAL SALT 1KG,15,25,25,0,1
03-01-2025,"Grains, Flours & Dals",AISHWARYA SP 5KG,4,400,400,0,1
03-01-2025,Pooja & Spiritual Items,GD JASMINE,12,120,120,0,2
03-01-2025,"Grains, Flours & Dals",EM Foxtail idli r 500 g,4,109,109,0,1
03-01-2025,"Grains, Flours & Dals",Em Multimillet idli r 500g,4,258,258,0,2
03-01-2025,Snacks & Ready-to-Eat,Pani Poori Chips 250GM,14,50,40,10,1
03-01-2025,Snacks & Ready-to-Eat,GANTASALA GINGER CANDY 200GM,14,105,105,0,1
03-01-2025,"Grains, Flours & Dals",Em kodo idli R 500G,4,129,129,0,1
03-01-2025,Spices & Seasonings,EVEREST PANI PURI MASALA 50GM,15,40,40,0,1
03-01-2025,"Grains, Flours & Dals",Em Multimillet upma 500g,4,129,129,0,1
03-01-2025,Milk & Dairy,BROWN EGGS 1P,7,140,120,20,10
03-01-2025,"Health, Wellness & Ayurvedic Products",DWI OWU WATER 200ML,5,75,75,0,1
03-01-2025,Spices & Seasonings,Masala Karam 500 gms,15,260,240,20,1
03-01-2025,Snacks & Ready-to-Eat,SATHVI REGIVADA 200GM,14,80,60,20,1
03-01-2025,"Grains, Flours & Dals",White Batani 250GM,4,40,30,10,1
03-01-2025,"Grains, Flours & Dals",White Chana 250 GM,4,60,50,10,1
03-01-2025,Personal Care & Cosmetics,BANJARAS ORANGE PEEL 100GM,10,80,80,0,1
03-01-2025,"Grains, Flours & Dals",MIXED FLOUR,4,273,273,0,1
03-01-2025,"Grains, Flours & Dals",white Bobarlu 500 gms,4,80,75,5,1
03-01-2025,Snacks & Ready-to-Eat,MB SORGHUM NOODLES 180GM,14,95,95,0,1
03-01-2025,Snacks & Ready-to-Eat,MB PEARL MILLET NOODLES 180GM,14,95,95,0,1
03-01-2025,"Dry Fruits, Nuts & Seeds",PULMAKHANA 100 GM,2,180,170,10,1
03-01-2025,"Grains, Flours & Dals",Wheat Flour 1 kg,4,70,60,10,1
03-01-2025,"Grains, Flours & Dals",Wheat Flour 1 kg,4,70,60,10,1
03-01-2025,Oils & Ghee,ANURAG RB OIL 1L,9,250,195,55,1
03-01-2025,Spices & Seasonings,GROUNDNUT KARAM POWDER,15,65,65,0,1
03-01-2025,Snacks & Ready-to-Eat,KURNOOL MARMURA,14,70,55,15,1
03-01-2025,Snacks & Ready-to-Eat,FUN TIME CRUNCH,14,90,90,0,2
03-01-2025,"Grains, Flours & Dals",SRILATHA RICE RAVVA 500GM,4,70,70,0,2
03-01-2025,Snacks & Ready-to-Eat,VD ATUKULU MIXTURE 175GM,14,120,120,0,2
03-01-2025,Oils & Ghee,Coconut oil 1 L,9,440,400,40,1
03-01-2025,Sweeteners,Natural Honey 1 kg,16,560,480,80,1
03-01-2025,"Grains, Flours & Dals",Sathya Javva Wheat Rava 500GM,4,190,190,0,2
03-01-2025,Snacks & Ready-to-Eat,RI Yogurt Berry Oats 35g,14,90,90,0,2
03-01-2025,"Grains, Flours & Dals",Em jowar idly R 500G,4,75,75,0,1
03-01-2025,Oils & Ghee,Groundnut oil 1 L,9,360,330,30,1
03-01-2025,Sweeteners,SUGAR 1KG,16,60,50,10,1
03-01-2025,General Household & Kitchenware,PREMIER,3,95,95,0,1
03-01-2025,"Grains, Flours & Dals",Arikalu (kodo),4,70,60,10,1
03-01-2025,"Grains, Flours & Dals",KORRALU (FOXTAIL M) 500GM,4,65,55,10,1
03-01-2025,Sweeteners,SUGAR 500GM,16,30,25,5,1
03-01-2025,Household & Cleaning,VIM 300GM,6,30,30,0,1
03-01-2025,"Grains, Flours & Dals",SAMALU (Little millet) 500 gms,4,85,65,20,1
03-01-2025,"Grains, Flours & Dals",Wheat Flour 2 kgs,4,140,120,20,1
03-01-2025,"Grains, Flours & Dals",DISANO OATS 1KG,4,142.5,142.5,0,1
03-01-2025,Household & Cleaning,VIM COOLING FRESHNESS MINT,6,20,20,0,1
03-01-2025,Sweeteners,Mishri 500GM,16,70,60,10,1
03-01-2025,Snacks & Ready-to-Eat,VD SANNAPUSA 175GM,14,60,60,0,1
03-01-2025,Snacks & Ready-to-Eat,MARMURA LADDU,14,80,60,20,1
03-01-2025,"Grains, Flours & Dals",FLOUR CHARGE,4,36,36,0,3
03-01-2025,"Grains, Flours & Dals",Multigrain 1 kg,4,100,85,15,1
03-01-2025,Snacks & Ready-to-Eat,VD BELLAM GAVVALU 200GM,14,60,60,0,1
03-01-2025,"Grains, Flours & Dals",Sathya Javva Wheat Rava 500GM,4,95,95,0,1
03-01-2025,Pooja & Spiritual Items,SWASTIK CAMPHOR 25GM,12,45,45,0,1
03-01-2025,Spices & Seasonings,Avalu big 250 gms,15,60,40,20,1
03-01-2025,Pooja & Spiritual Items,SWASTIK PURE CAMPHOR 50GM,12,90,90,0,1
03-01-2025,Snacks & Ready-to-Eat,KURNOOL MARMURA,14,70,55,15,1
03-01-2025,Sweeteners,SUGAR 1KG,16,60,50,10,1
03-01-2025,"Grains, Flours & Dals",SL Idly Rava 1KG,4,65,55,10,1
03-01-2025,Milk & Dairy,BROWN EGGS TRAY 30P,7,360,330,30,1
03-01-2025,Milk & Dairy,BROWN EGGS TRAY 30P,7,360,330,30,1
03-01-2025,Oils & Ghee,Groundnut oil 1 L,9,360,330,30,1
03-01-2025,Spices & Seasonings,PRO ORG FENUGREEK 200GM,15,86,86,0,1
03-01-2025,"Grains, Flours & Dals",Chana Flour 500 gms,4,70,65,5,1
03-01-2025,"Grains, Flours & Dals",White jowar.F 1 kg,4,100,80,20,1
03-01-2025,"Grains, Flours & Dals",Wheat Flour 1 kg,4,350,300,50,5
03-01-2025,"Grains, Flours & Dals",SL Idly Rava 1KG,4,65,55,10,1
03-01-2025,"Grains, Flours & Dals",RICE FLOUR 1KG,4,70,55,15,1
03-01-2025,"Grains, Flours & Dals",Chana Flour 1 kg,4,420,390,30,3
03-01-2025,Spices & Seasonings,DB CRYSTAL SALT 1KG,15,50,50,0,2
03-01-2025,Spices & Seasonings,YB PINK ROCK SALT 1KG,15,240,240,0,2
03-01-2025,Spices & Seasonings,NUVVULU 250GM,15,80,65,15,1
03-01-2025,"Health, Wellness & Ayurvedic Products",RB Max Protein DESI MASALA 60gm,5,45,45,0,1
03-01-2025,Oils & Ghee,Flaxseed oil 500 ml,9,300,270,30,1
03-01-2025,Personal Care & Cosmetics,GA DANT MANJAN TP 50GM,10,60,60,0,1
03-01-2025,Snacks & Ready-to-Eat,Sprouted Ragi Biscuits 450GM,14,150,150,0,1
03-01-2025,"Health, Wellness & Ayurvedic Products",RB Max Protein Chinese Manchurian,5,45,45,0,1
03-01-2025,"Dry Fruits, Nuts & Seeds",FLAX SEEDS 250GM,2,60,50,10,1
03-01-2025,Personal Care & Cosmetics,ES POCKET COMB,10,50,50,0,1
03-01-2025,Snacks & Ready-to-Eat,GANTASALA KARIVEPAKU SNACKS,14,60,60,0,1
03-01-2025,"Dry Fruits, Nuts & Seeds",LION SULTAN DATES 500GM,2,136,136,0,1
03-01-2025,Snacks & Ready-to-Eat,VD BOONDI 175GM,14,60,60,0,1
03-01-2025,"Dry Fruits, Nuts & Seeds",CASHEW 250GM,2,340,310,30,1
03-01-2025,"Grains, Flours & Dals",CORN FOUR 250GM,4,40,35,5,1
03-01-2025,"Grains, Flours & Dals",DESI CHANA,4,25,25,0,1
03-01-2025,Snacks & Ready-to-Eat,RSC ORANGE 100GMS,14,60,60,0,3
03-01-2025,"Grains, Flours & Dals",Chana Flour 500 gms,4,70,65,5,1
03-01-2025,"Grains, Flours & Dals",White Batani 250GM,4,40,30,10,1
03-01-2025,"Grains, Flours & Dals",PESARA PAPPU 500GMS,4,85,75,10,1
03-01-2025,"Grains, Flours & Dals",White Chana 250 GM,4,60,50,10,1
03-01-2025,"Grains, Flours & Dals",Multigrain 1 kg,4,100,85,15,1
03-01-2025,"Grains, Flours & Dals",Wheat Flour 1 kg,4,140,120,20,2
03-01-2025,"Health, Wellness & Ayurvedic Products",MD Pippalla Churnam 30GM,5,150,150,0,1
03-01-2025,Personal Care & Cosmetics,INDICA EASY,10,30,30,0,1
03-01-2025,"Grains, Flours & Dals",turdal 500 gms,4,110,100,10,1
03-01-2025,"Dry Fruits, Nuts & Seeds",PUMPKIN SEEDS 250GM,2,200,160,40,1
03-01-2025,"Grains, Flours & Dals",RAGI FLOUR 1KG,4,80,70,10,1
03-01-2025,"Grains, Flours & Dals",Bombay Rava 500GM,4,35,30,5,1
03-01-2025,"Grains, Flours & Dals",COW B rice 1 kg,4,144,138,6,2
03-01-2025,"Grains, Flours & Dals",Wheat Rava M 500GM,4,33,30,3,1
03-01-2025,Snacks & Ready-to-Eat,SUNNUNDALU,14,120,120,0,1
03-01-2025,Oils & Ghee,Sesame oil 1 L,9,590,560,30,1
03-01-2025,Snacks & Ready-to-Eat,VD PAPPU CHEGODI 200GM,14,60,60,0,1
03-01-2025,Spices & Seasonings,Dalchin Chekka 50GM,15,50,40,10,1
03-01-2025,"Grains, Flours & Dals",RICE FLOUR 500 GM,4,70,56,14,2
03-01-2025,Oils & Ghee,Castor oil 200 ml,9,400,320,80,4
03-01-2025,Oils & Ghee,Coconut oil 1 L,9,440,400,40,1
03-01-2025,"Health, Wellness & Ayurvedic Products",SHIKAKAI CHOORNAM,5,320,320,0,4
03-01-2025,Personal Care & Cosmetics,UVIS MULTANI MITTI 200GM,10,90,90,0,1
03-01-2025,Oils & Ghee,Groundnut oil 1 L,9,360,330,30,1
03-01-2025,Spices & Seasonings,ROYAL SAFFRON,15,125,125,0,1
03-01-2025,Spices & Seasonings,AVALU 100GM,15,25,20,5,1
03-01-2025,"Health, Wellness & Ayurvedic Products",GS Wheat Grass Powder 100GMS,5,349,349,0,1
03-01-2025,Oils & Ghee,Sesame oil 1 L,9,590,560,30,1
03-01-2025,Oils & Ghee,Mustard oil 500 ml,9,220,195,25,1
03-01-2025,"Grains, Flours & Dals",Urad dall 500 gms,4,95,85,10,1
03-01-2025,"Dry Fruits, Nuts & Seeds",Groundnuts 1 kg,2,190,170,20,1
03-01-2025,"Grains, Flours & Dals",BASMATHI RICE 1KG,4,150,135,15,1
03-01-2025,Sweeteners,PN ORGANIC BROWN SUGAR 500GM,16,78,78,0,1
03-01-2025,Spices & Seasonings,PN ORGANIC PINK SALT 1KG,15,124,124,0,1
03-01-2025,Oils & Ghee,ANURAG RB OIL,9,120,100,20,1
03-01-2025,Sweeteners,PN ORGANIC JAGGERY POWDER 400GM,16,86,86,0,1
03-01-2025,"Grains, Flours & Dals",SL Idly Rava 1KG,4,65,55,10,1
03-01-2025,Spices & Seasonings,TM MIRCH POWDER 200GM,15,163,163,0,1
03-01-2025,Spices & Seasonings,NUVVULU 250GM,15,100,85,15,1
03-01-2025,Oils & Ghee,Cow ghee 500 ml,9,430,390,40,1
03-01-2025,Sweeteners,MADHUR SUGAR 1KG,16,130,110,20,2
03-01-2025,"Grains, Flours & Dals",THICK POHA 500GM,4,40,35,5,1
03-01-2025,"Grains, Flours & Dals",White Chana 250 GM,4,60,50,10,1
03-01-2025,"Grains, Flours & Dals",VL Sabdana 500GM,4,77,77,0,1
03-01-2025,"Grains, Flours & Dals",FLOUR CHARGE,4,14.4,14.4,0,1.2
03-01-2025,Oils & Ghee,Sesame oil 500ml,9,295,280,15,1
03-01-2025,Beverages,BRU GREEN LABEL 200G,1,300,300,0,2
03-01-2025,Snacks & Ready-to-Eat,TILLI CHIKKI,14,30,30,0,6
03-01-2025,Snacks & Ready-to-Eat,GB SALT COOKIES,14,60,55,5,1
03-01-2025,Snacks & Ready-to-Eat,VD RICE SAGO PAPAD 150GM,14,55,55,0,1
03-01-2025,"Dry Fruits, Nuts & Seeds",SD Mango cubes 200gm,2,90,90,0,1
03-01-2025,Snacks & Ready-to-Eat,BD BARELY NOODLES 200G,14,70,70,0,1
03-01-2025,Pooja & Spiritual Items,GOMATHA AGARBATHI,12,75,75,0,1
03-01-2025,"Grains, Flours & Dals",HS jowar idly rava 500 gms,4,65,65,0,1
03-01-2025,Pooja & Spiritual Items,GD Aiswarya Deepam 700ML,12,195,195,0,1
03-01-2025,"Health, Wellness & Ayurvedic Products",MH Womens Malt 500GM,5,250,240,10,1
03-01-2025,Pooja & Spiritual Items,HERBAL PATCHOULI STICKS 20INC,12,45,45,0,1
03-01-2025,Oils & Ghee,Black Sesame oil 1 L,9,440,380,60,1
03-01-2025,"Grains, Flours & Dals",PRO SOYA CHUNKS 200G,4,79,79,0,1
03-01-2025,Snacks & Ready-to-Eat,SD Ginger Candy 100g,14,60,60,0,1
03-01-2025,Pooja & Spiritual Items,V GUGGILAM 50GM,12,45,45,0,1
03-01-2025,Snacks & Ready-to-Eat,SS IDLY BATTER 1KG,14,60,60,0,1
03-01-2025,Personal Care & Cosmetics,BAMBOO TOOTH BRUSH,10,100,100,0,2
03-01-2025,"Grains, Flours & Dals",turdal 500 gms,4,110,100,10,1
03-01-2025,Oils & Ghee,Groundnut oil 1 L,9,360,330,30,1
03-01-2025,"Grains, Flours & Dals",Bajra Flour 1 kg,4,70,60,10,1
03-01-2025,Milk & Dairy,HERITAGE CURD,7,48,48,0,1
03-01-2025,Personal Care & Cosmetics,TOUNGE CLEANER,10,10,10,0,1
03-01-2025,Personal Care & Cosmetics,KHADI LIME FRESH 125 GM,10,80,80,0,1
03-01-2025,Personal Care & Cosmetics,BAMBOO TOOTH BRUSH,10,120,120,0,1
03-01-2025,"Health, Wellness & Ayurvedic Products",MH Millets Malt 500GM,5,200,190,10,1
03-01-2025,Personal Care & Cosmetics,SVE MULTANI MITTI SOAP 100GM,10,90,90,0,1
03-01-2025,Oils & Ghee,Sesame oil 1 L,9,590,560,30,1
03-01-2025,Oils & Ghee,GANTASALA A2 COW GHEE 500ML,9,550,550,0,1
03-01-2025,"Grains, Flours & Dals",PESARA PAPPU 500GMS,4,85,75,10,1
03-01-2025,Pooja & Spiritual Items,GOMATHA AGARBATHI,12,75,75,0,1
03-01-2025,"Grains, Flours & Dals",VYS.SP RICE 1 KG,4,280,260,20,4
03-01-2025,Oils & Ghee,Coconut oil 1 L,9,440,400,40,1
03-01-2025,Snacks & Ready-to-Eat,SESAME CHIKKI,14,240,200,40,2
03-01-2025,Oils & Ghee,Groundnut oil 1 L,9,360,330,30,1
03-01-2025,Snacks & Ready-to-Eat,SATHVI MIXED CHIKKI 200GM,14,120,100,20,1
03-01-2025,"Grains, Flours & Dals",split urad dall 500 gms,4,90,80,10,1
03-01-2025,"Grains, Flours & Dals",split black gram 1 kg,4,180,170,10,1
03-01-2025,"Grains, Flours & Dals",Urad dall 1 Kg,4,185,170,15,1
03-01-2025,"Grains, Flours & Dals",FLOUR CHARGE,4,22.8,22.8,0,1.9
03-01-2025,Spices & Seasonings,DB CRYSTAL SALT 1KG,15,25,25,0,1
03-01-2025,Snacks & Ready-to-Eat,VD ARISELU 5 PIC,14,100,100,0,1
03-01-2025,Snacks & Ready-to-Eat,MARMURA LADDU,14,80,60,20,1
03-01-2025,Spices & Seasonings,ROYAL SAFFRON 400GRMS,15,65,65,0,1
03-01-2025,"Grains, Flours & Dals",SRILATHA RICE RAVVA 500GM,4,35,35,0,1
03-01-2025,"Grains, Flours & Dals",SL Idly Rava 1KG,4,65,55,10,1
03-01-2025,Spices & Seasonings,Dry Mirchi 200 gms,15,80,60,20,1
03-01-2025,"Grains, Flours & Dals",RICE FLOUR 500 GM,4,35,28,7,1
03-01-2025,"Grains, Flours & Dals",RICE FLOUR 1KG,4,70,50,20,1
03-01-2025,"Grains, Flours & Dals",turdal 1kg,4,220,195,25,1
03-01-2025,Household & Cleaning,ROOPERI PITAMBARI SILVER 50ML,6,110,110,0,1
03-01-2025,Sweeteners,GS Palm Jaggery Powder 400GM,16,180,180,0,1
03-01-2025,"Grains, Flours & Dals",RAGI FLOUR 500GRMS,4,40,35,5,1
03-01-2025,"Grains, Flours & Dals",Wheat Flour 1 kg,4,70,60,10,1
03-01-2025,"Dry Fruits, Nuts & Seeds",ALBUKARA 250GM,2,145,120,25,1
03-01-2025,"Grains, Flours & Dals",CHANA DAL 500GM,4,70,60,10,1
03-01-2025,"Grains, Flours & Dals",SRILALITHA MAIDA FLOUR 500G,4,32,32,0,1
03-01-2025,Spices & Seasonings,Telaga Pindi 250 GM,15,40,35,5,1
03-01-2025,Pooja & Spiritual Items,GD Aiswarya Deepam 700ML,12,195,195,0,1
03-01-2025,"Dry Fruits, Nuts & Seeds",PUTNALU 500GMS,2,90,76,14,1
03-01-2025,Snacks & Ready-to-Eat,SESAME LADDU 200GM,14,100,80,20,1
03-01-2025,Spices & Seasonings,YB PINK ROCK SALT 1KG,15,120,120,0,1
03-01-2025,Snacks & Ready-to-Eat,PALLI LADDU 200GMS,14,90,70,20,1
03-01-2025,Pooja & Spiritual Items,GD Aiswarya Deepam 700ML,12,390,390,0,2
03-01-2025,Snacks & Ready-to-Eat,TILLI CHIKKI,14,5,5,0,1
03-01-2025,Snacks & Ready-to-Eat,ANNAPURNA APPALAM,14,70,70,0,2
03-01-2025,Milk & Dairy,HERITAGE CURD,7,48,48,0,1
03-01-2025,Sweeteners,SUGAR 500GM,16,30,25,5,1
03-01-2025,"Grains, Flours & Dals",turdal 500 gms,4,110,100,10,1
03-01-2025,Snacks & Ready-to-Eat,BATANA NGT 70GMS,14,20,20,0,1
03-01-2025,"Grains, Flours & Dals",WHEAT 1 KG,4,300,250,50,5
03-01-2025,"Grains, Flours & Dals",RAGI FLOUR 500GRMS,4,40,35,5,1
03-01-2025,"Grains, Flours & Dals",Bajra Flour 500 gms,4,35,30,5,1
03-01-2025,"Grains, Flours & Dals",FLOUR CHARGE,4,60,60,0,5
03-01-2025,General Household & Kitchenware,COMFY SNUG FIT XL +50MM,3,30,30,0,1
03-01-2025,Personal Care & Cosmetics,COLGATE ACTIVE SALT,10,20,20,0,1
03-01-2025,Oils & Ghee,Coconut oil 500 ml,9,220,200,20,1
03-01-2025,"Grains, Flours & Dals",VYS.SP.RICE BAG 1,4,1800,"1,650.00",150,1
03-01-2025,Spices & Seasonings,Elaichi 25GM,15,145,120,25,1
03-01-2025,Spices & Seasonings,ROYAL SAFFRON 400GRMS,15,130,130,0,2
03-01-2025,"Grains, Flours & Dals",FLOUR CHARGE,4,32,32,0,1
03-01-2025,"Grains, Flours & Dals",FLOUR CHARGE,4,27.6,27.6,0,2.3
03-01-2025,Snacks & Ready-to-Eat,VD RED CHILLI RICEPAPAD 150GM,14,100,100,0,2
03-01-2025,Oils & Ghee,Coconut oil 500 ml,9,220,200,20,1
03-01-2025,Milk & Dairy,HERITAGE CURD,7,48,48,0,1
03-01-2025,"Grains, Flours & Dals",Red Chana 500 GM,4,75,60,15,1
03-01-2025,Oils & Ghee,Groundnut oil 1 L,9,360,330,30,1
03-01-2025,Oils & Ghee,Coconut oil 1 L,9,440,400,40,1
03-01-2025,"Grains, Flours & Dals",THICK POHA 1KG,4,80,70,10,1
03-01-2025,Personal Care & Cosmetics,GAYATHRI KUMKUDUKAYA,10,150,150,0,1
03-01-2025,Spices & Seasonings,Marati Magga 50GM,15,130,110,20,1
03-01-2025,Household & Cleaning,SURFEXCEL BAR 80G,6,40,40,0,4
03-01-2025,Oils & Ghee,Coconut oil 500 ml,9,220,200,20,1
03-01-2025,Sweeteners,SUGAR 1KG,16,120,100,20,2
03-01-2025,"Dry Fruits, Nuts & Seeds",Groundnuts 500 gms,2,190,170,20,2
03-01-2025,"Grains, Flours & Dals",Urad dall 500 gms,4,95,85,10,1
03-01-2025,Spices & Seasonings,Japatri 25GM,15,100,80,20,1
03-01-2025,Spices & Seasonings,RED COPRA 250GMS,15,85,74,11,1
03-01-2025,Spices & Seasonings,ROYAL SAFFRON 400GRMS,15,65,65,0,1
03-01-2025,Spices & Seasonings,AVALU 100GM,15,25,20,5,1
03-01-2025,"Grains, Flours & Dals",HS Multimillet upma r 500g,4,130,130,0,2
03-01-2025,Snacks & Ready-to-Eat,ZEEDI,14,70,70,0,1
03-01-2025,"Grains, Flours & Dals",Wheat Rava M 1KG,4,130,110,20,2
03-01-2025,Oils & Ghee,Groundnut oil 1 L,9,1080,990,90,3
03-01-2025,Household & Cleaning,VIM EXTRA 110GM,6,50,50,0,5
03-01-2025,Spices & Seasonings,Dry Mirchi 200 gms,15,80,60,20,1
03-01-2025,"Grains, Flours & Dals",turdal 500 gms,4,110,100,10,1
03-01-2025,Snacks & Ready-to-Eat,Popcorn Seeds 500GM,14,90,80,10,1
03-01-2025,Oils & Ghee,Black Sesame oil 500 ml,9,220,190,30,1
03-01-2025,"Grains, Flours & Dals",SL Idly Rava 1KG,4,65,55,10,1
03-01-2025,Spices & Seasonings,Jeera 100GM,15,50,45,5,1
03-01-2025,Spices & Seasonings,AVALU 100GM,15,25,20,5,1
03-01-2025,"Dry Fruits, Nuts & Seeds",Groundnuts 500 gms,2,95,85,10,1
03-01-2025,"Grains, Flours & Dals",White jowar.F 1 kg,4,200,160,40,2
03-01-2025,"Grains, Flours & Dals",VGR rice 1 kg,4,140,130,10,2
03-01-2025,Beverages,TATA CHAKRA GOLD PT 120GM,1,90,90,0,1
03-01-2025,Oils & Ghee,Groundnut oil 1 L,9,360,330,30,1
03-01-2025,"Grains, Flours & Dals",RICE FLOUR 500 GM,4,70,56,14,2
03-01-2025,"Grains, Flours & Dals",Chana Flour 500 gms,4,140,130,10,2
03-01-2025,"Grains, Flours & Dals",RAGI FLOUR 500GRMS,4,40,35,5,1
03-01-2025,Milk & Dairy,BROWN EGGS 1P,7,140,120,20,10
03-01-2025,Milk & Dairy,SANGAM FULL CREAM MILK 500ML,7,38,38,0,1
03-01-2025,"Grains, Flours & Dals",Em little upma R 500g,4,129,129,0,1
03-01-2025,"Grains, Flours & Dals",EM Foxtail idli r 500 g,4,109,109,0,1
03-01-2025,"Grains, Flours & Dals",EM kodo upma R 500g,4,129,129,0,1
03-01-2025,Oils & Ghee,Groundnut oil 1 L,9,360,330,30,1
03-01-2025,"Grains, Flours & Dals",SA Multi Grain Mix 500GM,4,159,159,0,1
03-01-2025,Personal Care & Cosmetics,BAMBOO TOOTH BRUSH,10,50,50,0,1
03-01-2025,Sweeteners,YB JAGGERY POWDER 500GMS,16,150,150,0,2
03-01-2025,Personal Care & Cosmetics,HIMALAYA LIP BALM 10GM,10,40,40,0,1
03-01-2025,"Grains, Flours & Dals",Red Wheat Flour 1 kg,4,140,130,10,1
03-01-2025,Personal Care & Cosmetics,COLGATE STRONG TEETH,10,20,20,0,1
03-01-2025,Personal Care & Cosmetics,HIMALAYA LIP BALM 10GM,10,40,40,0,1
03-01-2025,Personal Care & Cosmetics,DABUR AMLA,10,97,97,0,1
03-01-2025,Household & Cleaning,SURF EXCEL 150GM,6,20,20,0,1
03-01-2025,Snacks & Ready-to-Eat,KURNOOL MARMURA,14,70,55,15,1
03-01-2025,"Grains, Flours & Dals",VGR rice 1 kg,4,210,195,15,3
03-01-2025,"Dry Fruits, Nuts & Seeds",PULMAKHANA 100 GM,2,180,170,10,1
03-01-2025,Spices & Seasonings,BLACK JEERA 50 GM,15,45,30,15,1
03-01-2025,Beverages,BRU GREEN LABEL 1.2G,1,24,24,0,12
03-01-2025,"Grains, Flours & Dals",AISHWARYA SP 1KG,4,80,75,5,1
03-01-2025,"Grains, Flours & Dals",Wheat Flour 1 kg,4,70,60,10,1
03-01-2025,"Grains, Flours & Dals",Sathya Javva Wheat Rava 500GM,4,95,95,0,1
03-01-2025,Pooja & Spiritual Items,GOMATHA AGARBATHI,12,75,75,0,1
03-01-2025,"Dry Fruits, Nuts & Seeds",GF DATES 500GM,2,156,149,7,1
03-01-2025,Oils & Ghee,Safflower oil 1 L,9,440,400,40,1
03-01-2025,Beverages,GANTASALA TEJ DRY GINGER COFFEE,1,149,149,0,1
03-01-2025,Spices & Seasonings,SATHVI BIRYANI LEAF 25GM,15,30,20,10,1
03-01-2025,Snacks & Ready-to-Eat,VD SAGOPAPAD 150GM,14,55,55,0,1
03-01-2025,Snacks & Ready-to-Eat,MARMURA LADDU,14,80,60,20,1
03-01-2025,Snacks & Ready-to-Eat,Corn Chips 250GM,14,80,70,10,2
03-01-2025,Sweeteners,Natural Honey 1 kg,16,560,480,80,1
03-01-2025,Milk & Dairy,BROWN EGGS 1P,7,84,72,12,6
03-01-2025,Snacks & Ready-to-Eat,PALLI LADDU 200GMS,14,90,70,20,1
03-01-2025,Snacks & Ready-to-Eat,SATHVI MIXED CHIKKI 200GM,14,120,100,20,1
03-01-2025,Milk & Dairy,BROWN EGGS 1P,7,168,144,24,12
03-01-2025,Oils & Ghee,Safflower oil 1 L,9,440,400,40,1
03-01-2025,"Grains, Flours & Dals",RAGULU 1 KG,4,35,30,5,0.5
03-01-2025,Spices & Seasonings,Elaichi 25GM,15,145,120,25,1
03-01-2025,Spices & Seasonings,Lavangam 50GM,15,60,50,10,1
03-01-2025,Spices & Seasonings,Dalchin Chekka 50GM,15,50,40,10,1
03-01-2025,"Grains, Flours & Dals",White jowar.F 1 kg,4,100,80,20,1
03-01-2025,"Grains, Flours & Dals",JOWAR WHITE 1 KG,4,40,35,5,0.5
03-01-2025,Spices & Seasonings,Japatri 25GM,15,100,80,20,1
03-01-2025,Spices & Seasonings,Miriyalu 50GM,15,100,80,20,1
03-01-2025,"Dry Fruits, Nuts & Seeds",PULMAKHANA 100 GM,2,180,170,10,1
02-01-2025,"Grains, Flours & Dals",Urad dall 500 gms,4,95,85,10,1
02-01-2025,Pooja & Spiritual Items,GD Dhoop Sticks 26GM,12,20,20,0,1
02-01-2025,Snacks & Ready-to-Eat,SATHVI MIXED CHIKKI 200GM,14,120,100,20,1
02-01-2025,"Dry Fruits, Nuts & Seeds",Groundnuts 500 gms,2,95,85,10,1
02-01-2025,"Dry Fruits, Nuts & Seeds",Groundnuts 1 kg,2,190,170,20,1
02-01-2025,"Grains, Flours & Dals",PESARA PAPPU 1 KG,4,170,145,25,1
02-01-2025,Oils & Ghee,Groundnut oil 1 L,9,360,330,30,1
02-01-2025,"Grains, Flours & Dals",Bombay Rava 500GM,4,35,30,5,1
02-01-2025,Sweeteners,YB Brown Sugar 1KG,16,140,140,0,1
02-01-2025,"Grains, Flours & Dals",turdal 1kg,4,440,390,50,2
02-01-2025,"Dry Fruits, Nuts & Seeds",WATERMELON SEEDS 250GRM,2,320,280,40,1
02-01-2025,"Dry Fruits, Nuts & Seeds",PUMPKIN SEEDS 250GM,2,200,160,40,1
02-01-2025,Snacks & Ready-to-Eat,MILK BREAD,14,30,30,0,1
02-01-2025,"Grains, Flours & Dals",UDALU (Barnyard millet) 1 kg,4,140,115,25,1
02-01-2025,"Dry Fruits, Nuts & Seeds",FLAX SEEDS 250GM,2,60,50,10,1
02-01-2025,"Dry Fruits, Nuts & Seeds",SABJA SEEDS 100GM,2,80,70,10,1
02-01-2025,"Dry Fruits, Nuts & Seeds",PULMAKHANA 100 GM,2,180,170,10,1
02-01-2025,"Grains, Flours & Dals",CHANA DAL 500GM,4,70,60,10,1
02-01-2025,Spices & Seasonings,PURO Healthy Salt 1KG,15,110,110,0,1
02-01-2025,Spices & Seasonings,Lavangam 50GM,15,60,50,10,1
02-01-2025,"Health, Wellness & Ayurvedic Products",RB Max Protein Chinese Manchurian,5,45,45,0,1
02-01-2025,Snacks & Ready-to-Eat,PALLI LADDU 200GMS,14,90,70,20,1
02-01-2025,"Grains, Flours & Dals",Arikadu ( kodo),4,140,110,30,1
02-01-2025,Snacks & Ready-to-Eat,SD Moringa with plam jaggery 250gm,14,135,135,0,1
02-01-2025,"Grains, Flours & Dals",ANDU KORRALU (Browntop.m) 1 kg,4,320,290,30,1
02-01-2025,"Grains, Flours & Dals",KORRALU (FOXTAIL M) 1KG,4,140,110,30,1
02-01-2025,"Grains, Flours & Dals",UDALU (Barnyard millet) 1 kg,4,140,115,25,1
02-01-2025,"Grains, Flours & Dals",SAMALU (Little millet) 1 kg,4,170,130,40,1
02-01-2025,Household & Cleaning,GAJANAND BLACK DRAGN 10STI,6,80,80,0,4
02-01-2025,Oils & Ghee,Black Sesame oil 500 ml,9,220,190,30,1
02-01-2025,Snacks & Ready-to-Eat,VD DRY FRUIT PUTHAREKULU,14,120,120,0,1
02-01-2025,Personal Care & Cosmetics,COW DURBAR 7 HERBS SHAMPOO,10,125,125,0,1
02-01-2025,"Grains, Flours & Dals",RAJMA 250GM,4,55,45,10,1
02-01-2025,"Grains, Flours & Dals",turdal 1kg,4,220,195,25,1
02-01-2025,Snacks & Ready-to-Eat,COPRA LADDU 200GM,14,100,80,20,1
02-01-2025,Snacks & Ready-to-Eat,BROWN BREAD,14,55,55,0,1
02-01-2025,"Grains, Flours & Dals",Bombay Rava 500GM,4,35,30,5,1
02-01-2025,Spices & Seasonings,NUVVULU 250GM,15,80,70,10,1
02-01-2025,"Dry Fruits, Nuts & Seeds",Putnalu 250GM,2,45,38,7,1
02-01-2025,"Grains, Flours & Dals",Wheat Flour 1 kg,4,70,60,10,1
02-01-2025,"Grains, Flours & Dals",PESARA PAPPU 500GMS,4,85,75,10,1
02-01-2025,Snacks & Ready-to-Eat,JUNNU POWDER 100GM,14,70,70,0,1
02-01-2025,Spices & Seasonings,JEERA 250 gms,15,125,105,20,1
02-01-2025,"Grains, Flours & Dals",Urad dall 500 gms,4,95,85,10,1
02-01-2025,Personal Care & Cosmetics,OVAL BODY LOOFAH,10,55,55,0,1
02-01-2025,"Dry Fruits, Nuts & Seeds",Groundnuts 1 kg,2,190,170,20,1
02-01-2025,Snacks & Ready-to-Eat,BB VERMICELLY 500GM,14,53,53,0,1
02-01-2025,Oils & Ghee,Sesame oil 500ml,9,295,280,15,1
02-01-2025,Sweeteners,YB Brown Sugar 500GM,16,75,75,0,1
02-01-2025,Personal Care & Cosmetics,MADDI BATH POWDER 400GM,10,450,420,30,3
02-01-2025,Pooja & Spiritual Items,GB Bharatha Woods 75GM,12,120,120,0,2
02-01-2025,Snacks & Ready-to-Eat,KURNOOL MARMURA,14,70,55,15,1
02-01-2025,"Dry Fruits, Nuts & Seeds",Groundnuts 500 gms,2,95,85,10,1
02-01-2025,Snacks & Ready-to-Eat,SD High Protein Laddu 175gm,14,190,190,0,1
02-01-2025,Snacks & Ready-to-Eat,ZEEDI,14,70,70,0,1
02-01-2025,Snacks & Ready-to-Eat,COPRA LADDU 200GM,14,100,80,20,1
02-01-2025,Household & Cleaning,GAJANAND BLACK DRAGN 10STI,6,40,40,0,2
02-01-2025,"Grains, Flours & Dals",THICK POHA 1KG,4,80,70,10,1
02-01-2025,Milk & Dairy,BROWN EGGS 1P,7,280,240,40,20
02-01-2025,Personal Care & Cosmetics,BAMBOO TOOTH BRUSH,10,50,50,0,1
02-01-2025,Personal Care & Cosmetics,KAIPO NONI TP 100GM,10,90,90,0,1
02-01-2025,Personal Care & Cosmetics,COLGATE STRONG TEETH,10,20,20,0,1
02-01-2025,General Household & Kitchenware,4MM DOSA TAWA 12,3,460,460,0,1
02-01-2025,Oils & Ghee,Groundnut oil 1 L,9,360,330,30,1
02-01-2025,Snacks & Ready-to-Eat,SATHVI MIXED CHIKKI 200GM,14,120,100,20,1
02-01-2025,Oils & Ghee,Sesame oil 1 L,9,1180,"1,120.00",60,2
02-01-2025,"Grains, Flours & Dals",Multigrain 1 kg,4,100,85,15,1
02-01-2025,"Grains, Flours & Dals",VL Sabdana 500GM,4,77,77,0,1
02-01-2025,Snacks & Ready-to-Eat,VD MIXTURE 175 GM,14,60,60,0,1
02-01-2025,Snacks & Ready-to-Eat,URBAN MARMURA 450GM,14,60,55,5,1
02-01-2025,Snacks & Ready-to-Eat,ZEEDI,14,70,70,0,1
02-01-2025,"Grains, Flours & Dals",Em little upma R 500g,4,129,129,0,1
02-01-2025,Sweeteners,Mishri 250 GM,16,35,30,5,1
02-01-2025,"Grains, Flours & Dals",SA WHITE JOWAR RAVA 500GM,4,69,69,0,1
02-01-2025,"Grains, Flours & Dals",DESI CHANA,4,50,50,0,2
02-01-2025,"Dry Fruits, Nuts & Seeds",Groundnuts 500 gms,2,95,85,10,1
02-01-2025,"Grains, Flours & Dals",Em Multimillet idli r 500g,4,129,129,0,1
02-01-2025,Snacks & Ready-to-Eat,SALTED PHALLI,14,65,65,0,1
02-01-2025,"Grains, Flours & Dals",DOCTOR RICE DIABETIC SFR 1KG,4,360,360,0,3
02-01-2025,"Grains, Flours & Dals",HS JOWAR FLAKES 250GM 1+1,4,59,59,0,1
02-01-2025,"Grains, Flours & Dals",Green gram 500 gms,4,75,70,5,1
02-01-2025,Spices & Seasonings,Masala Karam 500 gms,15,260,240,20,1
02-01-2025,Snacks & Ready-to-Eat,SUNNUNDALU,14,120,120,0,1
02-01-2025,"Health, Wellness & Ayurvedic Products",RB Nuts& Seeds cashews 35g,5,135,135,0,3
02-01-2025,"Grains, Flours & Dals",Red Chana 250GM,4,35,30,5,1
02-01-2025,"Dry Fruits, Nuts & Seeds",Groundnuts 500 gms,2,95,85,10,1
02-01-2025,Spices & Seasonings,Menthulu 250 gms,15,50,45,5,1
02-01-2025,"Grains, Flours & Dals",Multigrain 1 kg,4,100,85,15,1
02-01-2025,"Grains, Flours & Dals",Wheat Flour 1 kg,4,140,120,20,2
02-01-2025,"Dry Fruits, Nuts & Seeds",PUMPKIN SEEDS 250GM,2,200,160,40,1
02-01-2025,Sweeteners,SH JAGGERY POWDER 500GM,16,160,160,0,2
02-01-2025,Oils & Ghee,Groundnut oil 1 L,9,360,330,30,1
02-01-2025,Spices & Seasonings,SWEET SOUNF,15,20,20,0,1
02-01-2025,Spices & Seasonings,Turmeric powder 500 gms,15,200,130,70,1
02-01-2025,Milk & Dairy,BROWN EGGS TRAY 30P,7,360,330,30,1
02-01-2025,Beverages,RED LABEL NATURAL CARE 100G,1,65,65,0,1
02-01-2025,Beverages,BRU GREEN LABEL 1.2G,1,24,24,0,12
02-01-2025,Oils & Ghee,Groundnut oil 1 L,9,360,330,30,1
02-01-2025,Milk & Dairy,BROWN EGGS TRAY 30P,7,360,330,30,1
02-01-2025,Snacks & Ready-to-Eat,MARMURA LADDU,14,80,60,20,1
02-01-2025,Oils & Ghee,BUFFALLO GHEE 500ML,9,410,370,40,1
02-01-2025,"Dry Fruits, Nuts & Seeds",SD Mango cubes 100gm,2,45,45,0,1
02-01-2025,Snacks & Ready-to-Eat,KHARJURAM DRY FRUIT LADDU,14,180,180,0,1
02-01-2025,Snacks & Ready-to-Eat,SUNNUNDALU 200GM,14,120,100,20,1
02-01-2025,Milk & Dairy,TOTAL CURD 50GMS,7,10,10,0,1
02-01-2025,"Grains, Flours & Dals",FLOUR CHARGE,4,60,60,0,5
02-01-2025,"Grains, Flours & Dals",SRILALITHA MAIDA FLOUR 500G,4,32,32,0,1
02-01-2025,Spices & Seasonings,SAJEERA,15,60,40,20,1
02-01-2025,"Grains, Flours & Dals",Urad dall 1 Kg,4,185,170,15,1
02-01-2025,"Grains, Flours & Dals",CHANA DAL 500GM,4,70,60,10,1
02-01-2025,Spices & Seasonings,Menthulu 250 gms,15,50,45,5,1
02-01-2025,"Grains, Flours & Dals",CORN FOUR 250GM,4,40,35,5,1
02-01-2025,"Dry Fruits, Nuts & Seeds",Groundnuts 1 kg,2,190,170,20,1
02-01-2025,Sweeteners,SUGAR 1KG,16,60,50,10,1
02-01-2025,Spices & Seasonings,SATHVI SONTI 50GM,15,30,20,10,1
02-01-2025,Sweeteners,Mishri 250 GM,16,35,30,5,1
02-01-2025,"Grains, Flours & Dals",Wheat Rava M 1KG,4,65,55,10,1
02-01-2025,"Grains, Flours & Dals",Bombay Rava 500GM,4,35,30,5,1
02-01-2025,Spices & Seasonings,SATHVI BIRYANI LEAF 25GM,15,30,20,10,1
02-01-2025,"Grains, Flours & Dals",turdal 1kg,4,220,195,25,1
02-01-2025,Spices & Seasonings,SATHVI GREEN SOUNF 100GM,15,60,40,20,1
02-01-2025,Spices & Seasonings,Marati Magga 50GM,15,130,110,20,1
02-01-2025,"Dry Fruits, Nuts & Seeds",DRIED KIWI 200GM,2,145,130,15,1
02-01-2025,"Grains, Flours & Dals",PESARA PAPPU 500GMS,4,85,75,10,1
02-01-2025,"Grains, Flours & Dals",Wheat Flour 1 kg,4,140,120,20,2
02-01-2025,"Grains, Flours & Dals",Multigrain 1 kg,4,100,85,15,1
02-01-2025,"Grains, Flours & Dals",Wheat Flour 1 kg,4,70,60,10,1
02-01-2025,"Grains, Flours & Dals",FLOUR CHARGE,4,32.4,32.4,0,2.7
02-01-2025,"Grains, Flours & Dals",SRILALITHA MAIDA FLOUR 500G,4,32,32,0,1
02-01-2025,Pooja & Spiritual Items,SWASTIK CAMPHOR 25GM,12,45,45,0,1
02-01-2025,Pooja & Spiritual Items,GD Dhoop Cones 40GM,12,30,30,0,1
02-01-2025,Beverages,BRU GREEN LABEL 1.2G,1,72,72,0,36
02-01-2025,Pooja & Spiritual Items,GD Dhoop Sticks 26GM,12,20,20,0,1
02-01-2025,Sweeteners,YB FOREST HONEY 250GM,16,180,180,0,1
02-01-2025,Snacks & Ready-to-Eat,MIX MILLET NOODLES,14,75,75,0,1
02-01-2025,"Grains, Flours & Dals",MELMEKER 250GMS,4,60,45,15,1
02-01-2025,"Grains, Flours & Dals",DESI CHANA,4,25,25,0,1
02-01-2025,Snacks & Ready-to-Eat,VD BELLAM GAVVALU 200GM,14,60,60,0,1
02-01-2025,"Health, Wellness & Ayurvedic Products",RB Max Protein DESI MASALA 60gm,5,45,45,0,1
02-01-2025,Snacks & Ready-to-Eat,SF MILLET Noodles Mild Masala 192g,14,129,129,0,1
02-01-2025,Oils & Ghee,Groundnut oil 1 L,9,360,330,30,1
02-01-2025,Snacks & Ready-to-Eat,COPRA LADDU 200GM,14,100,80,20,1
02-01-2025,"Health, Wellness & Ayurvedic Products",MH Millets Malt 500GM,5,200,190,10,1
02-01-2025,"Grains, Flours & Dals",RAGI FLOUR 1KG,4,80,70,10,1
02-01-2025,"Grains, Flours & Dals",RICE FLOUR 500 GM,4,35,28,7,1
02-01-2025,Snacks & Ready-to-Eat,COPRA LADDU 200GM,14,100,80,20,1
02-01-2025,Snacks & Ready-to-Eat,VD ARISELU 5 PIC,14,100,100,0,1
02-01-2025,Snacks & Ready-to-Eat,SATHVI MIXED CHIKKI 200GM,14,120,100,20,1
02-01-2025,Snacks & Ready-to-Eat,VD MAIDA CHEGODI 175GM,14,60,60,0,1
02-01-2025,Snacks & Ready-to-Eat,VD MYSOREPAK 6PIC,14,100,100,0,1
02-01-2025,Oils & Ghee,Sesame oil 1 L,9,590,560,30,1
02-01-2025,Oils & Ghee,Safflower oil 1 L,9,440,400,40,1
02-01-2025,Milk & Dairy,SANGAM FULL CREAM MILK 500ML,7,76,76,0,2
02-01-2025,Snacks & Ready-to-Eat,PALLI LADDU 200GMS,14,90,70,20,1
02-01-2025,"Grains, Flours & Dals",RICE FLOUR 500 GM,4,70,56,14,2
02-01-2025,"Grains, Flours & Dals",HS JOWAR FLAKES 250GM 1+1,4,59,59,0,1
02-01-2025,Oils & Ghee,Groundnut oil 1 L,9,720,660,60,2
02-01-2025,"Grains, Flours & Dals",HS BARLEY FLAKES 250GM 1+1,4,59,59,0,1
02-01-2025,"Grains, Flours & Dals",DISANO ROLED OATS,4,197,197,0,1
02-01-2025,"Grains, Flours & Dals",PRO ORG DALIYA BROKEN WHEAT 500G,4,72,72,0,1
02-01-2025,Snacks & Ready-to-Eat,PALLI LADDU 200GMS,14,180,140,40,2
02-01-2025,Snacks & Ready-to-Eat,VD MYSOREPAK 6PIC,14,100,100,0,1
02-01-2025,Snacks & Ready-to-Eat,MARMURA LADDU,14,240,180,60,3
02-01-2025,Snacks & Ready-to-Eat,KURNOOL MARMURA,14,70,55,15,1
02-01-2025,"Dry Fruits, Nuts & Seeds",PRO ORG RAW PEANUTS 500GM,2,174,174,0,1
02-01-2025,Spices & Seasonings,AVALU 100GM,15,25,20,5,1
02-01-2025,Oils & Ghee,Safflower oil 500 ml,9,220,200,20,1
02-01-2025,Snacks & Ready-to-Eat,RAGI LADDU,14,120,120,0,1
02-01-2025,"Grains, Flours & Dals",PN ORGANIC URAD WHITE WHOLE 500GM,4,158,158,0,1
02-01-2025,Snacks & Ready-to-Eat,VD NUVULU CHEGODI 175GM,14,60,60,0,1
02-01-2025,Spices & Seasonings,Jeera 100GM,15,50,45,5,1
02-01-2025,Snacks & Ready-to-Eat,VD BELLAM GAVVALU 200GM,14,60,60,0,1
02-01-2025,"Grains, Flours & Dals",SRILATHA RICE RAVVA 500GM,4,35,35,0,1
02-01-2025,Snacks & Ready-to-Eat,VD MURUKU 175GM,14,60,60,0,1
02-01-2025,Snacks & Ready-to-Eat,VD RIBBON PAKODI 175GM,14,60,60,0,1
02-01-2025,Snacks & Ready-to-Eat,COPRA LADDU 200GM,14,100,80,20,1
02-01-2025,Snacks & Ready-to-Eat,SD Little Millet WITH PLAM JAGGERY,14,135,135,0,1
02-01-2025,"Dry Fruits, Nuts & Seeds",ALMONDS 250GM,2,560,520,40,2
02-01-2025,"Dry Fruits, Nuts & Seeds",WATERMELON SEEDS 250GRM,2,320,280,40,1
02-01-2025,Snacks & Ready-to-Eat,PEANUT CHIKKI 450GM,14,125,125,0,1
02-01-2025,"Dry Fruits, Nuts & Seeds",YELLOW KISHMISH 250GM,2,130,110,20,1
02-01-2025,"Dry Fruits, Nuts & Seeds",PULMAKHANA 100 GM,2,180,170,10,1
02-01-2025,"Dry Fruits, Nuts & Seeds",CASHEW 250GM,2,340,310,30,1
02-01-2025,"Grains, Flours & Dals",Multigrain 1 kg,4,100,85,15,1
02-01-2025,Spices & Seasonings,Gasagasalu 50GM,15,130,110,20,1
02-01-2025,"Grains, Flours & Dals",PN ORGANIC KALA CHANA 500GM,4,119,119,0,1
02-01-2025,"Dry Fruits, Nuts & Seeds",ANJEER 250GM,2,400,360,40,1
02-01-2025,"Grains, Flours & Dals",Wheat Flour 1 kg,4,70,60,10,1
02-01-2025,Oils & Ghee,Sesame oil 1 L,9,1180,"1,120.00",60,2
02-01-2025,"Grains, Flours & Dals",HS Ragi upma rava 500 gms,4,70,70,0,1
02-01-2025,Milk & Dairy,BROWN EGGS 1P,7,84,72,12,6
02-01-2025,Snacks & Ready-to-Eat,BD RAGI NOODLES,14,75,75,0,1
02-01-2025,"Grains, Flours & Dals",SB Javva Wheat Ravva 500GM,4,190,190,0,2
02-01-2025,"Dry Fruits, Nuts & Seeds",PULMAKHANA 100 GM,2,180,170,10,1
02-01-2025,Snacks & Ready-to-Eat,PN ORGANIC PUFFED RICE 200GM,14,55,55,0,1
02-01-2025,Snacks & Ready-to-Eat,DISANO MACARONI 400GM,14,55,55,0,1
02-01-2025,Snacks & Ready-to-Eat,MARMURA LADDU,14,160,120,40,2
02-01-2025,"Grains, Flours & Dals",RED TURDAL 500GM,4,75,70,5,1
02-01-2025,Beverages,BRU GREEN LABEL 1.2G,1,24,24,0,12
02-01-2025,"Grains, Flours & Dals",VL Sabdana 500GM,4,77,77,0,1
02-01-2025,"Grains, Flours & Dals",Multigrain 1 kg,4,100,85,15,1
02-01-2025,Oils & Ghee,Safflower oil 1 L,9,440,400,40,1
02-01-2025,Spices & Seasonings,Tamarind 250GMS,15,80,65,15,1
02-01-2025,"Grains, Flours & Dals",SB Javva Wheat Ravva 500GM,4,95,95,0,1
02-01-2025,Snacks & Ready-to-Eat,KHARJURAM DRY FRUIT LADDU,14,360,360,0,2
02-01-2025,Snacks & Ready-to-Eat,VD ARISELU 5 PIC,14,100,100,0,1
02-01-2025,Oils & Ghee,Groundnut oil 1 L,9,360,330,30,1
02-01-2025,Spices & Seasonings,Jeera 100GM,15,50,45,5,1
02-01-2025,Snacks & Ready-to-Eat,VD MINAPA SUNNUNDALU 12P,14,180,180,0,1
02-01-2025,Snacks & Ready-to-Eat,COPRA LADDU 200GM,14,100,80,20,1
02-01-2025,"Grains, Flours & Dals",VYS.SP RICE 1 KG,4,350,325,25,5
02-01-2025,"Grains, Flours & Dals",split black gram 500 gms,4,90,85,5,1
02-01-2025,"Grains, Flours & Dals",Multigrain 1 kg,4,100,85,15,1
02-01-2025,General Household & Kitchenware,SABEENA,3,30,30,0,1
02-01-2025,"Grains, Flours & Dals",Chana Flour 500 gms,4,70,65,5,1
02-01-2025,"Grains, Flours & Dals",RAGI FLOUR 500GRMS,4,40,35,5,1
02-01-2025,"Grains, Flours & Dals",VGR rice 1 kg,4,280,260,20,4
02-01-2025,Personal Care & Cosmetics,MYSORE SANDAL SOAP 75G,10,42,42,0,1
02-01-2025,Snacks & Ready-to-Eat,VD Pappu Chekkalu 190gm,14,60,60,0,1
02-01-2025,Snacks & Ready-to-Eat,COPRA LADDU 200GM,14,100,80,20,1
02-01-2025,Snacks & Ready-to-Eat,PALLI LADDU 200GMS,14,90,70,20,1
02-01-2025,Milk & Dairy,BROWN EGGS 1P,7,112,96,16,8
02-01-2025,Milk & Dairy,BROWN EGGS 1P,7,140,120,20,10
02-01-2025,Spices & Seasonings,Tamarind 250GMS,15,160,130,30,2
02-01-2025,Milk & Dairy,BROWN EGGS 1P,7,84,72,12,6
02-01-2025,"Grains, Flours & Dals",VYS.SP RICE 1 KG,4,210,195,15,3
02-01-2025,Snacks & Ready-to-Eat,SD Thati thandra 200gm,14,150,150,0,1
02-01-2025,Oils & Ghee,Groundnut oil 1 L,9,360,330,30,1
02-01-2025,"Health, Wellness & Ayurvedic Products",HARITHAKI CHOORNAM,5,60,60,0,1
02-01-2025,"Grains, Flours & Dals",YB Red RICE 1 KG,4,150,120,30,1
02-01-2025,Snacks & Ready-to-Eat,PN ORGANIC PUFFED RICE 200GM,14,55,55,0,1
02-01-2025,"Grains, Flours & Dals",CORN FOUR 250GM,4,40,35,5,1
02-01-2025,"Health, Wellness & Ayurvedic Products",MH Millets Malt 500GM,5,200,190,10,1
02-01-2025,Snacks & Ready-to-Eat,TILLI CHIKKI,14,5,5,0,1
02-01-2025,Personal Care & Cosmetics,OVAL BODY LOOFAH,10,55,55,0,1
02-01-2025,Spices & Seasonings,ROYAL SAFFRON 400GRMS,15,65,65,0,1
02-01-2025,Oils & Ghee,Safflower oil 1 L,9,440,400,40,1
02-01-2025,"Grains, Flours & Dals",Sathya Javva Wheat Rava 500GM,4,190,190,0,2
02-01-2025,Sweeteners,GS Palm Jaggery Powder 400GM,16,180,180,0,1
02-01-2025,"Grains, Flours & Dals",Multigrain 1 kg,4,100,85,15,1
02-01-2025,Snacks & Ready-to-Eat,VD ATUKULU MIXTURE 175GM,14,60,60,0,1
02-01-2025,"Grains, Flours & Dals",Wheat Flour 1 kg,4,70,60,10,1
02-01-2025,"Grains, Flours & Dals",Yellow jowar.F 500 gms,4,55,50,5,1
02-01-2025,Oils & Ghee,Freedom Rice Bran Oil 1L,9,194,180,14,1
02-01-2025,"Grains, Flours & Dals",RAGI FLOUR 500GRMS,4,40,35,5,1
02-01-2025,Snacks & Ready-to-Eat,VD RIBBON PAKODI 175GM,14,60,60,0,1
02-01-2025,"Grains, Flours & Dals",Wheat Flour 1 kg,4,282,272,10,1
02-01-2025,Snacks & Ready-to-Eat,SATHVI MIXED CHIKKI 200GM,14,120,100,20,1
02-01-2025,Snacks & Ready-to-Eat,GANTASALA GINGER CANDY 200GM,14,105,105,0,1
02-01-2025,"Grains, Flours & Dals",Chana Flour 500 gms,4,70,65,5,1
02-01-2025,Snacks & Ready-to-Eat,WHOLE WHEAT BREAD,14,55,55,0,1
02-01-2025,"Grains, Flours & Dals",THICK POHA 500GM,4,40,35,5,1
02-01-2025,"Grains, Flours & Dals",Multigrain 1 kg,4,200,170,30,2
02-01-2025,Sweeteners,GS Palm Jaggery Powder 400GM,16,360,360,0,2
02-01-2025,"Dry Fruits, Nuts & Seeds",PULMAKHANA 100 GM,2,360,340,20,2
02-01-2025,"Grains, Flours & Dals",RAJMA 250GM,4,55,45,10,1
02-01-2025,"Health, Wellness & Ayurvedic Products",MH Millets Malt 1KG,5,2400,"2,280.00",120,6
02-01-2025,"Grains, Flours & Dals",Bombay Rava 500GM,4,35,30,5,1
02-01-2025,"Grains, Flours & Dals",Wheat Flour 2 kgs,4,140,120,20,1
02-01-2025,Milk & Dairy,BROWN EGGS 1P,7,28,24,4,2
02-01-2025,"Grains, Flours & Dals",Sathya Javva Wheat Rava 500GM,4,95,95,0,1
02-01-2025,"Grains, Flours & Dals",RAGI FLOUR 500GRMS,4,40,35,5,1
02-01-2025,"Grains, Flours & Dals",Chana Flour 500 gms,4,70,65,5,1
02-01-2025,"Grains, Flours & Dals",Urad dall 500 gms,4,95,85,10,1
02-01-2025,"Grains, Flours & Dals",FLOUR CHARGE,4,68.4,68.4,0,5.7
02-01-2025,Snacks & Ready-to-Eat,NGT CHATPATTA CHANA 90GM,14,25,25,0,1
02-01-2025,"Health, Wellness & Ayurvedic Products",RB FRUITS &amp;seeds Cranberries,5,45,45,0,1
02-01-2025,"Grains, Flours & Dals",White Batani 250GM,4,40,30,10,1
02-01-2025,Sweeteners,GS Organic Jaggery Powder 600GM,16,99,99,0,1
02-01-2025,"Grains, Flours & Dals",Wheat Flour 1 kg,4,70,60,10,1
02-01-2025,"Grains, Flours & Dals",Red Chana 250GM,4,35,30,5,1
02-01-2025,Sweeteners,YB FOREST HONEY 250GM,16,180,180,0,1
02-01-2025,"Grains, Flours & Dals",FLOUR CHARGE,4,24,24,0,2
02-01-2025,Spices & Seasonings,RED COPRA 250GMS,15,85,74,11,1
02-01-2025,Pooja & Spiritual Items,GOMATHA,12,75,75,0,1
02-01-2025,"Dry Fruits, Nuts & Seeds",LION SULTAN DATES 500GM,2,136,136,0,1
02-01-2025,"Grains, Flours & Dals",Green Batani 250GM,4,55,45,10,1
02-01-2025,Oils & Ghee,Castor oil 200 ml,9,100,80,20,1
02-01-2025,"Grains, Flours & Dals",SL Idly Rava 1KG,4,65,55,10,1
02-01-2025,"Grains, Flours & Dals",SH RED POHA 500GM,4,75,75,0,1
02-01-2025,"Health, Wellness & Ayurvedic Products",RB Max Protein Choco chips 55gm,5,50,50,0,1
02-01-2025,Snacks & Ready-to-Eat,Corn Chips 250GM,14,40,35,5,1
02-01-2025,Spices & Seasonings,SV Kashmiri Chilli Powder 100GM,15,130,130,0,1
02-01-2025,Snacks & Ready-to-Eat,VD RIBBON PAKODI 175GM,14,60,60,0,1
02-01-2025,"Grains, Flours & Dals",RED WHEAT 1 KG,4,260,240,20,2
02-01-2025,Personal Care & Cosmetics,MD Bath Powder 100GM,10,40,40,0,1
02-01-2025,Snacks & Ready-to-Eat,VD ATUKULU MIXTURE 175GM,14,60,60,0,1
02-01-2025,Snacks & Ready-to-Eat,RAJGIRA PEANUT CHIKKI,14,30,30,0,6
02-01-2025,"Grains, Flours & Dals",RAGI FLOUR 500GRMS,4,40,35,5,1
02-01-2025,"Grains, Flours & Dals",White jowar.F 1 kg,4,100,80,20,1
02-01-2025,"Grains, Flours & Dals",RICE FLOUR 500 GM,4,35,28,7,1
02-01-2025,Pooja & Spiritual Items,GD Aiswarya Deepam 700ML,12,390,390,0,2
02-01-2025,Oils & Ghee,Groundnut oil 1 L,9,720,660,60,2
02-01-2025,"Health, Wellness & Ayurvedic Products",AMLAKI CHOORNAM,5,100,100,0,1
02-01-2025,"Grains, Flours & Dals",VYS.SP RICE 1 KG,4,350,325,25,5
02-01-2025,Snacks & Ready-to-Eat,VD MINAPA VADIYAM,14,65,65,0,1
02-01-2025,"Grains, Flours & Dals",MIXED FLOUR,4,330,330,0,1
02-01-2025,"Dry Fruits, Nuts & Seeds",WALLNUTS 250GM,2,380,360,20,1
02-01-2025,"Dry Fruits, Nuts & Seeds",CASHEW 250GM,2,340,310,30,1
02-01-2025,Milk & Dairy,BROWN EGGS TRAY 30P,7,360,330,30,1
02-01-2025,"Dry Fruits, Nuts & Seeds",ALMONDS 250GM,2,560,520,40,2
02-01-2025,"Dry Fruits, Nuts & Seeds",PLAIN PISTA 250GM,2,660,550,110,1
02-01-2025,Snacks & Ready-to-Eat,VD MURUKU 175GM,14,60,60,0,1
02-01-2025,Snacks & Ready-to-Eat,PALLI LADDU 200GMS,14,90,70,20,1
02-01-2025,"Dry Fruits, Nuts & Seeds",KAJU HALF 250GM,2,310,290,20,1
02-01-2025,Snacks & Ready-to-Eat,SD MASALA GAVVALU 200GM,14,95,95,0,1
02-01-2025,"Grains, Flours & Dals",RICE FLOUR 500 GM,4,35,28,7,1
02-01-2025,Oils & Ghee,Groundnut oil 1 L,9,720,660,60,2
02-01-2025,Spices & Seasonings,Coconut Powder 250GM,15,90,70,20,1
02-01-2025,Milk & Dairy,SANGAM CURD 450GM,7,38,38,0,1
02-01-2025,Spices & Seasonings,NUVVULU 250GM,15,100,85,15,1
02-01-2025,"Grains, Flours & Dals",RICE FLOUR 1KG,4,70,50,20,1
02-01-2025,Personal Care & Cosmetics,PEARS BODY WASH,10,210,210,0,1
02-01-2025,Pooja & Spiritual Items,GOMATHA AGARBATHI,12,75,75,0,1
02-01-2025,"Dry Fruits, Nuts & Seeds",Groundnuts 500 gms,2,95,85,10,1
02-01-2025,Pooja & Spiritual Items,SWASTIK CAMPHORE,12,90,90,0,1
02-01-2025,Misc,HOME LIKES,8,10,10,0,1
02-01-2025,Snacks & Ready-to-Eat,GB SALT COOKIES,14,60,55,5,1
02-01-2025,Spices & Seasonings,DB CRYSTAL SALT 1KG,15,25,25,0,1
02-01-2025,Spices & Seasonings,TATA SALT 1KG,15,30,30,0,1
02-01-2025,Snacks & Ready-to-Eat,SATHVI MIXED CHIKKI 200GM,14,120,100,20,1
02-01-2025,"Grains, Flours & Dals",turdal 1kg,4,220,195,25,1
02-01-2025,Spices & Seasonings,SATHVI GREEN SOUNF 100GM,15,60,40,20,1
02-01-2025,Snacks & Ready-to-Eat,VD RIBBON PAKODI 175GM,14,60,60,0,1
02-01-2025,Sweeteners,SUGAR 1KG,16,180,150,30,3
02-01-2025,"Grains, Flours & Dals",FLOUR CHARGE,4,54,54,0,4.5
02-01-2025,"Grains, Flours & Dals",Chana Flour 500 gms,4,70,65,5,1
02-01-2025,General Household & Kitchenware,CANDLE,3,60,60,0,2
02-01-2025,"Dry Fruits, Nuts & Seeds",PULMAKHANA 100 GM,2,180,170,10,1
02-01-2025,"Dry Fruits, Nuts & Seeds",BLACK KISMIS 250GM,2,175,140,35,1
02-01-2025,Spices & Seasonings,Black Till 250GM,15,90,75,15,1
02-01-2025,"Grains, Flours & Dals",Red Chana 250GM,4,35,30,5,1
02-01-2025,Snacks & Ready-to-Eat,KURNOOL MARMURA,14,70,55,15,1
02-01-2025,"Dry Fruits, Nuts & Seeds",SATHVI CHIA SEEDS 100GM,2,100,80,20,1
02-01-2025,"Grains, Flours & Dals",Green gram 500 gms,4,75,70,5,1
02-01-2025,"Grains, Flours & Dals",Multigrain 1 kg,4,200,170,30,2
02-01-2025,"Grains, Flours & Dals",THICK POHA 1KG,4,80,70,10,1
02-01-2025,"Dry Fruits, Nuts & Seeds",SUNFLOWER SEEDS 250GRM,2,150,130,20,1
02-01-2025,"Grains, Flours & Dals",VL Sabdana 500GM,4,77,77,0,1
02-01-2025,"Dry Fruits, Nuts & Seeds",FLAX SEEDS 250GM,2,60,50,10,1
02-01-2025,Spices & Seasonings,ROYAL SAFFRON,15,125,125,0,1
02-01-2025,"Dry Fruits, Nuts & Seeds",PUMPKIN SEEDS 250GM,2,200,160,40,1
02-01-2025,"Dry Fruits, Nuts & Seeds",WATERMELON SEEDS 250GRM,2,320,280,40,1
02-01-2025,Spices & Seasonings,Turmeric powder 250 gms,15,100,75,25,1
02-01-2025,"Grains, Flours & Dals",Red Chana 250GM,4,35,30,5,1
02-01-2025,Oils & Ghee,Coconut oil 500 ml,9,220,200,20,1
02-01-2025,Snacks & Ready-to-Eat,Corn Chips 250GM,14,40,35,5,1
02-01-2025,"Grains, Flours & Dals",VYS.SP RICE 1 KG,4,350,325,25,5
02-01-2025,Oils & Ghee,Groundnut oil 5 L,9,1800,"1,600.00",200,1
02-01-2025,Oils & Ghee,ANURAG RB OIL,9,120,100,20,1
02-01-2025,Oils & Ghee,Sesame oil 500ml,9,295,280,15,1
02-01-2025,Sweeteners,SUGAR 1KG,16,60,50,10,1
02-01-2025,Snacks & Ready-to-Eat,RI Yogurt Berry Oats 35g,14,45,45,0,1
02-01-2025,Milk & Dairy,BROWN EGGS 1P,7,168,144,24,12
02-01-2025,Snacks & Ready-to-Eat,VD RICE SAGO PAPAD 150GM,14,55,55,0,1
02-01-2025,Snacks & Ready-to-Eat,URBAN MARMURA 450GM,14,60,55,5,1
02-01-2025,Oils & Ghee,Groundnut oil 1 L,9,360,330,30,1
02-01-2025,Snacks & Ready-to-Eat,VD RED CHILLI RICEPAPAD 150GM,14,50,50,0,1
02-01-2025,"Grains, Flours & Dals",RAGI FLOUR 1KG,4,160,140,20,2
02-01-2025,Snacks & Ready-to-Eat,MARMURA LADDU,14,80,60,20,1
02-01-2025,"Grains, Flours & Dals",SA YELLOW JOWAR RAVA 500GM,4,95,95,0,1
02-01-2025,Spices & Seasonings,Telaga Pindi 250 GM,15,40,35,5,1
02-01-2025,"Grains, Flours & Dals",HS Jowar upma rava 500 gms,4,65,65,0,1
02-01-2025,Spices & Seasonings,RED COPRA 500GM,15,170,148,22,1
02-01-2025,Spices & Seasonings,AV Iodized Salt 1KG,15,28,25,3,1
02-01-2025,Milk & Dairy,SANGAM TONED MILK 500ML,7,30,30,0,1
02-01-2025,"Grains, Flours & Dals",Urad dall 1 Kg,4,185,170,15,1
02-01-2025,"Grains, Flours & Dals",BAJRA 1 KG,4,30,25,5,0.5
02-01-2025,"Grains, Flours & Dals",idly/Dosa rice 1 kg,4,70,60,10,1
02-01-2025,Oils & Ghee,Sesame oil 1 L,9,590,560,30,1
02-01-2025,"Grains, Flours & Dals",split black gram 500 gms,4,90,85,5,1
02-01-2025,"Grains, Flours & Dals",RAGI FLOUR 500GRMS,4,40,35,5,1
02-01-2025,Spices & Seasonings,NUVVULU 500GM,15,200,170,30,1
02-01-2025,Oils & Ghee,Black Sesame oil 500 ml,9,220,190,30,1
02-01-2025,"Grains, Flours & Dals",Multigrain 1 kg,4,200,170,30,2
02-01-2025,Snacks & Ready-to-Eat,VD ATUKULU MIXTURE 175GM,14,60,60,0,1
02-01-2025,Pickles & Cooking Pastes,SD MESTA PICKLE,11,110,110,0,1
02-01-2025,Snacks & Ready-to-Eat,VD MURUKU 175GM,14,120,120,0,2
02-01-2025,"Dry Fruits, Nuts & Seeds",DRIED KIWI 200GM,2,145,130,15,1
02-01-2025,Snacks & Ready-to-Eat,NGT CHATPATTA CHANA 90GM,14,25,25,0,1
02-01-2025,"Dry Fruits, Nuts & Seeds",ANJEER 250GM,2,400,360,40,1
02-01-2025,"Dry Fruits, Nuts & Seeds",SALTED PISTA 250GM,2,400,350,50,1
02-01-2025,Snacks & Ready-to-Eat,VD PAPPU CHEGODI 200GM,14,60,60,0,1
02-01-2025,Snacks & Ready-to-Eat,PALLI LADDU 200GMS,14,180,140,40,2
02-01-2025,"Grains, Flours & Dals",EM Foxtail idli r 500 g,4,109,109,0,1
02-01-2025,Snacks & Ready-to-Eat,MARMURA LADDU,14,80,60,20,1
02-01-2025,"Dry Fruits, Nuts & Seeds",KAJU HALF 250GM,2,310,290,20,1
02-01-2025,Snacks & Ready-to-Eat,VD MINAPA VADIYAM,14,65,65,0,1
02-01-2025,Snacks & Ready-to-Eat,SD RAGI GAVVALU,14,95,95,0,1
02-01-2025,Snacks & Ready-to-Eat,SATHVI MIXED CHIKKI 200GM,14,120,100,20,1
02-01-2025,Snacks & Ready-to-Eat,VD ARISELU 5 PIC,14,200,200,0,2
02-01-2025,Spices & Seasonings,PRO HIMALAYAN PINK SALT 500GM,15,68,68,0,1
02-01-2025,Snacks & Ready-to-Eat,SATHVI PALLI CHIKKI 200GM,14,100,80,20,1
02-01-2025,Snacks & Ready-to-Eat,KHARJURAM DRY FRUIT LADDU,14,180,180,0,1
02-01-2025,Snacks & Ready-to-Eat,3D PAPAD,14,40,40,0,1
02-01-2025,"Grains, Flours & Dals",DESI CHANA,4,50,50,0,2
02-01-2025,Snacks & Ready-to-Eat,VD Pappu Chekkalu 190gm,14,120,120,0,2
02-01-2025,Snacks & Ready-to-Eat,VD MINAPA SUNNUNDALU 12P,14,180,180,0,1
02-01-2025,Snacks & Ready-to-Eat,RAGI LADDU,14,120,120,0,1
02-01-2025,Snacks & Ready-to-Eat,SD KODO MILLET WITH PALM JAGGERY,14,135,135,0,1
02-01-2025,Snacks & Ready-to-Eat,VD NUVULU CHEGODI 175GM,14,60,60,0,1
02-01-2025,"Grains, Flours & Dals",SH RED POHA 500GM,4,75,75,0,1
02-01-2025,"Grains, Flours & Dals",Em Little idli R 500g,4,129,129,0,1
02-01-2025,"Dry Fruits, Nuts & Seeds",SD Mango cubes 200gm,2,90,90,0,1
02-01-2025,Snacks & Ready-to-Eat,SD Atreyapuram DRY Fruit ghee,14,150,150,0,1
02-01-2025,Snacks & Ready-to-Eat,SD Atreyapuram DRY Fruit ghee,14,150,150,0,1
02-01-2025,Snacks & Ready-to-Eat,WHITE SESAME CHIKKI,14,10,10,0,1
02-01-2025,Snacks & Ready-to-Eat,URBAN MARMURA 450GM,14,60,55,5,1
02-01-2025,Personal Care & Cosmetics,WOW SHAMPOO 100ML,10,130,130,0,1
02-01-2025,"Grains, Flours & Dals",Wheat Flour 1 kg,4,700,600,100,10
02-01-2025,Pickles & Cooking Pastes,SD TAMARIND PICKLE,11,110,110,0,1
02-01-2025,Snacks & Ready-to-Eat,SATHVI REGIVADA 200GM,14,400,300,100,5
02-01-2025,Snacks & Ready-to-Eat,BLACK SESAME CHIKKI,14,10,10,0,1
02-01-2025,Snacks & Ready-to-Eat,VD RIBBON PAKODI 175GM,14,60,60,0,1
02-01-2025,"Grains, Flours & Dals",Em kodo idli R 500G,4,129,129,0,1
02-01-2025,Snacks & Ready-to-Eat,PUDEENA SEV 200GM,14,60,60,0,1
02-01-2025,Snacks & Ready-to-Eat,VD Minapa papad 200gm,14,60,60,0,1
02-01-2025,"Health, Wellness & Ayurvedic Products",MORINGA LEAF POWDER M,5,80,75,5,1
02-01-2025,Snacks & Ready-to-Eat,FUN TIME CRUNCH,14,45,45,0,1
02-01-2025,Sweeteners,YB Brown Sugar 500GM,16,150,150,0,2
02-01-2025,Snacks & Ready-to-Eat,ID IDLY DOSA BATTER,14,90,90,0,1
02-01-2025,Snacks & Ready-to-Eat,AQUAGRANO DOSA BATTER,14,69,69,0,1
02-01-2025,Oils & Ghee,Black Sesame oil 500 ml,9,220,190,30,1
02-01-2025,Oils & Ghee,Groundnut oil 500ml,9,180,165,15,1
02-01-2025,"Grains, Flours & Dals",FLOUR CHARGE,4,30,30,0,2.5
02-01-2025,Snacks & Ready-to-Eat,SD JOWAR WITH PALM JAGGERY 250GM,14,135,135,0,1
02-01-2025,"Health, Wellness & Ayurvedic Products",MH Millets Malt 500GM,5,200,190,10,1
02-01-2025,"Health, Wellness & Ayurvedic Products",MH Baby Food 400GM,5,200,200,0,1
02-01-2025,Snacks & Ready-to-Eat,SD FINGER Millet with palm Jaggery 250gm,14,135,135,0,1
02-01-2025,"Grains, Flours & Dals",RICE FLOUR 500 GM,4,35,28,7,1
02-01-2025,Oils & Ghee,Groundnut oil 1 L,9,360,330,30,1
02-01-2025,Oils & Ghee,Groundnut oil 1 L,9,360,330,30,1
02-01-2025,"Grains, Flours & Dals",MELMEKER 250GMS,4,60,45,15,1
02-01-2025,Pooja & Spiritual Items,GD KUMKUM 50GM,12,30,30,0,1
02-01-2025,"Grains, Flours & Dals",White jowar.F 1 kg,4,100,80,20,1
02-01-2025,"Grains, Flours & Dals",Multigrain 1 kg,4,100,85,15,1
02-01-2025,Oils & Ghee,Coconut oil 500 ml,9,220,200,20,1
02-01-2025,"Grains, Flours & Dals",Wheat Rava M 1KG,4,65,55,10,1
02-01-2025,"Dry Fruits, Nuts & Seeds",Groundnuts 500 gms,2,95,85,10,1
02-01-2025,Spices & Seasonings,ROYAL SAFFRON 400GRMS,15,65,65,0,1
02-01-2025,Snacks & Ready-to-Eat,RAGI LADDU,14,120,120,0,1
02-01-2025,Snacks & Ready-to-Eat,MARMURA LADDU,14,80,60,20,1
02-01-2025,Snacks & Ready-to-Eat,VD MINAPA SUNNUNDALU 12P,14,180,180,0,1
02-01-2025,Snacks & Ready-to-Eat,BD BARELY NOODLES 200G,14,70,70,0,1
02-01-2025,Milk & Dairy,SANGAM TONED MILK 500ML,7,90,90,0,3
02-01-2025,General Household & Kitchenware,TEA CUP 1P,3,135,135,0,3
02-01-2025,"Health, Wellness & Ayurvedic Products",PODAPATRI CHOORNAM,5,100,100,0,1
02-01-2025,Personal Care & Cosmetics,ORGANIC SPONGE LOOFAH,10,350,350,0,5
02-01-2025,Personal Care & Cosmetics,OVAL BODY LOOFAH,10,220,220,0,4
02-01-2025,Snacks & Ready-to-Eat,VD MINAPA VADIYAM,14,65,65,0,1
02-01-2025,Personal Care & Cosmetics,HEART SHAPE LOOFAH,10,79,79,0,1
02-01-2025,Oils & Ghee,Sesame oil 1 L,9,590,560,30,1
02-01-2025,Personal Care & Cosmetics,VASELINE 5GM,10,5,5,0,1
02-01-2025,Snacks & Ready-to-Eat,SF Millet Noodles Curry Masala 192g,14,129,129,0,1
02-01-2025,"Dry Fruits, Nuts & Seeds",PUMPKIN SEEDS 250GM,2,200,160,40,1
02-01-2025,Sweeteners,NATURAL HONEY 250GM,16,150,130,20,1
02-01-2025,"Grains, Flours & Dals",RICE FLOUR 500 GM,4,35,28,7,1
02-01-2025,Snacks & Ready-to-Eat,SF MASALA BOONDI 60GM,14,20,20,0,1
02-01-2025,Snacks & Ready-to-Eat,VD ARISELU 5 PIC,14,100,100,0,1
02-01-2025,"Dry Fruits, Nuts & Seeds",Groundnuts 500 gms,2,95,85,10,1
02-01-2025,Snacks & Ready-to-Eat,VD MAIDA CHEGODI 175GM,14,60,60,0,1
02-01-2025,Snacks & Ready-to-Eat,FUN TIME CRUNCH,14,45,45,0,1
02-01-2025,Snacks & Ready-to-Eat,KURNOOL MARMURA,14,70,55,15,1
02-01-2025,"Grains, Flours & Dals",THICK POHA 500GM,4,40,35,5,1
02-01-2025,"Dry Fruits, Nuts & Seeds",SALTED PISTA 250GM,2,400,350,50,1
02-01-2025,"Grains, Flours & Dals",RAGI FLOUR 500GRMS,4,40,35,5,1
02-01-2025,"Grains, Flours & Dals",RICE FLOUR 500 GM,4,35,28,7,1
02-01-2025,Oils & Ghee,Sesame oil 500ml,9,295,280,15,1
02-01-2025,"Dry Fruits, Nuts & Seeds",Groundnuts 500 gms,2,95,85,10,1
02-01-2025,Snacks & Ready-to-Eat,RAJGIRA PEANUT CHIKKI 450GM,14,250,250,0,2
02-01-2025,"Grains, Flours & Dals",CORN FOUR 250GM,4,40,35,5,1
02-01-2025,Snacks & Ready-to-Eat,PEANUT CHILLI,14,5,5,0,1
02-01-2025,Snacks & Ready-to-Eat,VD Pappu Chekkalu 190gm,14,240,240,0,4
02-01-2025,"Dry Fruits, Nuts & Seeds",SD Mango cubes 100gm,2,45,45,0,1
02-01-2025,"Dry Fruits, Nuts & Seeds",CASHEW 250GM,2,680,620,60,2
02-01-2025,"Grains, Flours & Dals",White jowar.F 1 kg,4,200,160,40,2
02-01-2025,"Grains, Flours & Dals",Wheat Flour 1 kg,4,210,180,30,3
02-01-2025,Oils & Ghee,GROUNDNUT OIL 1KG,9,2340,"2,100.00",240,6
02-01-2025,Sweeteners,YB Brown Sugar 1KG,16,420,420,0,3
02-01-2025,"Dry Fruits, Nuts & Seeds",WATERMELON SEEDS 250GRM,2,320,280,40,1
02-01-2025,"Dry Fruits, Nuts & Seeds",PUMPKIN SEEDS 250GM,2,200,160,40,1
02-01-2025,Snacks & Ready-to-Eat,ZEEDI,14,70,70,0,1
02-01-2025,Snacks & Ready-to-Eat,VD Pappu Chekkalu 190gm,14,60,60,0,1
02-01-2025,Snacks & Ready-to-Eat,VD PAPPU CHEGODI 200GM,14,60,60,0,1
02-01-2025,Snacks & Ready-to-Eat,PALLI LADDU 200GMS,14,90,70,20,1
02-01-2025,Snacks & Ready-to-Eat,VD MYSOREPAK 6PIC,14,100,100,0,1
02-01-2025,Snacks & Ready-to-Eat,VD BELLAM GAVVALU 200GM,14,60,60,0,1
02-01-2025,"Grains, Flours & Dals",RAGI FLOUR 500GRMS,4,40,35,5,1
02-01-2025,Spices & Seasonings,YB Rock Salt 1KG,15,120,120,0,1
02-01-2025,"Grains, Flours & Dals",URAD DALL,4,95,85,10,1
02-01-2025,"Grains, Flours & Dals",Wheat Rava M 500GM,4,33,30,3,1
02-01-2025,"Grains, Flours & Dals",Wheat Rava M 1KG,4,130,110,20,2
02-01-2025,"Grains, Flours & Dals",SPLIT BLACK GRAM 500 GM,4,90,85,5,1
02-01-2025,"Grains, Flours & Dals",JOWAR UPMA RAVA,4,65,65,0,1
02-01-2025,"Dry Fruits, Nuts & Seeds",Groundnuts 500 gms,2,95,85,10,1
02-01-2025,Spices & Seasonings,DURGA SALT CRYSTAL 1KG,15,25,25,0,1
02-01-2025,Spices & Seasonings,AVALU 100GM,15,25,20,5,1
02-01-2025,Snacks & Ready-to-Eat,VD BELLAM GAVVALU 200GM,14,60,60,0,1
02-01-2025,"Dry Fruits, Nuts & Seeds",ANJEER 250GM,2,400,360,40,1
02-01-2025,"Dry Fruits, Nuts & Seeds",PLAIN PISTA 250GM,2,660,550,110,1
02-01-2025,Oils & Ghee,Sesame oil 1 L,9,590,560,30,1
02-01-2025,"Grains, Flours & Dals",Wheat Flour 1 kg,4,70,60,10,1
02-01-2025,Spices & Seasonings,Turmeric powder 500 gms,15,200,150,50,1
02-01-2025,"Grains, Flours & Dals",Multigrain 1 kg,4,100,85,15,1
02-01-2025,Spices & Seasonings,SAJEERA,15,60,40,20,1
02-01-2025,Oils & Ghee,Safflower oil 500 ml,9,220,200,20,1
02-01-2025,Spices & Seasonings,ELACHI 25 GM,15,145,120,25,1
02-01-2025,Sweeteners,MISHRI 250 GM,16,35,30,5,1
02-01-2025,"Dry Fruits, Nuts & Seeds",YELLOW KISHMISH 250GM,2,130,110,20,1
02-01-2025,Spices & Seasonings,Dalchin Chekka 50GM,15,50,40,10,1
02-01-2025,"Dry Fruits, Nuts & Seeds",DRYDATES YELLOW 250GM,2,135,120,15,1
02-01-2025,"Dry Fruits, Nuts & Seeds",ALMONDS 250GM,2,280,260,20,1
02-01-2025,Snacks & Ready-to-Eat,VD MURUKU 175GM,14,60,60,0,1
02-01-2025,Snacks & Ready-to-Eat,FOXTAIL BIS,14,135,135,0,1
02-01-2025,Snacks & Ready-to-Eat,FOXTAIL BIS,14,0,0,0,1
02-01-2025,Milk & Dairy,BROWN EGGS TRAY 30P,7,360,330,30,1
02-01-2025,Snacks & Ready-to-Eat,VD MURUKU 175GM,14,60,60,0,1
02-01-2025,Spices & Seasonings,Elaichi 25GM,15,145,120,25,1
02-01-2025,Misc,HOME LIKES,8,10,10,0,1
02-01-2025,Pooja & Spiritual Items,SWASTIK CAMPHORE,12,180,180,0,2
02-01-2025,Personal Care & Cosmetics,HERBAL BATH POWDER,10,160,160,0,1
02-01-2025,Pooja & Spiritual Items,HAND MADE VOTHULU,12,100,100,0,2
02-01-2025,Pooja & Spiritual Items,GD Aiswarya Deepam 700ML,12,390,390,0,2
02-01-2025,Pooja & Spiritual Items,SOSR SWATHHI 365,12,30,30,0,1
02-01-2025,Sweeteners,GS JAGGERY NUGGETS 500GM,16,120,120,0,1
02-01-2025,Pooja & Spiritual Items,GD Aiswarya Deepam 700ML,12,195,195,0,1
02-01-2025,"Grains, Flours & Dals",HS Multimillet idly R 500 gms,4,65,65,0,1
02-01-2025,"Grains, Flours & Dals",HS Ragi upma rava 500 gms,4,70,70,0,1
02-01-2025,Spices & Seasonings,PRO ORG TURMERIC POWDER 100G,15,70,70,0,1
02-01-2025,Spices & Seasonings,Telaga Pindi 250 GM,15,40,35,5,1
02-01-2025,Sweeteners,YB FOREST HONEY 250GM,16,180,180,0,1
02-01-2025,Snacks & Ready-to-Eat,GS SORGHUM SNACKS 150GM,14,60,60,0,1
02-01-2025,"Dry Fruits, Nuts & Seeds",Groundnuts 500 gms,2,95,85,10,1
02-01-2025,"Grains, Flours & Dals",KORRALU (FOXTAIL M) 500GM,4,65,55,10,1
02-01-2025,"Grains, Flours & Dals",HS Multimillet idly R 500 gms,4,65,65,0,1
02-01-2025,"Grains, Flours & Dals",RICE FLOUR 500 GM,4,35,28,7,1
02-01-2025,Oils & Ghee,Safflower oil 5 L,9,2200,"1,950.00",250,1
02-01-2025,Snacks & Ready-to-Eat,URBAN MARMURA 450GM,14,60,55,5,1
02-01-2025,Milk & Dairy,BROWN EGGS 1P,7,112,96,16,8
02-01-2025,"Grains, Flours & Dals",Wheat Flour 1 kg,4,70,60,10,1
02-01-2025,"Grains, Flours & Dals",RAGI FLOUR 500GRMS,4,40,35,5,1
02-01-2025,Snacks & Ready-to-Eat,BD RED RICE NOODLES 200G,14,70,70,0,1
02-01-2025,Snacks & Ready-to-Eat,SD RED CHILLY PAPADS,14,80,80,0,1
02-01-2025,Oils & Ghee,Groundnut oil 1 L,9,360,330,30,1
02-01-2025,"Dry Fruits, Nuts & Seeds",SD Mango cubes 100gm,2,45,45,0,1
02-01-2025,Snacks & Ready-to-Eat,SATHVI PALLI CHIKKI 200GM,14,100,80,20,1
02-01-2025,Oils & Ghee,Groundnut oil 1 L,9,360,330,30,1
02-01-2025,Oils & Ghee,Groundnut oil 1 L,9,360,330,30,1
02-01-2025,Milk & Dairy,HRITAGE TONED MILK 500ML,7,30,30,0,1
02-01-2025,Milk & Dairy,HERITAGE CURD,7,48,48,0,1
02-01-2025,Snacks & Ready-to-Eat,SESAME LADDU 200GM,14,100,80,20,1
02-01-2025,Snacks & Ready-to-Eat,NGT CHATPATTA CHANA 90GM,14,50,50,0,2
02-01-2025,Snacks & Ready-to-Eat,PALLI LADDU 200GMS,14,90,70,20,1
02-01-2025,Milk & Dairy,BROWN EGGS 1P,7,84,72,12,6
02-01-2025,"Grains, Flours & Dals",Em jowar idly R 500G,4,150,150,0,2
02-01-2025,"Grains, Flours & Dals",BAJRA IDLY RAVA 400GM,4,130,130,0,2
02-01-2025,"Grains, Flours & Dals",Em Multimillet idli r 500g,4,129,129,0,1
02-01-2025,Snacks & Ready-to-Eat,GS INSTANT KORRA DOSA MIX 400GM,14,120,120,0,1
02-01-2025,"Grains, Flours & Dals",split green gram 500 gms,4,75,70,5,1
02-01-2025,Misc,HOME LIKES,8,10,10,0,1
02-01-2025,Personal Care & Cosmetics,MARGO,10,45,42,3,1
02-01-2025,Personal Care & Cosmetics,KAIPO ACT CHARCOAL TP 100G,10,90,90,0,1
02-01-2025,Snacks & Ready-to-Eat,VD SAGOPAPAD 150GM,14,55,55,0,1
02-01-2025,Personal Care & Cosmetics,GOW DURBAR NAVA 100GM SOAP,10,40,40,0,1
02-01-2025,"Grains, Flours & Dals",Wheat Rava M 500GM,4,33,30,3,1
02-01-2025,Personal Care & Cosmetics,KHADI MIX FRUIT SOAP 125GM,10,80,80,0,1
02-01-2025,"Grains, Flours & Dals",Multigrain 1 kg,4,100,85,15,1
02-01-2025,Snacks & Ready-to-Eat,GB SALT COOKIES,14,60,55,5,1
02-01-2025,Snacks & Ready-to-Eat,VD SAGOPAPAD 150GM,14,55,55,0,1
02-01-2025,"Grains, Flours & Dals",MAATEJA rice 1 kg,4,144,138,6,2
02-01-2025,Snacks & Ready-to-Eat,GANTASALA FLAX SEEDS SPICY,14,90,90,0,1
02-01-2025,"Grains, Flours & Dals",Yellow jowar.F 2 kgs,4,220,200,20,1
02-01-2025,"Grains, Flours & Dals",Multigrain 1 kg,4,100,85,15,1
02-01-2025,Misc,HOME LIKES,8,10,10,0,1
02-01-2025,Snacks & Ready-to-Eat,RINGS 200GM,14,30,30,0,1
02-01-2025,Snacks & Ready-to-Eat,MB PEARL MILLET NOODLES 180GM,14,95,95,0,1
02-01-2025,Beverages,BRU GREEN LABEL 1.2G,1,48,48,0,24
02-01-2025,Snacks & Ready-to-Eat,MB FOXTAIL MILLET NOODLES 180GM,14,95,95,0,1
02-01-2025,"Grains, Flours & Dals",Multigrain 1 kg,4,300,255,45,3
02-01-2025,"Grains, Flours & Dals",VYS.SP RICE 1 KG,4,210,195,15,3
02-01-2025,Oils & Ghee,Groundnut oil 1 L,9,360,330,30,1
02-01-2025,"Grains, Flours & Dals",SL Idly Rava 1KG,4,65,55,10,1
02-01-2025,Oils & Ghee,Groundnut oil 1 L,9,1080,960,120,3
02-01-2025,Snacks & Ready-to-Eat,DOSA BATTER 1KG,14,60,60,0,1
02-01-2025,Snacks & Ready-to-Eat,SATHVI REGIVADA 200GM,14,80,60,20,1
02-01-2025,Snacks & Ready-to-Eat,VD VAMUPUSA 175GM,14,60,60,0,1
02-01-2025,Snacks & Ready-to-Eat,SD Ginger Candy 100g,14,60,60,0,1
02-01-2025,Snacks & Ready-to-Eat,SUNNUNDALU,14,240,240,0,2
02-01-2025,"Grains, Flours & Dals",Urad dall 1 Kg,4,185,170,15,1
02-01-2025,"Grains, Flours & Dals",BAJRA 1 KG,4,60,50,10,1
02-01-2025,Pooja & Spiritual Items,HERBAL VETIVER STICK 20INC,12,45,45,0,1
02-01-2025,Snacks & Ready-to-Eat,SD barnyard Millet with palm jaggery,14,135,135,0,1
02-01-2025,"Grains, Flours & Dals",SAMALU (Little millet) 1 kg,4,170,130,40,1
02-01-2025,Pooja & Spiritual Items,GD Kailash 60 GM,12,60,60,0,1
02-01-2025,General Household & Kitchenware,WOODEN SPOON BIG,3,40,40,0,1
02-01-2025,"Grains, Flours & Dals",VGR rice 1 kg,4,140,130,10,2
02-01-2025,"Grains, Flours & Dals",MGSUGAR CONTROL RICE 1KG,4,417,330,87,3
02-01-2025,"Grains, Flours & Dals",BARLEY FLOUR 250GM,4,45,40,5,1
02-01-2025,"Grains, Flours & Dals",CORN FOUR 250GM,4,40,35,5,1
02-01-2025,Personal Care & Cosmetics,GODREJ NATURAL BLACK,10,30,30,0,2
02-01-2025,Pooja & Spiritual Items,GD Dhoop Sticks 26GM,12,60,60,0,3
02-01-2025,"Grains, Flours & Dals",Yellow jowar .F1 kg,4,110,100,10,1
02-01-2025,"Grains, Flours & Dals",White jowar.F 1 kg,4,200,160,40,2
02-01-2025,Snacks & Ready-to-Eat,RAJGIRA PEANUT CHIKKI 450GM,14,125,125,0,1
02-01-2025,"Dry Fruits, Nuts & Seeds",Groundnuts 1 kg,2,380,340,40,2
02-01-2025,"Grains, Flours & Dals",Idly Rava L 1KG,4,60,50,10,1
02-01-2025,"Grains, Flours & Dals",PESARA PAPPU 1 KG,4,170,145,25,1
02-01-2025,"Grains, Flours & Dals",CHANA DAL 500GM,4,70,60,10,1
02-01-2025,"Grains, Flours & Dals",RED TURDAL 500GM,4,75,70,5,1
02-01-2025,"Grains, Flours & Dals",Green gram 1 kg,4,150,130,20,1
02-01-2025,"Grains, Flours & Dals",Arikalu (kodo),4,70,60,10,1
02-01-2025,"Grains, Flours & Dals",Chana Flour 500 gms,4,70,65,5,1
02-01-2025,Spices & Seasonings,Menthulu 250 gms,15,50,45,5,1
02-01-2025,"Dry Fruits, Nuts & Seeds",DRIED KIWI 200GM,2,145,130,15,1
02-01-2025,"Grains, Flours & Dals",VYS.SP RICE 1 KG,4,210,195,15,3
02-01-2025,"Grains, Flours & Dals",Sathya Javva Wheat Rava 500GM,4,95,95,0,1
02-01-2025,"Grains, Flours & Dals",BOMBAY RAVA,4,70,55,15,1
02-01-2025,"Grains, Flours & Dals",Multigrain 1 kg,4,250,210,40,2.5
02-01-2025,Oils & Ghee,Safflower oil 1 L,9,880,800,80,2
02-01-2025,Sweeteners,GS Palm Jaggery Powder 400GM,16,180,180,0,1
02-01-2025,"Grains, Flours & Dals",Wheat Rava M 1KG,4,65,55,10,1
02-01-2025,"Grains, Flours & Dals",RAGI FLOUR 1KG,4,80,70,10,1
02-01-2025,"Grains, Flours & Dals",Bajra Flour 1 kg,4,70,60,10,1
02-01-2025,"Grains, Flours & Dals",RICE FLOUR 1KG,4,70,50,20,1
02-01-2025,"Grains, Flours & Dals",split green gram 1 kg,4,150,140,10,1
02-01-2025,Sweeteners,ACHU BELLAM 1KG,16,100,80,20,1
02-01-2025,Pooja & Spiritual Items,SWASTIK CAMPHOR 25GM,12,45,45,0,1
02-01-2025,Pooja & Spiritual Items,GD Aiswarya Deepam 700ML,12,585,585,0,3
02-01-2025,"Grains, Flours & Dals",turdal 1kg,4,220,195,25,1
02-01-2025,Snacks & Ready-to-Eat,VD RED CHILLI RICEPAPAD 150GM,14,50,50,0,1
02-01-2025,Oils & Ghee,Groundnut oil 1 L,9,360,330,30,1
02-01-2025,Snacks & Ready-to-Eat,DISANO MACARONI 400GM,14,55,55,0,1
02-01-2025,Snacks & Ready-to-Eat,SD RAGI GAVVALU,14,95,95,0,1
02-01-2025,"Grains, Flours & Dals",Chana Flour 500 gms,4,70,65,5,1
02-01-2025,Personal Care & Cosmetics,OVAL BODY LOOFAH,10,55,55,0,1
02-01-2025,Snacks & Ready-to-Eat,SATHVI MIXED CHIKKI 200GM,14,120,100,20,1
02-01-2025,Personal Care & Cosmetics,SVE MULTANI MITTI SOAP 100GM,10,90,90,0,1
02-01-2025,"Grains, Flours & Dals",SAMALU (Little millet) 500 gms,4,75,65,10,1
02-01-2025,Snacks & Ready-to-Eat,SD Moringa with plam jaggery 250gm,14,135,135,0,1
02-01-2025,Pooja & Spiritual Items,SREE REAL KASTURI CUP SAMBRANI,12,81,81,0,1
02-01-2025,"Grains, Flours & Dals",Wheat Flour 1 kg,4,350,300,50,5
02-01-2025,"Grains, Flours & Dals",SL Idly Rava 1KG,4,65,55,10,1
02-01-2025,"Grains, Flours & Dals",Yellow jowar.F 500 gms,4,55,50,5,1
02-01-2025,Personal Care & Cosmetics,ORGANIC SPONGE LOOFAH,10,70,70,0,1
02-01-2025,"Grains, Flours & Dals",JOWAR WHITE 1 KG,4,40,35,5,0.5
02-01-2025,Oils & Ghee,BUFFALLO GHEE 500ML,9,820,740,80,2
02-01-2025,Snacks & Ready-to-Eat,KURNOOL MARMURA,14,70,55,15,1
02-01-2025,Snacks & Ready-to-Eat,GS RAGI SNACKS 200GM,14,60,60,0,1
02-01-2025,Pooja & Spiritual Items,HAND MADE VOTHULU,12,50,50,0,1
02-01-2025,"Dry Fruits, Nuts & Seeds",Groundnuts 1 kg,2,190,170,20,1
02-01-2025,Sweeteners,YB Brown Sugar 500GM,16,75,75,0,1
02-01-2025,"Grains, Flours & Dals",Black gram 500 gms,4,75,70,5,1
02-01-2025,"Grains, Flours & Dals",Green Batani 250GM,4,55,45,10,1
02-01-2025,Snacks & Ready-to-Eat,SD Groundnut with palm jaggery 250gm,14,135,135,0,1
02-01-2025,"Grains, Flours & Dals",Chana Flour 500 gms,4,70,65,5,1
02-01-2025,"Grains, Flours & Dals",Red Chana 500 GM,4,75,60,15,1
02-01-2025,"Grains, Flours & Dals",VYS.SP RICE 1 KG,4,350,325,25,5
02-01-2025,Snacks & Ready-to-Eat,ELITE MILK RUSK 200GM,14,35,35,0,1
02-01-2025,"Grains, Flours & Dals",Multigrain 1 kg,4,100,85,15,1
02-01-2025,Spices & Seasonings,NUVVULU 500GM,15,160,140,20,1
02-01-2025,Spices & Seasonings,Masala Karam 500 gms,15,260,240,20,1
02-01-2025,"Grains, Flours & Dals",Red Bobarlu 500 gms,4,95,85,10,1
02-01-2025,Spices & Seasonings,Tamarind 250GMS,15,80,65,15,1
02-01-2025,"Grains, Flours & Dals",RAGULU 1 KG,4,35,30,5,0.5
02-01-2025,"Grains, Flours & Dals",VL Sabdana 500GM,4,77,77,0,1
02-01-2025,"Grains, Flours & Dals",Wheat Rava M 500GM,4,33,30,3,1
02-01-2025,Spices & Seasonings,Dry Mirchi 200 gms,15,80,60,20,1
02-01-2025,Snacks & Ready-to-Eat,Pani Poori Chips 500GM,14,100,80,20,1
02-01-2025,"Grains, Flours & Dals",SL Idly Rava 1KG,4,65,55,10,1
02-01-2025,"Grains, Flours & Dals",White Chana 500GM,4,120,100,20,1
02-01-2025,Pooja & Spiritual Items,GD Aiswarya Deepam 700ML,12,195,195,0,1
02-01-2025,Snacks & Ready-to-Eat,GB SALT COOKIES,14,60,55,5,1
02-01-2025,"Grains, Flours & Dals",CORN FLOUR,4,80,70,10,1
02-01-2025,Pooja & Spiritual Items,DASANGAM 50 G,12,0,0,0,1
02-01-2025,"Dry Fruits, Nuts & Seeds",Groundnuts 1 kg,2,190,170,20,1
02-01-2025,"Grains, Flours & Dals",RAGI IDLI RAVA 500 G,4,0,0,0,1
02-01-2025,Spices & Seasonings,ROYAL SAFFRON 400GRMS,15,65,65,0,1
02-01-2025,"Grains, Flours & Dals",SL Idly Rava 1KG,4,65,55,10,1
02-01-2025,Oils & Ghee,Groundnut oil 1 L,9,360,330,30,1
02-01-2025,Snacks & Ready-to-Eat,SATHVI REGIVADA 200GM,14,80,80,0,1
02-01-2025,"Grains, Flours & Dals",Urad dall 1 Kg,4,185,170,15,1
02-01-2025,Oils & Ghee,Groundnut oil 1 L,9,720,660,60,2
02-01-2025,Spices & Seasonings,RED COPRA 500GM,15,170,148,22,1
02-01-2025,"Grains, Flours & Dals",SRILATHA RICE RAVVA 500GM,4,210,210,0,6
02-01-2025,"Grains, Flours & Dals",White Batani 500GM,4,80,60,20,1
02-01-2025,"Grains, Flours & Dals",White jowar.F 1 kg,4,100,80,20,1
02-01-2025,Snacks & Ready-to-Eat,ELITE MILK RUSK 200GM,14,35,35,0,1
02-01-2025,"Grains, Flours & Dals",Wheat Flour 1 kg,4,350,300,50,5
02-01-2025,"Grains, Flours & Dals",THICK POHA 1KG,4,80,70,10,1
02-01-2025,"Grains, Flours & Dals",RICE FLOUR 1KG,4,70,50,20,1
02-01-2025,Snacks & Ready-to-Eat,KURNOOL MARMURA,14,70,55,15,1
02-01-2025,"Grains, Flours & Dals",Chana Flour 500 gms,4,70,65,5,1
02-01-2025,Snacks & Ready-to-Eat,VD GUMMADI VADIYAM,14,75,75,0,1
02-01-2025,"Grains, Flours & Dals",Em jowar idly R 500G,4,75,75,0,1
02-01-2025,"Grains, Flours & Dals",Multigrain 1 kg,4,100,85,15,1
02-01-2025,"Grains, Flours & Dals",BOMBAY RAVA,4,70,55,15,1
02-01-2025,"Grains, Flours & Dals",Wheat Flour 2 kgs,4,140,120,20,1
02-01-2025,"Health, Wellness & Ayurvedic Products",RB Max Protein DESI MASALA 60gm,5,45,45,0,1
02-01-2025,Sweeteners,NATURAL HONEY 250GM,16,150,130,20,1
02-01-2025,Spices & Seasonings,PRO HIMALAYAN PINK SALT 500GM,15,68,68,0,1
02-01-2025,"Health, Wellness & Ayurvedic Products",ORGANIC MORINGA POWER 100GM,5,249,249,0,1
02-01-2025,"Dry Fruits, Nuts & Seeds",YELLOW KISHMISH 250GM,2,130,110,20,1
02-01-2025,Personal Care & Cosmetics,NEEM SOAP 100GM,10,100,100,0,1
02-01-2025,Personal Care & Cosmetics,VETIVER SOAP 100GM,10,100,100,0,1
02-01-2025,"Grains, Flours & Dals",DESI CHANA,4,25,25,0,1
02-01-2025,"Health, Wellness & Ayurvedic Products",RB Max Protein PERI PERI 60gm,5,45,45,0,1
02-01-2025,Snacks & Ready-to-Eat,SD BLACK GRAM PAPADS,14,80,80,0,1
02-01-2025,Oils & Ghee,Groundnut oil 1 L,9,360,330,30,1
02-01-2025,"Grains, Flours & Dals",MAAGAANI LOW GI SP 1KG,4,149,115,34,1
02-01-2025,Sweeteners,SUGAR 1KG,16,60,50,10,1
02-01-2025,"Grains, Flours & Dals",White jowar.F 1 kg,4,100,80,20,1
02-01-2025,Snacks & Ready-to-Eat,SATHVI MIXED CHIKKI 200GM,14,120,100,20,1
02-01-2025,Milk & Dairy,HERITAGE CURD,7,48,48,0,1
02-01-2025,Spices & Seasonings,Sajeera 50GM,15,60,40,20,1
02-01-2025,"Grains, Flours & Dals",Yellow jowar.F 500 gms,4,55,50,5,1
02-01-2025,Spices & Seasonings,RED COPRA 250GMS,15,85,74,11,1
02-01-2025,Sweeteners,YB JAGGERY POWDER 1KG,16,140,140,0,1
02-01-2025,"Grains, Flours & Dals",White jowar.F 1 kg,4,100,80,20,1
02-01-2025,Spices & Seasonings,JEERA 250 gms,15,125,105,20,1
02-01-2025,"Grains, Flours & Dals",BASMATHI RICE 1KG,4,150,135,15,1
02-01-2025,"Grains, Flours & Dals",Green gram 1 kg,4,150,130,20,1
02-01-2025,"Grains, Flours & Dals",Yellow jowar .F1 kg,4,110,100,10,1
02-01-2025,Spices & Seasonings,PN ORGANIC PINK SALT 1KG,15,124,124,0,1
02-01-2025,Baking & Cooking Aids,MTR GULAB JAMUN MIX 190GM,0,80,80,0,1
02-01-2025,Sweeteners,PN ORGANIC BROWN SUGAR 500GM,16,234,234,0,3
02-01-2025,Beverages,TATA CHAKRA GOLD PT 120GM,1,180,180,0,2
02-01-2025,Snacks & Ready-to-Eat,KURNOOL MARMURA,14,140,110,30,2
02-01-2025,"Grains, Flours & Dals",Urad dall 1 Kg,4,370,340,30,2
02-01-2025,"Grains, Flours & Dals",RED TUDAL 1KG,4,150,140,10,1
02-01-2025,"Grains, Flours & Dals",CHANA DAL 500GM,4,70,60,10,1
02-01-2025,"Grains, Flours & Dals",turdal 1kg,4,440,390,50,2
02-01-2025,Oils & Ghee,Cow ghee 500 ml,9,860,780,80,2
02-01-2025,Spices & Seasonings,Dalchin Chekka 50GM,15,50,40,10,1
02-01-2025,"Health, Wellness & Ayurvedic Products",MH Millets Malt 1KG,5,400,380,20,1
02-01-2025,"Dry Fruits, Nuts & Seeds",FLAX SEEDS 250GM,2,60,50,10,1
02-01-2025,"Health, Wellness & Ayurvedic Products",MH Baby Food 400GM,5,200,200,0,1
02-01-2025,Personal Care & Cosmetics,COW DURBAR 7 HERBS SHAMPOO,10,375,375,0,3
02-01-2025,"Grains, Flours & Dals",CHANA DAL 1KG,4,140,120,20,1
02-01-2025,Snacks & Ready-to-Eat,Popcorn Seeds 500GM,14,180,160,20,2
02-01-2025,Spices & Seasonings,Lavangam 50GM,15,60,50,10,1
02-01-2025,Spices & Seasonings,NUVVULU 250GM,15,80,70,10,1
02-01-2025,Household & Cleaning,VIM TROPICAL LEMON FRESHNESS 250ML,6,110,110,0,2
02-01-2025,Spices & Seasonings,Elaichi 25GM,15,145,120,25,1
02-01-2025,"Grains, Flours & Dals",BOMBAY RAVA,4,70,55,15,1
02-01-2025,"Dry Fruits, Nuts & Seeds",SALTED PISTA 250GM,2,400,350,50,1
02-01-2025,Oils & Ghee,Safflower oil 1 L,9,440,400,40,1
02-01-2025,Oils & Ghee,Coconut oil 1 L,9,440,400,40,1
02-01-2025,"Grains, Flours & Dals",split black gram 1 kg,4,180,170,10,1
02-01-2025,"Grains, Flours & Dals",split green gram 1 kg,4,150,140,10,1
02-01-2025,Pooja & Spiritual Items,SOSR SWATHHI 365,12,60,60,0,2
02-01-2025,Pooja & Spiritual Items,SWASTIK CAMPHORE,12,90,90,0,1
02-01-2025,"Grains, Flours & Dals",DM LOW GI SP 1KG,4,475,475,0,5
02-01-2025,Snacks & Ready-to-Eat,Popcorn Seeds 250GM,14,45,40,5,1
02-01-2025,"Grains, Flours & Dals",Arikadu ( kodo),4,140,110,30,1
02-01-2025,Sweeteners,Mishri 250 GM,16,35,30,5,1
02-01-2025,"Grains, Flours & Dals",UDALU (Barnyard millet) 1 kg,4,140,115,25,1
02-01-2025,General Household & Kitchenware,WOODEN SPOON BIG,3,40,40,0,1
02-01-2025,Milk & Dairy,BROWN EGGS 1P,7,84,72,12,6
02-01-2025,"Grains, Flours & Dals",MAAGAANI LOW GI SP 1KG,4,149,115,34,1
02-01-2025,Oils & Ghee,Coconut oil 500 ml,9,220,200,20,1
02-01-2025,Oils & Ghee,Groundnut oil 1 L,9,720,660,60,2
02-01-2025,Milk & Dairy,TOTAL CURD 50GMS,7,30,30,0,3
02-01-2025,Milk & Dairy,SANGAM TONED MILK 500ML,7,60,60,0,2
02-01-2025,Milk & Dairy,HRITAGE TONED MILK 500ML,7,60,60,0,2
02-01-2025,Oils & Ghee,Coconut oil 500 ml,9,220,200,20,1
02-01-2025,"Grains, Flours & Dals",KORRALU (FOXTAIL M) 500GM,4,130,110,20,2
02-01-2025,"Grains, Flours & Dals",JOWAR YELLOW 1 K,4,90,90,0,1
02-01-2025,"Grains, Flours & Dals",Green gram 1 kg,4,150,130,20,1
02-01-2025,"Grains, Flours & Dals",Idly Rava L 1KG,4,60,50,10,1
02-01-2025,Pooja & Spiritual Items,VRP APOORVA JAVADHU POW,12,35,35,0,1
02-01-2025,Oils & Ghee,Sesame oil 1 L,9,590,560,30,1
02-01-2025,Snacks & Ready-to-Eat,PEANUT CHILLI,14,5,5,0,1
02-01-2025,"Dry Fruits, Nuts & Seeds",YELLOW KISHMISH 250GM,2,130,110,20,1
02-01-2025,Sweeteners,SUGAR 500 GM,16,30,25,5,1
02-01-2025,"Dry Fruits, Nuts & Seeds",CASHEW 250GM,2,340,310,30,1
02-01-2025,"Grains, Flours & Dals",VYS.SP RICE 1 KG,4,350,325,25,5
02-01-2025,"Grains, Flours & Dals",Wheat Flour 1 kg,4,70,60,10,1
02-01-2025,Oils & Ghee,Groundnut oil 1 L,9,360,330,30,1
02-01-2025,"Grains, Flours & Dals",turdal 1kg,4,220,195,25,1
02-01-2025,General Household & Kitchenware,K1 KADAI,3,252,239.4,12.6,1
02-01-2025,General Household & Kitchenware,TEA CUP 1P,3,45,45,0,1
02-01-2025,"Grains, Flours & Dals",Wheat Flour 1 kg,4,70,60,10,1
02-01-2025,Pickles & Cooking Pastes,SD MAGAYA PICKLE,11,120,120,0,1
02-01-2025,"Grains, Flours & Dals",RAGI FLOUR 500GRMS,4,80,70,10,2
02-01-2025,Snacks & Ready-to-Eat,SD Vamu with palm jaggery 250gm,14,135,135,0,1
02-01-2025,Snacks & Ready-to-Eat,SD FINGER Millet with palm Jaggery 250gm,14,135,135,0,1
02-01-2025,"Dry Fruits, Nuts & Seeds",PUMPKIN SEEDS 250GM,2,200,160,40,1
02-01-2025,Oils & Ghee,Groundnut oil 1 L,9,720,660,60,2
02-01-2025,Spices & Seasonings,NUVVULU 500GM,15,160,140,20,1
02-01-2025,Oils & Ghee,Safflower oil 1 L,9,440,400,40,1
02-01-2025,Spices & Seasonings,Masala Karam 500 gms,15,260,240,20,1
02-01-2025,Pickles & Cooking Pastes,SD GARLIC PICKLE,11,110,110,0,1
02-01-2025,Oils & Ghee,Castor oil 200 ml,9,100,80,20,1
02-01-2025,Oils & Ghee,Coconut oil 500 ml,9,220,200,20,1
02-01-2025,Spices & Seasonings,SD Redgram Karam Powder 100GM,15,65,65,0,1
02-01-2025,Snacks & Ready-to-Eat,SUKH MIX,14,45,45,0,1
02-01-2025,"Dry Fruits, Nuts & Seeds",Groundnuts 500 gms,2,95,85,10,1
02-01-2025,Snacks & Ready-to-Eat,PEANUT CHILLI,14,10,10,0,2
02-01-2025,Snacks & Ready-to-Eat,SESAME CHIKKI,14,120,100,20,1
02-01-2025,Oils & Ghee,Groundnut oil 1 L,9,720,660,60,2
02-01-2025,Sweeteners,Natural Honey 500 gms,16,280,240,40,1
02-01-2025,Oils & Ghee,Coconut oil 500 ml,9,220,200,20,1
02-01-2025,Milk & Dairy,SANGAM TONED MILK 500ML,7,90,90,0,3
01-01-2025,Spices & Seasonings,DALCHIN POWDER M,15,100,90,10,1
01-01-2025,"Health, Wellness & Ayurvedic Products",MORINGA LEAF POWDER M,5,80,75,5,1
01-01-2025,Oils & Ghee,Sesame oil 1 L,9,590,560,30,1
01-01-2025,Oils & Ghee,Sesame oil 1 L,9,590,560,30,1
01-01-2025,Oils & Ghee,Groundnut oil 1 L,9,360,330,30,1
01-01-2025,"Grains, Flours & Dals",turdal 1kg,4,440,390,50,2
01-01-2025,"Grains, Flours & Dals",Wheat Rava M 1KG,4,65,55,10,1
01-01-2025,"Grains, Flours & Dals",Wheat Flour 2 kgs,4,140,120,20,1
01-01-2025,Spices & Seasonings,PURO Healthy Salt Crystal 1KG,15,135,135,0,1
01-01-2025,"Grains, Flours & Dals",Multigrain 1 kg,4,100,85,15,1
01-01-2025,"Grains, Flours & Dals",SAMALU (Little millet) 500 gms,4,85,65,20,1
01-01-2025,"Grains, Flours & Dals",Wheat Flour 1 kg,4,70,60,10,1
01-01-2025,"Grains, Flours & Dals",UDALU (Barnyard millet) 500 gms,4,70,60,10,1
01-01-2025,Oils & Ghee,Coconut oil 1 L,9,440,400,40,1
01-01-2025,Spices & Seasonings,Elaichi 25GM,15,145,120,25,1
01-01-2025,Spices & Seasonings,PRO HIMALAYAN PINK SALT 500GM,15,68,68,0,1
01-01-2025,"Grains, Flours & Dals",KORRALU (FOXTAIL M) 500GM,4,65,55,10,1
01-01-2025,Sweeteners,YB JAGGERY POWDER 1KG,16,140,140,0,1
01-01-2025,"Grains, Flours & Dals",PESARA PAPPU 1 KG,4,170,145,25,1
01-01-2025,"Grains, Flours & Dals",Quinova 500 gms,4,120,105,15,1
01-01-2025,"Grains, Flours & Dals",RED TUDAL 1KG,4,150,140,10,1
01-01-2025,"Grains, Flours & Dals",Arikalu (kodo),4,70,60,10,1
01-01-2025,Pooja & Spiritual Items,SWASTIK CAMPHORE,12,90,90,0,1
01-01-2025,"Grains, Flours & Dals",JOWAR YELLOW 1 K,4,90,90,0,1
01-01-2025,Snacks & Ready-to-Eat,VD BLACK PEPPER PAPAD 190GM,14,90,90,0,1
01-01-2025,Oils & Ghee,Olive Oil 1 L,9,1100,550,550,1
01-01-2025,"Grains, Flours & Dals",POORI ATTA,4,60,55,5,1
01-01-2025,"Grains, Flours & Dals",BAJRA 1 KG,4,30,25,5,0.5
01-01-2025,"Grains, Flours & Dals",BAJRA IDLY RAVA 400GM,4,65,65,0,1
01-01-2025,"Grains, Flours & Dals",JOWAR YELLOW 1 K,4,90,90,0,1
01-01-2025,"Grains, Flours & Dals",Wheat Flour 1 kg,4,70,60,10,1
01-01-2025,Personal Care & Cosmetics,SVE REETHA KUNKUDUKAYALU,10,199,199,0,1
01-01-2025,"Grains, Flours & Dals",Wheat Rava M 500GM,4,33,30,3,1
01-01-2025,"Dry Fruits, Nuts & Seeds",SD Mango cubes 100gm,2,45,45,0,1
01-01-2025,Household & Cleaning,GAJANAND BLACK DRAGN 10STI,6,60,60,0,3
01-01-2025,"Grains, Flours & Dals",RAGI FLOUR 500GRMS,4,40,35,5,1
01-01-2025,"Grains, Flours & Dals",White jowar.F 1 kg,4,100,80,20,1
01-01-2025,"Grains, Flours & Dals",Arikalu (kodo),4,70,60,10,1
01-01-2025,"Grains, Flours & Dals",Yellow jowar.F 500 gms,4,55,50,5,1
01-01-2025,"Grains, Flours & Dals",VYS.SP.RICE BAG 1,4,1800,"1,650.00",150,1
01-01-2025,"Grains, Flours & Dals",VYS.SP RICE 1 KG,4,140,130,10,2
01-01-2025,Oils & Ghee,Mustard oil 500 ml,9,220,195,25,1
01-01-2025,"Dry Fruits, Nuts & Seeds",ANJEER 250GM,2,400,360,40,1
01-01-2025,Oils & Ghee,Castor oil 200 ml,9,100,80,20,1
01-01-2025,Oils & Ghee,Groundnut oil 1 L,9,360,330,30,1
01-01-2025,Snacks & Ready-to-Eat,URBAN MARMURA 450GM,14,60,55,5,1
01-01-2025,"Grains, Flours & Dals",MELMEKER 250GMS,4,60,45,15,1
01-01-2025,"Grains, Flours & Dals",BASMATHI RICE 1KG,4,150,135,15,1
01-01-2025,"Dry Fruits, Nuts & Seeds",WALLNUTS 250GM,2,380,360,20,1
01-01-2025,"Grains, Flours & Dals",ANDU KORRALU (Brown top .mlt) 500,4,160,145,15,1
01-01-2025,"Dry Fruits, Nuts & Seeds",ANJEER 250GM,2,400,360,40,1
01-01-2025,"Dry Fruits, Nuts & Seeds",SUNFLOWER SEEDS 250GRM,2,150,130,20,1
01-01-2025,"Grains, Flours & Dals",KORRALU (FOXTAIL M) 1KG,4,300,220,80,2
01-01-2025,"Dry Fruits, Nuts & Seeds",WATERMELON SEEDS 250GRM,2,320,280,40,1
01-01-2025,"Dry Fruits, Nuts & Seeds",FLAX SEEDS 250GM,2,60,50,10,1
01-01-2025,"Dry Fruits, Nuts & Seeds",PUMPKIN SEEDS 250GM,2,200,160,40,1
01-01-2025,Oils & Ghee,Groundnut oil 1 L,9,360,330,30,1
01-01-2025,"Grains, Flours & Dals",SATHVI SABDANA 250GM,4,45,35,10,1
01-01-2025,Sweeteners,Mishri 500GM,16,70,60,10,1
01-01-2025,Oils & Ghee,Coconut oil 1 L,9,440,400,40,1
01-01-2025,Sweeteners,Natural Honey 1 kg,16,560,480,80,1
01-01-2025,Oils & Ghee,Groundnut oil 1 L,9,360,330,30,1
01-01-2025,Snacks & Ready-to-Eat,COPRA LADDU 200GM,14,100,80,20,1
01-01-2025,"Grains, Flours & Dals",RAGI FLOUR 1KG,4,160,140,20,2
01-01-2025,"Grains, Flours & Dals",VYS.SP RICE 1 KG,4,140,130,10,2
01-01-2025,"Health, Wellness & Ayurvedic Products",RB Max Protein Chinese Manchurian,5,45,45,0,1
01-01-2025,"Grains, Flours & Dals",Brown RICE 1KG,4,140,130,10,2
01-01-2025,"Grains, Flours & Dals",VGR rice 1 kg,4,140,130,10,2
01-01-2025,"Grains, Flours & Dals",White jowar.F 1 kg,4,100,80,20,1
01-01-2025,"Grains, Flours & Dals",Red Wheat Flour 1 kg,4,280,260,20,2
01-01-2025,Snacks & Ready-to-Eat,MP CHOCO ALMOND COOKIE,14,120,120,0,2
01-01-2025,Snacks & Ready-to-Eat,DOSA BATTER 1KG,14,60,60,0,1
01-01-2025,"Grains, Flours & Dals",VYS.SP.RICE BAG 1,4,1800,"1,650.00",150,1
01-01-2025,"Health, Wellness & Ayurvedic Products",RB Max Protein Choco Almond bar 50g,5,75,75,0,1
01-01-2025,Sweeteners,ACHUBELLAM 500GM,16,50,40,10,1
01-01-2025,Snacks & Ready-to-Eat,RAJGIRA PEANUT CHIKKI 450GM,14,125,125,0,1
01-01-2025,Snacks & Ready-to-Eat,SALTED PHALLI,14,65,65,0,1
01-01-2025,Oils & Ghee,ANURAG RB OIL,9,120,100,20,1
01-01-2025,"Grains, Flours & Dals",VGR rice 1 kg,4,140,130,10,2
01-01-2025,"Dry Fruits, Nuts & Seeds",SATHVI CHIA SEEDS 100GM,2,200,160,40,2
01-01-2025,"Grains, Flours & Dals",DH URAD GOTA 1KG,4,215,190,25,1
01-01-2025,"Grains, Flours & Dals",SRILATHA RICE RAVVA 500GM,4,105,105,0,3
01-01-2025,"Grains, Flours & Dals",White Chana 500GM,4,240,200,40,2
01-01-2025,"Grains, Flours & Dals",EM kodo upma R 500g,4,129,129,0,1
01-01-2025,Snacks & Ready-to-Eat,VD MINAPA VADIYAM,14,65,65,0,1
01-01-2025,"Grains, Flours & Dals",BOMBAY RAVA,4,70,55,15,1
01-01-2025,"Grains, Flours & Dals",Wheat Flour 1 kg,4,70,60,10,1
01-01-2025,Household & Cleaning,VIM TROPICAL LEMON FRESHNESS 250ML,6,110,110,0,2
01-01-2025,"Dry Fruits, Nuts & Seeds",GF KIMIA DATES 500GM,2,295,190,105,1
01-01-2025,Spices & Seasonings,Avalu small 250 gms,15,60,40,20,1
01-01-2025,"Health, Wellness & Ayurvedic Products",RB Max Protein DESI MASALA 60gm,5,45,45,0,1
01-01-2025,"Grains, Flours & Dals",THICK POHA 1KG,4,80,70,10,1
01-01-2025,Spices & Seasonings,SH BAY LEAF / TEJ PATTA 30GM,15,35,35,0,1
01-01-2025,"Grains, Flours & Dals",SRILATHA RICE RAVVA 500GM,4,105,105,0,3
01-01-2025,Sweeteners,Mishri 250 GM,16,35,30,5,1
01-01-2025,Spices & Seasonings,TM MIRCH POWDER 200GM,15,163,163,0,1
01-01-2025,Sweeteners,SH JAGGERY POWDER 500GM,16,80,80,0,1
01-01-2025,Sweeteners,YB Brown Sugar 1KG,16,140,140,0,1
01-01-2025,Spices & Seasonings,Dry Mirchi 200 gms,15,80,60,20,1
01-01-2025,Oils & Ghee,Black Sesame oil 1 L,9,1760,"1,520.00",240,4
01-01-2025,Pooja & Spiritual Items,BALAJI BEL PHOOL DHOOP STICKS 10STK,12,70,70,0,1
01-01-2025,"Dry Fruits, Nuts & Seeds",ALMONDS 250GM,2,280,260,20,1
01-01-2025,Spices & Seasonings,PURO Healthy Salt 1KG,15,110,110,0,1
01-01-2025,"Dry Fruits, Nuts & Seeds",SD Mango cubes 200gm,2,180,180,0,2
01-01-2025,Oils & Ghee,Freedom Rice Bran Oil 1L,9,776,720,56,4
01-01-2025,"Grains, Flours & Dals",Bombay Rava 500GM,4,35,30,5,1
01-01-2025,"Grains, Flours & Dals",turdal 1kg,4,220,195,25,1
01-01-2025,"Grains, Flours & Dals",RICE FLOUR 1KG,4,70,50,20,1
01-01-2025,"Grains, Flours & Dals",Urad dall 1 Kg,4,555,510,45,3
01-01-2025,Spices & Seasonings,JEERA 250 gms,15,125,105,20,1
01-01-2025,"Dry Fruits, Nuts & Seeds",KAJU HALF 250GM,2,310,290,20,1
01-01-2025,"Dry Fruits, Nuts & Seeds",Groundnuts 1 kg,2,190,170,20,1
01-01-2025,"Grains, Flours & Dals",Idly Rava L 1KG,4,120,100,20,2
01-01-2025,Spices & Seasonings,ROYAL SAFFRON 400GRMS,15,130,130,0,2
01-01-2025,Snacks & Ready-to-Eat,PN ORGANIC PUFFED RICE 200GM,14,55,55,0,1
01-01-2025,"Grains, Flours & Dals",BARLEY SEEDS 250GMS,4,40,35,5,1
01-01-2025,Spices & Seasonings,Miriyalu 50GM,15,100,80,20,1
01-01-2025,General Household & Kitchenware,PREMIER,3,190,190,0,2
01-01-2025,Misc,HOME LIKES,8,10,10,0,1
01-01-2025,Pooja & Spiritual Items,SWASTIK CAMPHORE,12,90,90,0,1
01-01-2025,"Dry Fruits, Nuts & Seeds",PULMAKHANA 100 GM,2,180,170,10,1
01-01-2025,Beverages,BB TAJ MAHAL 275GM,1,235,235,0,1
01-01-2025,"Grains, Flours & Dals",Chana Flour 500 gms,4,70,65,5,1
01-01-2025,Personal Care & Cosmetics,BT FRESH NEEM,10,185,185,0,1
01-01-2025,Spices & Seasonings,RED COPRA 250GMS,15,85,74,11,1
01-01-2025,Spices & Seasonings,Tamarind 500GM,15,160,130,30,1
01-01-2025,Sweeteners,YB Brown Sugar 500GM,16,75,75,0,1
01-01-2025,Personal Care & Cosmetics,DWI SMARA SOAP 100GM,10,375,375,0,5
01-01-2025,"Grains, Flours & Dals",VGR rice 1 kg,4,140,130,10,2
01-01-2025,"Grains, Flours & Dals",Chana Flour 500 gms,4,70,65,5,1
01-01-2025,Pooja & Spiritual Items,DEVADARU GD,12,110,110,0,1
01-01-2025,Snacks & Ready-to-Eat,VD SAGOPAPAD 150GM,14,55,55,0,1
01-01-2025,Spices & Seasonings,PN ORGANIC PINK SALT 1KG,15,124,124,0,1
01-01-2025,Spices & Seasonings,Elaichi 25GM,15,120,95,25,1
01-01-2025,Pooja & Spiritual Items,BALAJI LAVENDER DOOP STICK 10STK,12,125,125,0,1
01-01-2025,Beverages,CONTINENTAL XTRA 50GM,1,120,120,0,1
01-01-2025,"Health, Wellness & Ayurvedic Products",MD Bringaraj Choornam 100GM,5,80,80,0,1
01-01-2025,Snacks & Ready-to-Eat,SESAME CHIKKI,14,120,100,20,1
01-01-2025,"Dry Fruits, Nuts & Seeds",ALMONDS 250GM,2,280,260,20,1
01-01-2025,"Grains, Flours & Dals",Wheat Rava S 500GM,4,33,30,3,1
01-01-2025,Snacks & Ready-to-Eat,SD barnyard Millet with palm jaggery,14,135,135,0,1
01-01-2025,Personal Care & Cosmetics,GODREJ NATURAL BLACK,10,15,15,0,1
01-01-2025,Sweeteners,YB JAGGERY POWDER 500GMS,16,150,150,0,2
01-01-2025,Snacks & Ready-to-Eat,PALLI LADDU 200GMS,14,180,140,40,2
01-01-2025,Sweeteners,YB JAGGERY POWDER 500GMS,16,150,150,0,2
01-01-2025,"Grains, Flours & Dals",THIN POHA 500GM,4,40,35,5,1
01-01-2025,Snacks & Ready-to-Eat,SANDWICH BREAD,14,55,55,0,1
01-01-2025,"Dry Fruits, Nuts & Seeds",PN ORGANIC MAKHANA 50GM,2,125,125,0,1
01-01-2025,"Grains, Flours & Dals",BLACK GRAM 1KG,4,150,140,10,1
01-01-2025,"Grains, Flours & Dals",DISANO OATS 1KG,4,285,285,0,1
01-01-2025,Oils & Ghee,Groundnut oil 1 L,9,360,330,30,1
01-01-2025,"Dry Fruits, Nuts & Seeds",SD Mango cubes 200gm,2,90,90,0,1
01-01-2025,Snacks & Ready-to-Eat,BATANA NGT 70GMS,14,20,20,0,1
01-01-2025,Milk & Dairy,BROWN EGGS TRAY 30P,7,360,330,30,1
01-01-2025,Snacks & Ready-to-Eat,HS Ragi biscuits,14,50,50,0,1
01-01-2025,Snacks & Ready-to-Eat,GB SALT COOKIES,14,60,55,5,1
01-01-2025,"Grains, Flours & Dals",SATHVI SABDANA 250GM,4,45,35,10,1
01-01-2025,"Grains, Flours & Dals",RAGI FLOUR 1KG,4,80,70,10,1
01-01-2025,Oils & Ghee,Groundnut oil 1 L,9,360,330,30,1
01-01-2025,"Grains, Flours & Dals",Wheat Flour 2 kgs,4,140,120,20,1
01-01-2025,Spices & Seasonings,Masala Karam 500 gms,15,260,240,20,1
01-01-2025,Sweeteners,MADHUR SUGAR 1KG,16,65,55,10,1
01-01-2025,"Grains, Flours & Dals",Wheat Rava S 1KG,4,65,55,10,1
01-01-2025,"Grains, Flours & Dals",BOMBAY RAVA,4,70,55,15,1
01-01-2025,"Grains, Flours & Dals",Wheat Flour 1 kg,4,140,120,20,2
01-01-2025,Spices & Seasonings,Elaichi 25GM,15,120,95,25,1
01-01-2025,Spices & Seasonings,Miriyalu 50GM,15,100,80,20,1
01-01-2025,Personal Care & Cosmetics,BAMBOO TOOTH BRUSH,10,240,240,0,2
01-01-2025,Personal Care & Cosmetics,ORGANIC SPONGE LOOFAH,10,70,70,0,1
01-01-2025,Snacks & Ready-to-Eat,MORINGA LEAVES PAPAD 200GM,14,90,90,0,1
01-01-2025,Snacks & Ready-to-Eat,SATHVI PALLI CHIKKI 200GM,14,100,80,20,1
01-01-2025,Milk & Dairy,BROWN EGGS TRAY 30P,7,360,330,30,1
01-01-2025,"Grains, Flours & Dals",PRO ORG MEDIUM POHA 500G,4,78,78,0,1
01-01-2025,Oils & Ghee,Groundnut oil 5 L,9,1800,"1,600.00",200,1
01-01-2025,Spices & Seasonings,Turmeric powder 250 gms,15,100,75,25,1
01-01-2025,"Grains, Flours & Dals",MELMEKER 250GMS,4,60,50,10,1
01-01-2025,"Dry Fruits, Nuts & Seeds",WALLNUTS 250GM,2,380,360,20,1
01-01-2025,Sweeteners,GS Palm Jaggery Powder 400GM,16,180,180,0,1
01-01-2025,"Dry Fruits, Nuts & Seeds",PUMPKIN SEEDS 250GM,2,200,160,40,1
01-01-2025,Spices & Seasonings,AVALU 100GM,15,25,20,5,1
01-01-2025,Milk & Dairy,TOTAL CURD 50GMS,7,10,10,0,1
01-01-2025,Milk & Dairy,SANGAM TONED MILK 500ML,7,30,30,0,1
01-01-2025,Spices & Seasonings,Menthulu 250 gms,15,50,45,5,1
01-01-2025,Snacks & Ready-to-Eat,PUMPKIN CHIKKI 200GM,14,140,120,20,1
01-01-2025,"Grains, Flours & Dals",Wheat Flour 1 kg,4,210,180,30,3
01-01-2025,"Grains, Flours & Dals",turdal 1kg,4,440,390,50,2
01-01-2025,"Grains, Flours & Dals",Chana Flour 1 kg,4,140,130,10,1
01-01-2025,Personal Care & Cosmetics,ORGANIC SPONGE LOOFAH,10,70,70,0,1
01-01-2025,"Grains, Flours & Dals",White jowar.F 1 kg,4,100,80,20,1
01-01-2025,Snacks & Ready-to-Eat,FUN TIME CRUNCH,14,135,135,0,3
01-01-2025,"Grains, Flours & Dals",White jowar.F 1 kg,4,100,80,20,1
01-01-2025,Beverages,BRU GREEN LABEL 1.2G,1,48,48,0,24
01-01-2025,"Grains, Flours & Dals",Wheat Flour 1 kg,4,140,120,20,2
01-01-2025,Sweeteners,Mishri 250 GM,16,35,30,5,1
01-01-2025,"Grains, Flours & Dals",Chana Flour 1 kg,4,140,130,10,1
01-01-2025,Pooja & Spiritual Items,SOSR SWATHHI 365,12,30,30,0,1
01-01-2025,General Household & Kitchenware,SABEENA,3,30,30,0,1
01-01-2025,Snacks & Ready-to-Eat,PEANUT CHIKKI 450GM,14,125,125,0,1
01-01-2025,"Grains, Flours & Dals",Red Wheat Flour 1 kg,4,420,390,30,3
01-01-2025,"Grains, Flours & Dals",HS jowar idly rava 500 gms,4,130,130,0,2
01-01-2025,"Grains, Flours & Dals",split black gram 500 gms,4,90,85,5,1
01-01-2025,Oils & Ghee,Groundnut oil 1 L,9,360,330,30,1
01-01-2025,"Grains, Flours & Dals",turdal 1kg,4,220,195,25,1
01-01-2025,"Health, Wellness & Ayurvedic Products",JAMBU SEED CHOORNAM 100GM,5,80,80,0,1
01-01-2025,Snacks & Ready-to-Eat,SD SESAME PAPAD,14,80,80,0,1
01-01-2025,Snacks & Ready-to-Eat,SD BLACK GRAM PAPADS,14,80,80,0,1
01-01-2025,Oils & Ghee,Sesame oil 1 L,9,590,560,30,1
01-01-2025,Oils & Ghee,Groundnut oil 1 L,9,360,330,30,1
01-01-2025,General Household & Kitchenware,VERMI COMPOST MIX,3,30,30,0,1
01-01-2025,Snacks & Ready-to-Eat,SESAME LADDU 200GM,14,100,80,20,1
01-01-2025,Spices & Seasonings,SD Garlic Karam Powder 100GM,15,65,65,0,1
01-01-2025,Milk & Dairy,BROWN EGGS 1P,7,140,120,20,10
01-01-2025,"Grains, Flours & Dals",THICK POHA 500GM,4,40,35,5,1
01-01-2025,Oils & Ghee,Groundnut oil 1 L,9,720,660,60,2
01-01-2025,Milk & Dairy,TOTAL CURD 50GMS,7,20,20,0,2
01-01-2025,Snacks & Ready-to-Eat,VD BOONDI 175GM,14,60,60,0,1
01-01-2025,"Grains, Flours & Dals",Idly Rava L 1KG,4,60,50,10,1
01-01-2025,"Grains, Flours & Dals",Wheat Flour 1 kg,4,140,120,20,2
01-01-2025,Milk & Dairy,BROWN EGGS 1P,7,56,48,8,4
01-01-2025,"Grains, Flours & Dals",Wheat Rava M 1KG,4,65,55,10,1
01-01-2025,"Grains, Flours & Dals",RAGI FLOUR 1KG,4,80,70,10,1
01-01-2025,"Grains, Flours & Dals",Wheat Rava M 500GM,4,33,30,3,1
01-01-2025,"Dry Fruits, Nuts & Seeds",PUMPKIN SEEDS 250GM,2,200,160,40,1
01-01-2025,Spices & Seasonings,Telaga Pindi 500GM,15,80,70,10,1
01-01-2025,Oils & Ghee,Groundnut oil 5 L,9,1800,"1,600.00",200,1
01-01-2025,Oils & Ghee,Coconut oil 1 L,9,440,400,40,1
01-01-2025,Oils & Ghee,Sesame oil 1 L,9,590,560,30,1
01-01-2025,Oils & Ghee,Safflower oil 1 L,9,440,400,40,1
01-01-2025,Oils & Ghee,Sesame oil 1 L,9,590,560,30,1
01-01-2025,Oils & Ghee,Groundnut oil 5 L,9,1800,"1,600.00",200,1
01-01-2025,"Grains, Flours & Dals",Chana Flour 1 kg,4,140,130,10,1
01-01-2025,Oils & Ghee,GANTASALA A2 COW GHEE 500ML,9,550,550,0,1
01-01-2025,"Grains, Flours & Dals",RED WHEAT 1 KG,4,260,240,20,2
01-01-2025,Spices & Seasonings,NUVVULU 250GM,15,160,140,20,2
01-01-2025,"Dry Fruits, Nuts & Seeds",CASHEW 250GM,2,340,310,30,1
01-01-2025,"Grains, Flours & Dals",Yellow jowar .F1 kg,4,110,100,10,1
01-01-2025,"Grains, Flours & Dals",FLOUR CHARGE,4,84,84,0,7
01-01-2025,Snacks & Ready-to-Eat,GB SALT COOKIES,14,60,55,5,1
01-01-2025,"Dry Fruits, Nuts & Seeds",FLAX SEEDS 250GM,2,60,50,10,1
01-01-2025,"Grains, Flours & Dals",WHEAT 1 KG,4,300,250,50,5
01-01-2025,Beverages,TAJ MAHAL 100GM,1,95,95,0,1
01-01-2025,Oils & Ghee,Groundnut oil 1 L,9,720,660,60,2
01-01-2025,Oils & Ghee,Coconut oil 500 ml,9,220,200,20,1
01-01-2025,"Dry Fruits, Nuts & Seeds",Groundnuts 1 kg,2,190,170,20,1
01-01-2025,Spices & Seasonings,Turmeric powder 250 gms,15,100,75,25,1
01-01-2025,Oils & Ghee,Groundnut oil 5 L,9,1800,"1,600.00",200,1
01-01-2025,"Grains, Flours & Dals",Multigrain 1 kg,4,200,170,30,2
01-01-2025,Spices & Seasonings,Chilli powder 500 gms,15,290,210,80,1
01-01-2025,Snacks & Ready-to-Eat,VD RICE MURUKU 150GM,14,50,50,0,1
01-01-2025,"Grains, Flours & Dals",Wheat Flour 2 kgs,4,140,120,20,1
01-01-2025,Snacks & Ready-to-Eat,KURNOOL MARMURA,14,70,55,15,1
01-01-2025,Snacks & Ready-to-Eat,GANTASALA GINGER CANDY 200GM,14,105,105,0,1
01-01-2025,"Grains, Flours & Dals",Wheat Rava M 500GM,4,33,30,3,1
01-01-2025,Oils & Ghee,Groundnut oil 5 L,9,1800,"1,600.00",200,1
01-01-2025,"Grains, Flours & Dals",UDALU (Barnyard millet) 1 kg,4,140,115,25,1
01-01-2025,"Grains, Flours & Dals",SAMALU (Little millet) 1 kg,4,170,130,40,1
01-01-2025,"Grains, Flours & Dals",RAGULU 1 KG,4,35,30,5,0.5
01-01-2025,"Grains, Flours & Dals",Wheat Flour 1 kg,4,70,60,10,1
01-01-2025,Milk & Dairy,BROWN EGGS 1P,7,84,72,12,6
01-01-2025,"Grains, Flours & Dals",Arikadu ( kodo),4,140,110,30,1
01-01-2025,Spices & Seasonings,PRO ORG FENUGREEK 200GM,15,86,86,0,1
01-01-2025,"Grains, Flours & Dals",BAJRA 1 KG,4,30,25,5,0.5
01-01-2025,Snacks & Ready-to-Eat,Popcorn Seeds 250GM,14,45,40,5,1
01-01-2025,Snacks & Ready-to-Eat,SD Groundnut with palm jaggery 250gm,14,135,135,0,1
01-01-2025,Spices & Seasonings,Biryani Leaf 25GM,15,30,20,10,1
01-01-2025,"Grains, Flours & Dals",GS WHEAT POHA 200 GM,4,60,60,0,1
01-01-2025,"Grains, Flours & Dals",Green gram 1 kg,4,150,130,20,1
01-01-2025,General Household & Kitchenware,VERMI COMPOST MIX,3,60,60,0,2
01-01-2025,"Dry Fruits, Nuts & Seeds",Groundnuts 500 gms,2,95,85,10,1
01-01-2025,"Grains, Flours & Dals",MUSTARD CAKE,4,50,50,0,1
01-01-2025,Snacks & Ready-to-Eat,ANNAPURNA APPALAM,14,70,70,0,2
01-01-2025,Oils & Ghee,Sesame oil 5 L,9,2950,"2,700.00",250,1
01-01-2025,Oils & Ghee,Groundnut oil 5 L,9,1800,"1,550.00",250,1
01-01-2025,Oils & Ghee,Groundnut oil 1 L,9,360,330,30,1
01-01-2025,"Grains, Flours & Dals",Wheat Rava S 500GM,4,33,30,3,1
01-01-2025,Snacks & Ready-to-Eat,RINGS 200GM,14,30,30,0,1
01-01-2025,Sweeteners,YB Brown Sugar 500GM,16,75,75,0,1
01-01-2025,Oils & Ghee,Sesame oil 500ml,9,295,280,15,1
01-01-2025,Oils & Ghee,Safflower oil 500 ml,9,220,200,20,1
01-01-2025,Sweeteners,SUGAR 1KG,16,60,50,10,1
01-01-2025,"Grains, Flours & Dals",THIN POHA 500GM,4,40,35,5,1
01-01-2025,"Dry Fruits, Nuts & Seeds",ANJEER 250GM,2,400,360,40,1
01-01-2025,"Health, Wellness & Ayurvedic Products",RB FRUITS &amp;seeds Cranberries,5,45,45,0,1
01-01-2025,"Dry Fruits, Nuts & Seeds",Putnalu 250GM,2,45,38,7,1
01-01-2025,Snacks & Ready-to-Eat,Corn Chips 250GM,14,40,35,5,1
01-01-2025,"Grains, Flours & Dals",Wheat Flour 1 kg,4,70,60,10,1
01-01-2025,Spices & Seasonings,NUVVULU 250GM,15,80,70,10,1
01-01-2025,"Grains, Flours & Dals",VYS.SP.RICE 10 KGS,4,700,650,50,1
01-01-2025,Milk & Dairy,BROWN EGGS 1P,7,84,72,12,6
01-01-2025,"Grains, Flours & Dals",VYS.SP RICE 1 KG,4,105,97.5,7.5,1.5
01-01-2025,Snacks & Ready-to-Eat,SATHVI REGIVADA 200GM,14,80,60,20,1
01-01-2025,"Grains, Flours & Dals",Em Multimillet upma 500g,4,129,129,0,1
01-01-2025,General Household & Kitchenware,SIRIDHANYALU BOOK,3,200,180,20,1
01-01-2025,"Grains, Flours & Dals",EM kodo upma R 500g,4,129,129,0,1
01-01-2025,Spices & Seasonings,Turmeric powder 250 gms,15,100,75,25,1
01-01-2025,"Grains, Flours & Dals",Wheat Flour 1 kg,4,210,180,30,3
01-01-2025,"Health, Wellness & Ayurvedic Products",RB Max Protein Choco Almond bar 50g,5,75,75,0,1
01-01-2025,"Grains, Flours & Dals",Wheat Flour 1 kg,4,210,180,30,3
01-01-2025,Spices & Seasonings,Chilli powder 1 kg,15,580,420,160,1
01-01-2025,Pooja & Spiritual Items,BALAJI BEL PHOOL STICKS 90GM,12,60,60,0,1
01-01-2025,"Grains, Flours & Dals",Em jowar idly R 500G,4,75,75,0,1
01-01-2025,"Grains, Flours & Dals",RICE FLOUR 1KG,4,70,50,20,1
01-01-2025,Pooja & Spiritual Items,SREE REAL KASTURI STICKS 90GM,12,72,72,0,1
01-01-2025,"Grains, Flours & Dals",Bajra Flour 1 kg,4,70,60,10,1
01-01-2025,"Grains, Flours & Dals",Chana Flour 500 gms,4,70,65,5,1
01-01-2025,Snacks & Ready-to-Eat,VD RICE PAPAD 150GM,14,50,50,0,1
01-01-2025,"Grains, Flours & Dals",Yellow jowar .F1 kg,4,110,100,10,1
01-01-2025,"Grains, Flours & Dals",White jowar.F 1 kg,4,300,240,60,3
01-01-2025,"Dry Fruits, Nuts & Seeds",Groundnuts 1 kg,2,190,170,20,1
01-01-2025,"Grains, Flours & Dals",Idly Rava L 1KG,4,120,100,20,2
01-01-2025,"Dry Fruits, Nuts & Seeds",MAHA BEERA SEEDS 100GM,2,60,60,0,1
01-01-2025,Oils & Ghee,Sesame oil 500ml,9,295,280,15,1
01-01-2025,Snacks & Ready-to-Eat,ANNAPURNA APPALAM,14,35,35,0,1
01-01-2025,Oils & Ghee,Coconut oil 500 ml,9,220,200,20,1
01-01-2025,Spices & Seasonings,NUVVULU 250GM,15,80,70,10,1
01-01-2025,Oils & Ghee,Black Sesame oil 500 ml,9,220,190,30,1
01-01-2025,Snacks & Ready-to-Eat,VD RED CHILLI RICEPAPAD 150GM,14,50,50,0,1
01-01-2025,Snacks & Ready-to-Eat,VD RICE SAGO PAPAD 150GM,14,55,55,0,1
01-01-2025,Snacks & Ready-to-Eat,SD SESAME PAPAD,14,80,80,0,1
01-01-2025,"Grains, Flours & Dals",White jowar.F 1 kg,4,100,80,20,1
01-01-2025,Oils & Ghee,Groundnut oil 1 L,9,720,660,60,2
01-01-2025,Spices & Seasonings,NUVVULU 500GM,15,160,140,20,1
01-01-2025,"Dry Fruits, Nuts & Seeds",PULMAKHANA 100 GM,2,180,170,10,1
01-01-2025,Spices & Seasonings,Tamarind 250GMS,15,80,65,15,1
01-01-2025,Spices & Seasonings,Chilli powder 500 gms,15,290,210,80,1
01-01-2025,"Grains, Flours & Dals",KORRALU (FOXTAIL M) 1KG,4,150,110,40,1
01-01-2025,Oils & Ghee,Cow ghee 500 ml,9,430,390,40,1
01-01-2025,Oils & Ghee,Groundnut oil 1 L,9,360,330,30,1
01-01-2025,Pooja & Spiritual Items,VRP APOORVA JAVADHU POW,12,35,35,0,1
01-01-2025,"Grains, Flours & Dals",SH RED POHA 500GM,4,75,75,0,1
01-01-2025,Snacks & Ready-to-Eat,BATANA NGT 70GMS,14,40,40,0,2
01-01-2025,Personal Care & Cosmetics,KHADI Neem Anti Dandruff Shampoo,10,199,199,0,1
01-01-2025,Snacks & Ready-to-Eat,SATHVI MIXED CHIKKI 200GM,14,120,100,20,1
01-01-2025,"Grains, Flours & Dals",Red Wheat Flour 1 kg,4,140,130,10,1
01-01-2025,General Household & Kitchenware,SABEENA,3,30,30,0,1
01-01-2025,Oils & Ghee,Safflower oil 1 L,9,440,400,40,1
01-01-2025,Beverages,ASSAM TEA GINGER TEA POWDER 250GM,1,190,190,0,1
01-01-2025,Spices & Seasonings,Chilli powder 500 gms,15,290,210,80,1
01-01-2025,Milk & Dairy,SANGAM FULL CREAM MILK 500ML,7,38,38,0,1
01-01-2025,"Grains, Flours & Dals",Red Bobarlu 1 kg,4,190,170,20,1
01-01-2025,"Grains, Flours & Dals",MIXED FLOUR,4,144,144,0,1
01-01-2025,"Grains, Flours & Dals",Chana Flour 500 gms,4,70,65,5,1
01-01-2025,Snacks & Ready-to-Eat,SD JOWAR WITH PALM JAGGERY 250GM,14,135,135,0,1
01-01-2025,Snacks & Ready-to-Eat,RSC ORANGE 100GMS,14,20,20,0,1
01-01-2025,"Grains, Flours & Dals",MIXED FLOUR,4,10,10,0,1
01-01-2025,"Grains, Flours & Dals",Chittimuthaylu rice 1 kg,4,160,140,20,1
01-01-2025,"Grains, Flours & Dals",VYS.SP RICE 1 KG,4,350,325,25,5
01-01-2025,Spices & Seasonings,SWASTIKS GINGER &amp;GARLIC PASTE,15,69,69,0,1
01-01-2025,Milk & Dairy,HRITAGE TONED MILK 500ML,7,30,30,0,1
01-01-2025,Spices & Seasonings,MTR Sambar Powder 200GM,15,150,150,0,1
01-01-2025,"Grains, Flours & Dals",SABDANA,4,45,35,10,1
01-01-2025,"Grains, Flours & Dals",SRILALITHA 5KG PINK B,4,465,390,75,1
01-01-2025,"Grains, Flours & Dals",MIXED FLOUR,4,217,217,0,1
01-01-2025,Oils & Ghee,Groundnut oil 1 L,9,360,330,30,1
01-01-2025,Oils & Ghee,Groundnut oil 1 L,9,360,330,30,1
01-01-2025,Oils & Ghee,Safflower oil 1 L,9,440,400,40,1
01-01-2025,"Grains, Flours & Dals",VYS.SP.RICE BAG 1,4,1800,"1,650.00",150,1
01-01-2025,"Grains, Flours & Dals",Wheat Flour 1 kg,4,140,120,20,2
01-01-2025,"Grains, Flours & Dals",RAGI FLOUR 1KG,4,80,70,10,1
01-01-2025,Milk & Dairy,BROWN EGGS TRAY 30P,7,360,330,30,1
01-01-2025,"Grains, Flours & Dals",POORI ATTA,4,60,55,5,1
01-01-2025,"Grains, Flours & Dals",THICK POHA 1KG,4,80,70,10,1
01-01-2025,Milk & Dairy,HRITAGE TONED MILK 500ML,7,30,30,0,1
01-01-2025,Snacks & Ready-to-Eat,PALLI LADDU 200GMS,14,90,70,20,1
01-01-2025,Milk & Dairy,BROWN EGGS 1P,7,28,24,4,2
01-01-2025,Milk & Dairy,BROWN EGGS TRAY 30P,7,360,330,30,1
01-01-2025,"Grains, Flours & Dals",VYS.SP RICE 1 KG,4,140,130,10,2
01-01-2025,Beverages,BRU GREEN LABEL 1.2G,1,28,28,0,14
01-01-2025,"Grains, Flours & Dals",SA YELLOW JOWAR RAVA 500GM,4,95,95,0,1
01-01-2025,"Grains, Flours & Dals",split green gram 500 gms,4,75,70,5,1
01-01-2025,Milk & Dairy,SANGAM TONED MILK 500ML,7,30,30,0,1
01-01-2025,"Grains, Flours & Dals",MELMEKER 250GMS,4,60,45,15,1
01-01-2025,"Dry Fruits, Nuts & Seeds",PUMPKIN SEEDS 250GM,2,200,160,40,1
01-01-2025,"Grains, Flours & Dals",Wheat Rava S 500GM,4,33,30,3,1
01-01-2025,Spices & Seasonings,AV Iodized Salt 1KG,15,28,25,3,1
01-01-2025,"Grains, Flours & Dals",RAGI FLOUR 1KG,4,80,70,10,1
31-12-2024,Milk & Dairy,BROWN EGGS TRAY 30P,7,360,330,30,1
31-12-2024,"Grains, Flours & Dals",Wheat Flour 1 kg,4,140,120,20,2
31-12-2024,Spices & Seasonings,SATHVI ANASAPUVUU 25GM,15,90,65,25,1
31-12-2024,Spices & Seasonings,SATHVI BIRYANI LEAF 25GM,15,30,20,10,1
31-12-2024,Personal Care & Cosmetics,HERBAL BATH POWDER 200GM,10,80,80,0,1
31-12-2024,Spices & Seasonings,Dry Mirchi 200 gms,15,80,60,20,1
31-12-2024,Spices & Seasonings,Jeera 100GM,15,50,45,5,1
31-12-2024,Household & Cleaning,VIM 300GM,6,60,60,0,2
31-12-2024,Spices & Seasonings,Elaichi 25GM,15,120,95,25,1
31-12-2024,Spices & Seasonings,AVALU 100GM,15,25,20,5,1
31-12-2024,Spices & Seasonings,Masala Karam 250 gms,15,130,120,10,1
31-12-2024,Spices & Seasonings,EV Chicken Masala 50GM,15,48,48,0,1
31-12-2024,Oils & Ghee,Groundnut oil 1 L,9,720,660,60,2
31-12-2024,Spices & Seasonings,ROYAL SAFFRON,15,250,250,0,2
31-12-2024,Spices & Seasonings,Coconut Powder 250GM,15,90,70,20,1
31-12-2024,Oils & Ghee,Groundnut oil 1 L,9,720,660,60,2
31-12-2024,"Grains, Flours & Dals",turdal 1kg,4,440,390,50,2
31-12-2024,Spices & Seasonings,Dry Mirchi 200 gms,15,80,80,0,1
31-12-2024,Oils & Ghee,BUFFALLO GHEE 500ML,9,410,370,40,1
31-12-2024,"Grains, Flours & Dals",Urad dall 500 gms,4,95,85,10,1
31-12-2024,"Grains, Flours & Dals",Urad dall 1 Kg,4,185,170,15,1
31-12-2024,Spices & Seasonings,Jeera 100GM,15,50,45,5,1
31-12-2024,Oils & Ghee,Castor oil 200 ml,9,100,80,20,1
31-12-2024,"Grains, Flours & Dals",turdal 500 gms,4,110,100,10,1
31-12-2024,Snacks & Ready-to-Eat,VD MURUKU 175GM,14,60,60,0,1
31-12-2024,"Health, Wellness & Ayurvedic Products",MH Millets Malt 500GM,5,200,190,10,1
31-12-2024,Oils & Ghee,Sesame oil 500ml,9,295,280,15,1
31-12-2024,"Grains, Flours & Dals",DISANO OATS 1KG,4,142,142,0,1
31-12-2024,"Grains, Flours & Dals",HS BARLEY FLAKES 250GM 1+1,4,59,59,0,1
31-12-2024,"Grains, Flours & Dals",HS JOWAR FLAKES 250GM 1+1,4,59,59,0,1
31-12-2024,"Grains, Flours & Dals",SH JOWAR DALIYA,4,65,65,0,1
31-12-2024,"Grains, Flours & Dals",SAMALU (Little millet) 500 gms,4,85,65,20,1
31-12-2024,Spices & Seasonings,Marati Magga 50GM,15,130,110,20,1
31-12-2024,"Health, Wellness & Ayurvedic Products",MD Rose Patals Choornam 30GM,5,180,180,0,2
31-12-2024,Spices & Seasonings,SATHVI ANASAPUVUU 25GM,15,90,65,25,1
31-12-2024,"Health, Wellness & Ayurvedic Products",MD Kasturi Pasupu Choornam 50GM,5,80,80,0,1
31-12-2024,Spices & Seasonings,Dalchin Chekka 50GM,15,50,40,10,1
31-12-2024,Milk & Dairy,BROWN EGGS 1P,7,336,288,48,24
31-12-2024,"Health, Wellness & Ayurvedic Products",MH Millets Malt 500GM,5,200,190,10,1
31-12-2024,Snacks & Ready-to-Eat,SATHVI PALLI CHIKKI 200GM,14,100,80,20,1
31-12-2024,Spices & Seasonings,Jeera 100GM,15,50,45,5,1
31-12-2024,Spices & Seasonings,Avalu small 250 gms,15,60,40,20,1
31-12-2024,Oils & Ghee,Safflower oil 1 L,9,440,400,40,1
31-12-2024,"Grains, Flours & Dals",Chana Flour 1 kg,4,140,130,10,1
31-12-2024,"Grains, Flours & Dals",Chana Flour 500 gms,4,70,65,5,1
31-12-2024,Snacks & Ready-to-Eat,VD MAIDA CHEGODI 175GM,14,60,60,0,1
31-12-2024,"Grains, Flours & Dals",Wheat Flour 1 kg,4,70,60,10,1
31-12-2024,Milk & Dairy,BROWN EGGS 1P,7,84,72,12,6
31-12-2024,"Grains, Flours & Dals",VYS.SP RICE 1 KG,4,350,325,25,5
31-12-2024,Personal Care & Cosmetics,SVE PREMIUM PAPAYA SOAP 100GM,10,220,220,0,2
31-12-2024,"Grains, Flours & Dals",Wheat Flour 1 kg,4,140,120,20,2
31-12-2024,"Grains, Flours & Dals",RAGI FLOUR 500GRMS,4,40,35,5,1
31-12-2024,Personal Care & Cosmetics,SVE RED SANDAL SOAP 100GM,10,180,180,0,2
31-12-2024,"Grains, Flours & Dals",MELMEKER 250GMS,4,60,45,15,1
31-12-2024,"Dry Fruits, Nuts & Seeds",PULMAKHANA 100 GM,2,180,170,10,1
31-12-2024,"Dry Fruits, Nuts & Seeds",ALMONDS 250GM,2,280,260,20,1
31-12-2024,"Dry Fruits, Nuts & Seeds",ALMONDS 250GM,2,280,260,20,1
31-12-2024,"Dry Fruits, Nuts & Seeds",PULMAKHANA 100 GM,2,180,170,10,1
31-12-2024,Pooja & Spiritual Items,SWASTIK PURE CAMPHOR 50GM,12,90,90,0,1
31-12-2024,"Health, Wellness & Ayurvedic Products",RB Max Protein Chinese Manchurian,5,45,45,0,1
31-12-2024,"Grains, Flours & Dals",THICK POHA 500GM,4,40,35,5,1
31-12-2024,"Grains, Flours & Dals",Wheat Flour 1 kg,4,70,60,10,1
31-12-2024,Snacks & Ready-to-Eat,SD Thati thandra 200gm,14,150,150,0,1
31-12-2024,Oils & Ghee,Groundnut oil 1 L,9,360,330,30,1
31-12-2024,"Grains, Flours & Dals",MAATEJA rice 1 kg,4,360,345,15,5
31-12-2024,"Grains, Flours & Dals",turdal 1kg,4,220,195,25,1
31-12-2024,"Health, Wellness & Ayurvedic Products",RB Max Protein Spanish Tomato,5,45,45,0,1
31-12-2024,Spices & Seasonings,Turmeric powder 250 gms,15,100,75,25,1
31-12-2024,"Health, Wellness & Ayurvedic Products",MH Millets Malt 500GM,5,200,190,10,1
31-12-2024,"Grains, Flours & Dals",Wheat Flour 1 kg,4,840,720,120,12
31-12-2024,Oils & Ghee,Coconut oil 500 ml,9,220,200,20,1
31-12-2024,"Grains, Flours & Dals",VYS.SP RICE 1 KG,4,350,325,25,5
31-12-2024,Spices & Seasonings,Jeera 100GM,15,50,45,5,1
31-12-2024,Oils & Ghee,Groundnut oil 1 L,9,360,330,30,1
31-12-2024,Snacks & Ready-to-Eat,BATANA NGT 70GMS,14,20,20,0,1
31-12-2024,Milk & Dairy,HRITAGE TONED MILK 500ML,7,90,90,0,3
30-12-2024,Oils & Ghee,Coconut oil 500 ml,9,220,200,20,1
30-12-2024,Oils & Ghee,Castor oil 200 ml,9,100,80,20,1
30-12-2024,Snacks & Ready-to-Eat,VD VAMUPUSA 175GM,14,60,60,0,1
30-12-2024,Snacks & Ready-to-Eat,VD RIBBON PAKODI 175GM,14,60,60,0,1
30-12-2024,Snacks & Ready-to-Eat,SATHVI REGIVADA 200GM,14,80,60,20,1
30-12-2024,Oils & Ghee,GANTASALA A2 COW GHEE 250ML,9,299,299,0,1
30-12-2024,Snacks & Ready-to-Eat,PUMPKIN CHIKKI 200GM,14,140,120,20,1
30-12-2024,"Grains, Flours & Dals",Multigrain 1 kg,4,100,85,15,1
30-12-2024,"Grains, Flours & Dals",Wheat Flour 1 kg,4,70,60,10,1
30-12-2024,Spices & Seasonings,Jeera 100GM,15,50,45,5,1
30-12-2024,Snacks & Ready-to-Eat,NGT CHATPATTA CHANA 90GM,14,50,50,0,2
30-12-2024,"Grains, Flours & Dals",SL Idly Rava 1KG,4,65,55,10,1
30-12-2024,Baking & Cooking Aids,Baking Soda 50GM,0,20,15,5,1
30-12-2024,"Grains, Flours & Dals",Idly Rava L 1KG,4,60,50,10,1
29-12-2024,Milk & Dairy,BROWN EGGS 1P,7,168,144,24,12
27-12-2024,"Grains, Flours & Dals",VYS.SP RICE 1 KG,4,350,325,25,5
27-12-2024,"Grains, Flours & Dals",Multigrain 1 kg,4,100,85,15,1
27-12-2024,Milk & Dairy,SANGAM TONED MILK 500ML,7,60,60,0,2
26-12-2024,"Grains, Flours & Dals",VGR rice 1 kg,4,350,325,25,5
26-12-2024,"Grains, Flours & Dals",Multigrain 1 kg,4,100,85,15,1
26-12-2024,Oils & Ghee,Sesame oil 1 L,9,590,560,30,1
26-12-2024,Oils & Ghee,Safflower oil 1 L,9,440,400,40,1
26-12-2024,"Grains, Flours & Dals",Wheat Flour 1 kg,4,70,60,10,1
26-12-2024,Oils & Ghee,Groundnut oil 1 L,9,720,660,60,2
26-12-2024,Snacks & Ready-to-Eat,MARMURA LADDU,14,80,60,20,1
26-12-2024,Snacks & Ready-to-Eat,RSC ORANGE 100GMS,14,20,20,0,1
26-12-2024,"Health, Wellness & Ayurvedic Products",YB APPLE CIDER VINEGAR500ML,5,500,500,0,1
26-12-2024,Oils & Ghee,Coconut oil 500 ml,9,220,200,20,1
26-12-2024,Oils & Ghee,Safflower oil 1 L,9,440,400,40,1
26-12-2024,Baking & Cooking Aids,GONDH 50GRMS,0,70,70,0,1
26-12-2024,"Grains, Flours & Dals",Multigrain 1 kg,4,100,85,15,1
26-12-2024,Personal Care & Cosmetics,KHADI MIX FRUIT SOAP 125GM,10,80,80,0,1
26-12-2024,"Grains, Flours & Dals",White Batani 250GM,4,40,30,10,1
26-12-2024,"Grains, Flours & Dals",Sathya Javva Wheat Rava 500GM,4,95,95,0,1
26-12-2024,"Grains, Flours & Dals",HS Jowar upma rava 500 gms,4,65,65,0,1
26-12-2024,Oils & Ghee,Safflower oil 1 L,9,440,400,40,1
26-12-2024,Spices & Seasonings,NUVVULU 250GM,15,80,70,10,1
26-12-2024,"Grains, Flours & Dals",HS jowar idly rava 500 gms,4,65,65,0,1
26-12-2024,Pooja & Spiritual Items,SWASTIK CAMPHOR 25GM,12,90,90,0,2
26-12-2024,Pooja & Spiritual Items,GD Dhoop Cones 40GM,12,30,30,0,1
26-12-2024,Oils & Ghee,Groundnut oil 1 L,9,360,330,30,1
26-12-2024,Personal Care & Cosmetics,KHADI LIME FRESH 125 GM,10,80,80,0,1
26-12-2024,Sweeteners,SUGAR 1KG,16,60,50,10,1
26-12-2024,"Grains, Flours & Dals",Chana Flour 500 gms,4,70,65,5,1
26-12-2024,Beverages,BRU GREEN LABEL 1.2G,1,96,96,0,48
26-12-2024,Personal Care & Cosmetics,KHADI ALMOND SOAP 125GM,10,80,80,0,1
26-12-2024,"Health, Wellness & Ayurvedic Products",PEDIASURE VANILLA 200G,5,420,420,0,1
26-12-2024,"Grains, Flours & Dals",PESARA PAPPU 1 KG,4,170,145,25,1
26-12-2024,"Dry Fruits, Nuts & Seeds",PUTNALU 500GMS,2,90,76,14,1
26-12-2024,"Dry Fruits, Nuts & Seeds",Groundnuts 500 gms,2,95,85,10,1
26-12-2024,Sweeteners,YB JAGGERY POWDER 500GMS,16,75,75,0,1
26-12-2024,"Grains, Flours & Dals",Wheat Flour 1 kg,4,70,60,10,1
26-12-2024,"Grains, Flours & Dals",Wheat Rava M 500GM,4,33,30,3,1
26-12-2024,"Grains, Flours & Dals",turdal 1kg,4,220,195,25,1
26-12-2024,Pooja & Spiritual Items,HERBAL CITRONELLA STICK 20INC,12,45,45,0,1
26-12-2024,Pooja & Spiritual Items,HERBAL VETIVER STICK 20INC,12,45,45,0,1
26-12-2024,Milk & Dairy,BROWN EGGS TRAY 30P,7,360,330,30,1
26-12-2024,"Grains, Flours & Dals",HS Multimillet idly R 500 gms,4,65,65,0,1
26-12-2024,Snacks & Ready-to-Eat,HS Ragi biscuits,14,50,50,0,1
26-12-2024,"Grains, Flours & Dals",Brown RICE 1KG,4,70,65,5,1
26-12-2024,Sweeteners,YB FOREST HONEY 250GM,16,180,180,0,1
26-12-2024,"Grains, Flours & Dals",JOWAR YELLOW 1 K,4,90,90,0,1
26-12-2024,Snacks & Ready-to-Eat,VD BELLAM GAVVALU 200GM,14,60,60,0,1
26-12-2024,"Grains, Flours & Dals",Wheat Flour 1 kg,4,70,60,10,1
26-12-2024,"Grains, Flours & Dals",RAGI FLOUR 500GRMS,4,40,35,5,1
26-12-2024,Oils & Ghee,Groundnut oil 1 L,9,360,330,30,1
26-12-2024,"Grains, Flours & Dals",Wheat Rava M 500GM,4,33,30,3,1
26-12-2024,Personal Care & Cosmetics,GOW DURBAR NAVA 100GM SOAP,10,40,40,0,1
26-12-2024,Spices & Seasonings,Telaga Pindi 500GM,15,80,70,10,1
24-12-2024,"Grains, Flours & Dals",UDALU (Barnyard millet) 500 gms,4,70,60,10,1
24-12-2024,"Grains, Flours & Dals",SAMALU (Little millet) 500 gms,4,85,65,20,1
24-12-2024,"Grains, Flours & Dals",KORRALU (FOXTAIL M) 500GM,4,75,70,5,1
24-12-2024,Oils & Ghee,Groundnut oil 1 L,9,720,660,60,2
24-12-2024,Sweeteners,YB Palm Crystals 100GM,16,75,75,0,1
24-12-2024,Oils & Ghee,Safflower oil 1 L,9,880,800,80,2
24-12-2024,Milk & Dairy,BROWN EGGS 1P,7,140,120,20,10
24-12-2024,Oils & Ghee,Groundnut oil 1 L,9,360,330,30,1
24-12-2024,"Grains, Flours & Dals",Wheat Rava M 500GM,4,33,30,3,1
24-12-2024,"Grains, Flours & Dals",White jowar.F 1 kg,4,100,80,20,1
24-12-2024,Spices & Seasonings,Chilli powder 500 gms,15,290,210,80,1
24-12-2024,"Grains, Flours & Dals",Wheat Flour 1 kg,4,140,120,20,2
24-12-2024,"Grains, Flours & Dals",Wheat Flour 1 kg,4,140,120,20,2
24-12-2024,"Grains, Flours & Dals",Wheat Flour 1 kg,4,140,120,20,2
24-12-2024,"Health, Wellness & Ayurvedic Products",MD Triphala Chorrnam 100GM,5,60,60,0,1
24-12-2024,"Grains, Flours & Dals",Chana Flour 500 gms,4,70,65,5,1
24-12-2024,"Grains, Flours & Dals",SL Suji Rava 500GM,4,32,32,0,1
24-12-2024,"Dry Fruits, Nuts & Seeds",PULMAKHANA 100 GM,2,180,170,10,1
24-12-2024,"Grains, Flours & Dals",SRILATHA RICE RAVVA 500GM,4,35,35,0,1
24-12-2024,Snacks & Ready-to-Eat,BATANA NGT 70GMS,14,20,20,0,1
24-12-2024,Oils & Ghee,Groundnut oil 1 L,9,360,330,30,1
24-12-2024,Milk & Dairy,SANGAM CURD 450GM,7,38,38,0,1
24-12-2024,Milk & Dairy,SANGAM TONED MILK 500ML,7,30,30,0,1
24-12-2024,Milk & Dairy,SANGAM FULL CREAM MILK 500ML,7,38,38,0,1
24-12-2024,Snacks & Ready-to-Eat,PALLI LADDU 200GMS,14,90,70,20,1
24-12-2024,"Dry Fruits, Nuts & Seeds",SUNFLOWER SEEDS 250GRM,2,150,130,20,1
24-12-2024,"Grains, Flours & Dals",idly/Dosa rice 1 kg,4,210,180,30,3
24-12-2024,Milk & Dairy,SANGAM TONED MILK 500ML,7,60,60,0,2
24-12-2024,"Grains, Flours & Dals",Chittimuthaylu rice 1 kg,4,160,140,20,1
24-12-2024,"Health, Wellness & Ayurvedic Products",SAI DURGA MORINGA LEAVES 100GM,5,80,80,0,1
24-12-2024,Milk & Dairy,BROWN EGGS 1P,7,168,144,24,12
24-12-2024,Snacks & Ready-to-Eat,SD Moringa with plam jaggery 250gm,14,135,135,0,1
24-12-2024,Household & Cleaning,GAJANAND BLACK DRAGN 10STI,6,40,40,0,2
24-12-2024,Snacks & Ready-to-Eat,SD Thati thandra 200gm,14,150,150,0,1
24-12-2024,Oils & Ghee,Groundnut oil 1 L,9,360,330,30,1
24-12-2024,"Grains, Flours & Dals",MELMEKER 250GMS,4,60,45,15,1
24-12-2024,Milk & Dairy,SANGAM TONED MILK 500ML,7,120,120,0,4
24-12-2024,Pooja & Spiritual Items,SWASTIK CAMPHOR 10GM,12,20,20,0,1
24-12-2024,"Grains, Flours & Dals",White jowar.F 1 kg,4,100,80,20,1
24-12-2024,"Grains, Flours & Dals",Wheat Flour 1 kg,4,70,60,10,1
23-12-2024,Milk & Dairy,BROWN EGGS 1P,7,210,180,30,15
23-12-2024,Snacks & Ready-to-Eat,HS Ragi biscuits,14,50,50,0,1
23-12-2024,"Grains, Flours & Dals",HS BAJRA FLAKES 250GM 1+1,4,476,476,0,4
23-12-2024,"Grains, Flours & Dals",SB Javva Wheat Ravva 500GM,4,95,95,0,1
23-12-2024,"Grains, Flours & Dals",SL Idly Rava 1KG,4,65,55,10,1
22-12-2024,Milk & Dairy,BROWN EGGS 1P,7,14,12,2,1
22-12-2024,Milk & Dairy,BROWN EGGS TRAY 30P,7,360,330,30,1
22-12-2024,Milk & Dairy,BROWN EGGS 1P,7,140,120,20,10
21-12-2024,Snacks & Ready-to-Eat,SESAME LADDU 200GM,14,100,80,20,1
21-12-2024,Snacks & Ready-to-Eat,PALLI LADDU 200GMS,14,90,70,20,1
21-12-2024,Oils & Ghee,Groundnut oil 1 L,9,360,330,30,1
21-12-2024,Oils & Ghee,Groundnut oil 1 L,9,330,330,0,1
21-12-2024,Oils & Ghee,Safflower oil 1 L,9,400,400,0,1
21-12-2024,Oils & Ghee,Sesame oil 1 L,9,560,560,0,1
21-12-2024,Oils & Ghee,Groundnut oil 500ml,9,165,165,0,1
20-12-2024,Oils & Ghee,Groundnut oil 1 L,9,360,330,30,1
20-12-2024,Oils & Ghee,Coconut oil 500 ml,9,220,200,20,1
20-12-2024,Milk & Dairy,BROWN EGGS 1P,7,56,48,8,4
20-12-2024,Oils & Ghee,Sesame oil 500ml,9,295,280,15,1
20-12-2024,General Household & Kitchenware,k2,3,210,210,0,1
20-12-2024,"Grains, Flours & Dals",EM jowar upma R 500G,4,75,75,0,1
20-12-2024,Oils & Ghee,Groundnut oil 1 L,9,360,330,30,1
20-12-2024,"Dry Fruits, Nuts & Seeds",Groundnuts 500 gms,2,95,85,10,1
20-12-2024,Oils & Ghee,Sesame oil 1 L,9,1770,"1,680.00",90,3
20-12-2024,Oils & Ghee,Black Sesame oil 500 ml,9,220,190,30,1
20-12-2024,"Grains, Flours & Dals",KORRALU (FOXTAIL M) 1KG,4,150,130,20,1
20-12-2024,"Grains, Flours & Dals",MAATEJA rice 1 kg,4,360,345,15,5
20-12-2024,Oils & Ghee,Groundnut oil 1 L,9,360,330,30,1
20-12-2024,"Grains, Flours & Dals",Wheat Rava M 500GM,4,33,30,3,1
20-12-2024,"Dry Fruits, Nuts & Seeds",YELLOW KISHMISH 250GM,2,130,110,20,1
19-12-2024,Oils & Ghee,Safflower oil 1 L,9,440,400,40,1
19-12-2024,Oils & Ghee,Sesame oil 1 L,9,1180,"1,120.00",60,2
19-12-2024,Oils & Ghee,Groundnut oil 1 L,9,360,330,30,1
19-12-2024,"Grains, Flours & Dals",Bombay Rava 500GM,4,35,30,5,1
19-12-2024,Spices & Seasonings,Dry Mirchi 200 gms,15,80,60,20,1
19-12-2024,"Grains, Flours & Dals",SL Idly Rava 1KG,4,65,55,10,1
19-12-2024,Snacks & Ready-to-Eat,KURNOOL MARMURA,14,70,55,15,1
19-12-2024,"Dry Fruits, Nuts & Seeds",Groundnuts 1 kg,2,190,170,20,1
19-12-2024,Personal Care & Cosmetics,MD HERBAL HAIR SHAMPOO,10,300,300,0,1
19-12-2024,Snacks & Ready-to-Eat,Corn Chips 250GM,14,40,35,5,1
19-12-2024,Oils & Ghee,Groundnut oil 500ml,9,180,165,15,1
19-12-2024,Sweeteners,NATURAL HONEY 500ML,16,280,240,40,1
19-12-2024,Personal Care & Cosmetics,ROUND LOOFAH,10,65,65,0,1
19-12-2024,Personal Care & Cosmetics,BLACK NATURALS,10,42,42,0,1
19-12-2024,"Grains, Flours & Dals",HS JOWAR FLAKES 250GM 1+1,4,119,59,60,1
19-12-2024,Snacks & Ready-to-Eat,Popcorn Seeds 250GM,14,45,40,5,1
19-12-2024,Oils & Ghee,Sesame oil 500ml,9,295,280,15,1
19-12-2024,"Grains, Flours & Dals",split urad dall 250 gms,4,45,40,5,1
19-12-2024,Spices & Seasonings,AVALU 100GM,15,25,20,5,1
19-12-2024,Snacks & Ready-to-Eat,Corn Chips 250GM,14,40,35,5,1
19-12-2024,Oils & Ghee,Sesame oil 1 L,9,590,560,30,1
19-12-2024,Oils & Ghee,Groundnut oil 5 L,9,1800,"1,600.00",200,1
19-12-2024,"Grains, Flours & Dals",Wheat Flour 1 kg,4,70,60,10,1
19-12-2024,Pooja & Spiritual Items,SWAATHI GATTI DEEPAM VATTULU,12,30,30,0,1
19-12-2024,Milk & Dairy,SANGAM TONED MILK 500ML,7,30,30,0,1
19-12-2024,Oils & Ghee,PRIYA RICE RICH 1LTR,9,223,210,13,1
19-12-2024,Snacks & Ready-to-Eat,SESAME CHIKKI,14,120,100,20,1
19-12-2024,Personal Care & Cosmetics,Soapnut 250GM,10,120,90,30,2
19-12-2024,"Grains, Flours & Dals",Green gram 500 gms,4,150,140,10,2
19-12-2024,Snacks & Ready-to-Eat,VD SAGOPAPAD 150GM,14,220,220,0,4
19-12-2024,"Dry Fruits, Nuts & Seeds",Groundnuts 1 kg,2,380,340,40,2
19-12-2024,"Grains, Flours & Dals",Urad dall 1 Kg,4,185,170,15,1
19-12-2024,Sweeteners,SUGAR 1KG,16,60,50,10,1
19-12-2024,"Grains, Flours & Dals",PESARA PAPPU 1 KG,4,170,145,25,1
19-12-2024,"Grains, Flours & Dals",RICE FLOUR 1KG,4,70,50,20,1
18-12-2024,"Grains, Flours & Dals",Wheat Flour 1 kg,4,70,60,10,1
18-12-2024,Spices & Seasonings,Jeera 100GM,15,50,45,5,1
18-12-2024,"Grains, Flours & Dals",Multigrain 1 kg,4,100,85,15,1
18-12-2024,"Grains, Flours & Dals",Multigrain 1 kg,4,100,85,15,1
18-12-2024,Snacks & Ready-to-Eat,SATHVI REGIVADA 200GM,14,80,80,0,1
18-12-2024,"Grains, Flours & Dals",Wheat Flour 1 kg,4,140,120,20,2
18-12-2024,Oils & Ghee,Coconut oil 1 L,9,1760,"1,600.00",160,4
18-12-2024,"Dry Fruits, Nuts & Seeds",Groundnuts 1 kg,2,190,170,20,1
18-12-2024,Oils & Ghee,Groundnut oil 1 L,9,360,330,30,1
18-12-2024,Sweeteners,YB Brown Sugar 1KG,16,140,140,0,1
18-12-2024,Spices & Seasonings,PURO Healthy Salt 1KG,15,110,110,0,1
18-12-2024,"Dry Fruits, Nuts & Seeds",Putnalu 250GM,2,45,38,7,1
18-12-2024,"Grains, Flours & Dals",Wheat Flour 1 kg,4,70,60,10,1
18-12-2024,Milk & Dairy,HRITAGE TONED MILK 500ML,7,30,30,0,1
18-12-2024,Milk & Dairy,SANGAM FULL CREAM MILK 500ML,7,38,38,0,1
17-12-2024,"Grains, Flours & Dals",Wheat Flour 1 kg,4,140,120,20,2
17-12-2024,Oils & Ghee,Sesame oil 1 L,9,1770,"1,680.00",90,3
17-12-2024,"Grains, Flours & Dals",Wheat Flour 2 kgs,4,140,120,20,1
17-12-2024,Oils & Ghee,Groundnut oil 1 L,9,360,330,30,1
17-12-2024,Snacks & Ready-to-Eat,GS Instant Raagi Dosa Mix 400GM,14,198,198,0,2
17-12-2024,"Grains, Flours & Dals",White Chana 500GM,4,120,100,20,1
17-12-2024,Oils & Ghee,Groundnut oil 1 L,9,360,330,30,1
17-12-2024,Oils & Ghee,Safflower oil 1 L,9,440,400,40,1
17-12-2024,"Grains, Flours & Dals",HS Ragi upma rava 500 gms,4,70,70,0,1
17-12-2024,"Dry Fruits, Nuts & Seeds",SALTED PISTA 250GM,2,400,350,50,1
17-12-2024,Snacks & Ready-to-Eat,RSC ORANGE 100GMS,14,20,20,0,1
17-12-2024,Snacks & Ready-to-Eat,SATHVI PALLI CHIKKI 200GM,14,100,80,20,1
17-12-2024,"Health, Wellness & Ayurvedic Products",AMLA PACHAK,5,100,100,0,1
17-12-2024,"Grains, Flours & Dals",Red Chana 500 GM,4,75,60,15,1
17-12-2024,Oils & Ghee,Groundnut oil 1 L,9,360,330,30,1
17-12-2024,Sweeteners,Mishri 250 GM,16,35,30,5,1
17-12-2024,Snacks & Ready-to-Eat,BATANA NGT 70GMS,14,40,40,0,2
17-12-2024,Oils & Ghee,Groundnut oil 1 L,9,720,660,60,2
17-12-2024,Spices & Seasonings,Biryani Leaf 25GM,15,30,20,10,1
17-12-2024,Personal Care & Cosmetics,KAIPO ACT CHARCOAL TP 100G,10,90,90,0,1
17-12-2024,Spices & Seasonings,RED COPRA 250GMS,15,85,74,11,1
17-12-2024,Sweeteners,YB JAGGERY POWDER 500GMS,16,75,75,0,1
17-12-2024,Oils & Ghee,Safflower oil 1 L,9,440,400,40,1
17-12-2024,Spices & Seasonings,Konark Crystal Salt 1KG,15,20,20,0,1
17-12-2024,Spices & Seasonings,Jeera 100GM,15,50,45,5,1
17-12-2024,Milk & Dairy,HRITAGE TONED MILK 500ML,7,60,60,0,2
17-12-2024,Household & Cleaning,COMFORT EAU DE PARFUM 210ML,6,65,65,0,1
17-12-2024,"Grains, Flours & Dals",RICE FLOUR 1KG,4,70,50,20,1
17-12-2024,Oils & Ghee,Groundnut oil 1 L,9,360,330,30,1
17-12-2024,"Grains, Flours & Dals",Wheat Flour 1 kg,4,210,180,30,3
17-12-2024,"Grains, Flours & Dals",POORI ATTA 1KG,4,70,60,10,1
17-12-2024,"Grains, Flours & Dals",white Bobarlu 500 gms,4,80,75,5,1
17-12-2024,"Grains, Flours & Dals",Chana Flour 500 gms,4,70,65,5,1
17-12-2024,Sweeteners,SUGAR 1KG,16,120,100,20,2
16-12-2024,Snacks & Ready-to-Eat,Popcorn Seeds 250GM,14,45,40,5,1
16-12-2024,"Dry Fruits, Nuts & Seeds",Groundnuts 500 gms,2,95,85,10,1
16-12-2024,"Grains, Flours & Dals",HS Multimillet upma r 500g,4,65,65,0,1
16-12-2024,"Grains, Flours & Dals",Wheat Flour 2 kgs,4,140,120,20,1
16-12-2024,"Grains, Flours & Dals",RAGI FLOUR 500GRMS,4,40,35,5,1
16-12-2024,"Grains, Flours & Dals",VGR RICE 10 KGS,4,700,650,50,1
16-12-2024,Pickles & Cooking Pastes,SD PESARA AVAKAYA 250GMS,11,110,110,0,1
16-12-2024,"Grains, Flours & Dals",Quinova 1 kg,4,240,210,30,1
16-12-2024,"Dry Fruits, Nuts & Seeds",Groundnuts 500 gms,2,95,85,10,1
16-12-2024,Spices & Seasonings,Masala Karam 250 gms,15,130,120,10,1
16-12-2024,"Grains, Flours & Dals",HS Multimillet upma r 500g,4,65,65,0,1
16-12-2024,Oils & Ghee,Groundnut oil 1 L,9,360,330,30,1
16-12-2024,Oils & Ghee,PRIYA RICE RICH 1LTR,9,223,210,13,1
16-12-2024,"Grains, Flours & Dals",white Bobarlu 500 gms,4,80,75,5,1
16-12-2024,"Grains, Flours & Dals",DH URAD GOTA 1KG,4,215,190,25,1
16-12-2024,Sweeteners,Mishri 250 GM,16,35,30,5,1
16-12-2024,Oils & Ghee,Groundnut oil 1 L,9,360,330,30,1
16-12-2024,Spices & Seasonings,Coconut Powder 250GM,15,70,70,0,1
16-12-2024,"Health, Wellness & Ayurvedic Products",MD Triphala Chorrnam 100GM,5,60,60,0,1
16-12-2024,"Dry Fruits, Nuts & Seeds",Dianuts 500GM,2,240,240,0,2
16-12-2024,"Grains, Flours & Dals",turdal 1kg,4,440,390,50,2
16-12-2024,"Dry Fruits, Nuts & Seeds",Groundnuts 1 kg,2,190,170,20,1
16-12-2024,Spices & Seasonings,ROYAL SAFFRON 400GRMS,15,65,65,0,1
16-12-2024,"Grains, Flours & Dals",Urad dall 1 Kg,4,370,340,30,2
16-12-2024,"Grains, Flours & Dals",AMMA RICE RAVA 500GRMS,4,42,42,0,1
16-12-2024,"Grains, Flours & Dals",Green gram 500 gms,4,75,70,5,1
16-12-2024,Spices & Seasonings,Masala Karam 500 gms,15,520,480,40,2
16-12-2024,"Grains, Flours & Dals",split black gram 500 gms,4,90,85,5,1
16-12-2024,"Grains, Flours & Dals",Em jowar idly R 500G,4,300,300,0,4
16-12-2024,"Grains, Flours & Dals",Wheat Flour 1 kg,4,70,60,10,1
16-12-2024,"Grains, Flours & Dals",Sathya Javva Wheat Rava 500GM,4,95,95,0,1
16-12-2024,Snacks & Ready-to-Eat,Sprouted Ragi Biscuits 450GM,14,150,150,0,1
16-12-2024,Spices & Seasonings,Jeera 100GM,15,100,90,10,2
16-12-2024,Sweeteners,GS Palm Jaggery Powder 400GM,16,180,180,0,1
16-12-2024,Spices & Seasonings,LG 50GM,15,92,92,0,1
16-12-2024,Oils & Ghee,Safflower oil 1 L,9,440,400,40,1
16-12-2024,Oils & Ghee,Safflower oil 1 L,9,440,400,40,1
16-12-2024,Oils & Ghee,Groundnut oil 1 L,9,360,330,30,1
16-12-2024,Spices & Seasonings,Green Sounf 100GM,15,60,60,0,1